nume,jud,pe_lista,"06_21 LP","06_21 LS","06_21 UM","06_21 LT","07_21 LP","07_21 LS","07_21 UM","07_21 LT"
"ALBA IULIA",AB,54716,3513,514,53,4080,10773,1249,94,12116
BĂRĂBANŢ,AB,2259,114,9,0,123,427,19,0,446
MICEŞTI,AB,2263,114,8,0,122,533,39,0,572
OARDA,AB,1988,132,11,0,143,508,43,1,552
PÎCLIŞA,AB,865,35,3,0,38,221,7,0,228
AIUD,AB,16397,818,72,369,1259,2921,213,407,3541
"AIUDUL DE SUS",AB,2032,101,4,1,106,450,23,2,475
CIUMBRUD,AB,1074,27,5,0,32,143,13,0,156
GÎMBAŞ,AB,414,6,4,0,10,31,9,0,40
"GÎRBOVA DE JOS",AB,418,15,2,0,17,107,24,0,131
"GÎRBOVA DE SUS",AB,233,8,2,0,10,59,8,0,67
GÎRBOVIŢA,AB,99,1,3,0,4,23,12,0,35
MĂGINA,AB,464,24,5,0,29,168,14,0,182
PĂGIDA,AB,93,1,4,0,5,15,6,0,21
SÎNCRAI,AB,572,23,7,0,30,124,13,0,137
BLAJ,AB,14362,592,83,0,675,2227,166,1,2394
MĂNĂRADE,AB,900,17,7,0,24,122,12,0,134
PETRISAT,AB,480,5,0,0,5,20,0,0,20
TIUR,AB,1301,41,0,0,41,204,1,0,205
SEBEŞ,AB,19741,981,92,4,1077,3296,215,9,3520
LANCRĂM,AB,1416,78,5,0,83,332,30,0,362
PETREŞTI,AB,4233,208,12,0,220,872,42,1,915
RĂHĂU,AB,850,17,2,0,19,118,12,0,130
ABRUD,AB,4666,190,25,0,215,1046,102,3,1151
"BAIA DE ARIEŞ",AB,2439,94,12,17,123,419,32,17,468
BRĂZEŞTI,AB,212,8,1,0,9,49,7,0,56
"CIOARA DE SUS",AB,191,7,3,0,10,40,5,0,45
MUNCELU,AB,304,10,5,0,15,81,11,0,92
SARTĂŞ,AB,320,10,0,0,10,320,6,0,326
CÎMPENI,AB,5342,414,72,41,527,1831,184,42,2057
CERTEGE,AB,384,40,0,0,40,128,9,0,137
MIHOEŞTI,AB,274,18,5,0,23,98,10,0,108
"VALEA BISTRII",AB,378,28,5,0,33,113,12,0,125
CUGIR,AB,20159,1085,85,0,1170,3947,196,5,4148
BUCURU,AB,104,0,2,0,2,14,7,0,21
CĂLENE,AB,48,5,5,0,10,15,6,0,21
MUGEŞTI,AB,93,0,4,0,4,6,5,0,11
VINEREA,AB,1971,69,11,0,80,430,33,0,463
"OCNA MUREŞ",AB,7788,302,23,0,325,1117,78,0,1195
"UIOARA DE JOS",AB,902,31,6,0,37,171,15,0,186
"UIOARA DE SUS",AB,1392,22,0,0,22,141,5,0,146
"CISTEIU DE MUREŞ",AB,542,9,1,0,10,36,5,0,41
MICOŞLACA,AB,245,1,2,0,3,22,10,0,32
RĂZBOIENI-CETATE,AB,1104,40,6,0,46,203,13,0,216
TEIUŞ,AB,5452,202,32,0,234,834,86,0,920
BELDIU,AB,201,5,1,0,6,29,22,0,51
PEŢELCA,AB,122,3,0,0,3,31,7,0,38
CĂPUD,AB,264,22,5,0,27,101,13,0,114
ZLATNA,AB,3537,171,15,0,186,562,48,0,610
FENEŞ,AB,765,26,5,0,31,272,24,0,296
GALAŢI,AB,311,5,1,0,6,37,14,0,51
"IZVORU AMPOIULUI",AB,419,5,0,0,5,60,11,0,71
PĂTRÎNGENI,AB,508,17,2,0,19,110,8,0,118
PIRITA,AB,369,10,1,0,11,39,5,0,44
TRÎMPOIELE,AB,338,19,1,0,20,66,8,0,74
"VALEA MICĂ",AB,342,34,6,0,40,137,8,0,145
VÎLTORI,AB,178,10,0,0,10,23,5,0,28
ALBAC,AB,751,48,60,0,108,328,112,9,449
CIONEŞTI,AB,541,9,7,0,16,198,20,3,221
COSTEŞTI,AB,86,2,2,0,4,36,5,0,41
POTIONCI,AB,68,11,3,0,14,36,7,0,43
ROGOZ,AB,242,29,10,0,39,113,20,0,133
"ALMAŞU MARE",AB,535,31,0,0,31,138,16,0,154
"ALMAŞU DE MIJLOC",AB,127,6,2,0,8,45,9,0,54
CIB,AB,240,1,0,0,1,27,5,0,32
GLOD,AB,154,7,4,0,11,78,16,0,94
ARIEŞENI,AB,1124,33,21,0,54,386,60,0,446
"CASA DE PIATRĂ",AB,90,1,0,0,1,19,1,0,20
COBLEŞ,AB,199,12,2,0,14,85,7,0,92
"AVRAM IANCU",AB,624,15,7,0,22,137,25,0,162
TÎRSA,AB,628,7,2,0,9,119,15,0,134
HENIG,AB,236,12,2,0,14,64,19,1,84
BERGHIN,AB,707,44,7,0,51,178,27,0,205
GHIRBOM,AB,425,17,3,0,20,152,21,0,173
STRAJA,AB,292,15,4,0,19,64,5,0,69
BISTRA,AB,2677,54,2,0,56,457,30,0,487
CIULDEŞTI,AB,626,8,5,0,13,94,7,0,101
GÎRDE,AB,654,14,3,0,17,113,13,0,126
BLANDIANA,AB,470,6,6,0,12,65,19,0,84
ACMARIU,AB,293,8,10,0,18,84,26,0,110
RĂCĂTĂU,AB,27,1,0,0,1,10,6,0,16
"BUCERDEA GRÂNOASĂ",AB,1846,25,0,0,25,222,8,0,230
CIUCULEŞTI,AB,361,14,3,0,17,82,15,0,97
BUCIUM-SAT,AB,416,20,1,0,21,136,16,0,152
CERBU,AB,272,9,0,0,9,69,8,0,77
POIENI,AB,275,21,1,0,22,93,20,0,113
CENADE,AB,759,12,2,1,15,94,8,2,104
"CERGĂU MARE",AB,813,13,2,0,15,139,8,0,147
"CERGĂU MIC",AB,259,22,2,0,24,78,19,0,97
LUPU,AB,206,20,9,0,29,71,18,0,89
CERU-BĂCĂINŢI,AB,213,9,1,0,10,38,11,0,49
"CETATEA DE BALTĂ",AB,1481,44,1,0,45,125,12,0,137
"CRACIUNELU DE SUS",AB,83,13,6,0,19,32,11,0,43
SÎNTĂMĂRIE,AB,243,5,0,0,5,20,3,0,23
TĂTÎRLAUA,AB,619,18,2,0,20,118,11,0,129
CIUGUD,AB,480,29,12,0,41,123,29,4,156
DRÎMBAR,AB,327,17,2,0,19,113,26,4,143
HĂPRIA,AB,488,73,9,0,82,185,38,12,235
LIMBA,AB,321,41,6,0,47,115,17,11,143
ŞEUŞA,AB,636,69,6,15,90,219,21,26,266
TELEAC,AB,335,44,7,0,51,140,19,8,167
BUNINGINEA,AB,371,19,4,0,23,141,13,5,159
CIURULEASA,AB,596,24,9,0,33,249,42,12,303
CÎLNIC,AB,1127,54,2,0,56,286,24,0,310
DEAL,AB,311,33,9,0,42,148,39,0,187
"CRĂCIUNELU DE JOS",AB,1730,45,10,0,55,243,22,0,265
CRICĂU,AB,1106,53,4,0,57,206,19,1,226
CRAIVA,AB,297,20,1,0,21,97,12,0,109
TIBRU,AB,324,10,1,0,11,82,8,0,90
CUT,AB,1062,30,1,0,31,283,20,0,303
"DAIA ROMÂNĂ",AB,2571,82,12,0,94,601,36,0,637
DOŞTAT,AB,402,14,2,0,16,82,23,0,105
BOZ,AB,368,17,4,0,21,63,8,0,71
FĂRĂU,AB,478,23,9,0,32,143,25,0,168
HERIA,AB,219,13,2,0,15,85,13,0,98
SÎNBENEDIC,AB,200,3,5,0,8,29,13,0,42
MEDVEŞ,AB,147,2,3,0,5,12,6,0,18
ŞILEA,AB,252,10,0,0,10,52,9,0,61
"GALDA DE JOS",AB,1566,53,5,0,58,326,27,0,353
BENIC,AB,431,10,2,0,12,53,15,0,68
CETEA,AB,360,8,7,0,15,49,24,0,73
"GALDA DE SUS",AB,342,21,10,0,31,76,24,0,100
MESENTEA,AB,198,6,6,0,12,47,20,0,67
OIEJDEA,AB,717,11,3,0,14,65,4,0,69
"POIANA GALDEI",AB,129,4,0,0,4,19,4,0,23
GÎRBOVA,AB,1178,38,5,0,43,220,16,0,236
CĂRPINIŞ,AB,206,14,10,0,24,52,23,0,75
RECIU,AB,267,19,5,0,24,86,20,0,106
"GÎRDA DE SUS",AB,829,39,4,0,43,199,40,1,240
BIHARIA,AB,131,1,0,0,1,21,7,0,28
GHEŢARI,AB,426,1,0,0,1,109,8,0,117
HOPÎRTA,AB,231,18,5,0,23,81,11,0,92
SILIVAŞ,AB,219,12,2,0,14,46,5,0,51
ŞPĂLNACA,AB,160,12,7,0,19,39,16,0,55
TURDAŞ,AB,142,8,7,0,15,39,23,0,62
"VAMA SEACĂ",AB,149,7,4,0,11,31,18,0,49
HOREA,AB,628,20,2,0,22,192,16,0,208
DÎRLEŞTI,AB,391,29,4,8,41,246,13,8,267
GIURGIUŢ,AB,123,0,2,0,2,46,9,0,55
MĂTIŞEŞTI,AB,356,8,1,0,9,163,7,0,170
PĂTRUŞEŞTI,AB,133,9,4,0,13,65,12,0,77
PRELUCA,AB,61,11,3,0,14,18,5,0,23
IGHIU,AB,1154,87,8,0,95,300,41,0,341
"BUCERDEA VINOASĂ",AB,753,25,5,0,30,195,23,0,218
IGHIEL,AB,821,58,2,0,60,328,12,0,340
ŞARD,AB,2001,51,10,0,61,272,35,0,307
ŢELNA,AB,886,25,0,0,25,236,6,0,242
ÎNTREGALDE,AB,234,6,0,0,6,26,6,0,32
"DEALU GEOAGIULUI",AB,87,5,2,0,7,8,5,0,13
GHIONCANI,AB,58,1,4,0,5,8,8,0,16
NECRILEŞTI,AB,145,5,3,0,8,37,5,0,42
JIDVEI,AB,1098,14,1,0,15,90,11,0,101
BĂLCACIU,AB,1107,19,2,0,21,81,12,0,93
"CĂPÎLNA DE JOS",AB,648,30,1,0,31,100,9,0,109
FEISA,AB,659,24,6,0,30,131,9,0,140
VESEUŞ,AB,750,17,2,0,19,79,5,0,84
LIVEZILE,AB,597,43,11,0,54,188,21,16,225
"POIANA AIUDULUI",AB,276,21,1,0,22,113,18,10,141
IZVOARELE,AB,106,30,27,0,57,59,41,10,110
VĂLIŞOARA,AB,116,5,6,0,11,39,24,0,63
"LOPADEA NOUĂ",AB,820,4,2,0,6,54,6,0,60
ASINIP,AB,87,2,1,0,3,28,26,0,54
BĂGĂU,AB,438,22,1,0,23,91,16,0,107
BEŢA,AB,312,3,3,0,6,7,4,0,11
CIUGUZEL,AB,549,25,10,0,35,192,26,0,218
ODVEREM,AB,46,3,7,0,10,15,13,0,28
"LUNCA MUREŞULUI",AB,1682,28,8,0,36,195,18,0,213
"GURA ARIEŞULUI",AB,388,39,2,0,41,96,16,0,112
LUPŞA,AB,692,40,7,0,47,225,30,0,255
HĂDĂRĂU,AB,313,8,8,0,16,83,25,0,108
"VALEA LUPŞII",AB,734,26,5,0,31,163,19,0,182
MUŞCA,AB,960,38,2,0,40,203,16,0,219
"LUNCA AMPOIŢEI",AB,212,4,5,0,9,48,11,0,59
"PRESACA AMPOIULUI",AB,294,12,0,0,12,91,14,0,105
METEŞ,AB,532,23,9,0,32,164,22,0,186
AMPOIŢA,AB,588,24,5,0,29,162,26,0,188
TĂUŢI,AB,545,11,1,0,12,95,11,1,107
"POIANA AMPOIULUI",AB,220,14,6,0,20,58,16,0,74
MIHALŢ,AB,1861,49,6,0,55,320,28,0,348
CISTEI,AB,466,14,1,0,15,72,15,0,87
OBREJA,AB,470,15,9,0,24,72,18,0,90
MIRĂSLĂU,AB,718,20,3,0,23,122,10,0,132
CICĂU,AB,104,2,0,0,2,17,10,0,27
DECEA,AB,635,10,4,0,14,90,15,0,105
"LOPADEA VECHE",AB,229,8,1,0,9,51,12,0,63
ORMENIŞ,AB,65,7,7,0,14,20,14,0,34
MOGOŞ,AB,512,15,3,0,18,107,21,0,128
BUTEŞTI,AB,59,4,0,0,4,12,7,0,19
"VALEA BARNII",AB,148,5,5,0,10,41,18,0,59
NOŞLAC,AB,977,26,10,0,36,160,27,0,187
GĂBUD,AB,211,2,2,0,4,47,17,0,64
"STÂNA DE MUREŞ",AB,317,11,4,0,15,56,21,0,77
OCOLIŞ,AB,268,11,3,0,14,54,12,0,66
"LUNCA LARGĂ",AB,51,5,2,0,7,18,7,0,25
RUNC,AB,123,1,0,0,1,26,4,0,30
VIDOLM,AB,57,3,0,0,3,9,11,0,20
OHABA,AB,361,18,9,0,27,134,26,10,170
COLIBI,AB,30,3,1,0,4,7,6,0,13
SECĂŞEL,AB,157,5,6,0,11,30,23,0,53
"PIANU DE SUS",AB,1381,39,8,0,47,346,27,0,373
"PIANU DE JOS",AB,1100,23,6,0,29,155,23,0,178
PLAIURI,AB,41,0,0,0,0,11,8,0,19
PURCĂREŢI,AB,215,10,2,0,12,31,3,0,34
STRUNGARI,AB,202,36,7,0,43,113,18,0,131
"POIANA VADULUI",AB,872,45,3,0,48,304,19,2,325
PONOR,AB,347,21,2,5,28,154,30,8,192
GEOGEL,AB,188,9,7,0,16,50,34,0,84
"POŞAGA DE JOS",AB,366,16,3,0,19,87,12,0,99
LUNCA,AB,122,2,4,0,6,15,7,0,22
ORĂŞTI,AB,107,4,1,0,5,26,5,0,31
"POŞAGA DE SUS",AB,145,1,0,0,1,23,6,0,29
SAGAGEA,AB,175,6,3,0,9,17,4,0,21
RĂDEŞTI,AB,575,29,7,0,36,133,20,0,153
LEORINŢ,AB,252,6,0,0,6,38,11,0,49
MEŞCREAC,AB,251,4,0,0,4,43,11,0,54
RIMETEA,AB,472,16,6,0,22,41,20,0,61
COLŢEŞTI,AB,441,3,2,0,5,13,3,0,16
RÎMEŢ,AB,178,11,5,0,16,41,27,7,75
BRĂDEŞTI,AB,93,10,11,0,21,37,31,0,68
"VALEA INZELULUI",AB,74,5,2,0,7,26,11,0,37
"VALEA MĂNĂSTIRII",AB,138,52,90,0,142,71,149,8,228
UNGUREI,AB,266,6,3,0,9,30,13,0,43
"ROŞIA DE SECAŞ",AB,582,26,3,0,29,131,16,0,147
TĂU,AB,369,21,7,0,28,80,18,0,98
CĂRPINIŞ,AB,1303,63,7,0,70,326,12,0,338
VÎRTOP,AB,182,4,2,0,6,51,12,0,63
"ROŞIA MONTANĂ",AB,700,17,5,0,22,127,16,0,143
CORNA,AB,133,9,0,0,9,35,9,0,44
"SĂLCIUA DE JOS",AB,704,28,6,0,34,187,25,1,213
"SĂLCIUA DE SUS",AB,591,15,0,0,15,147,9,0,156
SĂLIŞTEA,AB,1041,55,6,0,61,346,24,0,370
MĂRGINENI,AB,49,13,5,0,18,21,13,0,34
SĂLIŞTEA-DEAL,AB,236,10,3,0,13,121,5,0,126
TĂRTĂRIA,AB,570,11,1,0,12,88,22,0,110
CĂPÎLNA,AB,698,71,8,0,79,194,12,0,206
SĂSCIORI,AB,1338,35,4,0,39,199,28,0,227
LAZ,AB,349,18,4,0,22,91,14,0,105
SEBEŞEL,AB,1026,45,11,0,56,183,34,0,217
LOMAN,AB,677,26,2,0,28,139,11,0,150
RĂCHITA,AB,728,15,0,0,15,251,15,0,266
SCĂRIŞOARA,AB,596,13,1,0,14,163,13,0,176
NEGEŞTI,AB,154,1,0,0,1,41,5,0,46
RUNC,AB,144,3,4,0,7,42,4,0,46
SFOARTEA,AB,68,1,5,0,6,14,7,0,21
ŞTIULEŢI,AB,118,8,0,0,8,38,10,0,48
LĂZEŞTI,AB,212,29,1,0,30,86,31,0,117
SÎNCEL,AB,1318,28,5,0,33,209,19,0,228
ICLOD,AB,309,5,6,0,11,53,12,0,65
PĂNADE,AB,527,24,3,0,27,98,11,0,109
COŞLARIU,AB,357,12,5,0,17,54,19,0,73
TOTOI,AB,437,21,7,0,28,103,32,0,135
SÎNTIMBRU,AB,1177,55,6,0,61,208,24,0,232
DUMITRA,AB,70,4,3,0,7,13,10,0,23
GALTIU,AB,407,18,9,0,27,70,21,1,92
PELEŞ,AB,358,9,5,0,14,70,8,0,78
POIANA,AB,133,6,1,0,7,30,10,0,40
SOHODOL,AB,815,24,3,0,27,166,7,0,173
LAZURI,AB,185,4,4,0,8,44,7,0,51
STREMŢ,AB,1160,57,13,0,70,238,46,3,287
"GEOAGIU DE SUS",AB,643,24,6,0,30,121,21,0,142
GEOMAL,AB,271,8,8,0,16,97,25,0,122
ŞIBOT,AB,1174,19,1,0,20,210,44,0,254
"BALOMIRU DE CÎMP",AB,527,28,7,0,35,114,22,0,136
BĂCĂINŢI,AB,227,7,2,0,9,18,6,0,24
SĂRĂCSĂU,AB,161,7,2,0,9,29,4,0,33
"LUNCA TÎRNAVEI",AB,343,3,3,0,6,48,7,0,55
ŞONA,AB,1052,18,2,0,20,116,9,0,125
ALECUŞ,AB,91,3,11,0,14,20,16,0,36
BIIA,AB,969,14,9,0,23,154,13,0,167
SÎNMICLĂUŞ,AB,1154,9,3,0,12,42,4,0,46
ŞPRING,AB,579,21,5,0,26,203,35,2,240
CUNŢA,AB,474,20,9,0,29,131,18,0,149
DRAŞOV,AB,434,15,5,0,20,114,20,0,134
VINGARD,AB,574,17,5,0,22,104,19,0,123
DOBRA,AB,451,37,1,0,38,94,10,0,104
MĂRTINIE,AB,450,8,3,0,11,92,9,0,101
ŞUGAG,AB,1430,37,16,0,53,250,46,0,296
UNIREA,AB,2953,77,18,0,95,337,38,0,375
"CIUGUDU DE JOS",AB,281,14,1,0,15,53,4,0,57
"CIUGUDU DE SUS",AB,118,4,5,0,9,28,17,0,45
DUMBRAVA,AB,278,39,19,31,89,82,32,31,145
INOC,AB,163,7,9,0,16,32,15,0,47
MĂHĂCENI,AB,229,15,4,0,19,53,28,1,82
"VADU MOŢILOR",AB,1139,42,8,0,50,275,33,0,308
"VALEA LUNGĂ",AB,1553,42,2,0,44,163,10,2,175
FĂGET,AB,21,1,2,0,3,8,10,0,18
GLOGOVEŢ,AB,135,8,7,0,15,31,14,0,45
LODROMAN,AB,156,16,3,0,19,31,5,0,36
LUNCA,AB,374,5,10,0,15,43,20,0,63
TĂUNI,AB,241,6,1,0,7,40,13,0,53
VIDRA,AB,308,9,4,0,13,79,12,0,91
GOIEŞTI,AB,293,17,7,0,24,56,12,0,68
PONOREL,AB,733,20,0,0,20,151,9,0,160
VURPĂR,AB,860,21,1,0,22,128,11,0,139
"VINŢU DE JOS",AB,2975,153,15,0,168,631,49,1,681
INURI,AB,155,1,2,0,3,12,9,0,21
MERETEU,AB,171,2,4,0,6,51,10,0,61
"VALEA VINŢULUI",AB,335,3,4,0,7,24,6,0,30
PITEŞTI,AG,146478,9061,498,19,9578,24568,1553,79,26200
CÂMPULUNG,AG,30746,1338,183,10,1531,4517,473,38,5028
"CURTEA DE ARGEŞ",AG,27423,1024,132,51,1207,4262,329,51,4642
NOAPTEŞ,AG,735,18,3,0,21,100,18,0,118
COSTEŞTI,AG,6880,212,45,16,273,904,83,17,1004
BROŞTENI,AG,676,23,5,0,28,87,16,0,103
"PODU BROŞTENI",AG,521,12,13,0,25,57,33,0,90
"PÎRVU ROŞU",AG,518,11,3,0,14,52,11,0,63
STÎRCI,AG,199,10,4,0,14,13,10,0,23
MIOVENI,AG,23908,1146,175,289,1610,3313,423,290,4026
RACOVIŢA,AG,1604,95,53,11,159,398,221,32,651
COLIBAŞI,AG,2004,85,6,62,153,366,20,67,453
CLUCEREASA,AG,312,11,1,0,12,57,6,0,63
FĂGETU,AG,934,85,7,0,92,374,28,0,402
ENCULEŞTI,AG,470,13,2,0,15,65,11,0,76
"VALEA MARE-PODGORIA",AG,4716,166,40,0,206,768,138,0,906
"ŞTEFĂNEŞTII NOI",AG,3036,172,27,0,199,478,69,0,547
IZVORANI,AG,969,17,11,0,28,94,29,0,123
ŞTEFĂNEŞTI,AG,2464,68,16,0,84,327,70,0,397
GOLEŞTI,AG,1035,45,4,0,49,158,15,0,173
TOPOLOVENI,AG,7151,331,52,0,383,1218,135,0,1353
ŢIGĂNEŞTI,AG,690,28,7,0,35,139,11,0,150
"ALBEŞTII PAMÎNTENI",AG,1566,38,19,0,57,245,32,0,277
"ALBEŞTII UNGURENI",AG,2013,13,2,0,15,195,14,0,209
BRĂTEŞTI,AG,614,9,2,0,11,114,14,0,128
DOBROTU,AG,830,17,8,0,25,118,17,0,135
ALBEŞTI,AG,938,27,3,0,30,172,20,0,192
CÎNDEŞTI,AG,355,9,11,0,20,76,25,0,101
ALBOTA,AG,1875,75,6,0,81,293,30,0,323
MAREŞ,AG,873,15,7,0,22,186,31,0,217
CERBU,AG,634,28,13,0,41,152,27,0,179
ANINOASA,AG,1224,35,9,0,44,273,39,0,312
"VALEA SILIŞTII",AG,521,6,6,0,12,132,27,0,159
SLĂNIC,AG,919,19,4,0,23,253,24,0,277
AREFU,AG,1075,24,7,0,31,131,26,0,157
"CĂPĂŢÎNENII PĂMÂNTENI",AG,953,14,18,0,32,91,42,0,133
BASCOV,AG,4595,197,23,0,220,708,83,0,791
SCHIAU,AG,1451,52,6,0,58,274,20,5,299
GLÎMBOCU,AG,773,32,3,0,35,127,16,0,143
"VALEA URSULUI",AG,1558,28,9,0,37,261,66,0,327
MICA,AG,509,22,1,0,23,161,18,0,179
BĂBANA,AG,1359,40,12,0,52,274,59,0,333
SLĂATIOARELE,AG,675,19,7,0,26,112,33,0,145
GROŞI,AG,373,8,9,0,17,90,33,0,123
BĂICULEŞTI,AG,1398,26,7,0,33,200,36,0,236
MĂNICEŞTI,AG,625,10,3,0,13,98,21,0,119
ZIGONENI,AG,826,14,3,0,17,125,14,0,139
"VALEA LUI ENACHE",AG,682,2,3,0,5,121,10,0,131
TUTANA,AG,1526,17,4,0,21,278,21,0,299
BĂLILEŞTI,AG,909,32,10,0,42,176,33,0,209
BĂJEŞTI,AG,858,16,9,0,25,148,25,0,173
POIENIŢA,AG,990,23,1,0,24,193,16,0,209
GOLEŞTI,AG,582,16,6,0,22,113,18,0,131
BELEŢI,AG,547,17,3,0,20,79,9,0,88
NEGREŞTI,AG,975,16,6,0,22,185,29,0,214
BEREVOEŞTI,AG,1704,23,5,0,28,180,24,0,204
GĂMĂCEŞTI,AG,846,1,2,0,3,194,13,0,207
BRATIA,AG,155,8,10,0,18,34,13,0,47
URLUENI,AG,1030,29,7,0,36,97,49,0,146
MÎNDRA,AG,669,9,4,0,13,54,23,0,77
BÎRLA,AG,790,11,8,0,19,67,26,0,93
MOZĂCENII-VALE,AG,938,9,10,0,19,55,21,0,76
BĂDEŞTI,AG,269,11,8,0,19,32,14,0,46
BOGAŢI,AG,1366,31,8,0,39,176,35,0,211
GLÎMBOCELU,AG,593,13,9,0,22,117,34,0,151
CHIŢEŞTI,AG,219,8,7,0,15,77,22,0,99
BUJOI,AG,520,11,4,0,15,90,17,0,107
SUSENI,AG,816,16,2,0,18,145,16,1,162
GLÎMBOCEL,AG,161,6,5,0,11,37,10,0,47
BOTENI,AG,1511,26,2,0,28,236,18,0,254
LUNCA,AG,505,13,0,0,13,98,8,0,106
BOŢEŞTI,AG,935,28,22,0,50,155,67,0,222
BRADU,AG,3635,164,21,0,185,607,76,0,683
GEAMĂNA,AG,3128,110,13,0,123,378,60,0,438
BRĂDULEŢ,AG,454,15,2,0,17,90,30,0,120
GALEŞU,AG,758,21,27,0,48,191,57,0,248
BRĂDETU,AG,296,15,38,0,53,61,82,0,143
"BUDEASA MARE",AG,1069,20,16,0,36,118,35,0,153
"BUDEASA MICĂ",AG,722,18,4,0,22,132,14,0,146
GĂLĂŞEŞTI,AG,800,10,3,0,13,135,18,0,153
CALOTEŞTI,AG,834,10,8,0,18,165,34,0,199
"BUGHEA DE JOS",AG,2407,86,17,0,103,431,45,0,476
"BUGHEA DE SUS",AG,2380,53,8,0,61,231,26,0,257
ŞERBOENI,AG,1205,25,7,0,32,185,23,0,208
IONEŞTI,AG,621,18,3,1,22,91,16,2,109
TOMŞANCA,AG,307,10,4,0,14,54,16,0,70
VULPEŞTI,AG,840,9,2,0,11,68,15,0,83
CORNĂŢEL,AG,825,27,8,0,35,75,19,0,94
BUZOEŞTI,AG,907,12,5,0,17,117,32,0,149
CĂLDĂRARU,AG,734,17,4,0,21,70,22,0,92
STRÎMBENI,AG,710,25,8,0,33,96,23,2,121
BURDEA,AG,486,10,1,0,11,51,15,0,66
VRĂNEŞTI,AG,1604,35,4,0,39,169,20,0,189
CĂLINEŞTI,AG,1666,29,9,0,38,178,35,15,228
CÎRSTIENI,AG,1484,28,0,0,28,287,8,0,295
CIOCĂNEŞTI,AG,782,28,3,0,31,101,12,0,113
GLODU,AG,596,15,1,0,16,91,18,0,109
GORGANU,AG,860,22,4,0,26,115,16,0,131
"RADU NEGRU",AG,514,6,5,0,11,32,14,0,46
URLUCEA,AG,559,13,3,0,16,71,11,0,82
VĂLENI-PODGORIA,AG,912,16,8,0,24,79,18,0,97
CĂTEASCA,AG,702,11,5,0,16,105,29,0,134
SILIŞTEA,AG,405,16,2,0,18,60,18,0,78
GRUIU,AG,533,12,3,0,15,82,22,0,104
CIREŞU,AG,583,21,5,0,26,81,10,0,91
CATANELE,AG,794,45,7,0,52,222,23,0,245
"CEPARII PĂMÎNTENI",AG,706,22,5,0,27,123,24,0,147
CĂRPENIŞ,AG,588,13,6,0,19,157,24,0,181
URLUIEŞTI,AG,231,13,0,0,13,48,3,0,51
"CEPARII UNGURENI",AG,287,6,5,0,11,32,13,0,45
CETĂŢENI,AG,909,26,4,0,30,92,22,0,114
LĂICĂI,AG,687,12,5,0,17,101,17,0,118
"VALEA CETĂŢUIA",AG,694,5,4,0,9,100,6,0,106
CICĂNEŞTI,AG,1713,9,0,0,9,231,13,0,244
CIOFRÎNGENI,AG,1052,23,8,0,31,114,29,0,143
LACURILE,AG,533,9,4,0,13,75,30,0,105
BURLUŞI,AG,395,11,6,0,17,72,23,0,95
BRATIA,AG,347,8,2,0,10,48,23,0,71
CIOMĂGEŞTI,AG,346,6,6,0,12,54,10,0,64
DOGARI,AG,207,13,3,0,16,52,12,0,64
COCU,AG,509,5,4,0,9,64,31,0,95
CRUCIŞOARA,AG,252,13,11,0,24,32,30,0,62
"RĂCHIŢELE DE JOS",AG,310,14,4,0,18,52,16,0,68
"RĂCHIŢELE DE SUS",AG,318,8,4,0,12,18,8,0,26
BĂRBĂTEŞTI,AG,477,8,7,0,15,24,12,0,36
"OEŞTII UNGURENI",AG,2069,19,5,0,24,253,36,0,289
CORBENI,AG,1986,28,8,0,36,213,38,0,251
BERINDEŞTI,AG,604,6,4,0,10,67,14,0,81
CORBI,AG,1689,40,11,0,51,481,49,0,530
CORBŞORI,AG,775,15,9,0,24,191,43,0,234
STĂNEŞTI,AG,941,21,3,0,24,188,21,0,209
PETREŞTI,AG,717,14,2,0,16,135,35,0,170
COŞEŞTI,AG,861,10,5,0,15,96,19,0,115
LEICEŞTI,AG,1589,22,5,0,27,218,26,0,244
JUPÎNEŞTI,AG,889,13,7,0,20,87,21,0,108
LĂPUŞANI,AG,312,4,4,0,8,50,7,0,57
COTMEANA,AG,806,16,18,0,34,70,64,0,134
LINTEŞTI,AG,348,11,4,0,15,35,21,0,56
CUCA,AG,409,14,2,0,16,95,20,0,115
TEODOREŞTI,AG,523,12,9,0,21,77,31,0,108
MĂCĂI,AG,512,11,4,0,15,67,31,0,98
CÎRCEŞTI,AG,257,13,7,0,20,47,16,0,63
DAVIDEŞTI,AG,482,19,7,0,26,111,31,0,142
VOROVENI,AG,481,11,2,0,13,137,22,0,159
CONŢEŞTI,AG,1417,38,6,0,44,319,25,0,344
"PODU DÎMBOVIŢEI",AG,461,7,1,0,8,126,22,0,148
DÎMBOVICIOARA,AG,235,21,8,0,29,71,27,0,98
CIOCANU,AG,60,2,9,0,11,18,16,1,35
PISCANI,AG,764,17,3,0,20,86,29,0,115
DÎRMĂNEŞTI,AG,1051,12,4,0,16,107,15,0,122
"VALEA NANDRII",AG,586,9,8,0,17,84,22,0,106
NEGRENI,AG,556,18,4,0,22,80,14,0,94
DOBREŞTI,AG,759,24,16,0,40,112,46,1,159
FUREŞTI,AG,709,8,5,0,13,101,8,0,109
DOMNEŞTI,AG,2623,126,29,0,155,619,91,0,710
DRAGOSLAVELE,AG,1581,35,13,0,48,253,39,0,292
"VALEA HOTARULUI",AG,507,16,7,0,23,172,12,0,184
DRĂGANU-OLTENI,AG,1703,12,4,0,16,130,50,0,180
GODENI,AG,1056,44,10,0,54,233,27,0,260
COTEŞTI,AG,1464,31,3,0,34,226,21,0,247
HÎRSEŞTI,AG,1279,20,10,0,30,131,65,0,196
MARTALOGI,AG,592,8,4,0,12,71,29,0,100
HÂRTIEŞTI,AG,776,12,6,0,18,99,15,0,114
DEALU,AG,299,3,1,0,4,50,12,0,62
LUCIENI,AG,278,4,2,0,6,48,7,0,55
LESPEZI,AG,369,12,4,0,16,189,6,0,195
IZVORU,AG,1842,57,12,0,69,183,45,0,228
LEORDENI,AG,1416,41,15,0,56,237,53,18,308
BUDIŞTENI,AG,1066,17,5,0,22,95,20,0,115
GLÎMBOCATA,AG,908,15,4,0,19,101,22,0,123
CIULNIŢA,AG,929,18,6,0,24,111,23,0,134
"COTU MALULUI",AG,346,29,4,0,33,97,9,0,106
LEREŞTI,AG,2512,107,19,0,126,671,98,0,769
VOINEŞTI,AG,1370,77,34,0,111,308,69,0,377
"LUNCA CORBULUI",AG,2243,58,36,0,94,428,198,0,626
MĂLURENI,AG,947,30,8,0,38,149,59,0,208
TOPLIŢA,AG,643,21,9,0,30,142,38,0,180
ZĂRNEŞTI,AG,787,23,6,0,29,168,54,0,222
BUNEŞTI,AG,556,7,7,0,14,59,35,0,94
PĂULEASCA,AG,636,7,3,0,10,47,6,0,53
MĂRĂCINENI,AG,2708,174,43,0,217,789,172,0,961
ARGEŞELU,AG,1699,74,38,0,112,465,103,0,568
DOBROGOSTEA,AG,1026,14,1,0,15,123,10,0,133
BORLEŞTI,AG,475,12,8,0,20,60,18,0,78
MERIŞANI,AG,676,26,3,0,29,131,25,0,156
"MALU VÎNĂT",AG,637,64,7,0,71,152,9,0,161
VÎLCELELE,AG,758,9,13,0,22,85,49,0,134
MICEŞTI,AG,1445,61,11,0,72,333,47,0,380
PURCĂRENI,AG,1401,32,2,0,34,244,28,0,272
PĂULEASCA,AG,782,30,2,0,32,280,21,0,301
MIHĂEŞTI,AG,2008,34,7,0,41,252,17,0,269
"VALEA POPII",AG,787,32,8,0,40,167,21,0,188
DRĂGHICI,AG,893,18,4,0,22,137,22,0,159
VĂCAREA,AG,466,20,3,0,23,109,11,0,120
FURNICOŞI,AG,728,14,2,0,16,114,6,0,120
MĂŢĂU,AG,1002,13,5,0,18,108,14,0,122
SUSLĂNEŞTI,AG,337,16,9,0,25,62,18,0,80
MIROŞI,AG,1204,42,4,0,46,186,24,0,210
SURDULEŞTI,AG,748,22,10,0,32,108,22,0,130
MORĂREŞTI,AG,904,30,7,0,37,130,40,0,170
DEDULEŞTI,AG,613,19,5,0,24,70,30,0,100
MOŞOAIA,AG,1435,39,1,0,40,181,16,0,197
HINŢEŞTI,AG,972,16,2,0,18,118,14,0,132
SMEURA,AG,2143,78,11,0,89,280,28,0,308
CIOCĂNĂI,AG,543,4,1,0,5,33,10,0,43
MOZĂCENI,AG,1741,46,16,0,62,190,77,0,267
MUSĂŢEŞTI,AG,1190,36,5,0,41,214,36,0,250
VÎLSĂNEŞTI,AG,460,9,11,0,20,77,35,0,112
COSTEŞTI-VÎSLAN,AG,559,2,3,0,5,128,23,0,151
STROEŞTI,AG,868,23,3,0,26,230,45,0,275
NEGRAŞI,AG,618,8,4,0,12,49,19,0,68
BÎRLOGU,AG,662,19,12,0,31,80,43,0,123
MOZACU,AG,250,12,6,0,18,55,25,0,80
BUTA,AG,154,15,6,0,21,45,16,0,61
NUCŞOARA,AG,382,13,5,0,18,113,28,0,141
SBOGHIŢEŞTI,AG,348,12,3,0,15,123,10,0,133
SLATINA,AG,427,37,7,0,44,172,19,0,191
OARJA,AG,2242,109,15,0,124,425,85,0,510
PIETROŞANI,AG,1447,19,4,0,23,263,31,0,294
BĂDEŞTI,AG,1272,37,5,0,42,308,25,0,333
RETEVOIEŞTI,AG,1386,19,3,0,22,177,32,0,209
GĂNEŞTI,AG,540,9,6,0,15,97,13,0,110
"POIANA LACULUI",AG,1506,37,11,0,48,199,39,0,238
DINCULEŞTI,AG,283,24,7,0,31,62,8,0,70
CĂTUNAŞI,AG,397,13,4,0,17,58,13,0,71
SĂMARA,AG,766,10,0,0,10,74,12,0,86
METOFU,AG,283,2,3,0,5,20,6,0,26
"DEALU VIILOR",AG,304,8,5,0,13,25,16,0,41
"PĂDUROIU DIN DEAL",AG,737,19,2,0,21,97,10,0,107
"PĂDUROIU DIN VALE",AG,639,9,3,0,12,39,10,0,49
GĂRDINEŞTI,AG,378,7,3,0,10,58,17,0,75
POIENARI,AG,651,9,2,0,11,44,22,0,66
IOANICEŞTI,AG,191,3,5,0,8,15,9,0,24
POIENARI,AG,1217,18,8,0,26,131,22,1,154
JUGUR,AG,916,10,3,0,13,106,11,0,117
GROŞANI,AG,624,25,2,0,27,151,19,0,170
POPEŞTI,AG,511,24,9,0,33,116,44,0,160
SLOBOZIA,AG,562,67,5,0,72,272,23,0,295
PURCĂRENI,AG,572,50,3,0,53,192,38,0,230
PRIBOIENI,AG,2991,89,10,0,99,702,42,0,744
TIGVENI,AG,659,8,5,0,13,65,22,0,87
FURDUEŞTI,AG,436,17,3,0,20,63,10,0,73
NEJLOVELU,AG,408,13,4,0,17,58,18,0,76
PĂTULENI,AG,756,22,3,0,25,119,12,0,131
MAVRODOLU,AG,136,11,5,0,16,33,15,0,48
RÂCA,AG,862,135,21,0,156,517,103,0,620
RECEA,AG,1464,43,6,0,49,205,54,0,259
"DEAGU DE JOS",AG,785,18,8,0,26,133,43,0,176
ROCIU,AG,376,23,7,0,30,111,40,0,151
"GLIGANU DE JOS",AG,351,20,5,0,25,113,43,0,156
"GLIGANU DE SUS",AG,549,26,10,0,36,167,41,0,208
ŞERBĂNEŞTI,AG,798,30,9,0,39,206,26,0,232
RUCĂR,AG,4832,197,33,0,230,952,110,1,1063
SĂTIC,AG,99,7,13,0,20,23,38,0,61
SĂLĂTRUCU,AG,1223,23,7,0,30,190,23,0,213
VĂLENI,AG,546,19,5,0,24,102,17,0,119
"DEALU BRADULUI",AG,159,21,5,0,26,49,19,0,68
POPEŞTI,AG,663,25,21,0,46,162,41,0,203
BĂNĂREŞTI,AG,325,19,9,0,28,127,47,0,174
MÎRŢEŞTI,AG,215,14,8,0,22,68,25,0,93
LĂZĂREŞTI,AG,2852,76,11,0,87,522,56,0,578
"SCHITU GOLEŞTI",AG,1244,40,3,0,43,185,16,0,201
SLOBOZIA,AG,3599,43,8,0,51,339,33,0,372
NIGRIŞOARA,AG,248,13,6,0,19,39,11,0,50
STÎLPENI,AG,1588,62,12,0,74,341,29,0,370
LIVEZENI,AG,1206,33,7,0,40,261,33,0,294
RĂDEŞTI,AG,1398,39,15,0,54,261,34,0,295
STOENEŞTI,AG,1083,12,11,0,23,110,36,0,146
BĂDENI,AG,1465,33,6,0,39,188,20,0,208
PIATRA,AG,409,13,5,0,18,82,14,0,96
"VALEA BĂDENILOR",AG,616,10,0,0,10,172,13,0,185
STOLNICI,AG,1511,43,23,0,66,231,58,0,289
FÎLFANI,AG,1030,28,17,0,45,140,60,0,200
CERŞANI,AG,624,13,2,0,15,89,15,0,104
SUSENI,AG,897,9,11,0,20,96,45,0,141
ŢUŢULEŞTI,AG,1044,12,7,0,19,131,33,0,164
"ŞTEFAN CEL MARE",AG,1544,31,6,0,37,154,31,0,185
GLAVACIOC,AG,364,8,3,0,11,53,12,0,65
ŞUICI,AG,1015,4,0,0,4,81,15,0,96
RUDENI,AG,698,8,2,0,10,75,15,0,90
IANCULEŞTI,AG,227,5,3,0,8,37,7,0,44
"VALEA CALULUI",AG,79,4,1,0,5,29,4,0,33
TEIU,AG,957,52,10,0,62,199,48,0,247
LEŞILE,AG,155,5,3,0,8,47,23,0,70
TIGVENI,AG,1507,54,12,0,66,303,33,0,336
"BÎRSEŞTII DE JOS",AG,1024,21,2,0,23,124,20,0,144
VLĂDEŞTI,AG,207,3,0,0,3,34,11,0,45
BUCŞENEŞTI-LOTAŞI,AG,1249,13,2,0,15,122,13,1,136
"VALEA STÎNII",AG,854,28,4,0,32,148,12,0,160
ŢIŢEŞTI,AG,1002,20,0,0,20,118,13,0,131
"VALEA MĂNĂSTIRII",AG,780,7,3,0,10,135,15,0,150
UDA,AG,542,12,3,0,15,78,39,0,117
COTU,AG,211,10,5,0,15,31,26,0,57
SĂLIŞTEA,AG,467,14,7,0,21,42,26,0,68
RÎJLEŢU-GOVORA,AG,401,11,6,0,17,47,31,0,78
UNGHENI,AG,607,35,6,0,41,136,32,0,168
COLŢU,AG,599,65,16,0,81,261,54,0,315
HUMELE,AG,1105,34,9,0,43,200,41,0,241
"VALEA DANULUI",AG,1669,26,0,0,26,214,12,0,226
VERNEŞTI,AG,884,5,4,0,9,95,11,0,106
"VALEA IAŞULUI",AG,849,11,62,0,73,118,69,0,187
BOROVINEŞTI,AG,188,6,7,0,13,39,15,0,54
MUSTĂŢEŞTI,AG,1049,21,1,0,22,216,15,0,231
CERBURENI,AG,313,14,1,0,15,59,4,0,63
"VALEA MARE PRAVĂŢ",AG,1216,39,5,0,44,182,24,0,206
NĂMĂEŞTI,AG,509,28,22,0,50,105,30,0,135
BILCEŞTI,AG,721,6,6,0,12,53,11,0,64
"GURA PRAVĂŢ",AG,883,8,3,0,11,345,14,0,359
VEDEA,AG,755,16,9,48,73,85,43,48,176
VAŢA,AG,534,13,13,0,26,70,37,0,107
PRODANI,AG,600,11,3,0,14,62,16,0,78
FATA,AG,458,16,3,0,19,72,20,0,92
"IZVORU DE SUS",AG,287,6,9,0,15,44,26,0,70
FRĂTICI,AG,349,9,2,0,11,38,16,0,54
VLĂDEŞTI,AG,2537,67,4,0,71,455,31,0,486
VULTUREŞTI,AG,1590,14,2,0,16,212,23,0,235
BÂRZEŞTI,AG,466,6,4,0,10,96,19,0,115
HULUBA,AG,177,2,0,0,2,17,3,0,20
ARAD,AR,149404,10737,1033,530,12300,27896,2328,736,30960
CHIŞINEU-CRIŞ,AR,5386,310,18,0,328,843,81,0,924
NADAB,AR,1456,43,6,0,49,218,20,0,238
CURTICI,AR,7016,376,28,0,404,1215,95,1,1311
INEU,AR,7339,374,43,0,417,1438,102,0,1540
MOCREA,AR,618,20,2,0,22,81,9,0,90
LIPOVA,AR,6819,349,36,0,385,1174,107,0,1281
ŞOIMOŞ,AR,596,52,12,0,64,171,19,0,190
RADNA,AR,2091,149,9,2,160,497,40,2,539
NĂDLAC,AR,6632,172,23,0,195,592,78,0,670
PECICA,AR,10169,398,43,0,441,1186,140,2,1328
TURNU,AR,1014,27,7,0,34,109,18,0,127
SEDERHAT,AR,274,13,4,0,17,55,11,0,66
PÎNCOTA,AR,5168,343,31,1,375,1076,76,8,1160
MĂDERAT,AR,1268,76,5,0,81,294,30,0,324
SÂNTANA,AR,11551,353,47,0,400,1602,124,0,1726
"CAPORAL ALEXA",AR,1160,77,9,0,86,236,24,0,260
SEBIŞ,AR,4594,405,32,0,437,1360,120,0,1480
PRUNIŞOR,AR,487,17,5,0,22,129,14,0,143
DONCENI,AR,127,9,6,0,15,43,17,0,60
SĂLĂJENI,AR,147,5,8,0,13,48,12,0,60
ALMAŞ,AR,1131,80,3,0,83,386,35,3,424
CIL,AR,481,22,4,0,26,164,18,0,182
RĂDEŞTI,AR,350,34,11,0,45,150,34,1,185
"JOIA MARE",AR,165,6,6,0,12,44,11,0,55
APATEU,AR,1891,60,1,0,61,421,31,0,452
BERECHIU,AR,649,19,9,0,28,154,25,0,179
MOŢIORI,AR,234,15,1,0,16,96,7,0,103
ARCHIŞ,AR,307,45,6,0,51,153,19,0,172
NERMIŞ,AR,158,18,5,0,23,103,15,0,118
BÎRZEŞTI,AR,135,31,1,0,32,83,9,2,94
GROŞENI,AR,643,32,4,0,36,163,13,0,176
BATA,AR,343,18,8,0,26,93,18,0,111
ŢELA,AR,262,4,4,0,8,26,15,0,41
"BACĂU DE MIJLOC",AR,152,3,4,0,7,18,7,0,25
BULCI,AR,88,12,7,0,19,20,14,0,34
BELIU,AR,1431,92,8,0,100,472,42,0,514
TĂGĂDĂU,AR,403,37,6,0,43,131,25,0,156
BENEŞTI,AR,90,22,8,0,30,54,16,0,70
BOCHIA,AR,51,10,5,0,15,35,12,0,47
SECACI,AR,123,20,5,0,25,64,9,0,73
"VASILE GOLDIŞ",AR,396,27,6,0,33,129,14,0,143
BIRCHIŞ,AR,540,10,1,0,11,72,16,0,88
CĂPĂLNAŞ,AR,744,18,3,0,21,109,19,0,128
OSTROV,AR,216,4,10,0,14,62,20,0,82
BÎRSA,AR,795,25,3,0,28,179,18,0,197
ALDEŞTI,AR,436,27,3,0,30,125,18,0,143
HODIŞ,AR,144,4,0,0,4,26,11,0,37
VOIVODENI,AR,154,11,7,0,18,54,15,0,69
BÎRZAVA,AR,763,32,5,0,37,185,26,0,211
MONOROŞTIA,AR,252,11,4,0,15,66,9,0,75
CĂPRUŢA,AR,212,8,2,0,10,64,13,0,77
DUMBRĂVIŢA,AR,234,9,4,0,13,58,13,0,71
"GROŞII NOI",AR,174,12,4,0,16,46,19,0,65
"SLATINA DE MUREŞ",AR,136,18,6,0,24,63,9,0,72
BĂTUŢA,AR,54,4,1,0,5,10,11,0,21
LALAŞINŢ,AR,272,13,14,0,27,57,33,0,90
BOCSIG,AR,1865,91,14,0,105,405,36,0,441
MÎNERĂU,AR,296,15,9,0,24,52,15,0,67
RĂPSIG,AR,594,41,6,0,47,155,11,0,166
BRAZII,AR,73,2,3,0,5,23,15,0,38
IACOBINI,AR,165,17,1,0,18,59,10,0,69
SECAŞ,AR,387,37,6,0,43,167,13,0,180
BUCEAVA-ŞOIMUŞ,AR,148,18,6,0,24,67,14,0,81
MĂDRIGEŞTI,AR,225,20,4,0,24,102,14,0,116
BUTENI,AR,1769,84,13,0,97,421,59,1,481
CUIED,AR,545,17,4,0,21,125,12,0,137
PĂULIAN,AR,269,12,5,0,17,59,10,0,69
BERINDIA,AR,178,29,4,0,33,82,8,0,90
CĂRAND,AR,501,56,9,0,65,209,24,0,233
SELIŞTEA,AR,425,31,6,0,37,129,13,0,142
CERMEI,AR,1535,78,6,0,84,287,23,0,310
ŞOMOŞCHEŞ,AR,701,31,6,0,37,132,23,0,155
CHISINDIA,AR,719,24,6,0,30,190,23,0,213
PĂIUŞENI,AR,321,2,1,0,3,65,7,0,72
VĂSOAIA,AR,42,2,6,0,8,4,14,0,18
CONOP,AR,480,15,2,0,17,85,11,0,96
BELOTINŢ,AR,239,9,5,0,14,47,13,0,60
CHELMAC,AR,232,14,4,0,18,83,22,0,105
MILOVA,AR,440,27,4,0,31,142,11,0,153
ODVOŞ,AR,381,18,10,0,28,93,22,0,115
COVĂSINŢ,AR,2109,135,15,0,150,446,42,11,499
CRAIVA,AR,488,27,14,0,41,124,26,2,152
CHIŞLACA,AR,567,36,5,0,41,181,16,3,200
MĂRĂUŞ,AR,244,14,0,0,14,67,3,0,70
STOINEŞTI,AR,140,21,4,0,25,86,11,0,97
SUSAG,AR,292,7,0,0,7,64,7,0,71
COROI,AR,131,15,8,0,23,43,18,0,61
ŞIAD,AR,198,25,10,0,35,82,15,0,97
"ROGOZ DE BELIU",AR,112,19,11,0,30,62,20,0,82
CIUNTEŞTI,AR,129,14,1,0,15,75,6,0,81
DEZNA,AR,675,40,6,1,47,203,34,42,279
BUHANI,AR,154,15,5,0,20,61,23,0,84
NEAGRA,AR,81,7,3,0,10,39,9,0,48
"SLATINA DE CRIŞ",AR,109,6,5,0,11,32,9,0,41
LAZ,AR,41,5,4,0,9,7,9,0,16
DIECI,AR,625,44,6,14,64,192,19,40,251
CROCNA,AR,321,29,5,0,34,120,11,1,132
REVETIŞ,AR,266,36,5,0,41,81,9,0,90
ROŞIA,AR,41,4,4,0,8,17,15,0,32
DOROBANŢI,AR,1398,24,3,0,27,94,6,0,100
FÂNTÂNELE,AR,2173,88,9,0,97,359,33,0,392
"TISA NOUĂ",AR,836,39,5,0,44,188,21,0,209
FELNAC,AR,2272,120,10,0,130,492,27,3,522
CĂLUGĂRENI,AR,219,8,1,0,9,45,10,0,55
FRUMUŞENI,AR,1482,43,5,0,48,184,11,0,195
ALUNIŞ,AR,839,41,1,0,42,115,10,0,125
GHIOROC,AR,1548,77,9,1,87,233,32,1,266
CUVIN,AR,1350,92,17,0,109,352,47,4,403
MINIŞ,AR,561,34,3,0,37,92,13,0,105
GRĂNICERI,AR,1065,12,1,0,13,92,9,0,101
ŞICLĂU,AR,970,17,4,0,21,82,14,0,96
GURAHONŢ,AR,1495,178,21,0,199,530,68,3,601
BONŢEŞTI,AR,547,64,12,0,76,257,33,0,290
FENIŞ,AR,93,11,4,0,15,33,9,0,42
HONŢIŞOR,AR,275,23,2,0,25,102,7,0,109
IOSAŞ,AR,203,29,2,0,31,82,5,0,87
PESCARI,AR,225,5,7,0,12,45,20,0,65
ZIMBRU,AR,389,18,5,0,23,93,9,0,102
HĂLMAGIU,AR,1010,54,6,0,60,199,19,0,218
BĂNEŞTI,AR,258,4,0,0,4,29,7,0,36
BRUSTURI,AR,306,1,1,0,2,16,5,0,21
TISA,AR,157,6,2,0,8,57,11,0,68
ŢĂRMURE,AR,292,4,0,0,4,47,12,0,59
LEASA,AR,172,15,4,0,19,51,10,0,61
POIENARI,AR,156,11,2,0,13,33,7,0,40
HĂLMĂGEL,AR,497,20,7,0,27,77,21,0,98
LUNCŞOARA,AR,303,9,4,0,13,91,13,0,104
SÎRBI,AR,81,3,3,0,6,38,6,0,44
TÎRNĂVIŢA,AR,122,6,3,0,9,28,10,0,38
HĂŞMAŞ,AR,350,31,5,0,36,131,21,1,153
COMĂNEŞTI,AR,86,11,5,0,16,45,10,6,61
"AGRIŞU MIC",AR,140,21,4,0,25,71,16,0,87
BOTFEI,AR,194,36,4,0,40,120,15,0,135
"URVIŞU DE BELIU",AR,179,21,2,0,23,95,10,0,105
CLIT,AR,59,4,3,0,7,13,7,0,20
IGNEŞTI,AR,230,17,5,0,22,82,12,0,94
MINEAD,AR,79,8,5,0,13,31,10,0,41
NĂDĂLBEŞTI,AR,101,2,5,0,7,32,8,0,40
SUSANI,AR,177,17,2,0,19,77,14,0,91
IRATOŞU,AR,1618,39,8,0,47,144,19,0,163
"VARIAŞU MARE",AR,416,11,5,0,16,30,12,0,42
"VARIAŞU MIC",AR,103,7,2,0,9,16,4,0,20
LIVADA,AR,1583,116,12,1,129,417,41,1,459
SÎNLEANI,AR,1433,96,4,0,100,383,15,0,398
MACEA,AR,3753,120,12,0,132,605,37,0,642
SÎNMARTIN,AR,2154,68,17,0,85,196,27,0,223
MIŞCA,AR,1019,42,6,0,48,201,28,0,229
"SATU NOU",AR,674,13,0,0,13,47,7,0,54
VÎNĂTORI,AR,919,6,1,0,7,56,8,0,64
"ZERINDU MIC",AR,143,8,1,0,9,25,6,0,31
MONEASA,AR,585,41,126,0,167,182,207,0,389
RĂNUŞA,AR,199,18,6,0,24,56,11,0,67
OLARI,AR,1288,23,2,0,25,102,7,0,109
"SINTEA MICĂ",AR,328,4,2,0,6,27,8,0,35
PĂULIŞ,AR,1538,71,30,0,101,260,55,0,315
SÎMBĂTENI,AR,1588,245,18,0,263,588,47,0,635
CLADOVA,AR,251,13,7,0,20,45,15,0,60
BARAŢCA,AR,205,10,1,0,11,36,1,0,37
"PEREGU MARE",AR,773,11,3,0,14,46,8,0,54
"PEREGU MIC",AR,799,26,4,0,30,73,7,0,80
PETRIŞ,AR,367,16,6,0,22,66,21,0,87
ILTEU,AR,197,10,4,0,14,48,13,0,61
SELIŞTE,AR,97,7,0,0,7,27,10,0,37
CORBEŞTI,AR,152,14,3,0,17,52,9,0,61
"ROŞIA NOUĂ",AR,230,18,7,0,25,84,16,0,100
OBÎRŞIA,AR,93,4,1,0,5,32,3,0,35
PILU,AR,869,33,2,0,35,101,5,0,106
VĂRŞAND,AR,770,14,1,0,15,86,7,0,93
PLEŞCUŢA,AR,246,15,3,0,18,79,9,0,88
TĂLAGIU,AR,322,21,4,0,25,117,19,0,136
ACIUŢA,AR,181,15,3,0,18,49,13,0,62
"GURA VĂII",AR,229,12,2,0,14,79,13,0,92
SĂVÎRŞIN,AR,1281,68,12,0,80,331,37,1,369
PÎRNEŞTI,AR,144,4,0,0,4,44,5,0,49
TROAŞ,AR,142,12,4,0,16,48,15,0,63
TEMEŞEŞTI,AR,112,12,3,0,15,31,10,0,41
TOC,AR,350,13,3,0,16,73,9,0,82
CĂPRIOARA,AR,215,18,5,0,23,59,15,0,74
"VALEA MARE",AR,184,12,4,0,16,62,19,0,81
SECUSIGIU,AR,1834,94,18,0,112,301,32,1,334
"SATU MARE",AR,812,23,7,0,30,94,12,0,106
MUNAR,AR,416,11,2,0,13,54,10,0,64
"SÎNPETRU GERMAN",AR,1746,67,7,0,74,207,20,0,227
SELEUŞ,AR,1534,106,19,0,125,580,38,0,618
IERMATA,AR,333,45,5,0,50,197,25,0,222
MORODA,AR,581,39,5,0,44,218,27,0,245
SEMLAC,AR,3376,111,11,0,122,343,38,0,381
"SINTEA MARE",AR,1028,27,0,0,27,128,27,0,155
ADEA,AR,843,14,0,0,14,56,5,0,61
ŢIPAR,AR,1140,16,4,0,20,97,11,0,108
SOCODOR,AR,1810,80,4,0,84,316,23,0,339
ŞAGU,AR,1827,58,9,0,67,278,27,0,305
CRUCENI,AR,601,26,0,0,26,116,11,0,127
FIRITEAZ,AR,380,20,5,0,25,90,17,0,107
FISCUT,AR,456,20,5,0,25,116,15,0,131
"HUNEDOARA TIMIŞANĂ",AR,159,9,2,0,11,29,11,0,40
ŞEITIN,AR,2453,69,9,0,78,335,28,0,363
ŞEPREUŞ,AR,2157,76,1,0,77,349,22,2,373
GURBA,AR,918,25,5,0,30,148,19,0,167
CHERELUŞ,AR,758,38,2,0,40,164,14,0,178
ŞICULA,AR,1854,111,12,0,123,435,44,0,479
ŞILINDIA,AR,711,27,7,0,34,125,28,0,153
ŞIMAND,AR,3410,126,13,0,139,513,57,0,570
ŞIRIA,AR,4474,113,23,0,136,551,67,2,620
GALŞA,AR,1885,70,6,0,76,361,35,0,396
MÎSCA,AR,755,59,8,0,67,214,26,0,240
ŞIŞTAROVĂŢ,AR,273,28,13,0,41,86,32,0,118
ŞOFRONEA,AR,1800,119,13,0,132,379,44,1,424
SÎNPAUL,AR,598,20,7,0,27,91,26,0,117
MINIŞEL,AR,125,6,5,0,11,44,8,0,52
TAUŢ,AR,577,25,12,0,37,131,40,0,171
NADĂŞ,AR,628,17,3,0,20,133,16,0,149
"MINIŞU DE SUS",AR,55,10,1,0,11,20,14,0,34
TÎRNOVA,AR,1492,137,11,0,148,407,38,0,445
CHIER,AR,971,75,13,0,88,206,35,0,241
"AGRIŞU MARE",AR,909,76,5,0,81,418,28,0,446
ARĂNEAG,AR,332,17,9,0,26,110,34,0,144
DRAUŢ,AR,680,38,5,0,43,236,26,0,262
DUD,AR,544,78,6,0,84,231,21,0,252
USUSĂU,AR,486,33,5,0,38,168,18,0,186
DORGOŞ,AR,234,13,3,0,16,61,15,0,76
ZĂBALŢ,AR,239,21,3,0,24,87,15,0,102
BRUZNIC,AR,90,4,6,0,10,22,6,0,28
"VĂRĂDIA DE MUREŞ",AR,481,28,5,0,33,82,16,0,98
LUPEŞTI,AR,222,25,5,0,30,71,10,0,81
BAIA,AR,102,6,5,0,11,35,10,0,45
JULIŢA,AR,300,16,6,0,22,67,28,0,95
"NICOLAE BĂLCESCU",AR,197,5,4,0,9,36,12,0,48
STEJAR,AR,117,10,5,0,15,30,17,0,47
VINGA,AR,3761,88,8,0,96,501,54,0,555
MAILAT,AR,800,21,8,0,29,77,32,0,109
MĂNĂŞTUR,AR,983,21,4,0,25,125,12,0,137
VÎRFURILE,AR,995,24,9,0,33,139,30,0,169
"AVRAM IANCU",AR,649,9,5,0,14,64,11,0,75
LAZURI,AR,653,15,1,0,16,69,9,0,78
MÎNDRULOC,AR,1138,69,5,0,74,228,27,0,255
CICIR,AR,851,45,6,0,51,230,17,0,247
VLADIMIRESCU,AR,7050,361,31,0,392,1043,98,0,1141
HORIA,AR,2149,111,17,0,128,460,43,0,503
NEUDORF,AR,848,17,2,0,19,97,8,0,105
ZĂBRANI,AR,1919,93,7,0,100,294,19,0,313
CHESINŢ,AR,957,38,2,0,40,169,20,0,189
"BODROGU NOU",AR,231,26,10,0,36,64,31,0,95
ZĂDĂRENI,AR,2093,136,11,0,147,390,41,5,436
CINTEI,AR,968,79,18,0,97,359,35,0,394
ZĂRAND,AR,1144,34,2,0,36,330,25,0,355
ZERIND,AR,713,6,4,0,10,30,9,0,39
"IERMATA NEAGRĂ",AR,465,7,3,0,10,32,4,0,36
"ZIMANDU NOU",AR,1516,41,9,0,50,145,25,0,170
"ANDREI ŞAGUNA",AR,1253,49,3,0,52,252,17,0,269
ZIMANDCUZ,AR,1354,45,11,0,56,164,18,0,182
"BUCUREŞTI SECTORUL 1",B,207762,14298,1623,486,16407,33629,4195,637,38461
BACĂU,BC,166460,8833,693,140,9666,27453,1849,504,29806
MOINEŞTI,BC,20144,1106,86,187,1379,4637,227,201,5065
ONEŞTI,BC,42812,2291,194,1,2486,7036,444,101,7581
SLOBOZIA,BC,1068,38,4,0,42,195,16,0,211
BUHUŞI,BC,18843,822,62,21,905,2889,166,41,3096
COMĂNEŞTI,BC,19649,872,125,72,1069,3820,282,73,4175
DĂRMĂNEŞTI,BC,9361,312,44,0,356,1649,89,0,1738
LĂPOŞ,BC,806,15,2,0,17,118,8,0,126
PLOPU,BC,1247,35,5,22,62,257,21,22,300
CERDAC,BC,1098,36,5,0,41,144,21,0,165
SLĂNIC-MOLDOVA,BC,1546,98,154,0,252,237,257,0,494
CIREŞOAIA,BC,1487,20,5,0,25,184,11,0,195
"TÎRGU OCNA",BC,8942,426,219,119,764,1578,356,121,2055
POIENI,BC,788,11,0,0,11,107,7,0,114
VÎLCELE,BC,1015,20,5,0,25,113,10,0,123
AGĂŞ,BC,1017,45,11,0,56,175,18,2,195
COTUMBA,BC,1127,41,4,0,45,235,20,0,255
SULŢA,BC,831,39,5,0,44,131,10,1,142
COŞNEA,BC,363,3,0,0,3,42,6,0,48
PRELUCI,BC,978,84,3,0,87,254,13,0,267
GOIOASA,BC,696,6,1,0,7,101,22,0,123
ARDEOANI,BC,1305,20,2,13,35,192,33,13,238
LEONTINEŞTI,BC,688,30,9,2,41,143,15,3,161
ASĂU,BC,1794,71,4,0,75,463,28,0,491
"LUNCA ASĂU",BC,646,71,2,0,73,264,16,0,280
STRAJA,BC,992,24,1,0,25,193,11,0,204
CIOBĂNUŞ,BC,443,18,5,0,23,84,13,0,97
"APA ASĂU",BC,1274,26,2,0,28,264,10,0,274
PĂLTINIŞ,BC,528,36,4,0,40,177,9,0,186
BALCANI,BC,1146,45,5,13,63,300,15,15,330
FRUMOASA,BC,3017,56,13,0,69,465,35,0,500
"SCHITU FRUMOASA",BC,1594,28,10,0,38,394,28,20,442
LUDAŞI,BC,797,18,4,4,26,255,17,6,278
BEREŞTI-BISTRIŢA,BC,930,45,9,7,61,197,40,7,244
PĂDURENI,BC,370,23,3,5,31,100,12,5,117
CLIMEŞTI,BC,251,21,6,0,27,74,26,0,100
BRAD,BC,143,19,5,0,24,52,20,0,72
BEREŞTI-TAZLĂU,BC,970,28,3,0,31,296,13,13,322
BOŞOTENI,BC,363,13,2,0,15,97,15,15,127
ENĂCHEŞTI,BC,641,19,6,44,69,185,21,44,250
PRISACA,BC,412,20,2,0,22,141,9,8,158
ROMÂNEŞTI,BC,353,24,6,11,41,131,17,11,159
TESCANI,BC,631,25,6,0,31,139,12,0,151
TURLUIANU,BC,1059,24,0,0,24,288,5,24,317
BERZUNŢI,BC,2091,39,13,0,52,432,36,0,468
DRAGOMIR,BC,1652,91,7,0,98,512,28,0,540
BUDA,BC,457,26,6,0,32,183,47,0,230
BÎRSĂNEŞTI,BC,1479,22,0,0,22,190,20,0,210
ALBELE,BC,540,11,2,1,14,96,8,1,105
BRĂTEŞTI,BC,908,12,2,0,14,113,12,0,125
CARACLĂU,BC,937,39,4,0,43,300,17,1,318
BLĂGEŞTI,BC,1925,26,6,0,32,194,21,0,215
BUDA,BC,1559,96,8,0,104,456,29,0,485
"VALEA LUI ION",BC,1151,26,2,0,28,203,13,0,216
"ŢÎRDENII MARI",BC,598,7,3,0,10,104,9,0,113
"POIANA NEGUSTORULUI",BC,533,41,5,0,46,275,7,0,282
BOGDĂNEŞTI,BC,1810,30,4,0,34,235,21,0,256
FILIPEŞTI,BC,511,11,3,0,14,86,14,0,100
BRUSTUROASA,BC,1923,36,10,0,46,367,25,1,393
CAMENCA,BC,774,22,2,0,24,220,9,0,229
BUCIUMI,BC,1182,60,14,0,74,550,55,0,605
RĂCĂUŢI,BC,1235,140,7,0,147,523,33,0,556
BUHOCI,BC,1421,29,4,0,33,146,26,0,172
BIJGHIR,BC,2027,49,3,0,52,311,14,0,325
COTENI,BC,623,7,1,0,8,63,5,0,68
CAŞIN,BC,2632,47,3,0,50,355,22,0,377
CURIŢA,BC,630,12,2,0,14,82,12,0,94
CĂIUŢI,BC,1345,24,7,0,31,179,20,0,199
POPENI,BC,667,17,1,0,18,93,17,0,110
BLIDARI,BC,591,17,4,0,21,91,11,0,102
PRALEA,BC,739,12,5,0,17,154,12,0,166
BOIŞTEA,BC,147,3,4,0,7,27,9,0,36
HELTIU,BC,314,6,2,0,8,46,14,0,60
VRÎNCENI,BC,305,4,3,0,7,47,10,0,57
MĂRCEŞTI,BC,115,0,9,0,9,47,11,0,58
CLEJA,BC,3747,88,14,0,102,319,48,0,367
SOMUŞCA,BC,1187,9,0,0,9,122,6,0,128
"VALEA MICĂ",BC,570,15,2,0,17,121,12,0,133
COLONEŞTI,BC,1098,23,5,0,28,304,26,0,330
SPRIA,BC,273,9,4,0,13,107,19,0,126
"SATU NOU",BC,272,13,2,0,15,101,6,0,107
CORBASCA,BC,618,27,1,0,28,261,46,0,307
SCĂRIŞOARA,BC,640,16,5,0,21,190,20,0,210
MARVILA,BC,474,13,2,0,15,82,12,0,94
VÎLCELE,BC,494,10,0,0,10,124,6,0,130
BĂCIOIU,BC,1541,83,1,0,84,257,21,0,278
ROGOAZA,BC,260,18,2,0,20,72,14,0,86
COŢOFĂNEŞTI,BC,996,51,3,0,54,295,32,0,327
BORŞANI,BC,589,20,11,2,33,186,27,2,215
BÎLCA,BC,593,44,7,0,51,198,26,0,224
TĂMĂŞOAIA,BC,369,73,7,0,80,173,14,0,187
DĂMIENEŞTI,BC,454,9,2,0,11,118,29,0,147
CĂLUGĂRENI,BC,793,26,2,0,28,171,13,0,184
DRĂGEŞTI,BC,221,13,1,0,14,69,23,0,92
"DEALU MORII",BC,901,21,3,0,24,300,53,23,376
CĂUIA,BC,536,20,7,19,46,186,22,19,227
NEGULEŞTI,BC,472,10,3,0,13,132,24,0,156
TĂVĂDĂREŞTI,BC,308,18,3,13,34,86,19,13,118
DOFTEANA,BC,2594,100,9,8,117,495,23,10,528
HĂGHIAC,BC,1245,40,4,11,55,285,8,11,304
BOGATA,BC,714,25,5,0,30,168,13,5,186
CUCUIEŢI,BC,1950,55,6,0,61,418,10,13,441
LARGA,BC,1050,73,2,0,75,408,15,20,443
"ŞTEFAN VODĂ",BC,939,42,6,3,51,239,10,3,252
SEACA,BC,377,18,4,0,22,106,5,3,114
FARAOANI,BC,4411,89,10,0,99,744,43,0,787
FILIPENI,BC,553,23,3,21,47,161,48,22,231
MĂRĂŞTI,BC,584,22,6,0,28,159,41,19,219
FRUNTEŞTI,BC,622,18,6,0,24,133,35,0,168
FILIPEŞTI,BC,808,27,9,0,36,138,53,0,191
GALBENI,BC,717,17,11,0,28,103,37,1,141
CÎRLIGI,BC,936,18,6,0,24,83,20,0,103
ONIŞCANI,BC,397,10,2,0,12,44,16,0,60
BOANŢA,BC,270,7,6,0,13,45,21,0,66
HÎRLEŞTI,BC,636,20,4,0,24,90,20,0,110
GĂICEANA,BC,743,19,5,0,24,151,18,0,169
ARINI,BC,984,25,1,0,26,197,5,0,202
HUŢU,BC,471,6,6,0,12,35,15,0,50
FĂGET,BC,1100,15,1,0,16,113,13,0,126
TĂRHĂUŞI,BC,654,5,0,0,5,84,4,0,88
GHIMEŞ,BC,874,6,1,0,7,92,15,0,107
"FĂGETU DE SUS",BC,201,7,7,0,14,36,9,0,45
BOLOVĂNIŞ,BC,742,8,4,0,12,83,12,1,96
RĂCHITIŞ,BC,184,5,0,0,5,67,14,0,81
GIOSENI,BC,3164,42,8,0,50,387,24,0,411
"GÎRLENII DE SUS",BC,1450,14,6,0,20,87,21,0,108
GÎRLENI,BC,1991,32,3,0,35,193,29,0,222
LESPEZI,BC,2225,21,3,0,24,220,11,0,231
GLĂVĂNEŞTI,BC,1438,28,2,12,42,285,30,22,337
FRUMUŞELU,BC,1054,12,1,0,13,214,46,0,260
MUNCELU,BC,195,5,1,0,6,43,10,0,53
"GURA VĂII",BC,1568,35,3,0,38,237,27,0,264
MOTOCEŞTI,BC,117,16,5,0,21,23,5,0,28
TEMELIA,BC,760,15,2,4,21,71,8,4,83
PĂLTINATA,BC,377,14,4,9,27,93,13,9,115
DUMBRAVA,BC,990,15,1,0,16,215,20,0,235
CAPĂTA,BC,284,11,0,0,11,78,7,0,85
HELEGIU,BC,960,11,2,0,13,127,19,0,146
BRĂTILA,BC,1534,29,9,0,38,237,32,0,269
DELENI,BC,1382,15,2,0,17,195,10,0,205
DRĂGUGEŞTI,BC,1610,19,3,0,22,217,23,0,240
HEMEIUŞ,BC,2234,95,10,0,105,380,68,1,449
LILIECI,BC,2578,68,10,0,78,401,43,0,444
HORGEŞTI,BC,1393,33,2,0,35,274,17,0,291
SOHODOR,BC,963,42,5,0,47,251,11,0,262
RECEA,BC,659,21,7,0,28,222,33,4,259
RĂCĂTĂU-RĂZEŞI,BC,895,14,4,0,18,168,20,1,189
HURUIEŞTI,BC,586,22,9,0,31,131,20,0,151
PERCHIU,BC,126,6,3,0,9,23,6,0,29
PRĂDAIŞ,BC,261,16,7,0,23,86,20,0,106
CĂPOTEŞTI,BC,173,8,11,0,19,77,30,0,107
OCHENI,BC,294,8,1,0,9,64,12,0,76
FLOREŞTI,BC,136,6,2,0,8,28,8,0,36
FUNDOAIA,BC,333,10,4,0,14,156,21,0,177
ITEŞTI,BC,698,14,5,0,19,111,20,0,131
DUMBRAVA,BC,364,9,4,0,13,73,26,0,99
CIUMAŞI,BC,146,8,6,0,14,28,27,0,55
"IZVORU BERHECIULUI",BC,650,13,1,0,14,99,12,0,111
ANTOHEŞTI,BC,309,11,2,0,13,60,14,0,74
OBÎRŞIA,BC,322,12,3,0,15,91,20,0,111
"LETEA VECHE",BC,2974,124,6,0,130,552,69,0,621
HOLT,BC,1449,42,9,0,51,371,45,0,416
RADOMIREŞTI,BC,335,7,3,0,10,60,10,0,70
RUŞI-CIUTEA,BC,584,36,7,0,43,207,59,0,266
SIRETU,BC,455,15,5,0,20,116,26,0,142
LIPOVA,BC,513,15,9,2,26,170,32,2,204
"VALEA HOGEI",BC,226,14,3,0,17,77,20,0,97
"SATU NOU",BC,388,16,0,0,16,114,7,0,121
"VALEA CASELOR",BC,370,111,10,0,121,173,17,4,194
MÎLOSU,BC,747,17,3,0,20,158,8,0,166
LIVEZI,BC,778,11,2,0,13,117,10,0,127
ORĂŞA,BC,706,13,0,0,13,141,12,0,153
PRAJOAIA,BC,784,7,0,0,7,154,0,0,154
SCĂRIGA,BC,450,7,3,0,10,86,8,0,94
POIANA,BC,742,15,8,0,23,120,22,0,142
BĂLĂNEASA,BC,922,9,0,0,9,108,9,0,117
LUIZI-CĂLUGĂRA,BC,2469,42,5,0,47,464,42,0,506
OSEBIŢI,BC,1770,25,1,0,26,353,10,0,363
MĂGIREŞTI,BC,1494,55,1,1,57,447,13,1,461
STĂNEŞTI,BC,505,14,1,0,15,171,11,0,182
"VALEA ARINILOR",BC,993,25,8,0,33,273,15,0,288
PRĂJEŞTI,BC,506,25,8,0,33,175,20,0,195
MĂGURA,BC,3239,90,10,0,100,472,78,1,551
CRIHAN,BC,1086,7,6,0,13,111,24,0,135
"MĂNĂSTIREA CAŞIN",BC,1586,35,11,0,46,319,21,0,340
PÎRVULEŞTI,BC,612,2,0,0,2,73,0,0,73
SCUTARU,BC,1646,35,3,0,38,356,17,0,373
LUPEŞTI,BC,629,13,3,0,16,100,16,0,116
MĂRGINENI,BC,3472,75,7,0,82,473,39,0,512
BARAŢI,BC,1719,48,12,0,60,334,37,0,371
TREBEŞ,BC,714,18,0,0,18,133,7,0,140
"VALEA BUDULUI",BC,410,21,3,0,24,92,11,0,103
PĂDURENI,BC,313,10,4,0,14,62,5,0,67
LUNCANI,BC,1024,19,6,0,25,96,49,0,145
PODIŞ,BC,535,11,9,0,20,83,66,0,149
MOTOŞENI,BC,851,20,8,0,28,276,43,0,319
ŢEPOAIA,BC,436,9,0,0,9,113,12,0,125
COCIU,BC,253,5,2,0,7,93,17,0,110
POIANA,BC,270,17,5,0,22,131,49,0,180
FÎNTÎNELE,BC,545,10,4,0,14,172,39,0,211
ŞENDREŞTI,BC,303,17,4,0,21,123,34,0,157
NEGRI,BC,1081,32,8,0,40,184,33,0,217
POIANA,BC,1191,49,1,0,50,228,24,0,252
"NICOLAE BĂLCESCU",BC,4290,36,1,0,37,564,31,0,595
GALBENI,BC,1201,24,6,0,30,272,20,0,292
"VALEA SEACĂ",BC,2470,29,1,0,30,268,37,0,305
LĂRGUŢA,BC,180,9,3,0,12,63,3,0,66
ODOBEŞTI,BC,379,18,8,0,26,115,39,0,154
TISA-SILVESTRI,BC,879,67,17,0,84,331,51,16,398
CIUTUREŞTI,BC,653,14,5,0,19,201,35,0,236
OITUZ,BC,5376,98,9,0,107,667,58,0,725
MARGINEA,BC,608,15,0,0,15,120,4,0,124
CĂLCÎI,BC,385,10,0,0,10,57,6,0,63
FERESTRĂU-OITUZ,BC,880,13,2,0,15,117,16,0,133
HÎRJA,BC,260,28,44,17,89,69,79,17,165
"POIANA SĂRATĂ",BC,220,16,6,0,22,49,20,0,69
ONCEŞTI,BC,758,13,6,0,19,166,34,0,200
TARNIŢA,BC,528,20,6,0,26,167,19,0,186
ORBENI,BC,1603,53,10,0,63,347,53,22,422
SCURTA,BC,1397,22,14,0,36,303,36,3,342
PALANCA,BC,1274,46,6,0,52,275,43,1,319
CIUGHEŞ,BC,1481,38,2,0,40,314,19,0,333
CĂDĂREŞTI,BC,90,4,1,0,5,12,3,0,15
PARAVA,BC,731,10,1,2,13,128,25,2,155
DRĂGUŞANI,BC,703,8,4,0,12,90,32,0,122
RĂDOAIA,BC,960,64,6,1,71,145,9,1,155
TEIUŞ,BC,210,7,3,0,10,74,12,0,86
PARINCEA,BC,749,36,6,0,42,156,18,0,174
VĂLENI,BC,450,8,0,0,8,76,11,0,87
VLADNIC,BC,693,17,7,0,24,212,28,0,240
NĂNEŞTI,BC,592,11,4,0,15,109,15,0,124
POIENI,BC,237,9,8,0,17,35,14,0,49
PÂRJOL,BC,727,24,10,23,57,181,41,23,245
TĂRÎŢA,BC,842,17,4,0,21,138,20,0,158
BĂHNĂŞENI,BC,708,17,3,0,20,201,25,0,226
BĂRNEŞTI,BC,189,11,6,0,17,60,9,1,70
BĂSĂŞTI,BC,517,21,2,0,23,145,22,0,167
HÂINEALA,BC,225,7,4,0,11,40,17,0,57
CÎMPENI,BC,511,25,0,14,39,148,6,14,168
PUSTIANA,BC,1580,29,12,0,41,230,27,0,257
PÎNCEŞTI,BC,1169,52,12,0,64,299,50,0,349
DIENEŢ,BC,540,10,2,0,12,86,17,0,103
PETREŞTI,BC,661,31,8,0,39,196,33,0,229
SOCI,BC,639,18,4,0,22,130,13,0,143
FULGERIŞ,BC,401,17,7,0,24,134,19,0,153
"PÎRÎU BOGHII",BC,370,13,4,0,17,93,7,0,100
PÎRGĂREŞTI,BC,828,10,0,0,10,88,15,0,103
"SATU NOU",BC,1360,10,3,0,13,153,11,0,164
NICOREŞTI,BC,828,6,2,0,8,145,6,0,151
BAHNA,BC,482,12,1,0,13,80,5,0,85
PLOPANA,BC,766,25,2,0,27,253,36,16,305
"FUNDU TUTOVEI",BC,468,32,9,0,41,139,25,0,164
IŢCANI,BC,618,17,3,0,20,191,20,2,213
"RUSENII RĂZEŞI",BC,318,5,5,0,10,88,16,1,105
STRĂMINOASA,BC,341,10,7,0,17,139,24,0,163
"PODU TURCULUI",BC,2352,167,11,0,178,684,58,18,760
CĂBEŞTI,BC,746,23,7,0,30,149,38,0,187
LEHANCEA,BC,530,17,6,0,23,142,17,0,159
SÎRBI,BC,373,24,0,0,24,163,7,0,170
PODURI,BC,2211,73,16,1,90,725,46,4,775
"VALEA ŞOŞII",BC,962,33,1,7,41,335,14,11,360
PROHOZEŞTI,BC,802,39,3,0,42,238,14,3,255
BUCŞEŞTI,BC,1333,40,4,0,44,337,16,0,353
CERNU,BC,1193,31,8,0,39,288,25,3,316
PRĂJEŞTI,BC,1926,44,5,0,49,331,54,0,385
RACOVA,BC,1905,54,11,0,65,333,36,0,369
"GURA VĂII",BC,1039,19,4,0,23,164,21,0,185
RĂCĂCIUNI,BC,2865,63,8,0,71,458,38,8,504
"GHEORGHE DOJA",BC,932,9,2,0,11,105,12,0,117
GÎŞTENI,BC,745,11,74,19,104,134,90,19,243
"FUNDU RĂCĂCIUNI",BC,1512,42,5,0,47,309,14,0,323
CIUCANI,BC,476,6,0,0,6,89,7,0,96
RĂCHITOASA,BC,1131,17,2,73,92,177,16,73,266
"FUNDĂTURA RĂCHITOASA",BC,227,12,6,0,18,51,9,0,60
DUMBRAVA,BC,532,10,3,0,13,95,4,0,99
BURDUSACI,BC,711,15,4,0,19,81,22,0,103
BARCANA,BC,523,13,5,0,18,133,8,0,141
BUDA,BC,541,8,9,0,17,56,19,0,75
ROŞIORI,BC,1014,13,5,0,18,249,23,0,272
POIENI,BC,286,9,6,0,15,88,25,0,113
"VALEA MARE",BC,473,13,3,0,16,73,9,0,82
SASCUT,BC,2611,103,15,0,118,571,74,16,661
BEREŞTI,BC,1150,174,20,0,194,696,59,23,778
CONŢEŞTI,BC,454,14,12,5,31,126,22,21,169
PĂNCEŞTI,BC,2212,145,3,0,148,1192,50,14,1256
SASCUT-SAT,BC,1691,58,10,17,85,382,40,17,439
SĂNDULENI,BC,1609,17,3,0,20,259,21,0,280
VERŞEŞTI,BC,676,18,0,0,18,247,14,0,261
COMAN,BC,1078,6,1,0,7,171,8,0,179
STUFU,BC,303,14,0,0,14,85,12,0,97
SĂRATA,BC,1800,70,17,2,89,358,58,3,419
SĂUCEŞTI,BC,2039,93,9,0,102,358,54,0,412
SCHINENI,BC,673,22,5,0,27,144,40,0,184
SIRETU,BC,650,30,13,0,43,149,33,0,182
ŞERBEŞTI,BC,477,32,5,0,37,108,18,0,126
"BOGDAN VODĂ",BC,555,24,7,0,31,122,20,0,142
SCORŢENI,BC,1265,12,3,0,15,180,13,0,193
GRIGORENI,BC,684,16,3,0,19,157,53,0,210
FLOREŞTI,BC,554,10,5,0,15,97,15,0,112
SECUIENI,BC,1109,19,6,0,25,232,28,0,260
FUNDENI,BC,292,10,2,0,12,63,30,0,93
CHITICENI,BC,150,18,8,0,26,47,17,0,64
GLODIŞOARELE,BC,218,4,0,0,4,56,4,0,60
SOLONŢ,BC,1226,48,2,1,51,381,25,1,407
SĂRATA,BC,686,17,2,6,25,193,9,6,208
CUCUIEŢI,BC,1044,23,6,24,53,331,22,24,377
STĂNIŞEŞTI,BC,811,32,10,8,50,238,39,8,285
BENEŞTI,BC,372,8,4,5,17,130,9,5,144
CRĂIEŞTI,BC,366,2,2,0,4,108,27,0,135
SLOBOZIA,BC,1222,11,16,5,32,169,64,5,238
"SLOBOZIA NOUĂ",BC,561,15,9,7,31,187,26,7,220
STRUGARI,BC,846,33,1,0,34,219,12,0,231
RĂCHITIŞU,BC,337,9,6,6,21,110,14,6,130
PETRICICA,BC,588,11,5,0,16,123,23,0,146
"ŞTEFAN CEL MARE",BC,1243,54,2,0,56,284,35,0,319
NEGOIEŞTI,BC,723,29,8,0,37,152,20,0,172
VIIŞOARA,BC,507,12,1,0,13,114,13,0,127
GUTINAŞ,BC,342,16,4,0,20,85,11,1,97
RĂDEANA,BC,1199,16,3,0,19,222,14,0,236
TAMAŞI,BC,1261,52,1,0,53,403,39,0,442
CHETRIŞ,BC,635,16,7,0,23,116,21,0,137
FURNICARI,BC,532,16,4,0,20,154,13,0,167
TĂTĂRĂŞTI,BC,381,7,2,0,9,115,9,0,124
"CORNII DE SUS",BC,728,14,3,0,17,211,18,0,229
GIURGENI,BC,198,5,4,0,9,80,16,0,96
DRĂGEŞTI,BC,299,11,9,0,20,112,22,0,134
GHERDANA,BC,289,4,0,0,4,78,9,0,87
VIIŞOARA,BC,928,22,7,0,29,138,26,0,164
"TÎRGU TROTUŞ",BC,1832,43,4,0,47,273,17,0,290
TUTA,BC,1768,51,7,0,58,346,26,0,372
TRAIAN,BC,1439,38,13,0,51,250,47,0,297
BOGDĂNEŞTI,BC,460,4,2,0,6,72,8,0,80
ZĂPODIA,BC,519,9,8,0,17,37,17,0,54
"HERTIOANA DE JOS",BC,147,3,1,0,4,29,20,0,49
UNGURENI,BC,774,45,14,0,59,186,36,0,222
VIFORENI,BC,377,20,8,0,28,103,18,0,121
BĂRTĂŞEŞTI,BC,294,41,9,0,50,122,13,0,135
BOTEŞTI,BC,679,25,5,0,30,152,18,0,170
BIBIREŞTI,BC,769,31,4,0,35,226,26,0,252
URECHEŞTI,BC,1410,32,3,0,35,226,29,0,255
CORNĂŢEL,BC,696,15,2,0,17,154,22,0,176
SLOBOZIA,BC,458,21,8,0,29,132,19,0,151
"LUNCA DOCHIEI",BC,274,9,4,0,13,61,12,0,73
"SATU NOU",BC,262,10,0,0,10,80,10,0,90
"VALEA SEACĂ",BC,2325,138,33,0,171,783,139,24,946
CUCOVA,BC,556,15,9,0,24,179,40,4,223
VULTURENI,BC,411,11,0,0,11,91,15,0,106
LICHITIŞENI,BC,437,12,3,0,15,66,17,5,88
"GODINEŞTII DE JOS",BC,303,12,5,0,17,88,19,5,112
MEDELENI,BC,147,5,4,0,9,33,13,0,46
GHILĂVEŞTI,BC,224,6,0,0,6,16,5,0,21
ZEMEŞ,BC,3020,154,4,35,193,695,21,38,754
BOLĂTĂU,BC,873,25,3,0,28,147,14,0,161
ORADEA,BH,186943,15348,1392,651,17391,39514,3549,903,43966
BEIUŞ,BH,9041,755,96,31,882,2498,275,40,2813
DELANI,BH,295,16,0,0,16,121,11,1,133
MARGHITA,BH,13327,577,41,5,623,2155,123,5,2283
CHEŢ,BH,914,42,3,0,45,214,8,0,222
GHENETEA,BH,593,17,6,0,23,111,17,0,128
SALONTA,BH,15975,706,66,11,783,2108,165,48,2321
ALEŞD,BH,6549,619,47,44,710,1885,150,45,2080
PEŞTIŞ,BH,1119,140,15,0,155,473,30,3,506
TINĂUD,BH,653,182,16,0,198,366,37,0,403
"PĂDUREA NEAGRĂ",BH,596,20,0,0,20,95,7,0,102
NUCET,BH,1229,117,22,1,140,487,99,44,630
BĂIŢA,BH,524,56,7,1,64,209,76,44,329
CADEA,BH,932,5,0,0,5,35,0,0,35
CUBULCUT,BH,696,2,0,0,2,31,1,0,32
OLOSIG,BH,439,8,2,0,10,26,6,0,32
"SÂNNICOLAU DE MUNTE",BH,706,9,2,0,11,91,6,0,97
SĂCUENI,BH,6159,139,14,0,153,504,39,0,543
CIOCAIA,BH,776,22,4,0,26,92,10,0,102
ŞTEI,BH,6093,489,27,202,718,1523,104,203,1830
"VALEA LUI MIHAI",BH,8987,211,34,10,255,856,68,10,934
VAŞCĂU,BH,1386,71,4,0,75,352,32,0,384
CÎMP,BH,195,12,4,0,16,61,10,0,71
COLEŞTI,BH,111,8,7,0,15,36,8,0,44
"VĂRZARII DE JOS",BH,185,20,5,0,25,78,15,0,93
"VĂRZARII DE SUS",BH,107,13,5,0,18,41,10,0,51
CÎMP-MOŢI,BH,44,2,0,0,2,8,8,0,16
ABRAM,BH,777,34,1,0,35,157,4,0,161
DIJIR,BH,239,14,11,0,25,78,16,0,94
ITEU,BH,242,31,9,0,40,96,22,3,121
"SATU BARBĂ",BH,230,8,1,0,9,63,13,0,76
"ITEU NOU",BH,121,12,0,0,12,41,4,0,45
MARGINE,BH,410,33,8,2,43,228,28,2,258
SUIUG,BH,467,19,6,0,25,122,16,0,138
ABRĂMUŢ,BH,376,6,6,0,12,68,17,0,85
CRESTUR,BH,363,5,5,0,10,79,19,0,98
FĂNCICA,BH,275,10,0,0,10,69,7,0,76
PETREU,BH,1415,32,5,0,37,211,19,0,230
CHISTAG,BH,493,44,10,0,54,175,27,0,202
AŞTILEU,BH,1280,71,3,0,74,346,20,0,366
CĂLĂŢEA,BH,528,81,10,5,96,273,36,5,314
PEŞTERE,BH,693,83,7,0,90,333,18,2,353
AUŞEU,BH,785,62,5,0,67,253,28,0,281
GROŞI,BH,837,49,5,0,54,314,19,3,336
LUNCŞOARA,BH,753,31,10,0,41,248,28,0,276
"AVRAM IANCU",BH,1558,81,5,0,86,510,30,0,540
ANT,BH,161,5,5,0,10,10,14,0,24
TĂMAŞDA,BH,911,69,6,0,75,299,13,0,312
BALC,BH,1064,18,4,0,22,142,10,0,152
"ALMAŞU MARE",BH,627,29,4,0,33,196,17,0,213
"ALMAŞU MIC",BH,287,15,4,0,19,103,16,0,119
"SĂLDĂBAGIU DE BARCĂU",BH,436,17,6,0,23,163,18,2,183
GHIDA,BH,125,16,8,0,24,46,15,0,61
BATĂR,BH,1314,161,18,12,191,427,45,12,484
ARPĂŞEL,BH,736,15,2,0,17,58,5,0,63
TALPOŞ,BH,1314,251,18,0,269,495,35,0,530
TĂUT,BH,753,161,30,9,200,366,52,9,427
BIHARIA,BH,3207,110,8,0,118,446,36,0,482
CAUACEU,BH,641,15,0,0,15,113,13,0,126
"BOIANU MARE",BH,465,25,0,0,25,203,6,9,218
PĂGAIA,BH,557,32,7,0,39,196,23,0,219
BOROD,BH,1260,62,8,0,70,358,43,0,401
BOROZEL,BH,513,27,0,0,27,201,12,0,213
CETEA,BH,185,11,8,0,19,91,32,0,123
CORNIŢEL,BH,421,85,15,2,102,228,36,2,266
"VALEA MARE DE CRIŞ",BH,370,70,14,1,85,234,34,1,269
ŞERANI,BH,333,15,12,0,27,90,34,0,124
BORŞ,BH,1193,25,9,0,34,121,21,0,142
SÂNTION,BH,1613,46,6,0,52,244,16,0,260
"SANTĂUL MARE",BH,325,9,8,14,31,35,21,14,70
"SANTĂUL MIC",BH,475,33,10,0,43,75,13,0,88
BRATCA,BH,1218,150,23,11,184,450,61,11,522
BEZNEA,BH,1079,88,3,0,91,358,36,0,394
DAMIŞ,BH,458,18,11,0,29,146,26,0,172
PONOARĂ,BH,468,14,3,4,21,155,16,4,175
LORĂU,BH,365,25,3,2,30,122,12,2,136
"VALEA CRIŞULUI",BH,364,40,3,0,43,174,17,0,191
BRUSTURI,BH,946,51,17,0,68,265,49,0,314
CUIEŞD,BH,655,22,5,0,27,183,43,0,226
ORVIŞELE,BH,321,30,10,0,40,118,29,0,147
PĂULEŞTI,BH,250,12,10,0,22,64,28,0,92
PICLEU,BH,729,44,12,2,58,191,41,2,234
BUDUREASA,BH,1266,37,7,0,44,553,39,0,592
BURDA,BH,320,10,1,0,11,118,14,1,133
SACA,BH,176,19,3,0,22,89,9,0,98
"SĂLIŞTE DE BEIUŞ",BH,208,8,0,0,8,71,5,0,76
TELEAC,BH,135,6,2,0,8,63,13,0,76
BUDUSLĂU,BH,828,20,3,0,23,139,9,0,148
ALBIŞ,BH,793,20,4,0,24,97,6,0,103
BULZ,BH,696,41,5,0,46,233,37,0,270
MUNTENI,BH,414,19,7,0,26,139,15,0,154
REMEŢI,BH,619,25,34,0,59,161,67,0,228
BUNTEŞTI,BH,479,32,4,4,40,215,18,4,237
BRĂDET,BH,570,30,1,0,31,202,10,0,212
DUMBRĂVANI,BH,244,13,0,0,13,85,8,1,94
FERICE,BH,396,36,3,10,49,182,18,10,210
LELEŞTI,BH,332,26,4,7,37,156,20,7,183
"POIENII DE JOS",BH,504,19,3,0,22,196,26,0,222
"POIENII DE SUS",BH,559,27,1,0,28,255,14,0,269
SĂUD,BH,354,48,3,4,55,198,16,4,218
STÎNCEŞTI,BH,253,15,4,0,19,98,15,0,113
CĂBEŞTI,BH,740,30,4,0,34,215,20,0,235
JOSANI,BH,392,19,5,0,24,123,14,8,145
GOILA,BH,152,14,3,0,17,48,7,0,55
SOHODOL,BH,243,10,6,0,16,60,14,0,74
CĂPÎLNA,BH,256,63,35,15,113,138,71,16,225
ROHANI,BH,88,17,8,0,25,35,17,6,58
GINTA,BH,229,8,7,0,15,48,31,0,79
"SUPLACU DE TINCA",BH,326,12,5,0,17,127,31,17,175
"SĂLDĂBAGIU MIC",BH,340,28,10,0,38,145,57,13,215
CĂRPINET,BH,442,38,13,0,51,183,27,0,210
CĂLUGĂRI,BH,394,46,34,0,80,131,57,0,188
IZBUC,BH,407,16,3,0,19,142,8,0,150
LEHECENI,BH,311,22,6,0,28,116,17,0,133
CEFA,BH,1017,42,7,0,49,221,31,0,252
ATEAŞ,BH,158,7,5,0,12,59,21,0,80
INAND,BH,735,36,9,0,45,151,29,0,180
CEICA,BH,766,97,5,1,103,311,35,2,348
BUCIUM,BH,175,47,5,0,52,88,23,0,111
CEIŞOARA,BH,462,47,5,0,52,231,20,0,251
CORBEŞTI,BH,376,31,7,0,38,156,33,0,189
COTIGLET,BH,324,72,13,0,85,179,32,12,223
DUŞEŞTI,BH,420,84,13,0,97,232,39,3,274
INCEŞTI,BH,293,47,16,0,63,141,42,0,183
ŞIŞTEREA,BH,498,6,5,0,11,49,14,0,63
ŞUŞTUROGI,BH,198,17,9,0,26,55,32,0,87
CETARIU,BH,921,15,7,0,22,88,15,0,103
TĂUTELEC,BH,195,5,1,0,6,28,12,0,40
CHERECHIU,BH,577,4,0,0,4,58,5,0,63
CHEŞEREU,BH,805,16,3,0,19,98,4,0,102
TÎRGUŞOR,BH,443,11,5,0,16,54,10,0,64
CHIŞLAZ,BH,388,22,9,0,31,108,26,0,134
CHIRALEU,BH,485,24,3,0,27,130,15,0,145
MIŞCA,BH,767,51,5,0,56,286,15,0,301
"POCLUŞA DE BARCĂU",BH,309,7,3,0,10,49,6,0,55
SĂRSIG,BH,251,10,2,0,12,90,14,0,104
SÎNLAZĂR,BH,333,23,3,0,26,106,18,0,124
CIUMEGHIU,BH,1487,25,3,0,28,292,33,0,325
BOIU,BH,592,34,10,0,44,169,23,0,192
GHIORAC,BH,1311,28,5,0,33,164,28,0,192
CÎMPANI,BH,698,30,2,0,32,221,17,0,238
FÎNAŢE,BH,510,61,1,0,62,238,13,0,251
HÎRSEŞTI,BH,274,19,6,0,25,125,16,0,141
SIGHIŞTEL,BH,264,41,10,0,51,144,21,0,165
"VALEA DE SUS",BH,244,35,4,0,39,161,20,0,181
"COCIUBA MARE",BH,741,38,10,0,48,238,34,30,302
CHEŞA,BH,462,42,13,12,67,242,55,12,309
CĂRĂSĂU,BH,594,81,9,36,126,234,32,36,302
PETID,BH,506,55,3,22,80,249,42,22,313
BUCUROAIA,BH,270,50,12,0,62,147,33,0,180
CHIJIC,BH,214,22,8,0,30,83,33,0,116
SURDUC,BH,329,30,14,0,44,103,49,0,152
COPĂCEL,BH,336,77,25,0,102,152,57,0,209
"POIANA TĂŞAD",BH,122,14,7,0,21,44,15,0,59
SĂRAND,BH,407,33,12,13,58,133,48,13,194
"CRIŞTIORU DE JOS",BH,288,13,4,1,18,110,18,1,129
"CRIŞTIORU DE SUS",BH,73,8,2,0,10,14,5,0,19
POIANA,BH,399,35,4,0,39,151,15,0,166
"SĂLIŞTE DE VAŞCĂU",BH,334,17,1,0,18,82,10,0,92
CURĂŢELE,BH,657,21,5,0,26,172,16,0,188
BEIUŞELE,BH,367,18,4,0,22,133,11,0,144
CRESUIA,BH,362,13,3,0,16,112,5,0,117
NIMĂIEŞTI,BH,679,33,2,0,35,252,21,0,273
CURTUIŞENI,BH,2281,32,14,0,46,167,21,0,188
VĂŞAD,BH,679,28,7,0,35,146,31,0,177
DERNA,BH,742,26,5,0,31,184,24,0,208
DERNIŞOARA,BH,427,59,2,0,61,221,30,0,251
SACALASĂU,BH,432,20,8,0,28,127,23,0,150
"SACALASĂU NOU",BH,223,2,2,0,4,36,9,0,45
TRIA,BH,247,18,4,0,22,83,20,0,103
DIOSIG,BH,5500,132,45,0,177,652,110,0,762
DOBREŞTI,BH,1528,144,17,13,174,583,37,14,634
LUNCASPRIE,BH,794,103,7,0,110,323,18,2,343
HIDIŞEL,BH,552,52,7,0,59,255,37,0,292
CRÎNCEŞTI,BH,340,65,6,0,71,177,24,0,201
CORNIŞEŞTI,BH,172,25,7,0,32,68,22,0,90
"TOPA DE JOS",BH,151,15,4,0,19,69,18,0,87
"TOPA DE SUS",BH,484,46,10,10,66,225,30,10,265
DRĂGĂNEŞTI,BH,371,42,0,0,42,151,6,0,157
BELEJENI,BH,256,26,2,0,28,151,8,0,159
GRĂDINARI,BH,387,14,1,0,15,99,9,0,108
"LIVADA BEIUŞULUI",BH,110,18,0,0,18,61,4,0,65
MIZIEŞ,BH,437,21,5,0,26,116,13,0,129
PĂNTĂŞEŞTI,BH,115,10,1,0,11,69,7,0,76
ŞEBIŞ,BH,257,33,5,0,38,121,18,0,139
TALPE,BH,203,15,0,0,15,64,6,0,70
"ŢIGĂNEŞTII DE BEIUŞ",BH,120,17,1,0,18,69,2,0,71
PĂCĂLEŞTI,BH,169,19,0,0,19,100,8,0,108
DRĂGEŞTI,BH,279,22,3,0,25,70,27,0,97
DICĂNEŞTI,BH,220,23,9,0,32,97,32,0,129
STRACOŞ,BH,176,12,4,0,16,52,15,0,67
TĂŞAD,BH,991,63,21,0,84,314,54,0,368
TOPEŞTI,BH,180,30,6,7,43,64,14,7,85
FINIŞ,BH,1353,73,2,2,77,538,20,2,560
FIZIŞ,BH,193,11,1,0,12,51,10,0,61
IOANIŞ,BH,584,40,3,0,43,228,12,0,240
ŞUNCUIŞ,BH,674,19,5,0,24,126,14,0,140
GEPIU,BH,1007,135,75,0,210,421,221,19,661
BICACI,BH,493,21,13,0,34,112,43,0,155
"GIRIŞU DE CRIŞ",BH,1271,69,10,0,79,229,30,0,259
TĂRIAN,BH,1811,57,7,0,64,208,18,0,226
"HIDIŞELU DE SUS",BH,869,111,14,24,149,392,75,24,491
"HIDIŞELU DE JOS",BH,484,29,6,0,35,139,19,0,158
MIERLĂU,BH,594,118,19,0,137,341,67,12,420
SÎNTELEC,BH,316,23,6,0,29,131,26,0,157
ŞUMUGIU,BH,325,22,15,0,37,83,46,0,129
HOLOD,BH,390,88,18,17,123,177,55,17,249
DUMBRAVA,BH,500,43,9,0,52,176,27,27,230
DUMBRĂVIŢA,BH,146,24,9,0,33,63,28,9,100
FOROSIG,BH,120,42,7,0,49,71,27,0,98
HODIŞ,BH,134,26,15,10,51,68,47,10,125
LUPOAIA,BH,452,42,13,0,55,169,22,0,191
"VALEA MARE DE CODRU",BH,68,13,17,0,30,30,39,0,69
VINTERE,BH,601,116,24,0,140,226,53,16,295
"HUSASĂU DE TINCA",BH,612,40,27,12,79,224,66,19,309
FONĂU,BH,160,63,8,0,71,95,14,1,110
MIERSIG,BH,325,36,3,0,39,93,36,0,129
OŞAND,BH,374,67,15,3,85,146,35,3,184
SITITELEC,BH,256,27,26,0,53,74,79,8,161
INEU,BH,1929,132,29,0,161,521,95,0,616
BOTEAN,BH,523,30,3,0,33,134,20,0,154
"HUSASĂU DE CRIŞ",BH,978,133,15,0,148,350,40,0,390
"LAZURI DE BEIUŞ",BH,288,11,5,0,16,119,9,0,128
HINCHIRIŞ,BH,535,54,9,0,63,243,37,3,283
CUSUIUŞ,BH,373,16,1,0,17,121,12,0,133
BĂLENI,BH,168,11,6,0,17,82,13,0,95
LĂZĂRENI,BH,649,66,11,0,77,361,54,0,415
CĂRĂNDENI,BH,336,30,16,0,46,104,40,1,145
CĂRĂNZEL,BH,78,30,29,3,62,42,46,3,91
"CALEA MARE",BH,500,49,7,0,56,224,33,13,270
GEPIŞ,BH,542,88,4,0,92,241,45,0,286
GRUILUNG,BH,94,7,1,0,8,41,12,0,53
MIHELEU,BH,136,15,11,0,26,59,41,1,101
"LUGAŞU DE JOS",BH,1289,210,22,45,277,570,48,45,663
"LUGAŞU DE SUS",BH,674,91,9,0,100,290,26,0,316
URVIND,BH,752,25,0,0,25,257,24,24,305
LUNCA,BH,779,43,2,0,45,223,13,0,236
BRIHENI,BH,251,67,12,0,79,127,23,1,151
HOTĂREL,BH,243,44,13,4,61,125,21,4,150
SEGHIŞTE,BH,474,15,2,0,17,110,11,0,121
SÎRBEŞTI,BH,229,13,3,0,16,90,7,0,97
ŞUŞTIU,BH,364,27,5,0,32,124,13,0,137
MARŢIHAZ,BH,162,11,4,1,16,70,25,1,96
MĂDĂRAŞ,BH,762,27,13,0,40,152,24,20,196
HOMOROG,BH,575,31,6,0,37,174,44,0,218
IANOŞDA,BH,745,41,12,4,57,163,55,4,222
MĂGEŞTI,BH,215,19,6,0,25,98,16,3,117
BUTANI,BH,305,49,4,0,53,136,12,3,151
ORTITEAG,BH,425,30,5,0,35,180,19,0,199
"CACUCIU NOU",BH,289,15,4,0,19,77,14,0,91
JOSANI,BH,294,13,8,0,21,105,11,11,127
GĂLĂŞENI,BH,219,23,5,0,28,127,13,2,142
DOBRICIONEŞTI,BH,425,21,3,0,24,122,12,0,134
NOJORID,BH,1974,116,17,0,133,515,68,0,583
APATEU,BH,246,44,15,0,59,108,56,0,164
CHIŞIRID,BH,193,24,41,3,68,70,75,3,148
LEŞ,BH,691,31,9,0,40,140,34,0,174
"LIVADA DE BIHOR",BH,1169,71,5,0,76,230,32,18,280
PĂUŞA,BH,246,13,6,0,19,77,26,0,103
ŞAUAIEU,BH,236,18,5,0,23,55,32,0,87
OLCEA,BH,455,27,7,0,34,196,21,4,221
CĂLACEA,BH,968,136,10,34,180,526,29,35,590
HODIŞEL,BH,254,14,3,0,17,142,17,0,159
UCURIŞ,BH,454,49,17,17,83,119,30,17,166
OŞORHEI,BH,2767,241,23,0,264,821,84,0,905
ALPAREA,BH,847,94,19,0,113,335,59,0,394
CHERIU,BH,627,26,7,0,33,135,28,0,163
FELCHERIU,BH,275,25,18,0,43,93,47,0,140
FUGHIU,BH,960,111,9,0,120,289,24,3,316
PALEU,BH,1337,38,8,0,46,164,25,0,189
"UILEACU DE MUNTE",BH,412,14,7,0,21,50,9,0,59
"SĂLDĂBAGIU DE MUNTE",BH,753,25,3,0,28,160,17,0,177
PIETROASA,BH,654,42,4,0,46,236,10,0,246
GURANI,BH,485,38,8,0,46,189,21,0,210
"COCIUBA MICĂ",BH,366,9,1,0,10,121,9,0,130
CHIŞCĂU,BH,601,43,11,0,54,243,25,13,281
GIULEŞTI,BH,134,5,4,0,9,59,4,1,64
MĂGURA,BH,248,27,6,0,33,126,10,3,139
MOŢEŞTI,BH,74,15,4,0,19,46,6,0,52
POCOLA,BH,448,50,26,0,76,243,62,22,327
FENERIŞ,BH,293,56,13,0,69,158,40,7,205
PETRANI,BH,281,39,12,0,51,131,36,6,173
"SÎNMARTIN DE BEIUŞ",BH,192,19,4,0,23,90,18,3,111
COŞDENI,BH,442,127,12,0,139,281,30,10,321
HIDIŞ,BH,278,16,11,0,27,120,22,0,142
"SPINUŞ DE POMEZEU",BH,178,30,5,0,35,91,19,19,129
"VĂLANI DE POMEZEU",BH,466,62,2,0,64,257,11,0,268
SITANI,BH,370,60,6,0,66,209,17,0,226
POMEZEU,BH,114,8,6,0,14,47,17,10,74
"LACU SĂRAT",BH,36,2,0,0,2,20,4,0,24
"CÎMPANI DE POMEZEU",BH,349,50,10,0,60,162,26,3,191
POPEŞTI,BH,1878,88,3,0,91,446,29,58,533
VOIVOZI,BH,1411,31,10,0,41,344,26,0,370
BISTRA,BH,838,19,0,0,19,208,9,0,217
BUDOI,BH,747,13,2,0,15,135,5,0,140
CUZAP,BH,944,29,5,0,34,360,23,0,383
VARVIZ,BH,410,24,6,0,30,141,18,0,159
VĂRZARI,BH,257,11,2,0,13,46,5,0,51
RĂBĂGANI,BH,511,44,6,0,50,188,42,5,235
ALBEŞTI,BH,216,21,5,0,26,105,24,1,130
"SALIŞTE DE POMEZEU",BH,87,14,8,0,22,58,22,0,80
SĂUCANI,BH,385,21,1,0,22,165,35,0,200
VĂRĂŞENI,BH,314,22,9,0,31,110,17,3,130
BRĂTEŞTI,BH,101,29,10,0,39,53,26,5,84
REMETEA,BH,663,37,11,0,48,264,44,0,308
MEZIAD,BH,897,16,4,0,20,384,39,1,424
DRĂGOTENI,BH,324,11,8,0,19,118,26,0,144
PETREASA,BH,352,32,3,0,35,143,26,5,174
SOIMUŞ,BH,100,11,11,0,22,47,21,0,68
RIENI,BH,451,17,2,0,19,92,6,0,98
GHIGHIŞENI,BH,787,47,10,0,57,219,21,0,240
"VALEA DE JOS",BH,472,21,1,0,22,142,11,0,153
PETRILENI,BH,465,37,7,0,44,140,17,0,157
SUDRIGIU,BH,277,24,6,0,30,124,20,0,144
ROŞIA,BH,1616,58,14,0,72,465,41,0,506
LAZURI,BH,321,23,2,0,25,120,6,0,126
ROŞIORI,BH,1159,67,9,6,82,276,23,6,305
"MIHAI BRAVU",BH,831,61,19,0,80,301,48,3,352
VAIDA,BH,370,29,5,0,34,126,16,3,145
SĂCĂDAT,BH,725,35,10,0,45,200,75,0,275
SĂBOLCIU,BH,593,108,23,0,131,223,46,0,269
BORŞA,BH,140,15,10,0,25,56,56,0,112
OTOMANI,BH,590,22,1,0,23,131,10,0,141
SĂLACEA,BH,1874,43,6,0,49,244,11,8,263
SĂLARD,BH,2478,95,32,0,127,412,50,12,474
HODOŞ,BH,604,6,1,0,7,72,8,0,80
SÎNTIMREU,BH,479,18,6,0,24,89,12,0,101
SÂNIOB,BH,1065,2,2,0,4,130,17,0,147
CIUHOI,BH,291,16,14,0,30,98,30,0,128
CENALOŞ,BH,217,7,3,0,10,50,13,0,63
SFÂRNAŞ,BH,208,33,8,0,41,111,33,0,144
"SÂNNICOLAU ROMÂN",BH,944,74,15,0,89,336,48,0,384
BERECHIU,BH,269,20,6,0,26,81,19,0,100
ROIT,BH,524,57,9,2,68,222,29,6,257
SÎMBĂTA,BH,293,27,10,0,37,114,82,5,201
COPĂCENI,BH,107,22,12,1,35,55,30,1,86
OGEŞTI,BH,172,33,3,6,42,110,20,6,136
ROTĂREŞTI,BH,113,24,16,4,44,67,45,4,116
ROGOZ,BH,231,18,5,0,23,80,20,7,107
ZĂVOIU,BH,196,16,14,0,30,101,48,2,151
SÎNMARTIN,BH,3577,448,103,0,551,1139,251,1,1391
BETFIA,BH,377,33,11,0,44,141,34,0,175
"BĂILE FELIX",BH,484,48,468,0,516,143,874,70,1087
CIHEI,BH,1159,209,55,0,264,543,157,2,702
HAIEU,BH,1017,75,158,0,233,320,268,2,590
RONTĂU,BH,940,57,4,0,61,282,19,2,303
CORDĂU,BH,1298,107,12,0,119,409,41,0,450
SÎNTANDREI,BH,4678,285,46,0,331,1037,136,0,1173
PALOTA,BH,590,24,6,0,30,116,16,0,132
SÎRBI,BH,836,127,35,0,162,427,86,18,531
BURZUC,BH,627,66,15,0,81,291,49,13,353
"ALMAŞU MIC",BH,85,8,7,0,15,36,27,0,63
CHIOAG,BH,118,10,4,0,14,43,8,0,51
FEGERNIC,BH,280,12,5,0,17,86,35,0,121
SARCĂU,BH,52,0,4,0,4,16,10,0,26
SPINUŞ,BH,306,7,7,0,14,86,28,0,114
NĂDAR,BH,186,10,17,0,27,77,47,0,124
CIULEŞTI,BH,157,22,11,0,33,50,27,0,77
SĂLIŞTE,BH,200,9,5,0,14,31,13,0,44
GURBEŞTI,BH,103,9,1,0,10,21,7,0,28
"SUPLACU DE BARCĂU",BH,2022,55,10,0,65,348,31,0,379
BORUMLACA,BH,758,19,2,0,21,149,10,4,163
DOLEA,BH,128,3,0,0,3,12,5,0,17
FOGLAŞ,BH,164,7,3,0,10,47,6,0,53
"VALEA CERULUI",BH,370,7,4,0,11,63,4,0,67
VÎLCELELE,BH,204,11,6,0,17,49,8,0,57
ŞIMIAN,BH,2025,49,6,0,55,223,17,0,240
ŞILINDRU,BH,736,22,7,0,29,107,14,0,121
VOIVOZI,BH,325,16,7,0,23,58,40,0,98
ŞINTEU,BH,967,25,3,0,28,140,32,0,172
ŞOIMI,BH,575,44,6,0,50,154,16,1,171
"SÎNNICOLAU DE BEIUŞ",BH,97,9,6,0,15,40,12,2,54
URSAD,BH,125,9,2,0,11,58,23,0,81
"POCLUŞA DE BEIUŞ",BH,71,18,7,0,25,55,15,0,70
CODRU,BH,137,12,3,0,15,66,10,0,76
BORZ,BH,151,5,2,0,7,50,7,1,58
"URVIŞ DE BEIUŞ",BH,503,51,7,0,58,155,23,0,178
"DUMBRĂVIŢA DE CODRU",BH,265,26,6,0,32,129,27,0,156
ŞUNCUIUŞ,BH,1385,81,17,50,148,379,53,50,482
BĂLNACA,BH,779,22,8,0,30,207,31,0,238
BĂLNACA-GROŞI,BH,55,6,5,0,11,31,14,0,45
"ZECE HOTARE",BH,291,12,9,0,21,97,34,0,131
TARCEA,BH,739,25,8,0,33,129,17,0,146
ADONI,BH,617,7,0,0,7,72,8,0,80
GALOŞPETREU,BH,772,10,4,0,14,71,7,0,78
"SATU NOU",BH,190,15,3,0,18,46,12,0,58
TĂMĂŞEU,BH,903,51,7,0,58,266,20,0,286
NIUVED,BH,194,10,4,0,14,42,7,0,49
PARHIDA,BH,405,21,5,0,26,83,20,0,103
TĂRCAIA,BH,917,76,4,0,80,338,11,0,349
TĂRCĂIŢA,BH,336,39,9,0,48,179,19,0,198
TOTORENI,BH,231,20,5,0,25,124,26,0,150
MIERAG,BH,167,19,3,0,22,107,12,0,119
CIUTELEC,BH,547,23,8,24,55,160,16,24,200
POIANA,BH,206,7,1,0,8,42,8,0,50
TĂUTEU,BH,921,17,0,0,17,99,7,0,106
BOGEI,BH,1172,49,4,0,53,279,13,0,292
CHIRIBIŞ,BH,637,24,0,1,25,145,12,1,158
TILEAGD,BH,3269,208,21,9,238,758,90,8,856
CĂLĂTANI,BH,156,19,13,0,32,62,20,0,82
BĂLAIA,BH,525,47,2,0,49,229,12,1,242
TILECUŞ,BH,676,87,19,0,106,276,54,5,335
POŞOLOACA,BH,330,17,3,0,20,69,7,0,76
"UILEACU DE CRIŞ",BH,689,16,3,0,19,110,14,0,124
TINCA,BH,3735,336,47,0,383,1211,171,55,1437
GURBEDIU,BH,913,79,6,0,85,287,30,7,324
"GIRIŞU NEGRU",BH,582,79,9,0,88,210,32,34,276
RÎPA,BH,448,33,12,0,45,174,51,1,226
BELFIR,BH,479,15,2,0,17,38,8,0,46
TOBOLIU,BH,775,28,8,0,36,137,28,0,165
CHERESIG,BH,930,53,9,13,75,153,20,13,186
TULCA,BH,1791,205,25,0,230,643,66,15,724
CĂUAŞD,BH,374,53,12,0,65,152,25,2,179
ŢEŢCHEA,BH,676,43,3,0,46,259,18,3,280
SUBPIATRĂ,BH,486,45,9,1,55,188,10,1,199
TELECHIU,BH,637,28,0,0,28,197,10,8,215
HOTAR,BH,719,23,11,0,34,193,28,1,222
FORĂU,BH,664,36,5,10,51,424,39,10,473
"UILEACU DE BEIUŞ",BH,507,22,4,0,26,177,29,0,206
PRISACA,BH,369,20,4,0,24,180,18,7,205
"VĂLANII DE BEIUŞ",BH,207,40,3,0,43,140,11,0,151
"VADU CRIŞULUI",BH,2329,160,11,0,171,612,47,0,659
TOMNATIC,BH,222,4,5,0,9,41,7,0,48
"TOPA DE CRIŞ",BH,356,38,10,0,48,146,17,0,163
BIRTIN,BH,293,21,2,0,23,126,11,0,137
VIIŞOARA,BH,876,31,2,0,33,307,15,0,322
IZVOARELE,BH,168,5,4,0,9,32,9,0,41
VÂRCIOROG,BH,870,57,11,0,68,285,39,0,324
FÂŞCA,BH,356,31,17,0,48,177,31,0,208
ŞERGHIŞ,BH,433,83,15,0,98,215,46,0,261
BISTRIŢA,BN,69000,4110,352,371,4833,12287,909,515,13711
UNIREA,BN,2777,174,18,0,192,714,71,0,785
SLĂTINIŢA,BN,623,13,1,0,14,153,5,0,158
GHINDA,BN,649,17,2,0,19,121,6,0,127
SIGMIR,BN,850,23,4,0,27,183,10,0,193
VIIŞOARA,BN,2347,67,3,0,70,381,29,1,411
SĂRATA,BN,962,11,7,0,18,104,21,0,125
BECLEAN,BN,8557,678,106,44,828,2233,224,50,2507
COLDĂU,BN,656,25,4,0,29,157,15,0,172
FIGA,BN,422,18,3,0,21,161,12,0,173
"RUSU DE JOS",BN,290,5,7,0,12,80,9,0,89
NĂSĂUD,BN,8272,464,30,26,520,1894,133,28,2055
"LIVIU REBREANU",BN,609,25,1,0,26,224,12,0,236
LUŞCA,BN,532,17,4,0,21,119,9,0,128
SÎNGEORZ-BĂI,BN,8062,350,83,0,433,2189,162,0,2351
CORMAIA,BN,683,51,7,0,58,283,14,0,297
"BISTRIŢA BÎRGĂULUI",BN,3393,77,8,0,85,750,38,0,788
COLIBIŢA,BN,248,3,1,0,4,58,26,0,84
BRANIŞTEA,BN,951,12,1,0,13,125,26,0,151
CIREŞOAIA,BN,1171,17,0,6,23,111,0,8,119
MĂLUŢ,BN,469,19,1,0,20,130,15,0,145
"BUDACU DE JOS",BN,767,17,1,0,18,185,11,0,196
BUDUŞ,BN,450,16,1,0,17,118,15,3,136
JELNA,BN,775,29,4,0,33,227,23,0,250
MONARIU,BN,414,36,5,0,41,148,23,0,171
SIMIONEŞTI,BN,175,11,7,0,18,64,22,0,86
BUDEŞTI,BN,483,31,2,0,33,129,20,0,149
BUDEŞTI-FÂNAŢE,BN,258,14,1,0,15,84,12,1,97
ŢAGU,BN,485,26,7,0,33,137,16,2,155
ŢĂGŞORU,BN,201,7,3,0,10,52,10,0,62
"CĂIANU MIC",BN,1230,83,17,28,128,484,29,32,545
"CĂIANU MARE",BN,468,37,7,0,44,216,20,9,245
DOBRIC,BN,1097,136,7,23,166,457,20,23,500
CICEU-POIENI,BN,567,116,21,0,137,286,53,19,358
"SATU NOU",BN,588,34,4,0,38,176,22,0,198
PETRIŞ,BN,1004,31,12,0,43,322,22,10,354
"ORHEIU BISTRIŢEI",BN,644,26,4,0,30,199,21,0,220
CHIOCHIŞ,BN,317,10,4,0,14,54,11,0,65
APATIU,BN,257,3,0,0,3,69,5,0,74
STRUGURENI,BN,160,2,2,0,4,22,7,0,29
BOZIEŞ,BN,528,16,2,0,18,79,7,0,86
CHEŢIU,BN,266,4,2,0,6,66,7,0,73
SÎNNICOARĂ,BN,91,3,5,0,8,33,13,0,46
ŢENTEA,BN,105,1,0,0,1,21,6,0,27
MANIC,BN,198,7,2,0,9,70,11,0,81
JIMBOR,BN,349,23,1,0,24,131,18,0,149
"BUZA CĂTUN",BN,95,1,0,0,1,30,7,0,37
CHIUZA,BN,739,31,5,0,36,269,13,0,282
SĂSARM,BN,552,27,7,0,34,147,29,0,176
PIATRA,BN,404,21,3,0,24,147,18,1,166
MIREŞ,BN,114,4,1,0,5,57,9,0,66
CICEU-MIHĂIEŞTI,BN,742,21,4,0,25,136,16,0,152
LELEŞTI,BN,119,4,3,0,7,44,21,0,65
CICEU-CORABIA,BN,111,10,10,0,20,34,28,0,62
CICEU-GIURGEŞTI,BN,752,64,11,0,75,246,32,29,307
DUMBRĂVENI,BN,522,28,7,0,35,169,24,15,208
COŞBUC,BN,1625,65,4,0,69,513,41,0,554
DUMITRA,BN,2380,67,3,0,70,382,19,0,401
CEPARI,BN,910,35,5,0,40,220,20,0,240
TĂRPIU,BN,752,24,1,0,25,136,21,0,157
DUMITRIŢA,BN,1022,44,1,0,45,225,20,2,247
"BUDACU DE SUS",BN,1496,22,0,0,22,256,8,0,264
FELDRU,BN,4658,204,24,0,228,1259,68,0,1327
NEPOS,BN,1518,154,0,0,154,493,27,2,522
"GALAŢII BISTRIŢEI",BN,558,25,0,0,25,176,25,1,202
DIPŞA,BN,687,22,3,0,25,208,21,0,229
HERINA,BN,436,16,2,0,18,119,19,1,139
"ALBEŞTII BISTRIŢEI",BN,127,5,10,0,15,33,18,0,51
TONCIU,BN,189,0,1,0,1,29,13,0,42
"ILVA MARE",BN,1969,109,4,51,164,712,31,62,805
"ILVA MICA",BN,2745,124,7,24,155,777,41,46,864
"JOSENII BÎRGĂULUI",BN,1698,52,4,0,56,465,24,0,489
"MIJLOCENII BÎRGĂULUI",BN,1393,33,4,0,37,230,20,0,250
"RUSU BÎRGĂULUI",BN,769,34,4,0,38,164,19,0,183
STRÎMBA,BN,354,30,9,0,39,125,20,0,145
LECHINŢA,BN,2378,89,7,8,104,527,50,14,591
"SÎNGEORZU NOU",BN,808,26,5,0,31,141,13,0,154
CHIRALEŞ,BN,413,27,3,0,30,121,35,2,158
SÎNIACOB,BN,182,12,3,0,15,86,16,8,110
ŢIGĂU,BN,363,17,3,0,20,98,7,2,107
VERMEŞ,BN,738,25,0,0,25,223,0,0,223
LEŞU,BN,1366,54,1,0,55,317,22,0,339
"LUNCA LEŞULUI",BN,916,11,3,0,14,130,11,11,152
LIVEZILE,BN,2433,98,13,0,111,513,33,2,548
DOROLEA,BN,560,35,3,0,38,139,11,0,150
CUŞMA,BN,520,17,10,7,34,145,16,7,168
"VALEA POENII",BN,126,20,6,0,26,72,11,0,83
DUMBRAVA,BN,330,26,5,0,31,136,10,0,146
"LUNCA ILVEI",BN,2686,85,1,0,86,447,8,0,455
MAIERU,BN,4770,317,9,25,351,1924,26,40,1990
ANIEŞ,BN,1460,42,1,0,43,435,5,0,440
MATEI,BN,590,6,0,0,6,55,6,1,62
BIDIU,BN,166,11,1,0,12,56,6,0,62
CORVINEŞTI,BN,540,19,2,0,21,162,14,0,176
ENCIU,BN,145,11,4,0,15,56,15,1,72
FÎNTÎNELE,BN,473,13,3,0,16,91,24,0,115
MORUŢ,BN,167,10,2,0,12,51,9,0,60
"MĂGURA ILVEI",BN,1389,50,0,0,50,460,16,0,476
ARŞIŢA,BN,346,5,6,0,11,97,12,0,109
MĂGURELE,BN,531,10,6,0,16,93,19,0,112
DOMNEŞTI,BN,715,27,4,0,31,215,35,0,250
BÎRLA,BN,286,18,6,0,24,128,16,0,144
SÎNTIOANA,BN,389,12,2,0,14,115,6,0,121
JEICA,BN,87,2,3,0,5,10,14,0,24
"MICEŞTII DE CÎMPIE",BN,252,12,7,0,19,83,24,0,107
FÎNTÎNIŢA,BN,301,9,4,0,13,49,8,0,57
VISUIA,BN,322,11,5,0,16,48,10,0,58
MILAŞ,BN,591,21,3,0,24,142,33,0,175
OROSFAIA,BN,305,18,2,0,20,92,14,0,106
COMLOD,BN,113,8,4,0,12,25,17,0,42
MONOR,BN,699,35,7,0,42,217,23,0,240
GLEDIN,BN,420,27,0,0,27,163,14,0,177
NEGRILEŞTI,BN,1035,62,17,0,79,320,62,7,389
PURCĂRETE,BN,175,9,10,0,19,80,15,0,95
BREAZA,BN,804,17,0,0,17,192,5,0,197
"NIMIGEA DE JOS",BN,1312,30,2,0,32,227,14,0,241
MOCOD,BN,493,25,5,0,30,144,15,0,159
MITITEI,BN,593,18,2,0,20,185,16,0,201
"NIMIGEA DE SUS",BN,479,28,7,0,35,193,20,0,213
MINTIU,BN,349,21,0,0,21,129,26,0,155
TĂURE,BN,352,19,7,0,26,100,14,0,114
MOGOŞENI,BN,290,7,4,0,11,93,9,0,102
FLOREŞTI,BN,392,10,0,0,10,121,12,0,133
NUŞENI,BN,733,44,53,28,125,270,95,52,417
BEUDIU,BN,470,16,1,0,17,241,26,14,281
FELEAC,BN,267,11,4,0,15,104,15,0,119
MALIN,BN,356,18,1,0,19,113,28,2,143
"RUSU DE SUS",BN,243,8,7,0,15,94,17,0,111
VIŢA,BN,302,8,7,0,15,71,20,3,94
PARVA,BN,1928,108,2,0,110,697,25,7,729
RETEAG,BN,2192,101,5,0,106,487,20,0,507
BAŢA,BN,706,15,1,0,16,133,6,0,139
"POIANA ILVEI",BN,1259,40,1,12,53,430,23,25,478
"PRUNDU BÎRGĂULUI",BN,4130,143,16,0,159,793,66,0,859
"SUSENII BÎRGĂULUI",BN,1147,17,6,22,45,206,26,22,254
REBRA,BN,2062,90,9,0,99,513,17,0,530
REBRIŞOARA,BN,3111,206,7,1,214,845,35,1,881
"GERSA I",BN,577,19,0,0,19,116,7,0,123
"GERSA II",BN,147,6,7,0,13,40,9,0,49
RODNA,BN,4847,206,22,0,228,993,45,2,1040
"VALEA VINULUI",BN,161,6,1,0,7,39,5,0,44
ROMULI,BN,1030,32,1,0,33,352,19,18,389
"DEALU ŞTEFĂNIŢEI",BN,344,15,1,0,16,122,6,12,140
"RUNCU SALVEI",BN,1055,21,4,0,25,146,13,0,159
SALVA,BN,2351,130,5,0,135,711,31,28,770
"SILIVAŞU DE CÎMPIE",BN,798,15,2,0,17,105,15,0,120
"SÎNMIHAIU DE CÎMPIE",BN,543,29,12,0,41,185,64,6,255
BRĂTENI,BN,64,7,5,0,12,44,17,1,62
SĂLCUŢA,BN,96,9,5,0,14,36,18,3,57
STUPINI,BN,170,8,2,0,10,79,23,3,105
ZORENI,BN,242,23,3,0,26,83,13,1,97
SPERMEZEU,BN,1429,86,13,0,99,717,46,0,763
SITA,BN,251,15,1,0,16,113,7,0,120
HĂLMĂSĂU,BN,230,12,2,0,14,139,4,0,143
DUMBRĂVIŢA,BN,648,26,6,0,32,224,18,0,242
DOBRICEL,BN,446,28,6,0,34,240,23,0,263
ŞANŢ,BN,2425,331,9,0,340,1373,27,20,1420
"VALEA MARE",BN,258,33,7,0,40,194,13,8,215
ŞIEU,BN,1084,20,0,0,20,172,11,0,183
ARDAN,BN,591,7,0,0,7,46,2,0,48
POSMUŞ,BN,549,17,3,0,20,111,10,0,121
ŞOIMUŞ,BN,127,6,2,0,8,55,10,0,65
ŞIEU-MĂGHERUŞ,BN,985,27,3,0,30,171,21,0,192
CHINTELNIC,BN,546,16,2,0,18,157,26,0,183
CRAINIMĂT,BN,816,28,4,0,32,134,19,0,153
SĂRĂŢEL,BN,481,7,0,0,7,63,13,0,76
ARCALIA,BN,738,25,9,0,34,211,25,0,236
ŞIEU-ODORHEI,BN,601,15,0,0,15,134,16,0,150
"AGRIŞU DE JOS",BN,295,10,2,0,12,111,12,0,123
"AGRIŞU DE SUS",BN,142,11,3,0,14,66,17,0,83
BRETEA,BN,135,4,6,0,10,53,24,0,77
COASTA,BN,161,8,4,0,12,56,10,0,66
CRISTUR-ŞIEU,BN,401,20,3,0,23,142,25,0,167
ŞIRIOARA,BN,202,8,6,0,14,63,23,0,86
ŞIEUŢ,BN,582,34,8,0,42,208,22,0,230
RUŞTIOR,BN,494,14,6,0,20,171,12,0,183
SEBIŞ,BN,686,18,4,0,22,139,7,0,146
LUNCA,BN,310,20,0,0,20,106,11,0,117
ŞINTEREAG,BN,845,37,16,0,53,208,35,3,246
CAILA,BN,258,15,4,0,19,80,16,0,96
COCIU,BN,896,43,2,0,45,295,10,0,305
"BLĂJENII DE JOS",BN,301,5,1,0,6,110,18,0,128
"BLĂJENII DE SUS",BN,318,15,8,0,23,94,29,0,123
ŞIEU-SFÎNTU,BN,394,26,4,0,30,127,23,0,150
ARCHIUD,BN,455,15,1,0,16,99,8,0,107
BUDURLENI,BN,79,10,7,0,17,39,17,0,56
OCNIŢA,BN,839,15,6,0,21,163,13,0,176
PINTICU,BN,628,22,1,0,23,87,12,0,99
TEACA,BN,1674,37,12,0,49,222,28,0,250
"VIILE TECII",BN,835,21,3,0,24,110,18,0,128
TELCIU,BN,3150,91,12,0,103,676,52,1,729
TELCIŞOR,BN,866,35,0,0,35,303,10,0,313
FIAD,BN,174,1,7,0,8,34,18,0,52
BICHIGIU,BN,670,25,0,0,25,152,5,0,157
"TIHA BÎRGĂULUI",BN,1366,18,7,0,25,214,30,0,244
TUREAC,BN,2102,30,18,0,48,313,43,0,356
"MUREŞENII BÎRGĂULUI",BN,1349,30,7,0,37,304,28,0,332
"PIATRA FÎNTÎNELE",BN,321,23,6,0,29,90,31,0,121
TÎRLIŞUA,BN,1031,37,7,0,44,251,31,36,318
BORLEASA,BN,312,25,2,0,27,147,11,7,165
"LUNCA SĂTEASCA",BN,464,16,6,0,22,83,10,0,93
AGRIEŞ,BN,770,18,7,0,25,255,21,10,286
MOLIŞET,BN,177,7,4,0,11,84,7,4,95
URIU,BN,1225,44,3,0,47,263,12,0,275
"CRISTEŞTII CICEULUI",BN,989,66,7,0,73,310,28,0,338
ILIŞUA,BN,594,36,1,0,37,152,12,0,164
"HĂŞMAŞU CICEULUI",BN,193,7,4,0,11,56,22,0,78
URMENIŞ,BN,749,19,6,0,25,132,22,0,154
ŞOPTERIU,BN,302,3,4,0,7,32,9,0,41
DELURENI,BN,257,8,8,0,16,33,14,0,47
FÎNAŢE,BN,157,8,4,0,12,45,9,0,54
ZAGRA,BN,877,48,0,0,48,456,8,0,464
"POIENILE ZAGREI",BN,703,40,0,3,43,295,15,0,310
SUPLAI,BN,507,25,6,0,31,201,10,0,211
PERIŞOR,BN,436,11,0,0,11,183,5,0,188
ALUNIŞUL,BN,185,30,5,0,35,117,14,0,131
BRĂILA,BR,175287,11315,523,397,12235,30618,1227,468,32313
FĂUREI,BR,3341,199,13,0,212,597,37,19,653
IANCA,BR,5483,241,18,0,259,1075,75,0,1150
PLOPU,BR,1224,51,7,0,58,191,20,0,211
OPRIŞENEŞTI,BR,650,45,3,0,48,200,14,0,214
PERIŞORU,BR,877,101,5,0,106,348,22,2,372
"TÎRLELE FILIU",BR,447,26,4,0,30,103,21,0,124
BERLEŞTI,BR,268,34,4,0,38,79,8,0,87
ÎNSURĂŢEI,BR,5399,167,24,0,191,645,66,0,711
"LACU REZII",BR,385,28,3,0,31,104,7,0,111
BĂRĂGANUL,BR,2568,115,18,0,133,366,49,0,415
"BERTEŞTII DE JOS",BR,697,70,1,0,71,194,21,0,215
"SPIRU HARET",BR,1242,46,5,0,51,183,12,0,195
"BERTEŞTII DE SUS",BR,274,36,6,0,42,82,15,0,97
"GURA CĂLMĂŢUI",BR,266,47,6,0,53,129,21,0,150
"BORDEI VERDE",BR,1112,65,5,0,70,337,26,0,363
"CONSTANTIN GABRIELESCU",BR,537,50,2,0,52,138,3,0,141
LIŞCOTEANCA,BR,440,23,3,0,26,101,11,0,112
CAZASU,BR,2943,87,14,0,101,439,51,0,490
CHIŞCANI,BR,3391,145,12,0,157,527,37,0,564
"LACU SĂRAT",BR,1781,67,13,0,80,257,31,0,288
CIOCILE,BR,1600,49,5,0,54,291,24,0,315
CHICHINEŢU,BR,448,37,9,0,46,87,21,0,108
CIREŞU,BR,744,31,6,0,37,139,21,0,160
BATOGU,BR,532,40,4,0,44,122,14,0,136
SCĂRLĂTEŞTI,BR,684,30,0,0,30,197,7,0,204
VULTURENI,BR,468,40,4,0,44,159,20,0,179
DUDEŞTI,BR,1342,36,5,0,41,198,17,0,215
TĂTARU,BR,1546,70,11,0,81,265,41,0,306
AGAUA,BR,427,19,2,0,21,93,8,0,101
FRECĂŢEI,BR,298,24,6,0,30,104,17,0,121
TITCOV,BR,382,26,2,0,28,133,7,0,140
GALBENU,BR,759,33,10,0,43,234,24,0,258
SĂTUC,BR,573,23,5,0,28,175,18,0,193
ZAMFIREŞTI,BR,300,18,5,0,23,89,12,0,101
DROGU,BR,670,50,10,0,60,224,31,0,255
PÎNTECANI,BR,143,13,3,0,16,41,10,0,51
GEMENELE,BR,1454,92,4,0,96,397,25,0,422
GRADIŞTEA,BR,1001,72,12,0,84,231,28,0,259
IBRIANU,BR,515,26,8,0,34,90,13,0,103
MARALOIU,BR,232,32,8,0,40,94,19,0,113
GROPENI,BR,2804,112,10,0,122,394,32,0,426
JIRLĂU,BR,2540,55,8,0,63,374,37,0,411
MĂRAŞU,BR,775,19,11,0,30,105,21,0,126
BĂNDOIU,BR,345,25,2,0,27,63,5,0,68
ŢĂCĂU,BR,570,14,3,0,17,59,7,0,66
MĂGURENI,BR,436,9,6,0,15,41,9,0,50
PLOPI,BR,149,11,3,0,14,34,3,0,37
MĂXINENI,BR,1223,36,13,0,49,207,26,0,233
"CORBU NOU",BR,693,52,3,0,55,167,13,23,203
"CORBU VECHI",BR,233,31,0,0,31,84,5,5,94
LATINU,BR,607,20,0,0,20,62,15,0,77
"MIRCEA VODĂ",BR,1965,75,6,0,81,349,33,0,382
DEDULEŞTI,BR,706,52,3,0,55,186,22,0,208
"MOVILA MIRESII",BR,2327,298,33,0,331,975,87,0,1062
"ŢEPEŞ VODĂ",BR,770,50,6,0,56,224,20,0,244
ESNA,BR,258,67,3,0,70,124,11,0,135
RACOVIŢĂ,BR,879,48,3,0,51,157,18,0,175
RÎMNICELU,BR,1128,59,12,0,71,202,25,0,227
CONSTANTINEŞTI,BR,259,15,4,0,19,92,12,0,104
"MIHAIL KOGĂLNICEANU",BR,208,41,8,0,49,85,15,0,100
ROMANU,BR,1153,33,3,0,36,271,34,0,305
OANCEA,BR,321,24,12,0,36,83,21,0,104
ROŞIORI,BR,1277,63,8,0,71,247,36,0,283
COLŢEA,BR,851,36,1,0,37,96,11,0,107
"SALCIA TUDOR",BR,607,21,9,0,30,128,18,3,149
"CUZA VODĂ",BR,705,40,4,0,44,205,23,0,228
GULIANCA,BR,322,12,2,0,14,42,9,0,51
OLĂNEASCA,BR,345,38,0,0,38,99,8,0,107
ARICIU,BR,134,15,4,1,20,35,7,1,43
"SCORŢARU NOU",BR,694,21,4,0,25,106,27,0,133
SIHLEANU,BR,381,27,2,0,29,91,7,0,98
SILIŞTEA,BR,870,40,0,0,40,229,41,0,270
MUCHEA,BR,337,43,11,0,54,117,25,0,142
"COTU LUNG",BR,262,21,1,0,22,92,26,0,118
STĂNCUŢA,BR,1251,113,5,0,118,409,18,0,427
"CUZA VODĂ",BR,1208,39,5,0,44,365,10,0,375
STANCA,BR,362,34,9,0,43,109,25,0,134
SURDILA-GĂISEANCA,BR,1349,160,9,0,169,523,38,0,561
FILIPEŞTI,BR,649,80,14,0,94,202,35,0,237
SURDILA-GRECI,BR,602,81,4,0,85,190,13,0,203
"FĂUREI SAT",BR,284,25,9,0,34,84,12,0,96
HORIA,BR,327,41,3,0,44,143,16,0,159
ŞUŢEŞTI,BR,3311,99,10,0,109,438,49,0,487
"MIHAIL KOGĂLNICEANU",BR,297,14,1,0,15,51,13,0,64
TICHILEŞTI,BR,2803,110,13,107,230,462,28,107,597
ALBINA,BR,255,11,5,0,16,36,20,0,56
TRAIAN,BR,935,36,3,0,39,133,15,0,148
SILISTRARU,BR,615,17,0,0,17,123,0,0,123
URLEASCA,BR,1021,19,4,0,23,113,12,0,125
CĂLDĂRUŞA,BR,162,20,0,0,20,44,3,0,47
"TUDOR VLADIMIRESCU",BR,819,21,2,0,23,76,16,0,92
"SCORŢARU VECHI",BR,774,87,8,0,95,200,36,0,236
COMĂNEASCA,BR,172,30,6,0,36,71,12,0,83
TUFEŞTI,BR,4249,190,29,0,219,788,93,0,881
ULMU,BR,2286,101,9,0,110,450,33,0,483
JUGUREANU,BR,814,24,4,0,28,127,18,0,145
UNIREA,BR,885,53,11,1,65,185,24,1,210
"VALEA CÎNEPII",BR,1048,46,10,0,56,111,27,0,138
VĂDENI,BR,1944,52,8,0,60,206,25,0,231
BALDOVINEŞTI,BR,973,30,0,0,30,113,15,0,128
PIETROIU,BR,432,7,0,0,7,52,3,0,55
VICTORIA,BR,1718,77,4,0,81,373,16,0,389
"MIHAI BRAVU",BR,1225,42,1,0,43,157,8,0,165
VIŞANI,BR,1434,40,6,0,46,221,35,0,256
CÎINENI-BĂI,BR,484,24,4,0,28,108,24,0,132
VIZIRU,BR,3196,161,19,0,180,599,106,0,705
LANURILE,BR,1804,48,0,0,48,217,16,0,233
ZĂVOAIA,BR,1899,109,12,0,121,722,43,0,765
DUDESCU,BR,621,27,9,0,36,156,24,0,180
BOTOŞANI,BT,100135,6689,465,615,7769,21757,1236,997,23990
DOROHOI,BT,24955,1679,101,1,1781,5810,302,42,6154
"LOTURI ENESCU",BT,339,20,7,0,27,108,12,0,120
BUCECEA,BT,3892,288,35,0,323,1029,86,28,1143
CĂLINEŞTI,BT,546,32,4,0,36,121,15,1,137
DARABANI,BT,8619,198,24,8,230,1590,99,9,1698
BAJURA,BT,1523,34,4,0,38,251,13,0,264
LISMĂNIŢA,BT,553,17,4,0,21,147,11,0,158
EŞANCA,BT,265,12,4,0,16,46,16,0,62
FLAMÂNZI,BT,3713,81,23,5,109,666,72,5,743
POIANA,BT,1437,16,5,0,21,324,19,0,343
"NICOLAE BĂLCESCU",BT,3187,106,10,38,154,705,76,46,827
CHIŢOVENI,BT,425,20,4,0,24,130,14,0,144
PRISĂCANI,BT,505,31,2,0,33,202,13,0,215
SĂVENI,BT,4936,230,60,3,293,1323,201,40,1564
PETRICANI,BT,1008,43,8,0,51,271,44,0,315
BODEASA,BT,341,17,4,0,21,160,18,0,178
BOZIENI,BT,219,12,7,0,19,85,21,0,106
BOBULEŞTI,BT,1183,31,10,0,41,233,25,0,258
BĂDIUŢI,BT,807,57,5,0,62,224,19,0,243
ŞTEFĂNEŞTI,BT,2050,75,15,42,132,385,57,42,484
STÂNCA,BT,760,63,4,0,67,222,29,3,254
ADĂŞENI,BT,803,36,4,0,40,260,17,0,277
ZOIŢANI,BT,318,21,10,0,31,128,22,0,150
ALBEŞTI,BT,1567,60,9,0,69,345,37,0,382
BUIMĂCENI,BT,596,15,5,0,20,88,15,0,103
COŞTIUGENI,BT,446,13,2,0,15,119,16,0,135
JIJIA,BT,503,13,1,0,14,69,11,0,80
MĂŞCĂTENI,BT,304,21,4,0,25,95,8,0,103
"TUDOR VLADIMIRESCU",BT,1397,133,25,0,158,356,37,0,393
AVRĂMENI,BT,1148,18,2,0,20,211,16,0,227
PANAITOAIA,BT,561,33,2,0,35,194,6,0,200
"TUDOR VLADIMIRESCU",BT,578,53,6,0,59,212,21,0,233
"AUREL VLAICU",BT,468,15,3,0,18,104,6,0,110
ICHIMENI,BT,106,17,5,0,22,40,9,0,49
BĂLUŞENI,BT,1128,55,11,0,66,335,35,0,370
"BĂLUŞENII NOI",BT,262,32,5,0,37,88,8,0,96
BUZENI,BT,542,33,5,0,38,133,29,2,164
DRAXINI,BT,1526,61,19,0,80,347,51,0,398
ZĂICEŞTI,BT,570,44,10,0,54,120,25,0,145
BLÂNDEŞTI,BT,622,30,3,0,33,277,31,8,316
CERCHEJENI,BT,646,71,8,0,79,290,38,9,337
ŞOLDĂNEŞTI,BT,333,20,3,0,23,103,13,0,116
BRĂEŞTI,BT,1139,56,13,0,69,236,39,0,275
POIANA,BT,354,16,3,0,19,102,14,14,130
POPENI,BT,208,23,3,0,26,88,8,0,96
BROSCĂUŢI,BT,2821,108,11,0,119,529,40,0,569
CĂLĂRAŞI,BT,1866,38,13,0,51,400,43,0,443
PLEŞANI,BT,497,10,0,0,10,161,25,0,186
LIBERTATEA,BT,371,13,2,0,15,61,5,0,66
CÂNDEŞTI,BT,853,52,11,5,68,278,46,14,338
TALPA,BT,549,59,9,0,68,231,24,1,256
VIŢCANI,BT,271,23,8,0,31,128,17,0,145
CONCEŞTI,BT,1223,109,9,0,118,427,27,0,454
MOVILENI,BT,262,24,8,0,32,109,12,0,121
COPĂLĂU,BT,2230,93,6,34,133,619,31,37,687
COTU,BT,496,11,1,7,19,99,11,7,117
CERBU,BT,645,37,5,0,42,248,17,18,283
CORDĂRENI,BT,767,70,13,0,83,397,52,0,449
GRIVIŢA,BT,389,18,11,0,29,219,26,0,245
SLOBOZIA,BT,278,73,7,0,80,168,18,6,192
CORLĂTENI,BT,519,31,6,0,37,117,18,0,135
CARASA,BT,443,51,4,0,55,143,28,0,171
VLĂDENI,BT,364,18,6,0,24,92,15,0,107
PODENI,BT,331,19,3,0,22,89,7,0,96
CORNI,BT,3269,105,8,0,113,670,42,0,712
SARAFINEŞTI,BT,1189,51,5,0,56,351,18,0,369
MESTEACĂN,BT,350,30,7,0,37,154,36,0,190
"BALTA ARSĂ",BT,335,32,12,0,44,103,28,0,131
COŞULA,BT,985,24,4,0,28,233,33,0,266
BUDA,BT,247,11,4,0,15,61,14,0,75
PĂDURENI,BT,484,20,0,0,20,148,2,0,150
ŞUPITCA,BT,660,47,2,0,49,204,21,0,225
COŢUŞCA,BT,1498,35,3,0,38,189,13,0,202
GHIRENI,BT,507,13,7,0,20,66,13,0,79
"COTU MICULINŢI",BT,320,16,9,0,25,58,20,0,78
CRASNALEUCA,BT,476,23,10,0,33,133,20,0,153
PUŢURENI,BT,449,19,4,0,23,74,12,0,86
NICHITENI,BT,708,37,3,0,40,165,13,0,178
CRISTEŞTI,BT,1900,54,18,0,72,443,68,16,527
ONEAGA,BT,1155,33,4,0,37,362,18,0,380
SCHIT-ORĂŞENI,BT,467,11,2,0,13,98,13,0,111
CRISTINEŞTI,BT,1221,43,8,0,51,212,48,0,260
DRAGALINA,BT,524,15,1,0,16,118,28,0,146
"FUNDU HERŢII",BT,611,37,6,0,43,183,24,0,207
BARANCA,BT,495,14,8,0,22,127,13,0,140
CURTEŞTI,BT,1027,49,11,0,60,235,25,0,260
AGAFTON,BT,219,34,30,0,64,86,34,0,120
BĂICENI,BT,743,38,2,0,40,196,27,0,223
"MĂNĂSTIREA DOAMNEI",BT,976,49,10,0,59,210,24,2,236
ORĂŞENI-DEAL,BT,954,35,5,0,40,262,19,0,281
ORĂŞENI-VALE,BT,552,30,6,0,36,173,29,0,202
DERSCA,BT,2518,92,11,0,103,742,54,14,810
MATEIENI,BT,194,12,5,0,17,70,11,8,89
DIMĂCHENI,BT,827,41,13,0,54,225,40,28,293
DÎNGENI,BT,602,24,3,3,30,134,13,5,152
HULUB,BT,438,25,5,0,30,171,20,0,191
IACOBENI,BT,830,35,6,0,41,213,39,0,252
STRAHOTIN,BT,420,16,7,0,23,75,8,0,83
DOBÂRCENI,BT,667,12,6,0,18,143,14,0,157
BIVOLARI,BT,141,11,4,0,15,35,8,0,43
BRĂTENI,BT,518,26,2,0,28,141,20,0,161
CIŞMĂNEŞTI,BT,325,64,8,0,72,155,20,0,175
LIVADA,BT,383,17,3,0,20,94,7,0,101
DRĂGUŞENI,BT,1270,31,3,0,34,241,13,0,254
PODRIGA,BT,769,24,6,0,30,252,24,0,276
SARATA-DRĂGUŞENI,BT,104,11,6,0,17,45,10,0,55
DURNEŞTI,BT,938,35,3,0,38,232,26,0,258
CUCUTENI,BT,673,61,7,0,68,227,20,0,247
GURANDA,BT,892,43,12,0,55,181,24,0,205
BĂBICENI,BT,584,26,3,0,29,102,17,0,119
FRUMUŞICA,BT,646,46,2,0,48,197,15,0,212
STOREŞTI,BT,849,45,0,0,45,190,10,0,200
ŞENDRENI,BT,564,23,7,0,30,179,25,0,204
VLĂDENI-DEAL,BT,1271,34,4,0,38,322,17,0,339
BOSCOTENI,BT,526,23,5,0,28,142,15,0,157
RĂDENI,BT,782,85,3,0,88,297,20,0,317
DUMENI,BT,1436,51,3,0,54,384,55,0,439
ARBOREA,BT,345,27,7,0,34,117,19,0,136
POPENI,BT,410,23,7,0,30,119,24,0,143
STÎNCA,BT,294,32,3,0,35,92,9,0,101
GORBĂNEŞTI,BT,818,36,3,1,40,261,23,1,285
BĂTRÎNEŞTI,BT,215,5,5,0,10,59,21,0,80
"GEORGE COŞBUC",BT,192,15,4,0,19,75,12,0,87
SOCRUJENI,BT,627,22,3,0,25,147,19,0,166
VÎNĂTORI,BT,485,28,4,0,32,163,15,0,178
SILIŞCANI,BT,273,16,9,0,25,100,16,5,121
HAVÎRNA,BT,2636,95,11,0,106,543,54,2,599
BALINŢI,BT,405,13,2,0,15,62,12,0,74
TĂTĂRĂŞENI,BT,642,27,4,0,31,159,13,0,172
HĂNEŞTI,BT,1018,51,3,0,54,226,31,0,257
SARATA-BASARAB,BT,330,13,1,0,14,113,8,0,121
BOROLEA,BT,302,33,3,0,36,144,16,0,160
HILIŞEU-HORIA,BT,595,18,9,0,27,145,27,0,172
HILIŞEU-CRIŞAN,BT,1095,24,1,0,25,245,21,0,266
HILIŞEU-CLOŞCA,BT,520,20,7,0,27,125,21,0,146
HLIPICENI,BT,1354,72,9,0,81,340,53,0,393
DRAGALINA,BT,301,19,11,0,30,93,18,0,111
VICTORIA,BT,1111,23,0,0,23,258,15,0,273
HUDEŞTI,BT,926,29,3,0,32,261,26,1,288
VATRA,BT,897,31,9,0,40,233,25,0,258
ALBA,BT,1155,46,5,0,51,342,17,2,361
MLENĂUŢI,BT,602,54,8,0,62,262,32,0,294
BAŞEU,BT,401,24,11,0,35,112,20,0,132
BARANCA,BT,846,22,5,0,27,260,17,0,277
DUMBRĂVIŢA,BT,1435,123,15,0,138,507,46,0,553
IBĂNEŞTI,BT,1695,134,15,0,149,624,96,0,720
LEORDA,BT,1144,33,18,0,51,258,55,0,313
COSTINEŞTI,BT,171,15,6,0,21,62,18,0,80
LOZNA,BT,824,24,10,0,34,250,28,0,278
STRĂTENI,BT,712,37,5,0,42,257,18,0,275
LUNCA,BT,1276,67,19,0,86,365,93,5,463
STROIEŞTI,BT,691,23,8,0,31,127,17,0,144
ZLĂTUNOAIA,BT,1450,42,10,23,75,504,84,24,612
MANOLEASA,BT,487,9,4,0,13,97,15,1,113
FLONDORA,BT,433,33,3,0,36,122,12,0,134
SADOVENI,BT,368,22,6,0,28,149,19,0,168
ZAHORENI,BT,449,17,9,0,26,134,16,0,150
LIVENI,BT,540,11,9,0,20,151,27,0,178
LOTURI,BT,139,9,7,0,16,61,9,0,70
MANOLEASA-PRUT,BT,122,7,1,0,8,26,21,0,47
IPOTEŞTI,BT,503,9,4,0,13,101,16,0,117
CUCORĂNI,BT,674,22,5,0,27,145,19,0,164
CERVICEŞTI,BT,714,67,12,11,90,319,39,11,369
CĂTĂMĂREŞTI-DEAL,BT,2803,199,19,11,229,780,79,11,870
STÎNCEŞTI,BT,1351,74,3,0,77,345,31,0,376
CĂTĂMĂREŞTI,BT,514,26,5,0,31,120,27,0,147
MIHĂILENI,BT,1215,32,6,0,38,313,51,15,379
ROGOJEŞTI,BT,448,23,7,0,30,160,24,12,196
"PÂRÂU NEGRU",BT,411,40,12,0,52,115,17,4,136
MIHĂLĂŞENI,BT,624,18,3,0,21,138,9,0,147
SARATA,BT,403,20,1,0,21,85,10,0,95
NEGREŞTI,BT,381,10,6,0,16,108,15,0,123
NĂSTASE,BT,339,11,11,0,22,63,23,0,86
MILEANCA,BT,1293,45,4,0,49,310,23,0,333
CODRENI,BT,271,4,4,0,8,26,5,0,31
SCUTARI,BT,230,4,8,0,12,39,8,0,47
SELIŞTEA,BT,319,7,6,0,13,86,12,0,98
MITOC,BT,964,20,8,0,28,171,19,0,190
HORIA,BT,400,6,2,0,8,119,12,0,131
NICŞENI,BT,760,20,7,0,27,212,23,0,235
DOROBANŢI,BT,1251,32,2,0,34,340,29,0,369
DACIA,BT,125,13,8,0,21,62,15,0,77
PĂLTINIŞ,BT,1942,58,22,0,80,373,79,0,452
CUZLĂU,BT,357,17,4,0,21,84,13,0,97
HORODIŞTEA,BT,593,27,17,0,44,169,73,0,242
POMÎRLA,BT,1845,52,6,0,58,304,36,0,340
RACOVĂŢ,BT,278,22,6,0,28,105,19,0,124
PRĂJENI,BT,998,41,5,0,46,210,13,0,223
CÎMPENI,BT,507,22,3,0,25,124,12,0,136
LUPĂRIA,BT,589,30,2,0,32,238,10,0,248
MILETIN,BT,468,20,4,0,24,141,9,0,150
RĂCHIŢI,BT,1002,67,7,16,90,355,37,16,408
COSTEŞTI,BT,1258,26,6,0,32,263,29,0,292
ROŞIORI,BT,1190,63,2,0,65,315,12,0,327
RĂDĂUŢI-PRUT,BT,767,26,7,0,33,127,22,0,149
REDIU,BT,732,38,4,0,42,200,39,0,239
MIORCANI,BT,1442,35,7,0,42,183,29,0,212
RĂUSENI,BT,1070,19,0,0,19,150,21,0,171
DOINA,BT,428,15,0,0,15,204,16,0,220
REDIU,BT,430,32,6,0,38,118,20,0,138
STOLNICENI,BT,157,18,5,0,23,49,9,0,58
RIPICENI,BT,3593,33,11,0,44,215,29,0,244
ROMA,BT,2361,107,10,0,117,522,56,21,599
COTÎRGACI,BT,614,15,4,0,19,92,21,4,117
ROMÂNEŞTI,BT,1129,31,5,0,36,284,32,0,316
DĂMIDENI,BT,482,13,9,0,22,69,9,0,78
"SANTA MARE",BT,1000,20,1,0,21,108,22,0,130
BERZA,BT,179,8,0,0,8,49,3,0,52
BOGDĂNEŞTI,BT,309,7,3,0,10,82,12,0,94
RÎNGHILEŞTI,BT,297,10,3,0,13,65,16,0,81
ILIŞENI,BT,324,19,1,0,20,62,8,0,70
STĂUCENI,BT,1104,19,3,0,22,191,17,1,209
SILIŞTEA,BT,414,32,4,0,36,115,10,2,127
VICTORIA,BT,521,30,4,0,34,154,22,0,176
TOCILENI,BT,896,30,6,0,36,163,17,1,181
SUHARĂU,BT,1557,48,8,12,68,433,67,12,512
LIŞNA,BT,725,25,3,0,28,192,23,0,215
OROFTIANA,BT,743,12,4,0,16,132,29,0,161
SMÎRDAN,BT,633,23,2,0,25,192,31,1,224
SULIŢA,BT,1326,40,8,0,48,225,22,0,247
DRACŞANI,BT,1170,29,5,0,34,244,23,0,267
ŞENDRICENI,BT,1891,42,8,4,54,450,53,13,516
HORLĂCENI,BT,473,16,9,0,25,106,21,0,127
PĂDURENI,BT,881,21,3,1,25,126,9,1,136
ŞTIUBIENI,BT,1424,71,12,0,83,349,40,11,400
NEGRENI,BT,650,29,6,0,35,203,24,0,227
TODIRENI,BT,1686,91,9,0,100,336,39,1,376
CERNEŞTI,BT,671,55,14,0,69,248,29,0,277
IUREŞTI,BT,442,24,4,0,28,102,16,0,118
TRUŞEŞTI,BT,2081,103,8,0,111,477,30,22,529
BUHĂCENI,BT,640,31,3,0,34,152,14,0,166
DRISLEA,BT,839,28,7,0,35,124,22,0,146
IONĂŞENI,BT,788,16,3,0,19,126,26,0,152
TUDORA,BT,3965,68,21,47,136,826,86,47,959
UNGURENI,BT,2232,58,8,0,66,289,37,0,326
"MIHAI VITEAZU",BT,388,21,3,0,24,168,13,4,185
BORZEŞTI,BT,1106,31,7,0,38,217,18,0,235
"PLOPENII MARI",BT,805,36,4,0,40,203,30,0,233
CĂLUGĂRENI,BT,589,17,3,0,20,107,15,0,122
UNŢENI,BT,989,58,5,0,63,243,21,0,264
MÎNĂSTIRENI,BT,654,23,8,0,31,97,18,0,115
BURLEŞTI,BT,553,13,5,0,18,201,41,0,242
VĂCULEŞTI,BT,877,33,13,0,46,274,36,15,325
SAUCENIŢA,BT,770,38,4,0,42,218,22,23,263
GOROVEI,BT,29,7,10,0,17,20,17,0,37
MAGHERA,BT,642,31,6,0,37,186,43,0,229
"VÂRFU CÂMPULUI",BT,1519,35,9,0,44,272,27,0,299
IONĂŞENI,BT,703,23,4,0,27,215,26,0,241
LUNCA,BT,545,92,23,0,115,287,78,0,365
VIIŞOARA,BT,715,28,2,0,30,171,18,0,189
"CUZA VODĂ",BT,444,19,2,0,21,107,18,0,125
"VIIŞOARA MICĂ",BT,399,11,1,0,12,87,15,0,102
VLĂDENI,BT,1479,62,19,0,81,414,80,0,494
BREHUIEŞTI,BT,1365,20,3,0,23,230,21,0,251
MÎNDREŞTI,BT,1115,64,11,0,75,407,40,0,447
VLĂSINEŞTI,BT,1242,73,11,34,118,371,41,34,446
SÎRBI,BT,839,32,0,0,32,305,25,20,350
"MIRON COSTIN",BT,326,12,2,0,14,157,16,0,173
VORNICENI,BT,2962,59,12,0,71,576,49,0,625
"DEALU CRUCII",BT,307,7,0,0,7,41,4,0,45
VORONA,BT,2087,123,27,0,150,719,101,15,835
"VORONA MARE",BT,1019,38,7,5,50,362,45,9,416
JOLDEŞTI,BT,1030,36,4,1,41,280,29,3,312
ICUŞENI,BT,1047,14,6,0,20,217,38,0,255
POIANA,BT,996,18,3,2,23,255,24,14,293
BRAŞOV,BV,247013,15689,1445,61,17195,38899,3552,96,42547
CODLEA,BV,21002,1218,68,0,1286,3735,180,318,4233
FĂGĂRAŞ,BV,31946,1586,96,0,1682,4656,346,0,5002
SĂCELE,BV,27370,1338,88,0,1426,4069,238,1,4308
GHIMBAV,BV,5402,213,30,0,243,864,96,2,962
PREDEAL,BV,3613,240,181,0,421,522,360,0,882
"TIMIŞU DE SUS",BV,302,18,3,0,21,36,19,0,55
"TIMIŞU DE JOS",BV,351,3,5,0,8,40,12,0,52
RÂŞNOV,BV,14766,626,143,0,769,2048,313,0,2361
RUPEA,BV,4481,144,12,0,156,568,54,9,631
FIŞER,BV,386,13,2,0,15,98,6,0,104
VICTORIA,BV,7204,306,31,1,338,913,112,1,1026
ZĂRNEŞTI,BV,20360,898,87,0,985,2995,250,2,3247
"TOHANU NOU",BV,1194,50,5,0,55,255,29,8,292
APAŢA,BV,2389,33,2,0,35,194,8,0,202
AUGUSTIN,BV,1282,34,11,0,45,103,31,0,134
BECLEAN,BV,634,18,3,0,21,114,25,0,139
HUREZ,BV,365,14,3,0,17,93,10,0,103
BOHOLŢ,BV,158,22,5,0,27,84,22,0,106
CALBOR,BV,195,11,1,0,12,38,10,0,48
LUŢA,BV,59,6,1,0,7,14,11,0,25
BOD,BV,2295,98,24,0,122,316,78,0,394
"COLONIA BOD",BV,1836,61,16,0,77,216,38,0,254
BRAN,BV,1707,70,77,0,147,294,180,0,474
PREDELUŢ,BV,872,23,22,0,45,144,66,0,210
SOHODOL,BV,907,28,4,0,32,95,16,0,111
ŞIMON,BV,1042,26,15,0,41,176,22,0,198
BUDILA,BV,3060,58,10,0,68,429,26,0,455
BUNEŞTI,BV,617,16,8,0,24,87,24,0,111
CRIŢ,BV,545,7,0,0,7,59,8,0,67
MEŞENDORF,BV,286,4,1,0,5,14,8,0,22
ROADEŞ,BV,251,12,0,0,12,31,1,0,32
VISCRI,BV,365,5,8,0,13,43,18,0,61
CAŢA,BV,1034,27,2,0,29,115,8,0,123
BEIA,BV,328,9,1,0,10,36,11,0,47
DRĂUŞENI,BV,406,12,0,0,12,33,4,0,37
IONEŞTI,BV,104,5,3,0,8,18,4,0,22
PALOŞ,BV,193,4,4,0,8,38,20,0,58
CINCU,BV,1292,45,214,0,259,171,311,0,482
TOARCLA,BV,281,4,2,0,6,39,8,0,47
"COMANA DE JOS",BV,848,14,6,0,20,83,15,0,98
"COMANA DE SUS",BV,288,9,11,0,20,48,36,1,85
CRIHALMA,BV,563,18,4,0,22,191,14,0,205
"TICUŞU NOU",BV,460,13,1,0,14,86,16,0,102
CRISTIAN,BV,4378,193,61,0,254,702,141,0,843
CRIZBAV,BV,1326,45,9,0,54,339,35,0,374
CUTUŞ,BV,559,26,0,0,26,195,11,0,206
DRĂGUŞ,BV,936,21,5,0,26,147,27,0,174
DUMBRĂVIŢA,BV,3361,115,13,0,128,452,39,0,491
VLĂDENI,BV,720,51,12,0,63,165,40,0,205
FELDIOARA,BV,4338,183,15,0,198,720,36,2,758
ROTBAV,BV,1051,31,5,0,36,194,41,0,235
"COLONIA RECONSTRUCŢIA",BV,590,24,4,0,28,73,9,0,82
FUNDATA,BV,456,19,16,0,35,112,55,0,167
ŞIRNEA,BV,216,7,24,0,31,41,46,0,87
HĂLCHIU,BV,2972,72,17,0,89,417,52,0,469
"SATU NOU",BV,989,35,6,0,41,109,16,0,125
"PODU OLTULUI",BV,644,25,9,0,34,94,40,0,134
HĂRMAN,BV,4738,180,22,0,202,630,70,0,700
HÂRSENI,BV,480,40,6,0,46,149,20,2,171
SEBEŞ,BV,653,19,3,0,22,92,22,0,114
MĂRGINENI,BV,246,26,11,0,37,97,38,0,135
COPĂCEL,BV,511,4,3,0,7,71,19,0,90
HOGHIZ,BV,1811,41,11,0,52,136,22,0,158
"BOGATA OLTEANĂ",BV,329,13,3,0,16,87,15,0,102
CUCIULATA,BV,1142,22,8,0,30,163,25,0,188
DOPCA,BV,407,13,3,0,16,38,4,0,42
FÂNTÂNA,BV,214,5,3,0,8,41,5,0,46
LUPŞA,BV,79,3,0,0,3,11,8,0,19
HOLBAV,BV,1028,66,4,0,70,286,19,0,305
HOMOROD,BV,1179,34,4,0,38,120,14,0,134
MERCHEAŞA,BV,413,29,3,0,32,66,9,0,75
JIMBOR,BV,381,3,1,0,4,25,5,0,30
JIBERT,BV,627,7,0,0,7,63,4,0,67
DACIA,BV,607,19,0,0,19,64,8,0,72
LOVNIC,BV,437,7,3,0,10,43,10,0,53
GRÎNARI,BV,292,9,2,0,11,29,5,0,34
VĂLENI,BV,136,11,6,0,17,50,22,0,72
LISA,BV,875,20,7,0,27,234,45,0,279
BREAZA,BV,559,10,12,0,22,128,49,0,177
MĂIERUŞ,BV,1451,50,1,0,51,187,7,0,194
ARINI,BV,761,16,3,0,19,89,11,0,100
MÂNDRA,BV,950,33,8,0,41,164,36,0,200
ILENI,BV,642,24,10,0,34,151,38,0,189
RÂUŞOR,BV,426,12,11,0,23,71,26,0,97
TODERIŢA,BV,231,13,10,0,23,45,30,0,75
ŞONA,BV,195,10,13,0,23,36,26,0,62
"MOIECIU DE JOS",BV,2316,80,46,0,126,389,139,0,528
"MOIECIU DE SUS",BV,768,11,28,0,39,151,57,0,208
PEŞTERA,BV,364,29,7,0,36,73,25,0,98
MĂGURA,BV,428,15,4,0,19,104,17,0,121
ORMENIŞ,BV,1555,32,4,0,36,139,11,0,150
PĂRĂU,BV,506,14,2,0,16,72,23,0,95
GRID,BV,250,7,7,0,14,36,25,0,61
"VENEŢIA DE JOS",BV,577,19,3,0,22,89,21,0,110
"VENEŢIA DE SUS",BV,368,26,8,0,34,96,23,0,119
"POIANA MĂRULUI",BV,2661,122,17,0,139,710,59,0,769
PREJMER,BV,5139,149,20,0,169,673,84,0,757
"LUNCA CALNICULUI",BV,2601,122,16,0,138,522,51,1,574
MATEIAŞ,BV,393,10,4,0,14,60,12,0,72
RACOŞ,BV,2120,21,2,0,23,85,9,0,94
RECEA,BV,1584,51,15,0,66,238,88,0,326
BERIVOI,BV,471,18,10,0,28,93,40,0,133
SĂVĂSTRENI,BV,568,20,7,0,27,151,37,0,188
"SÂMBĂTA DE SUS",BV,1304,76,16,0,92,345,70,0,415
SÎNPETRU,BV,5930,270,42,0,312,826,150,0,976
ŞERCAIA,BV,1405,25,3,0,28,113,18,0,131
VAD,BV,447,34,3,0,37,104,26,0,130
HĂLMEAG,BV,401,11,2,0,13,21,7,0,28
VÂLCEA,BV,180,10,1,0,11,33,5,0,38
BUCIUM,BV,213,9,7,0,16,45,21,0,66
OHABA,BV,274,15,11,0,26,54,27,0,81
PERŞANI,BV,884,34,6,0,40,324,52,0,376
ŞERCĂIŢA,BV,575,25,8,0,33,96,23,0,119
"ŞINCA VECHE",BV,708,15,8,0,23,99,43,0,142
"ŞINCA NOUĂ",BV,1146,90,14,0,104,447,45,3,495
PALTIN,BV,136,10,7,0,17,55,34,0,89
ŞOARŞ,BV,499,16,2,0,18,83,9,0,92
FELMER,BV,376,28,10,0,38,57,18,0,75
BĂRCUT,BV,346,14,3,0,17,61,11,0,72
RODBAV,BV,259,7,3,0,10,32,5,0,37
SELIŞTAT,BV,173,5,4,0,9,18,14,0,32
TĂRLUNGENI,BV,3549,90,12,0,102,446,40,1,487
PURCĂRENI,BV,1241,40,6,0,46,152,16,0,168
ZIZIN,BV,2091,56,8,0,64,579,24,0,603
CĂRPINIŞ,BV,402,31,11,0,42,98,30,0,128
TELIU,BV,3194,41,17,0,58,340,44,1,385
"TICUŞU VECHI",BV,584,6,2,0,8,43,8,0,51
COBOR,BV,186,1,3,0,4,10,7,0,17
"UCEA DE JOS",BV,698,27,9,0,36,118,27,1,146
"UCEA DE SUS",BV,822,43,13,0,56,178,31,0,209
FELDIOARA,BV,173,4,6,0,10,34,16,0,50
CORBI,BV,166,7,3,0,10,23,17,0,40
UNGRA,BV,1097,19,1,0,20,69,10,0,79
DĂIŞOARA,BV,577,27,4,0,31,204,14,0,218
"VAMA BUZĂULUI",BV,1354,30,6,0,36,165,18,0,183
ACRIŞ,BV,959,9,11,0,20,148,26,0,174
BUZĂIEL,BV,458,9,4,0,13,34,5,0,39
"VIŞTEA DE JOS",BV,631,23,5,0,28,85,32,0,117
"VIŞTEA DE SUS",BV,490,28,11,0,39,82,31,0,113
OLTEŢ,BV,291,7,5,0,12,54,31,0,85
RUCĂR,BV,323,12,5,0,17,65,17,0,82
VOILA,BV,622,27,4,0,31,132,24,4,160
CINCŞOR,BV,654,14,9,0,23,62,23,0,85
DRIDIF,BV,340,23,13,0,36,92,37,0,129
LUDIŞOR,BV,152,7,7,0,14,36,34,1,71
"SÂMBĂTA DE JOS",BV,427,11,4,0,15,91,33,0,124
VOIVODENI,BV,347,18,4,0,22,102,63,2,167
VULCAN,BV,3261,123,7,0,130,479,31,0,510
"COLONIA 1 MAI",BV,678,44,4,0,48,176,13,0,189
BUZĂU,BZ,111313,6607,449,64,7120,19368,1077,162,20607
"RÂMNICU SĂRAT",BZ,32899,2059,185,69,2313,6359,380,94,6833
NEHOIU,BZ,5400,288,29,7,324,1212,78,34,1324
"LUNCA PRIPORULUI",BZ,351,18,4,9,31,128,17,9,154
"BÎSCA ROZILEI",BZ,1089,39,7,0,46,279,13,8,300
VINEŢIŞU,BZ,122,10,5,0,15,60,6,2,68
PĂLTINENI,BZ,701,48,2,19,69,221,18,19,258
MLĂJET,BZ,712,50,2,0,52,317,21,0,338
CHIRLEŞTI,BZ,658,30,2,0,32,161,15,1,177
CURMĂTURA,BZ,136,19,5,12,36,68,9,12,89
PĂTÂRLAGELE,BZ,2107,151,31,0,182,513,69,0,582
POIENILE,BZ,248,22,2,0,24,64,13,0,77
MĂRUNŢIŞU,BZ,1237,55,6,0,61,273,19,0,292
MUŞCEL,BZ,597,30,3,0,33,148,12,0,160
"VALEA LUPULUI",BZ,376,25,11,0,36,102,18,0,120
"VALEA VIEI",BZ,405,25,3,0,28,107,15,0,122
CRÂNG,BZ,533,52,9,0,61,197,18,0,215
"SIBICIU DE SUS",BZ,719,34,5,0,39,266,29,0,295
"VALEA SIBICIULUI",BZ,185,13,5,0,18,59,8,0,67
POGOANELE,BZ,4425,86,15,0,101,503,51,0,554
CĂLDĂRĂŞTI,BZ,1548,133,6,28,167,403,24,28,455
AMARU,BZ,957,46,13,0,59,190,35,0,225
DULBANU,BZ,405,41,12,0,53,94,20,0,114
"LACU SINAIA",BZ,196,20,2,0,22,78,12,0,90
LUNCA,BZ,309,39,16,1,56,88,32,1,121
"BALTA ALBĂ",BZ,443,41,17,0,58,137,31,0,168
BĂILE,BZ,364,24,10,0,34,117,41,0,158
AMARA,BZ,1226,37,8,0,45,283,40,0,323
BĂLĂCEANU,BZ,1284,46,4,13,63,285,39,28,352
BECENI,BZ,810,19,5,0,24,118,23,0,141
"GURA DIMIENII",BZ,778,43,4,0,47,270,21,23,314
"VALEA PĂRULUI",BZ,1165,51,5,0,56,321,37,0,358
"IZVORU DULCE",BZ,694,36,9,0,45,201,32,0,233
FLOREŞTI,BZ,205,9,8,0,17,48,21,0,69
BERCA,BZ,2983,117,21,22,160,495,77,22,594
SĂTUC,BZ,545,16,6,0,22,118,20,0,138
RĂTEŞTI,BZ,821,67,12,0,79,256,20,0,276
PÎCLELE,BZ,134,6,5,0,11,19,7,0,26
JOSENI,BZ,776,26,4,0,30,135,25,0,160
PLEŞEŞTI,BZ,1552,50,16,0,66,235,34,0,269
"VALEA NUCULUI",BZ,577,14,2,0,16,89,19,0,108
BISOCA,BZ,487,21,8,0,29,113,30,0,143
RECEA,BZ,800,26,4,0,30,187,11,0,198
PLEŞI,BZ,353,14,1,0,15,123,5,0,128
SĂRILE,BZ,401,12,0,0,12,108,6,0,114
BLĂJANI,BZ,600,31,9,0,40,176,35,0,211
SOREŞTI,BZ,239,12,3,0,15,107,19,0,126
BOLDU,BZ,1810,152,18,51,221,569,69,53,691
BOZIORU,BZ,511,14,4,0,18,126,27,6,159
FIŞICI,BZ,316,13,13,0,26,76,24,4,104
BRĂDEANU,BZ,909,48,12,0,60,158,27,0,185
SMÎRDAN,BZ,734,23,9,0,32,173,31,0,204
MITROPOLIA,BZ,354,25,4,0,29,114,15,0,129
BRĂEŞTI,BZ,376,16,5,0,21,85,10,0,95
BRĂTILEŞTI,BZ,1094,23,2,0,25,273,15,0,288
PINU,BZ,297,15,2,0,17,92,13,0,105
BREAZA,BZ,792,48,8,0,56,155,35,0,190
GRECEANCA,BZ,768,18,5,0,23,89,21,0,110
VISPEŞTI,BZ,581,46,17,0,63,131,52,0,183
BUDA,BZ,892,34,2,0,36,201,24,0,225
MUCEŞTI-DĂNULEŞTI,BZ,947,30,5,0,35,218,12,0,230
TOROPĂLEŞTI,BZ,527,35,0,0,35,159,17,0,176
"C.A. ROSETTI",BZ,721,19,2,0,21,80,12,0,92
BĂLTENI,BZ,375,17,5,0,22,60,30,0,90
BÎLHACU,BZ,183,18,3,0,21,41,11,0,52
"COTU CIORII",BZ,491,44,14,0,58,108,37,0,145
LUNCA,BZ,847,100,6,0,106,308,25,18,351
VIZIRENI,BZ,372,16,0,0,16,46,8,0,54
CALVINI,BZ,788,23,3,0,26,100,7,0,107
"BÎSCENII DE JOS",BZ,1991,54,9,0,63,280,29,0,309
"BÎSCENII DE SUS",BZ,726,13,3,0,16,126,19,1,146
CĂNEŞTI,BZ,469,24,24,0,48,162,52,25,239
NEGOŞINA,BZ,159,18,0,0,18,88,12,0,100
CĂTINA,BZ,621,21,6,0,27,101,17,0,118
CORBU,BZ,665,26,4,0,30,180,12,0,192
"VALEA CĂTINEI",BZ,392,25,6,0,31,79,16,0,95
SLOBOZIA,BZ,163,8,5,0,13,22,6,0,28
ZELETIN,BZ,160,8,2,0,10,17,5,0,22
CERNĂTEŞTI,BZ,935,24,6,0,30,126,23,0,149
"ZĂRNEŞTII DE SLĂNIC",BZ,1108,42,7,0,49,180,27,1,208
ALDENI,BZ,686,41,11,0,52,192,53,0,245
FULGA,BZ,396,19,7,0,26,81,17,0,98
CHILIILE,BZ,271,18,6,0,24,149,36,0,185
TRESTIOARA,BZ,180,16,2,0,18,87,9,0,96
CHIOJDU,BZ,801,37,24,0,61,219,63,0,282
"BÎSCA CHIOJDULUI",BZ,960,11,7,0,18,97,20,0,117
PLESCIOARA,BZ,134,8,6,0,14,53,6,0,59
CĂTIAŞU,BZ,296,16,7,0,23,95,11,0,106
LERA,BZ,359,31,2,0,33,142,12,0,154
POENIŢELE,BZ,187,44,4,0,48,90,9,0,99
CILIBIA,BZ,1212,101,11,0,112,351,31,0,382
"MOVILA OII",BZ,304,26,11,0,37,150,21,0,171
CISLĂU,BZ,1845,61,5,0,66,348,17,0,365
SCĂRIŞOARA,BZ,1033,25,4,0,29,172,12,0,184
"BUDA CRĂCIUNEŞTI",BZ,643,17,4,0,21,162,14,0,176
"GURA BÎSCEI",BZ,302,15,8,0,23,104,20,0,124
COCHIRLEANCA,BZ,2143,129,11,0,140,567,32,0,599
BOBOC,BZ,1370,53,3,0,56,340,29,0,369
ROŞIORU,BZ,573,27,5,0,32,174,24,0,198
"GARA BOBOCU",BZ,295,20,28,0,48,89,70,0,159
TÎRLELE,BZ,41,8,6,0,14,19,12,0,31
COLŢI,BZ,407,13,7,0,20,85,23,0,108
ALUNIŞ,BZ,127,2,7,0,9,29,9,0,38
"MUSCELU CĂRĂMĂNEŞTI",BZ,84,7,3,0,10,24,15,0,39
"COLŢII DE JOS",BZ,254,12,0,0,12,75,3,0,78
COSTEŞTI,BZ,1281,33,5,0,38,208,42,0,250
PIETROSU,BZ,1115,27,0,0,27,99,11,0,110
BUDIŞTENI,BZ,406,16,7,0,23,88,21,0,109
SPĂTARU,BZ,1054,36,4,0,40,164,31,0,195
GOMOEŞTI,BZ,184,10,4,0,14,44,12,0,56
COZIENI,BZ,522,17,20,0,37,141,40,0,181
BĂLĂNEŞTI,BZ,611,29,9,0,38,135,27,0,162
TRESTIA,BZ,323,10,7,0,17,76,11,0,87
PIETRARU,BZ,184,10,10,0,20,43,19,0,62
FLORICA,BZ,1068,77,10,0,87,391,65,0,456
GĂLBINAŞI,BZ,1077,18,6,0,24,139,20,0,159
BENTU,BZ,766,79,15,0,94,191,32,0,223
TĂBĂRĂŞTI,BZ,1665,36,6,0,42,215,28,0,243
GHERĂSENI,BZ,2336,151,14,0,165,723,59,0,782
SUDIŢI,BZ,446,25,2,0,27,105,18,0,123
GHERGHEASA,BZ,991,23,10,0,33,158,26,0,184
SĂLCIOARA,BZ,846,10,0,0,10,83,8,0,91
"GLODEANU SĂRAT",BZ,1744,54,9,0,63,342,42,0,384
ILEANA,BZ,346,20,7,0,27,85,19,0,104
PITULICEA,BZ,760,49,6,4,59,204,27,14,245
CĂLDĂRUŞEANCA,BZ,470,29,11,0,40,141,30,0,171
GLODEANU-SILIŞTEA,BZ,1102,51,11,0,62,302,52,0,354
COTORCA,BZ,789,32,5,0,37,160,31,0,191
"CÎRLIGU MARE",BZ,364,25,5,0,30,75,21,0,96
VĂCĂREASCA,BZ,401,13,8,0,21,72,27,0,99
CASOTA,BZ,277,24,4,0,28,73,23,0,96
GREBĂNU,BZ,1810,32,5,0,37,226,30,0,256
HOMEŞTI,BZ,808,19,8,0,27,103,33,0,136
LIVADA,BZ,597,52,19,0,71,174,56,0,230
PLEVNA,BZ,1146,52,8,0,60,304,24,0,328
PĂLTINIŞ,BZ,523,13,7,0,20,90,13,0,103
FURTUNEŞTI,BZ,749,23,3,0,26,140,14,0,154
"GURA TEGHII",BZ,1109,16,8,0,24,261,28,0,289
VARLAAM,BZ,457,19,0,0,19,112,23,0,135
LARGU,BZ,1252,48,10,0,58,153,28,0,181
LOPĂTARI,BZ,1001,45,11,0,56,292,35,2,329
LUNCILE,BZ,666,29,4,0,33,166,14,0,180
TERCA,BZ,349,17,6,0,23,122,10,0,132
PLOŞTINA,BZ,408,17,4,0,21,149,7,0,156
"PLAIU NUCULUI",BZ,594,42,15,0,57,287,50,14,351
LUCIU,BZ,1534,102,14,0,116,315,40,0,355
CARAGELE,BZ,695,73,5,0,78,213,25,1,239
MĂGURA,BZ,1087,58,12,0,70,252,72,25,349
CIUTA,BZ,637,22,9,0,31,270,25,0,295
MĂRĂCINENI,BZ,2586,85,10,0,95,426,43,0,469
CĂPĂŢÎNEŞTI,BZ,2960,94,9,0,103,496,32,0,528
POTOCENI,BZ,1712,48,3,0,51,363,29,0,392
MĂRGĂRITEŞTI,BZ,539,8,0,0,8,162,22,0,184
MEREI,BZ,927,21,10,0,31,76,37,0,113
LIPIA,BZ,1610,60,11,0,71,237,65,0,302
SĂRATA-MONTEORU,BZ,668,22,73,0,95,139,176,0,315
"GURA SĂRĂŢII",BZ,143,16,6,0,22,38,24,0,62
"DEALUL VIEI",BZ,645,23,8,0,31,81,24,0,105
"IZVORU DULCE",BZ,736,23,5,0,28,109,24,0,133
NENCIULEŞTI,BZ,267,12,8,0,20,43,15,0,58
OGRĂZILE,BZ,596,14,4,0,18,115,27,0,142
MIHĂILEŞTI,BZ,986,46,11,0,57,191,42,0,233
MĂRGINEANU,BZ,636,45,7,0,52,264,21,0,285
MÎNZĂLEŞTI,BZ,624,19,3,0,22,142,9,0,151
BEŞLII,BZ,471,30,7,0,37,114,19,0,133
"VALEA COTOAREI",BZ,167,6,3,0,9,53,7,0,60
"GURA BĂDICULUI",BZ,371,5,6,0,11,77,25,0,102
TRESTIOARA,BZ,295,7,1,0,8,71,9,0,80
"MOVILA BANULUI",BZ,1031,44,12,0,56,189,44,0,233
LIMPEZIŞ,BZ,817,30,6,0,36,197,23,0,220
CIORANCA,BZ,210,13,3,0,16,54,12,0,66
MURGEŞTI,BZ,751,31,9,0,40,295,63,0,358
NĂENI,BZ,473,27,12,4,43,160,43,9,212
FINŢEŞTI,BZ,484,37,13,0,50,129,39,0,168
VÎRF,BZ,206,17,4,0,21,101,14,4,119
PROŞCA,BZ,188,16,6,0,22,69,34,0,103
ODĂILE,BZ,656,10,1,0,11,149,16,0,165
PADINA,BZ,3212,89,25,0,114,354,87,0,441
PARDOŞI,BZ,332,40,9,0,49,139,44,0,183
PĂNĂTĂU,BZ,1265,68,8,0,76,283,24,0,307
TEGA,BZ,537,23,9,0,32,110,27,0,137
BEGU,BZ,186,15,6,0,21,82,10,0,92
PIETROASELE,BZ,1558,40,14,0,54,140,44,0,184
ŞARÎNGA,BZ,1192,56,13,0,69,175,53,1,229
PÎRSCOV,BZ,2467,89,19,0,108,415,59,0,474
BADILA,BZ,663,15,3,0,18,76,12,0,88
"LUNCA FRUMOASĂ",BZ,910,14,9,0,23,122,13,0,135
ROBEŞTI,BZ,491,23,12,0,35,79,38,0,117
TRESTIENI,BZ,47,4,0,0,4,8,8,0,16
PLEŞEŞTI,BZ,312,20,3,0,23,73,12,0,85
PODGORIA,BZ,1304,64,10,1,75,350,37,10,397
COŢATCU,BZ,972,40,8,0,48,376,52,0,428
"POŞTA CÎLNĂU",BZ,2055,66,7,0,73,391,42,0,433
POTÎRNICHEŞTI,BZ,391,12,0,0,12,96,14,0,110
ZILIŞTEANCA,BZ,1117,31,3,0,34,159,11,0,170
SUDIŢI,BZ,1470,78,9,0,87,404,47,0,451
"PUIEŞTII DE SUS",BZ,320,37,5,0,42,84,18,0,102
"PUIEŞTII DE JOS",BZ,1112,35,3,0,38,231,38,0,269
NICOLEŞTI,BZ,597,41,12,0,53,161,29,0,190
DĂSCĂLEŞTI,BZ,594,31,0,0,31,127,19,0,146
MĂCRINA,BZ,455,17,7,0,24,75,29,0,104
RACOVIŢENI,BZ,1054,31,6,0,37,286,41,0,327
RÎMNICELU,BZ,2445,93,10,0,103,620,30,0,650
ŞTIUBEI,BZ,484,17,7,0,24,123,25,0,148
COLIBAŞI,BZ,332,26,7,0,33,90,15,0,105
FOTIN,BZ,175,23,9,0,32,56,12,0,68
ROBEASCA,BZ,570,31,5,15,51,194,24,15,233
MOŞEŞTI,BZ,265,23,20,24,67,79,65,24,168
RUŞEŢU,BZ,2937,132,14,0,146,673,76,0,749
"SERGENT IONEL ŞTEFAN",BZ,166,7,7,0,14,74,8,0,82
SĂGEATA,BZ,1135,71,12,0,83,374,37,20,431
DÎMBROCA,BZ,1022,49,5,0,54,253,27,16,296
BORDUŞANI,BZ,320,33,13,0,46,129,30,0,159
BEILIC,BZ,301,35,6,7,48,106,18,11,135
GĂVĂNEŞTI,BZ,853,71,6,0,77,304,36,33,373
BANIŢA,BZ,254,17,11,0,28,71,29,0,100
SĂHĂTENI,BZ,1297,52,5,0,57,172,16,0,188
"ISTRIŢA DE JOS",BZ,274,15,5,0,20,55,13,0,68
GĂGENI,BZ,363,22,5,0,27,106,13,0,119
VINTILEANCA,BZ,721,53,2,0,55,215,17,0,232
SĂPOCA,BZ,1428,42,7,67,116,210,42,93,345
MĂTEŞTI,BZ,1416,39,2,0,41,273,27,0,300
SĂRULEŞTI,BZ,1070,53,7,0,60,396,36,0,432
SCORŢOASA,BZ,1017,23,5,0,28,133,32,0,165
"GURA VĂII",BZ,181,16,2,0,18,56,14,0,70
PLOPEASA,BZ,164,14,2,0,16,49,15,0,64
"GRABICINA DE JOS",BZ,174,12,8,0,20,67,15,0,82
"GOLU GRABICINA",BZ,233,15,3,0,18,75,19,0,94
"BALTA TOCILA",BZ,265,20,11,0,31,79,29,0,108
BECIU,BZ,115,12,5,0,17,45,12,0,57
SCUTELNICI,BZ,902,37,14,0,51,153,47,0,200
BRĂGĂREASA,BZ,529,14,6,0,20,100,28,0,128
ARCANU,BZ,330,22,3,0,25,96,9,0,105
"LUNCA JARIŞTEI",BZ,1425,49,4,0,53,266,15,0,281
"COLŢU PIETRII",BZ,1135,38,1,0,39,232,7,0,239
SMEENI,BZ,2862,72,18,0,90,305,52,1,358
MOISICA,BZ,289,30,7,0,37,81,19,0,100
ALBEŞTI,BZ,719,15,3,0,18,97,13,0,110
UDAŢI-MÂNZU,BZ,721,18,2,0,20,73,8,0,81
CĂLŢUNA,BZ,433,7,4,0,11,64,12,0,76
UDAŢI-LUCIENI,BZ,349,1,4,0,5,20,5,0,25
STÎLPU,BZ,2585,144,25,0,169,566,54,26,646
GRĂJDANA,BZ,920,22,6,0,28,126,23,0,149
IZVORANU,BZ,97,8,4,0,12,23,13,0,36
"VALEA SĂLCIILOR",BZ,500,11,1,0,12,43,6,0,49
HALEŞ,BZ,774,27,10,0,37,149,39,0,188
PĂDURENII,BZ,468,24,1,0,25,91,9,0,100
TISĂU,BZ,619,18,2,0,20,78,17,0,95
STREZENI,BZ,444,25,4,0,29,70,20,0,90
POŞTA,BZ,437,13,5,0,18,98,14,0,112
TOPLICENI,BZ,1046,21,8,0,29,130,22,0,152
RĂDUCEŞTI,BZ,380,15,5,0,20,86,23,0,109
BĂBENI,BZ,847,23,11,0,34,136,26,0,162
DEDULEŞTI,BZ,776,19,2,0,21,167,21,0,188
"GURA FĂGETULUI",BZ,133,8,6,0,14,40,10,0,50
ŢINTEŞTI,BZ,1847,158,14,0,172,680,59,0,739
MAXENU,BZ,1810,60,8,0,68,489,42,0,531
ULMENI,BZ,1237,40,30,0,70,194,62,1,257
CLONDIRU,BZ,1348,87,14,0,101,380,60,5,445
UNGURIU,BZ,1894,56,17,85,158,255,41,85,381
"VADU PAŞII",BZ,3401,101,9,0,110,491,45,0,536
FOCŞĂNEI,BZ,1189,68,2,0,70,252,25,0,277
SCURTEŞTI,BZ,2195,95,14,0,109,368,35,0,403
STĂNCEŞTI,BZ,1209,68,4,0,72,256,17,0,273
OREAVUL,BZ,1905,82,4,0,86,408,24,0,432
"VALEA RÎMNICULUI",BZ,1826,120,4,30,154,469,21,30,520
RUBLA,BZ,968,55,5,0,60,316,22,0,338
"VALEA SALCIEI",BZ,590,23,0,11,34,201,16,23,240
VERNEŞTI,BZ,1915,47,13,0,60,265,40,0,305
CÎNDEŞTI,BZ,2745,37,4,0,41,339,20,0,359
ZOREŞTI,BZ,1105,26,11,0,37,143,33,0,176
NIŞCOV,BZ,1064,46,15,0,61,148,37,1,186
"SĂSENII NOI",BZ,296,16,4,0,20,59,22,0,81
MIEREA,BZ,374,25,9,0,34,101,37,0,138
"VINTILĂ VODĂ",BZ,1292,78,15,23,116,382,60,43,485
NICULEŞTI,BZ,966,24,7,0,31,139,31,0,170
COCA-ANTIMIREŞTI,BZ,206,3,4,0,7,15,8,0,23
VIPEREŞTI,BZ,906,28,3,0,31,233,25,0,258
TRONARI,BZ,753,32,3,0,35,271,15,0,286
URSOAIA,BZ,874,4,4,0,8,94,18,0,112
MUSCEL,BZ,106,6,6,0,12,25,12,0,37
VÎLCELELE,BZ,1217,51,16,0,67,277,63,90,430
FUNDENI,BZ,1856,99,8,0,107,511,33,0,544
PRUNENI,BZ,307,20,9,0,29,89,23,0,112
"VADU SOREŞTI",BZ,1075,77,5,2,84,274,18,2,294
ZĂRNEŞTI,BZ,869,47,11,0,58,266,39,0,305
ZIDURI,BZ,817,27,9,0,36,169,31,0,200
LANURILE,BZ,599,35,15,0,50,112,31,0,143
"HELIADE RĂDULESCU",BZ,668,63,14,0,77,246,47,0,293
COSTIENI,BZ,617,24,4,0,28,173,20,0,193
ZOIŢA,BZ,454,42,4,0,46,140,18,0,158
CUCULEASA,BZ,372,25,4,0,29,90,11,0,101
CLUJ-NAPOCA,CJ,272616,15711,3156,523,19390,44126,8065,863,53054
"CÂMPIA TURZII",CJ,23378,980,71,0,1051,3066,195,10,3271
DEJ,CJ,31553,1727,95,111,1933,5713,336,111,6160
"ŞOMCUTU MIC",CJ,484,21,6,0,27,92,10,0,102
PINTIC,CJ,197,9,4,0,13,45,15,0,60
GHERLA,CJ,18789,846,119,0,965,3113,290,315,3718
HĂŞDATE,CJ,277,3,8,0,11,58,11,0,69
SILIVAŞ,CJ,158,3,0,0,3,21,7,0,28
TURDA,CJ,47190,2102,158,35,2295,6510,415,38,6963
HUEDIN,CJ,7379,194,48,0,242,965,167,17,1149
BICĂLATU,CJ,266,4,2,0,6,19,2,0,21
AGHIREŞU,CJ,1078,33,9,0,42,117,16,0,133
AGHIREŞU-FABRICI,CJ,2568,32,2,0,34,201,18,0,219
ARGHIŞU,CJ,106,4,2,0,6,17,11,0,28
BĂGARA,CJ,324,2,0,0,2,55,11,0,66
DÎNCU,CJ,59,2,11,0,13,12,32,0,44
DOROLŢU,CJ,72,0,4,0,4,6,8,0,14
INUCU,CJ,262,10,4,0,14,47,14,0,61
LEGHIA,CJ,399,7,2,0,9,61,7,1,69
MACĂU,CJ,514,4,2,0,6,37,7,0,44
TICU,CJ,58,8,2,0,10,15,9,0,24
TICU-COLONIE,CJ,132,1,6,0,7,7,14,0,21
AITON,CJ,496,16,5,0,21,69,12,0,81
REDIU,CJ,385,7,8,0,15,65,33,0,98
ALUNIŞ,CJ,443,4,2,0,6,62,18,0,80
CORNENI,CJ,108,4,5,0,9,10,8,0,18
GHIROLT,CJ,317,4,2,0,6,50,9,0,59
VALE,CJ,76,3,8,0,11,16,23,0,39
APAHIDA,CJ,6501,160,18,0,178,747,123,0,870
SÎNNICOARĂ,CJ,1736,110,20,0,130,395,75,1,471
DEZMIR,CJ,1540,48,9,0,57,253,58,0,311
PATA,CJ,483,17,5,0,22,109,39,0,148
CORPADEA,CJ,334,2,4,0,6,34,19,0,53
CÎMPENEŞTI,CJ,114,6,6,0,12,30,30,0,60
"AŞCHILEU MARE",CJ,448,12,0,0,12,82,12,0,94
"AŞCHILEU MIC",CJ,238,9,7,0,16,53,19,0,72
CRISTOREL,CJ,305,3,4,0,7,52,12,0,64
FODORA,CJ,215,11,3,0,14,51,35,0,86
BACIU,CJ,5817,168,31,0,199,757,163,0,920
CORUŞU,CJ,460,14,9,0,23,104,40,0,144
MERA,CJ,1273,13,3,0,16,114,8,0,122
POPEŞTI,CJ,524,15,5,0,20,90,15,0,105
"SĂLIŞTEA NOUĂ",CJ,142,20,11,0,31,49,30,0,79
SUCEAGU,CJ,1153,17,2,0,19,83,13,0,96
BĂIŞOARA,CJ,846,20,8,0,28,148,22,0,170
SĂCEL,CJ,340,11,3,0,14,68,9,0,77
"MUNTELE BĂIŞORII",CJ,272,6,4,0,10,34,21,0,55
"MUNTELE CACOVEI",CJ,84,5,2,0,7,8,7,0,15
"MUNTELE SĂCELULUI",CJ,58,0,4,0,4,11,9,0,20
"MOARA DE PĂDURE",CJ,120,1,8,0,9,18,12,0,30
BELIŞ,CJ,510,21,15,0,36,131,65,0,196
BĂLCEŞTI,CJ,113,9,3,0,12,24,12,0,36
"DEALU BOTII",CJ,49,2,0,0,2,17,8,0,25
SMIDA,CJ,45,4,3,0,7,11,18,0,29
"GIURCUŢA DE SUS",CJ,110,9,1,0,10,45,5,0,50
"POIANA HOREA",CJ,300,6,0,0,6,72,5,0,77
BĂBDIU,CJ,133,4,10,0,14,30,27,0,57
BOBÎLNA,CJ,318,10,6,0,16,67,27,0,94
MAIA,CJ,182,4,5,0,9,49,19,0,68
OŞORHEL,CJ,106,7,4,0,11,27,15,0,42
PRUNI,CJ,25,3,13,0,16,8,25,0,33
RĂZBUNENI,CJ,187,20,7,0,27,52,22,0,74
SUARĂŞ,CJ,118,9,9,0,18,29,23,1,53
VÎLCELELE,CJ,83,7,7,0,14,24,17,0,41
BONŢIDA,CJ,2430,60,7,0,67,241,46,0,287
RĂSCRUCI,CJ,1270,37,7,0,44,154,49,0,203
COASTA,CJ,97,7,11,0,18,18,23,0,41
TĂUŞENI,CJ,40,3,11,0,14,12,30,0,42
BORŞA,CJ,886,27,10,0,37,116,42,0,158
GIULA,CJ,113,10,7,0,17,33,25,0,58
CIUMĂFAIA,CJ,131,5,9,0,14,15,18,0,33
BUZA,CJ,1015,19,1,0,20,154,26,0,180
"CĂIANU MIC",CJ,611,12,2,0,14,57,27,0,84
BĂRĂI,CJ,207,7,6,0,13,39,11,0,50
CĂIANU-VAMĂ,CJ,459,7,3,0,10,33,14,0,47
VAIDA-CĂMĂRAŞ,CJ,715,7,0,0,7,41,8,0,49
CĂLĂRAŞI,CJ,780,19,3,0,22,78,9,1,88
BOGATA,CJ,937,39,1,0,40,117,6,0,123
CĂLĂRAŞI-GARĂ,CJ,320,9,0,0,9,59,3,0,62
CĂLĂŢELE,CJ,938,19,2,0,21,144,23,0,167
CĂLATA,CJ,315,13,8,0,21,63,29,0,92
VĂLENI,CJ,264,2,6,0,8,27,8,0,35
FINCIU,CJ,111,17,9,0,26,48,21,0,69
"DEALU NEGRU",CJ,353,15,0,0,15,75,30,0,105
CĂMĂRAŞU,CJ,1205,7,1,0,8,120,6,0,126
NĂOIU,CJ,379,4,0,0,4,33,14,0,47
SÎMBOLENI,CJ,478,7,7,0,14,56,10,0,66
"CĂPUŞU MARE",CJ,690,10,3,0,13,52,14,0,66
"CĂPUŞU MIC",CJ,610,19,4,0,23,110,30,0,140
AGÎRBICIU,CJ,375,23,4,0,27,86,15,2,103
DUMBRAVA,CJ,295,6,4,0,10,35,19,0,54
PĂNICENI,CJ,237,14,2,0,16,53,8,0,61
"DÎNGĂU MARE",CJ,391,3,3,0,6,85,26,0,111
CĂŞEIU,CJ,1210,29,4,0,33,219,20,0,239
COPLEAN,CJ,345,12,6,0,18,86,20,0,106
RUGĂŞEŞTI,CJ,877,32,7,0,39,187,23,0,210
GUGA,CJ,256,10,2,0,12,81,10,0,91
"GÎRBĂU DEJULUI",CJ,184,9,0,0,9,28,13,0,41
SĂLĂTRUC,CJ,120,2,0,0,2,21,16,0,37
URIŞOR,CJ,817,31,6,0,37,186,22,0,208
CĂTINA,CJ,918,8,2,0,10,103,12,0,115
FELDIOARA,CJ,428,12,2,0,14,54,15,0,69
COPRU,CJ,93,2,2,0,4,24,6,0,30
"CEANU MARE",CJ,1154,18,8,0,26,117,18,0,135
BOIAN,CJ,750,12,2,0,14,74,7,0,81
BOLDUŢ,CJ,665,33,4,0,37,116,10,0,126
IACOBENI,CJ,517,44,11,0,55,144,36,0,180
"DOSU NAPULUI",CJ,122,1,0,0,1,11,13,0,24
CHINTENI,CJ,1311,43,13,0,56,197,69,0,266
DEUŞU,CJ,597,16,11,0,27,112,39,0,151
MĂCICAŞU,CJ,348,17,6,0,23,94,23,0,117
FEIURDENI,CJ,385,12,8,0,20,64,24,0,88
CHIUIEŞTI,CJ,1250,53,2,0,55,479,74,2,555
MĂGOAJA,CJ,314,10,5,0,15,103,25,0,128
STRÎMBU,CJ,359,35,17,0,52,155,34,2,191
HUTA,CJ,98,12,0,0,12,67,9,0,76
CIUCEA,CJ,956,35,8,0,43,197,38,0,235
VÂNĂTORI,CJ,357,10,6,0,16,85,15,0,100
CIURILA,CJ,190,7,9,0,16,38,25,0,63
"FILEA DE JOS",CJ,238,3,8,0,11,58,36,0,94
ŞUTU,CJ,300,3,5,0,8,14,18,0,32
SĂLICEA,CJ,350,29,15,0,44,101,72,0,173
SĂLIŞTE,CJ,78,4,5,0,9,26,26,0,52
CÎŢCĂU,CJ,1247,36,6,0,42,242,22,3,267
MUNCEL,CJ,186,6,0,0,6,40,12,0,52
SĂLIŞCA,CJ,463,11,2,0,13,94,16,0,110
COJOCNA,CJ,1901,38,15,0,53,137,42,0,179
BOJU,CJ,347,10,9,0,19,59,35,0,94
BOJ-CĂTUN,CJ,189,14,2,0,16,20,4,0,24
CARA,CJ,675,21,7,0,28,80,25,0,105
"IURIU DE CÎMPIE",CJ,206,6,6,0,12,33,23,0,56
IGRIŢIA,CJ,34,3,3,0,6,10,9,0,19
"TIOCU DE SUS",CJ,70,9,6,0,15,24,17,0,41
"TIOCU DE JOS",CJ,101,10,2,0,12,25,8,0,33
CORNEŞTI,CJ,187,7,1,0,8,44,14,0,58
STOIANA,CJ,164,34,10,0,44,65,23,0,88
MORĂU,CJ,43,5,2,0,7,15,16,0,31
LUJERDIU,CJ,263,11,4,0,15,50,29,0,79
BÎRLEA,CJ,131,10,1,0,11,29,10,0,39
TIOLTIUR,CJ,148,14,12,0,26,40,25,0,65
CUZDRIOARA,CJ,1757,44,2,0,46,257,16,0,273
MĂNĂŞTUREL,CJ,693,20,5,0,25,100,17,0,117
DĂBÎCA,CJ,543,17,7,0,24,101,42,0,143
"LUNA DE JOS",CJ,532,13,8,0,21,53,19,0,72
PÎGLIŞA,CJ,82,12,11,0,23,30,31,0,61
FELEACU,CJ,1591,56,13,0,69,248,37,1,286
GHEORGHIENI,CJ,884,8,1,0,9,62,11,0,73
VÎLCELE,CJ,844,24,14,0,38,119,36,0,155
"FIZEŞU GHERLII",CJ,1101,11,2,0,13,84,10,0,94
NICULA,CJ,539,39,16,0,55,101,30,0,131
BONŢ,CJ,290,4,1,0,5,34,7,0,41
SĂCĂLAIA,CJ,205,12,5,0,17,51,14,0,65
FLOREŞTI,CJ,26758,1022,274,1,1297,3182,880,3,4065
"LUNA DE SUS",CJ,1789,50,18,0,68,224,35,0,259
TĂUŢI,CJ,201,8,5,0,13,38,36,0,74
FRATA,CJ,1555,27,2,0,29,141,17,0,158
BERCHIEŞU,CJ,516,14,0,0,14,59,7,0,66
"POIANA FRĂŢII",CJ,177,6,0,0,6,34,3,0,37
"SOPORU DE CÎMPIE",CJ,982,16,5,0,21,118,19,0,137
GEACA,CJ,438,10,7,0,17,72,29,0,101
SUCUTARD,CJ,291,10,3,0,13,49,14,0,63
LACU,CJ,231,10,0,0,10,26,2,0,28
LEGII,CJ,116,2,5,0,7,16,11,0,27
CHIRIŞ,CJ,67,3,4,0,7,19,10,0,29
PUINI,CJ,74,4,0,0,4,11,4,0,15
GILĂU,CJ,5653,130,26,0,156,696,132,0,828
"SOMEŞU RECE",CJ,1561,95,38,0,133,394,128,0,522
GÎRBĂU,CJ,576,25,2,0,27,136,17,0,153
VIŞTEA,CJ,603,13,5,0,18,54,9,0,63
TUREA,CJ,426,9,0,0,9,44,9,0,53
NĂDĂŞELU,CJ,208,10,10,0,20,40,25,0,65
CORNEŞTI,CJ,105,9,61,0,70,28,98,0,126
AGRIŞ,CJ,326,8,0,0,8,29,7,0,36
"CACOVA IERII",CJ,337,7,5,0,12,46,9,0,55
"FĂGETU IERII",CJ,250,10,6,0,16,35,6,0,41
IARA,CJ,1654,53,4,0,57,219,19,0,238
MAŞCA,CJ,129,2,2,0,4,4,5,0,9
OCOLIŞEL,CJ,107,3,5,0,8,18,7,0,25
SURDUC,CJ,249,4,3,0,7,16,3,0,19
"VALEA VADULUI",CJ,40,0,4,0,4,4,12,0,16
BORZEŞTI,CJ,52,6,2,0,8,12,14,0,26
BURU,CJ,144,7,5,0,12,19,10,0,29
LUNGEŞTI,CJ,35,1,1,0,2,13,6,0,19
"MĂGURA IERII",CJ,24,1,0,0,1,8,6,0,14
ICLOD,CJ,1698,17,2,0,19,209,31,0,240
FUNDĂTURA,CJ,566,6,5,0,11,61,15,0,76
LIVADA,CJ,863,48,4,0,52,180,17,0,197
ORMAN,CJ,450,6,14,0,20,80,22,0,102
NADĂŞU,CJ,187,10,6,0,16,41,16,0,57
"IZVORU CRIŞULUI",CJ,770,5,1,0,6,72,5,0,77
ŞAULA,CJ,320,1,2,0,3,28,7,0,35
"JICHIŞU DE JOS",CJ,355,18,4,0,22,106,20,0,126
CODOR,CJ,336,17,2,0,19,92,14,0,106
"JICHIŞU DE SUS",CJ,190,2,10,0,12,27,15,0,42
TĂRPIU,CJ,89,1,7,0,8,20,11,0,31
ŞIGĂU,CJ,21,3,12,0,15,8,22,0,30
"JUCU DE SUS",CJ,1440,41,4,0,45,151,39,0,190
"JUCU DE MIJLOC",CJ,940,7,0,0,7,111,19,0,130
GĂDĂLIN,CJ,523,17,5,0,22,94,39,2,135
VIŞEA,CJ,464,7,3,0,10,51,23,0,74
JUC-HERGHELIE,CJ,364,13,0,0,13,52,6,0,58
LUNA,CJ,2149,47,7,0,54,225,31,0,256
LUNCANI,CJ,1265,31,3,0,34,149,12,0,161
GLIGOREŞTI,CJ,467,16,6,0,22,65,13,0,78
"MUNTELE RECE",CJ,448,12,2,0,14,62,24,0,86
MĂGURI-RĂCĂTĂU,CJ,710,16,1,0,17,163,19,0,182
MĂGURI,CJ,741,12,5,0,17,118,8,0,126
MĂNĂSTIRENI,CJ,747,22,8,0,30,144,36,0,180
BEDECIU,CJ,442,16,1,0,17,125,16,0,141
SCRIND-FRĂSINET,CJ,151,8,4,0,12,43,21,0,64
BUTENI,CJ,181,6,10,0,16,29,27,0,56
MĂRGĂU,CJ,360,8,4,0,12,108,25,0,133
RĂCHIŢELE,CJ,604,12,4,0,16,106,17,0,123
MĂRIŞEL,CJ,1278,21,4,0,25,263,47,0,310
MICA,CJ,577,21,7,19,47,103,16,19,138
MĂNĂSTIREA,CJ,590,31,5,0,36,132,19,2,153
NIREŞ,CJ,900,1,0,0,1,82,0,0,82
SÎNMĂRGHITA,CJ,885,15,2,0,17,86,8,0,94
"MIHAI VITEAZU",CJ,3797,67,12,0,79,329,53,0,382
CHEIA,CJ,467,6,3,0,9,39,6,0,45
CORNEŞTI,CJ,636,23,1,0,24,67,7,0,74
"MINTIU GHERLII",CJ,1272,40,3,0,43,226,27,0,253
BUNEŞTI,CJ,757,20,10,0,30,122,34,0,156
NIMA,CJ,592,17,2,0,19,105,12,0,117
PĂDURENII,CJ,79,6,6,0,12,18,13,0,31
PETREŞTI,CJ,206,12,2,0,14,34,10,0,44
SALATIU,CJ,225,9,1,0,10,27,5,0,32
MOCIU,CJ,1319,14,8,0,22,145,42,0,187
CHESĂU,CJ,274,13,1,0,14,49,6,0,55
CRIŞENI,CJ,207,6,6,0,12,39,12,0,51
"GHIRIŞU ROMÂN",CJ,271,6,4,0,10,32,9,0,41
"ZORENII DE VALE",CJ,252,2,3,0,5,25,13,0,38
BOTENI,CJ,177,4,4,0,8,26,13,0,39
ROŞIENI,CJ,144,3,0,0,3,23,10,0,33
MOLDOVENEŞTI,CJ,1000,10,1,0,11,53,13,0,66
PLĂIEŞTI,CJ,519,6,0,0,6,13,6,0,19
BĂDENI,CJ,570,8,4,0,12,26,8,0,34
STEJERIŞ,CJ,157,1,1,0,2,11,5,0,16
PIETROASA,CJ,110,2,0,0,2,9,5,0,14
PODENI,CJ,369,10,5,0,15,61,39,0,100
NEGRENI,CJ,1331,71,4,0,75,361,35,0,396
BUCEA,CJ,586,44,8,0,52,171,31,0,202
PRELUCELE,CJ,94,3,3,0,6,14,6,0,20
SĂRATA,CJ,244,3,4,0,7,36,16,0,52
PANTICEU,CJ,521,10,4,0,14,86,28,0,114
"CUBLEŞU SOMEŞAN",CJ,307,11,11,0,22,42,37,0,79
DÎRJA,CJ,170,4,3,0,7,15,13,0,28
CĂTĂLINA,CJ,54,0,5,0,5,7,19,0,26
PĂLATCA,CJ,635,16,4,0,20,121,30,0,151
SAVA,CJ,261,8,9,0,17,30,23,0,53
PLAIURI,CJ,102,5,5,0,10,29,26,0,55
"PETREŞTII DE MIJLOC",CJ,111,6,3,0,9,19,12,0,31
DELENI,CJ,181,9,5,0,14,38,29,0,67
CRĂEŞTI,CJ,167,7,1,0,8,32,3,0,35
"PETREŞTII DE JOS",CJ,509,7,2,0,9,54,19,0,73
LIVADA,CJ,161,5,5,0,10,18,13,0,31
"PETREŞTII DE SUS",CJ,75,6,5,0,11,14,13,0,27
PLOSCOŞ,CJ,337,6,5,0,11,29,17,0,46
"VALEA FLORILOR",CJ,224,8,4,0,12,31,13,0,44
POIENI,CJ,955,32,2,0,34,159,35,0,194
BOLOGA,CJ,517,15,4,0,19,137,23,0,160
MORLACA,CJ,616,10,10,0,20,121,37,0,158
HODIŞU,CJ,306,10,12,0,22,98,27,0,125
"VALEA DRĂGANULUI",CJ,1301,38,16,0,54,203,44,0,247
TRANIŞU,CJ,288,2,2,0,4,26,6,0,32
"LUNCA VIŞAGULUI",CJ,186,2,4,0,6,23,14,0,37
RECEA-CRISTUR,CJ,549,22,3,0,25,111,20,0,131
ELCIU,CJ,83,9,0,0,9,28,17,0,45
PUSTUŢA,CJ,74,9,5,0,14,25,15,0,40
OSOI,CJ,88,14,6,0,20,32,18,0,50
CIUBĂNCUŢA,CJ,124,12,5,0,17,29,14,0,43
CIUBANCA,CJ,80,6,2,0,8,24,17,0,41
RÎŞCA,CJ,780,18,6,0,24,105,15,0,120
"DEALU MARE",CJ,324,20,1,0,21,109,19,0,128
MĂRCEŞTI,CJ,156,9,5,0,14,34,7,0,41
SĂCUIEU,CJ,465,15,11,0,26,65,16,0,81
ROGOJEL,CJ,530,8,4,0,12,94,10,0,104
VIŞAGU,CJ,222,0,4,0,4,48,12,0,60
SĂNDULEŞTI,CJ,595,23,7,0,30,84,18,0,102
COPĂCENI,CJ,1131,25,5,0,30,142,18,0,160
SĂVĂDISLA,CJ,863,3,7,0,10,36,30,0,66
LITA,CJ,253,10,3,0,13,41,18,0,59
VĂLIŞOARA,CJ,47,0,3,0,3,8,14,0,22
VLAHA,CJ,754,11,8,0,19,42,15,0,57
HĂŞDATE,CJ,398,4,4,0,8,60,21,0,81
FINIŞEL,CJ,672,52,2,0,54,164,19,0,183
LITENI,CJ,326,4,6,0,10,18,12,0,30
STOLNA,CJ,198,15,9,0,24,58,19,0,77
SÂNCRAIU,CJ,931,58,17,0,75,280,35,2,317
ALUNIŞU,CJ,90,4,3,0,7,15,8,0,23
DOMOŞU,CJ,295,8,7,0,15,76,13,0,89
SÂNMĂRTIN,CJ,198,5,5,0,10,50,18,0,68
CEABA,CJ,186,18,6,0,24,88,29,0,117
CUTCA,CJ,329,20,5,0,25,238,21,0,259
SÎMBOIENI,CJ,128,19,6,0,25,84,16,0,100
TÎRGUŞOR,CJ,98,9,20,0,29,53,40,0,93
MĂHAL,CJ,72,18,8,0,26,49,19,0,68
"DIVICIORII MARI",CJ,125,8,12,0,20,77,37,0,114
"DIVICIORII MICI",CJ,52,13,9,0,22,32,23,0,55
SIC,CJ,1995,18,3,0,21,160,12,0,172
SÎNPAUL,CJ,699,25,6,0,31,109,30,0,139
ŞARDU,CJ,344,24,11,0,35,93,30,0,123
BERINDU,CJ,359,13,4,0,17,56,29,0,85
MIHĂIEŞTI,CJ,215,9,3,0,12,37,11,0,48
"TOPA MICĂ",CJ,190,5,7,0,12,27,21,0,48
SUATU,CJ,1069,16,2,0,18,71,14,0,85
ARUNCUTA,CJ,277,9,3,0,12,39,16,0,55
"TRITENII DE JOS",CJ,1250,18,1,0,19,151,11,0,162
"TRITENII DE SUS",CJ,874,20,0,0,20,165,18,0,183
COLONIA,CJ,398,6,2,0,8,41,6,0,47
PĂDURENI,CJ,986,22,3,0,25,92,12,0,104
TRITENII-HOTAR,CJ,243,6,5,0,11,23,8,0,31
CLAPA,CJ,71,2,6,0,8,9,10,0,19
TURENI,CJ,790,8,9,0,17,83,29,0,112
"CEANU MIC",CJ,330,6,4,0,10,40,16,0,56
COMŞEŞTI,CJ,185,4,3,0,7,22,9,0,31
MĂRTINEŞTI,CJ,304,5,4,0,9,31,10,0,41
MICEŞTI,CJ,218,8,13,0,21,33,36,0,69
ŢAGA,CJ,618,12,5,0,17,81,19,0,100
SÎNTIOANA,CJ,458,4,3,0,7,52,8,0,60
NĂSAL,CJ,259,3,6,0,9,39,23,0,62
SÎNTEJUDE,CJ,197,1,6,0,7,23,23,0,46
UNGURAŞ,CJ,1510,26,5,0,31,250,28,0,278
BATIN,CJ,559,8,5,0,13,103,17,0,120
"VALEA UNGURAŞULUI",CJ,168,4,1,0,5,33,15,0,48
VAD,CJ,267,14,5,0,19,52,20,0,72
CETAN,CJ,477,25,5,0,30,140,31,0,171
"BOGATA DE JOS",CJ,197,12,1,0,13,57,11,0,68
"CURTUIUŞU DEJULUI",CJ,137,22,2,0,24,55,18,0,73
"BOGATA DE SUS",CJ,203,6,4,0,10,66,14,0,80
"VALEA GROŞILOR",CJ,205,15,13,0,28,54,43,0,97
CALNA,CJ,110,15,2,0,17,45,13,0,58
"VALEA IERII",CJ,801,26,12,0,38,170,36,0,206
VIIŞOARA,CJ,4025,86,11,0,97,472,53,1,526
URCA,CJ,808,19,2,0,21,117,8,0,125
VULTURENI,CJ,318,12,2,0,14,64,20,0,84
BĂBUŢIU,CJ,179,22,3,0,25,48,12,0,60
BĂDEŞTI,CJ,96,7,3,0,10,22,8,0,30
CHIDEA,CJ,95,4,2,0,6,13,8,0,21
FĂURENI,CJ,144,6,10,0,16,31,29,0,60
ŞOIMENI,CJ,266,13,7,0,20,62,33,0,95
CĂLĂRAŞI,CL,62645,3000,257,38,3295,8796,570,111,9477
OLTENIŢA,CL,23197,1357,78,56,1491,4220,211,57,4488
BUDEŞTI,CL,3793,104,1,0,105,552,55,0,607
APROZI,CL,812,34,20,0,54,157,48,0,205
BUCIUMENI,CL,517,27,15,0,42,167,42,0,209
GRUIU,CL,602,28,15,0,43,120,58,0,178
FUNDULEA,CL,4736,208,48,0,256,1035,233,0,1268
GOSTILELE,CL,534,31,17,0,48,117,53,0,170
LEHLIU-GARĂ,CL,3155,196,29,0,225,722,101,12,835
RĂZVANI,CL,1824,106,11,0,117,453,37,0,490
BUZOENI,CL,375,25,12,0,37,135,33,0,168
"NICOLAE BĂLCESCU",CL,1022,44,8,0,52,184,32,0,216
"ALEXANDRU ODOBESCU",CL,912,32,7,0,39,170,37,0,207
GĂLĂŢUI,CL,257,27,12,0,39,87,40,0,127
BELCIUGATELE,CL,1286,82,29,0,111,300,120,0,420
MĂRIUŢA,CL,407,42,21,0,63,92,62,0,154
BORCEA,CL,6826,296,47,9,352,1359,149,9,1517
CĂSCIOARELE,CL,1488,85,15,0,100,359,48,0,407
CHIRNOGI,CL,6011,210,13,0,223,1076,73,0,1149
CHISELET,CL,2621,175,32,0,207,848,133,0,981
CIOCĂNEŞTI,CL,3370,70,34,40,144,312,95,40,447
CRIVĂŢ,CL,1681,61,14,0,75,449,69,38,556
CURCANI,CL,4203,276,33,0,309,1191,139,0,1330
CEACU,CL,1071,37,4,0,41,155,27,0,182
"CUZA VODĂ",CL,1682,46,13,0,59,219,50,0,269
"CĂLĂRAŞII VECHI",CL,547,26,7,0,33,95,23,1,119
DICHISENI,CL,748,19,6,0,25,63,17,0,80
COSLOGENI,CL,710,26,6,0,32,70,8,0,78
"DOR MĂRUNT",CL,2852,109,30,51,190,694,134,69,897
OGORU,CL,277,14,1,0,15,63,13,0,76
ÎNFRĂŢIREA,CL,266,15,6,0,21,66,21,0,87
PELINU,CL,81,3,4,0,7,15,7,1,23
DÎLGA-GARĂ,CL,1063,23,3,11,37,189,21,12,222
DÎLGA,CL,612,19,8,9,36,78,20,10,108
DOROBANŢU,CL,1209,27,11,0,38,161,37,0,198
VĂRĂŞTI,CL,782,19,10,0,29,82,25,0,107
BOŞNEAGU,CL,314,15,7,0,22,54,18,0,72
DRAGALINA,CL,4884,100,19,0,119,498,51,1,550
"DRAJNA NOUĂ",CL,1073,42,7,0,49,223,29,0,252
"CONSTANTIN BRÂNCOVEANU",CL,766,23,9,0,32,104,25,0,129
"DRAGOŞ VODĂ",CL,2062,92,20,17,129,526,74,35,635
SOCOALELE,CL,183,17,6,8,31,44,25,8,77
FRĂSINET,CL,878,106,17,0,123,304,59,0,363
LUPTĂTORI,CL,455,32,18,0,50,151,69,0,220
PASĂREA,CL,598,68,29,3,100,217,95,3,315
FRUMUŞANI,CL,1892,107,55,4,166,488,171,4,663
PĂDURIŞU,CL,503,77,51,0,128,188,145,0,333
ORĂŞTI,CL,791,35,44,0,79,230,94,0,324
FUNDENI,CL,3690,181,51,0,232,1247,199,0,1446
GĂLBINAŞI,CL,2698,139,28,0,167,707,127,0,834
GRĂDIŞTEA,CL,1775,97,12,0,109,280,41,0,321
RASA,CL,1030,18,5,0,23,88,22,0,110
CUNEŞTI,CL,722,10,7,0,17,67,17,0,84
BOGATA,CL,479,16,3,1,20,82,17,1,100
GURBĂNEŞTI,CL,449,66,21,0,87,137,44,0,181
COŢOFANCA,CL,310,32,21,0,53,87,46,0,133
"VALEA PRESNEI",CL,148,25,38,4,67,49,58,4,111
ILEANA,CL,785,12,7,0,19,86,36,0,122
FLORICA,CL,511,24,5,0,29,66,25,0,91
ŞTEFĂNEŞTI,CL,619,56,18,0,74,207,70,0,277
ARŢARI,CL,497,15,8,0,23,48,24,0,72
INDEPENDENŢA,CL,1796,62,1,0,63,300,16,0,316
VIŞINII,CL,434,15,6,0,21,79,23,0,102
POTCOAVA,CL,662,22,10,0,32,96,42,0,138
JEGĂLIA,CL,1595,50,6,0,56,272,25,10,307
GÎLDĂU,CL,1119,102,15,0,117,350,46,5,401
IEZERU,CL,778,26,6,0,32,120,18,3,141
LEHLIU,CL,1411,45,9,0,54,268,49,0,317
SĂPUNARI,CL,671,37,9,0,46,142,26,0,168
LUICA,CL,1281,74,6,0,80,414,69,0,483
"VALEA STÎNII",CL,436,23,4,0,27,119,60,0,179
NUCETU,CL,521,25,12,0,37,96,33,0,129
LUPŞANU,CL,504,32,9,0,41,142,29,0,171
"RADU VODĂ",CL,968,48,10,0,58,156,40,0,196
PLEVNA,CL,523,49,18,0,67,125,53,0,178
MÂNĂSTIREA,CL,2871,171,21,0,192,685,71,0,756
COCONI,CL,695,172,29,0,201,365,80,10,455
SULTANA,CL,783,43,20,0,63,245,72,0,317
MITRENI,CL,1176,61,3,0,64,266,22,18,306
"VALEA ROŞIE",CL,1839,137,23,16,176,446,69,43,558
CLĂTEŞTI,CL,415,11,7,0,18,56,17,0,73
MODELU,CL,6442,229,14,0,243,895,73,10,978
TONEA,CL,1608,39,5,0,44,219,16,0,235
NANA,CL,1847,118,14,0,132,481,66,8,555
"NICOLAE BĂLCESCU",CL,1008,63,18,0,81,196,60,0,256
"FÎNTÎNA DOAMNEI",CL,220,12,9,0,21,67,40,0,107
PERIŞORU,CL,3640,86,11,1,98,450,32,3,485
"TUDOR VLADIMIRESCU",CL,593,15,4,0,19,67,10,0,77
PLĂTĂREŞTI,CL,1102,71,32,0,103,214,70,0,284
DOROBANŢU,CL,771,41,28,0,69,193,92,0,285
"PODU PITARULUI",CL,799,38,18,0,56,158,55,0,213
RADOVANU,CL,2925,80,15,0,95,519,93,0,612
"VALEA POPII",CL,469,82,13,32,127,195,38,39,272
ROSEŢI,CL,4974,163,10,0,173,627,36,0,663
SĂRULEŞTI-GARĂ,CL,1157,95,17,0,112,286,55,0,341
SĂNDULIŢA,CL,475,5,7,0,12,125,41,0,166
SĂRULEŞTI,CL,338,5,5,0,10,43,23,0,66
SOLACOLU,CL,217,7,8,0,15,27,17,0,44
SOHATU,CL,1303,54,26,0,80,250,102,0,352
PROGRESU,CL,789,49,11,0,60,247,75,0,322
SPANŢOV,CL,834,67,6,15,88,377,47,15,439
"CETATEA VECHE",CL,714,103,8,2,113,319,28,2,349
STANCEA,CL,2087,211,16,0,227,940,85,0,1025
ŞOLDANU,CL,1767,91,36,0,127,422,109,36,567
NEGOEŞTI,CL,823,36,7,10,53,127,45,10,182
"ŞTEFAN CEL MARE",CL,2662,76,9,0,85,496,42,8,546
"ŞTEFAN VODĂ",CL,1897,37,9,0,46,199,32,0,231
"TĂMĂDĂU MARE",CL,1221,41,10,0,51,163,41,0,204
PLUMBUITA,CL,729,15,14,0,29,86,31,0,117
ULMENI,CL,4004,248,33,0,281,923,135,0,1058
ULMU,CL,670,23,4,0,27,76,23,0,99
FĂUREI,CL,344,14,8,0,22,26,22,0,48
ZIMBRU,CL,98,14,9,0,23,21,25,0,46
UNIREA,CL,2304,96,11,0,107,327,38,21,386
"VALEA ARGOVEI",CL,1372,34,18,0,52,152,55,0,207
SILIŞTEA,CL,549,29,11,0,40,114,49,0,163
VASILAŢI,CL,2731,71,50,0,121,514,179,23,716
NUCI,CL,291,18,10,0,28,88,34,1,123
POPEŞTI,CL,278,14,12,0,26,40,30,0,70
VÎLCELELE,CL,932,58,15,66,139,219,43,127,389
FLOROAICA,CL,490,11,9,30,50,67,34,38,139
"VLAD ŢEPEŞ",CL,1257,43,12,0,55,225,43,0,268
"MIHAI VITEAZU",CL,425,14,10,0,24,65,45,0,110
REŞIŢA,CS,69996,3761,229,23,4013,9621,574,33,10228
CÎLNIC,CS,1344,44,3,0,47,183,6,0,189
CUPTOARE,CS,286,19,2,0,21,66,7,0,73
DOMAN,CS,600,11,3,0,14,54,10,0,64
SECU,CS,398,20,2,0,22,53,3,0,56
ŢEROVA,CS,455,22,3,0,25,90,5,0,95
MONIOM,CS,274,32,5,0,37,95,10,1,106
CARANSEBEŞ,CS,24562,1472,201,25,1698,4224,425,49,4698
JUPA,CS,473,29,7,0,36,130,22,0,152
ANINA,CS,7489,378,49,1,428,1027,90,2,1119
"BĂILE HERCULANE",CS,3772,209,556,0,765,589,874,0,1463
PECINIŞCA,CS,505,30,3,0,33,91,11,0,102
BOCŞA,CS,15144,1112,52,0,1164,2923,141,3,3067
"MOLDOVA NOUĂ",CS,9202,671,59,24,754,1804,159,32,1995
MĂCEŞTI,CS,459,33,2,0,35,165,6,0,171
"MOLDOVA VECHE",CS,1284,109,9,0,118,310,20,0,330
MOLDOVIŢA,CS,180,16,10,0,26,97,26,0,123
ORAVIŢA,CS,8867,443,78,1,522,1357,176,1,1534
AGADICI,CS,156,20,16,0,36,60,23,0,83
"BRĂDIŞORU DE JOS",CS,459,15,8,0,23,71,17,0,88
BROŞTENI,CS,525,51,10,0,61,158,19,0,177
"CICLOVA MONTANĂ",CS,439,36,7,0,43,93,16,0,109
RĂCHITOVA,CS,309,24,11,0,35,71,20,0,91
MARILA,CS,27,5,10,0,15,12,23,0,35
"OŢELU ROŞU",CS,10075,691,56,0,747,1886,142,0,2028
MAL,CS,297,40,11,0,51,161,18,0,179
"SUB MARGINE",CS,145,5,1,0,6,43,4,0,47
ARMENIŞ,CS,1100,58,2,0,60,335,32,0,367
FENEŞ,CS,462,35,10,0,45,117,29,0,146
"SAT BĂTRÎN",CS,301,24,2,0,26,105,11,0,116
BĂNIA,CS,950,79,6,0,85,368,17,0,385
GÎRBOVĂŢ,CS,470,26,4,0,30,137,19,0,156
BĂUŢAR,CS,1336,83,13,0,96,522,36,3,561
BUCOVA,CS,752,17,7,0,24,269,20,0,289
BERLIŞTE,CS,302,31,6,0,37,73,14,0,87
IAM,CS,301,5,2,0,7,62,10,0,72
MILCOVENI,CS,195,19,4,0,23,44,17,0,61
"RUSOVA NOUĂ",CS,162,12,11,0,23,38,20,0,58
BERZASCA,CS,1165,332,19,1,352,811,50,1,862
BIGĂR,CS,182,41,5,0,46,121,7,0,128
LIUBCOVA,CS,904,332,2,0,334,693,9,0,702
BERZOVIA,CS,1746,69,8,0,77,279,31,0,310
FIZEŞ,CS,623,29,6,0,35,90,13,0,103
GHERTENIŞ,CS,789,27,7,0,34,141,22,0,163
BOLVAŞNIŢA,CS,387,16,3,0,19,135,10,0,145
VÎRCIOROVA,CS,757,29,0,0,29,259,11,0,270
BOZOVICI,CS,1812,156,13,0,169,603,83,1,687
PRILIPEŢ,CS,592,52,9,0,61,256,23,0,279
APADIA,CS,198,6,3,0,9,31,10,0,41
BREBU,CS,567,18,2,0,20,144,49,0,193
VALEADENI,CS,200,13,8,0,21,58,41,0,99
GĂRÎNA,CS,269,5,17,0,22,13,27,0,40
POIANA,CS,524,40,0,0,40,300,23,10,333
BUCHIN,CS,748,55,5,0,60,210,26,0,236
"VALEA TIMIŞULUI",CS,428,24,0,0,24,147,18,0,165
BUCOŞNIŢA,CS,611,18,4,0,22,234,15,0,249
PETROŞNIŢA,CS,799,60,6,0,66,348,32,0,380
GOLEŢ,CS,446,47,2,0,49,240,18,0,258
VĂLIŞOARA,CS,529,27,11,0,38,171,27,0,198
CARAŞOVA,CS,1919,41,3,0,44,221,12,0,233
IABALCEA,CS,162,9,1,0,10,50,9,0,59
NERMED,CS,439,11,0,0,11,122,10,0,132
CĂRBUNARI,CS,539,49,8,0,57,281,37,9,327
ŞTINĂPARI,CS,286,43,14,0,57,139,29,0,168
"CICLOVA ROMÂNĂ",CS,940,51,13,0,64,196,37,0,233
ILIDIA,CS,285,9,5,0,14,75,45,0,120
SOCOLARI,CS,116,19,5,0,24,50,33,0,83
CIUCHICI,CS,425,55,9,0,64,141,24,0,165
MACOVIŞTE,CS,79,17,10,0,27,40,25,0,65
PETRILOVA,CS,120,22,11,0,33,36,25,0,61
NICOLINŢ,CS,249,28,7,0,35,68,17,0,85
JITIN,CS,102,14,0,0,14,48,10,0,58
CIUDANOVIŢA,CS,412,38,5,0,43,96,18,0,114
MACIOVA,CS,392,25,5,0,30,96,16,0,112
ZĂGUJENI,CS,452,18,2,0,20,125,17,2,144
"MÎTNICU MARE",CS,310,18,8,0,26,92,19,0,111
PEŞTERE,CS,181,5,5,0,10,54,25,0,79
PRISACA,CS,357,18,5,0,23,96,12,4,112
CĂVĂRAN,CS,587,21,5,0,26,165,18,0,183
COPĂCELE,CS,314,16,3,0,19,99,23,8,130
OHABA-MÎTNIC,CS,232,40,14,0,54,134,48,6,188
RUGINOSU,CS,98,6,3,0,9,37,6,0,43
ZORILE,CS,317,11,2,0,13,95,17,0,112
CORNEA,CS,619,17,2,0,19,98,10,0,108
CRUŞOVĂŢ,CS,370,30,6,0,36,112,19,0,131
CUPTOARE,CS,503,38,0,0,38,256,32,0,288
CORNEREVA,CS,466,24,4,10,38,132,14,14,160
BOGÎLTIN,CS,334,9,3,0,12,80,15,0,95
DOBRAIA,CS,64,7,2,0,9,24,6,0,30
DOLINA,CS,648,21,3,1,25,232,13,1,246
GRUNI,CS,786,29,1,0,30,224,5,8,237
INELEŢ,CS,84,7,2,0,9,22,3,0,25
"SFÎNTA ELENA",CS,451,52,3,0,55,170,7,1,178
CORONINI,CS,1147,306,18,0,324,576,36,9,621
DALBOŞEŢ,CS,847,57,5,0,62,237,28,4,269
"ŞOPOTU VECHI",CS,526,49,7,0,56,187,18,0,205
DOCLIN,CS,425,24,5,0,29,94,19,0,113
BINIŞ,CS,653,39,3,0,42,128,11,0,139
TIROL,CS,542,6,6,0,12,65,11,0,76
CALINA,CS,79,5,7,0,12,22,11,0,33
DOGNECEA,CS,1544,126,14,0,140,374,37,0,411
DOMAŞNEA,CS,801,33,9,0,42,267,43,0,310
CĂNICEA,CS,307,7,2,0,9,66,8,0,74
"EFTIMIE MURGU",CS,1330,157,10,0,167,516,24,0,540
EZERIŞ,CS,540,6,1,0,7,56,15,0,71
SOCENI,CS,540,8,2,0,10,52,17,0,69
FÎRLIUG,CS,647,26,1,0,27,140,39,0,179
DEZEŞTI,CS,149,14,5,0,19,83,39,0,122
DULEU,CS,163,10,10,0,20,84,26,0,110
SCĂIUŞ,CS,236,17,3,0,20,65,13,0,78
"VALEA MARE",CS,93,6,3,0,9,42,16,0,58
REMETEA-POGĂNICI,CS,172,9,2,0,11,32,9,0,41
COMORÎŞTE,CS,464,34,5,0,39,189,20,0,209
"SURDUCU MARE",CS,364,16,7,0,23,89,21,0,110
FOROTIC,CS,566,26,7,0,33,141,17,0,158
GÎRNIC,CS,397,6,0,0,6,54,11,2,67
"PADINA MATEI",CS,739,56,2,0,58,273,18,10,301
GLIMBOCA,CS,1544,150,10,0,160,476,18,41,535
GORUIA,CS,312,22,1,0,23,78,14,0,92
GIURGIOVA,CS,128,9,6,0,15,44,29,0,73
GÎRLIŞTE,CS,216,14,16,0,30,42,33,0,75
GRĂDINARI,CS,872,44,7,0,51,155,31,1,187
GREONI,CS,794,32,5,0,37,82,11,0,93
IABLANIŢA,CS,613,47,5,0,52,275,26,0,301
"GLOBU CRAIOVEI",CS,546,54,13,0,67,225,29,0,254
PETNIC,CS,618,41,8,0,49,255,22,0,277
LĂPUŞNICEL,CS,397,40,26,0,66,146,66,1,213
PÎRVOVA,CS,355,69,14,0,83,242,44,0,286
ŞUMIŢA,CS,70,27,0,0,27,51,5,0,56
"LĂPUŞNICU MARE",CS,902,86,7,0,93,304,25,0,329
MOCERIŞ,CS,471,29,6,0,35,163,24,0,187
LUNCAVIŢA,CS,671,13,1,0,14,91,4,0,95
VERENDIN,CS,1332,15,0,0,15,132,8,0,140
LUPAC,CS,743,17,1,0,18,82,8,0,90
CLOCOTICI,CS,705,24,7,0,31,86,16,0,102
RAFNIC,CS,437,16,1,0,17,43,1,0,44
VODNIC,CS,344,4,4,0,8,20,5,0,25
MARGA,CS,908,100,5,0,105,365,27,13,405
MĂURENI,CS,1501,63,1,0,64,231,21,0,252
ŞOŞDEA,CS,684,29,4,0,33,141,18,0,159
GLOBURĂU,CS,196,8,2,0,10,34,6,0,40
PLUGOVA,CS,670,25,4,0,29,120,12,0,132
"VALEA BOLVAŞNIŢA",CS,560,50,13,0,63,167,36,0,203
MEHADIA,CS,1991,79,9,0,88,245,26,0,271
MEHADICA,CS,584,32,3,0,35,247,23,0,270
LESCOVIŢA,CS,212,21,6,0,27,76,34,0,110
NAIDĂŞ,CS,664,42,6,0,48,134,19,7,160
OBREJA,CS,1482,106,8,0,114,440,31,0,471
CIUTA,CS,299,35,7,0,42,154,22,0,176
IAZ,CS,592,70,10,0,80,225,45,0,270
VAR,CS,325,26,10,0,36,146,58,5,209
"OCNA DE FIER",CS,591,47,7,0,54,108,9,0,117
PĂLTINIŞ,CS,570,46,2,0,48,159,20,0,179
OHABIŢA,CS,65,3,5,0,8,26,13,0,39
CORNUŢEL,CS,846,32,7,0,39,162,25,0,187
DELINEŞTI,CS,353,11,6,0,17,85,25,0,110
RUGI,CS,221,6,1,0,7,43,12,0,55
POJEJENA,CS,925,69,6,0,75,323,36,0,359
BELOBREŞCA,CS,498,48,2,0,50,142,34,0,176
RADIMNA,CS,444,54,3,0,57,174,9,0,183
DIVICI,CS,215,21,12,0,33,90,23,0,113
ŞUŞCA,CS,377,85,6,0,91,177,17,0,194
"BORLOVENII VECHI",CS,374,59,10,0,69,190,24,0,214
"BORLOVENII NOI",CS,340,25,6,0,31,146,16,7,169
PĂTAŞ,CS,439,30,2,0,32,150,14,5,169
PUTNA,CS,135,16,8,0,24,63,11,0,74
PRIGOR,CS,750,45,10,0,55,209,21,0,230
RAMNA,CS,976,37,3,0,40,276,30,0,306
VALEAPAI,CS,336,28,7,0,35,81,41,0,122
RĂCĂŞDIA,CS,1340,59,5,0,64,215,24,0,239
VRĂNIUŢ,CS,297,10,8,0,18,40,23,0,63
"RUSCA MONTANĂ",CS,1326,40,2,0,42,337,19,1,357
RUŞCHIŢA,CS,283,18,2,0,20,54,7,0,61
TINCOVA,CS,364,15,6,0,21,71,22,0,93
SACU,CS,662,13,4,0,17,139,19,0,158
"SĂLBĂGELU NOU",CS,205,26,4,0,30,104,18,2,124
BOGODINŢ,CS,83,8,18,0,26,39,37,0,76
"SASCA ROMÂNĂ",CS,284,20,4,0,24,72,9,0,81
SLATINA-NERA,CS,294,109,25,0,134,169,55,5,229
"SASCA MONTANĂ",CS,404,31,10,0,41,92,29,0,121
POTOC,CS,215,24,8,0,32,89,23,0,112
GORNEA,CS,457,57,8,0,65,240,34,15,289
SICHEVIŢA,CS,1262,74,2,0,76,325,24,2,351
LIBORAJDEA,CS,85,1,10,0,11,7,16,0,23
SLATINA-TIMIŞ,CS,1407,63,6,0,69,305,12,0,317
ILOVA,CS,617,32,3,0,35,244,8,0,252
"SADOVA NOUĂ",CS,193,11,3,0,14,78,5,0,83
"SADOVA VECHE",CS,313,15,3,0,18,54,9,0,63
SOCOL,CS,597,44,3,0,47,194,13,14,221
BAZIAŞ,CS,47,2,10,0,12,11,23,1,35
CÎMPIA,CS,463,30,3,0,33,133,15,16,164
ZLATIŢA,CS,617,89,8,0,97,267,22,15,304
"ŞOPOTU NOU",CS,275,39,11,0,50,114,26,1,141
RAVENSCA,CS,113,9,0,0,9,38,4,0,42
RĂCHITA,CS,100,5,1,0,6,29,5,0,34
STĂNCILOVA,CS,219,28,9,0,37,69,11,0,80
"VALEA ROŞIE",CS,212,28,4,0,32,103,10,0,113
TEREGOVA,CS,2338,99,5,0,104,692,29,0,721
RUSCA,CS,975,26,4,0,30,231,18,0,249
CÎRNECEA,CS,260,8,7,0,15,38,10,0,48
SECĂŞENI,CS,298,13,6,0,19,49,23,0,72
"TICVANIU MIC",CS,268,19,6,0,25,66,10,0,76
"TICVANIU MARE",CS,699,12,5,0,17,53,14,0,67
TÎRNOVA,CS,1373,52,7,0,59,262,28,0,290
TOPLEŢ,CS,1159,61,4,2,67,211,16,2,229
BÎRZA,CS,1037,53,8,0,61,190,29,0,219
"TURNU RUIENI",CS,704,34,5,0,39,215,14,0,229
BORLOVA,CS,1172,155,23,0,178,495,42,0,537
DALCI,CS,216,13,3,0,16,76,16,0,92
ZERVEŞTI,CS,441,39,7,0,46,156,18,0,174
ZLAGNA,CS,255,31,2,0,33,141,15,0,156
VĂLIUG,CS,657,14,6,0,20,55,20,0,75
VĂRĂDIA,CS,647,62,10,0,72,205,32,0,237
MERCINA,CS,475,20,7,0,27,137,14,0,151
ERSIG,CS,250,10,4,0,14,46,11,0,57
IZGAR,CS,244,9,6,0,15,45,15,0,60
VERMEŞ,CS,799,33,8,0,41,214,35,4,253
VRANI,CS,705,35,15,0,50,145,25,0,170
CIORTEA,CS,143,19,5,0,24,50,13,0,63
ZĂVOI,CS,1493,80,7,0,87,310,29,0,339
MĂGURA,CS,447,31,2,0,33,155,5,0,160
MĂRU,CS,890,36,8,0,44,257,23,0,280
"POIANA MĂRULUI",CS,59,4,10,0,14,8,28,0,36
VOISLOVA,CS,481,24,3,0,27,151,10,0,161
ZORLENCIOR,CS,112,16,15,0,31,40,44,0,84
"ZORLENŢU MARE",CS,681,13,18,0,31,137,92,0,229
CONSTANŢA,CT,264330,15498,1191,38,16727,38259,2826,123,41208
MAMAIA,CT,277,9,17,0,26,26,26,0,52
MANGALIA,CT,32380,1617,290,0,1907,4343,522,10,4875
NEPTUN,CT,1877,44,42,0,86,171,79,0,250
MEDGIDIA,CT,35120,1760,116,1,1877,4863,260,1,5124
"VALEA DACILOR",CT,1244,31,5,0,36,116,9,0,125
"REMUS OPREANU",CT,295,24,3,0,27,42,4,0,46
BĂNEASA,CT,2755,62,15,0,77,377,42,0,419
NEGURENI,CT,575,6,8,0,14,115,13,0,128
FĂUREI,CT,976,22,1,0,23,199,6,0,205
CERNAVODĂ,CT,15537,467,54,0,521,1436,137,0,1573
"EFORIE SUD",CT,4041,149,58,0,207,458,122,0,580
"EFORIE NORD",CT,5255,219,268,0,487,558,456,0,1014
HÂRŞOVA,CT,8427,229,21,0,250,873,63,0,936
"VADU OII",CT,316,7,3,0,10,41,7,0,48
MURFATLAR,CT,8150,337,21,0,358,1093,76,0,1169
SIMINOC,CT,996,40,1,0,41,168,12,0,180
NĂVODARI,CT,34613,1514,130,0,1644,3893,346,0,4239
"NEGRU VODĂ",CT,3729,116,15,0,131,363,56,0,419
DARABANI,CT,611,29,4,0,33,107,7,0,114
VÎLCELELE,CT,196,10,4,0,14,19,6,0,25
OVIDIU,CT,10899,333,34,0,367,1188,99,0,1287
POIANA,CT,862,29,3,0,32,90,38,0,128
CULMEA,CT,1041,58,10,0,68,173,21,0,194
TECHIRGHIOL,CT,6795,256,148,0,404,758,304,7,1069
"23 AUGUST",CT,2564,65,2,0,67,240,29,0,269
DULCEŞTI,CT,1124,24,3,0,27,64,7,0,71
MOŞNENI,CT,1048,12,2,0,14,43,9,0,52
ADAMCLISI,CT,962,48,9,0,57,159,25,10,194
ZORILE,CT,497,11,2,0,13,72,6,0,78
URLUIA,CT,288,10,4,0,14,36,15,0,51
ABRUD,CT,112,8,2,0,10,18,2,0,20
AGIGEA,CT,5192,317,50,0,367,989,108,17,1114
LAZU,CT,1604,83,24,2,109,270,62,2,334
ALBEŞTI,CT,1277,28,1,0,29,132,11,0,143
ARSA,CT,511,9,4,0,13,34,7,0,41
"COTU VĂII",CT,895,19,3,0,22,58,9,0,67
COROANA,CT,95,4,3,0,7,24,7,0,31
VÎRTOP,CT,218,12,2,0,14,49,4,0,53
ALIMAN,CT,661,18,4,0,22,47,13,0,60
DUNĂRENI,CT,1126,24,1,0,25,69,1,0,70
VLAHII,CT,408,10,1,0,11,39,6,0,45
AMZACEA,CT,1186,23,3,0,26,93,4,0,97
"GENERAL SCĂRIŞOREANU",CT,790,16,6,0,22,64,11,0,75
CASICEA,CT,353,31,0,0,31,74,5,0,79
BĂRĂGANU,CT,928,42,3,0,45,163,4,0,167
LANURILE,CT,749,6,1,0,7,45,4,0,49
CASTELU,CT,2512,74,5,0,79,258,15,0,273
NISIPARI,CT,1560,40,13,0,53,174,19,0,193
CERCHEZU,CT,416,25,5,0,30,158,28,0,186
CĂSCIOARELE,CT,228,21,2,0,23,87,8,0,95
VIROAGA,CT,389,3,7,0,10,31,11,0,42
MĂGURA,CT,70,15,2,0,17,35,10,0,45
CHIRNOGENI,CT,1506,35,5,0,40,189,22,1,212
PLOPENI,CT,865,12,2,0,14,46,13,0,59
CREDINŢA,CT,246,8,5,0,13,38,6,0,44
CIOBANU,CT,2534,57,7,0,64,228,17,0,245
MIORIŢA,CT,260,11,3,0,14,40,8,0,48
CIOCÎRLIA,CT,1256,57,7,0,64,250,19,0,269
"CIOCÎRLIA DE SUS",CT,1175,43,7,0,50,144,16,0,160
COBADIN,CT,5438,70,16,0,86,286,32,0,318
CONACU,CT,290,1,1,0,2,14,4,0,18
NEGREŞTI,CT,373,19,1,0,20,39,19,0,58
VIIŞOARA,CT,1294,32,6,0,38,118,15,0,133
COGEALAC,CT,2912,75,17,0,92,255,37,0,292
TARIVERDE,CT,847,16,5,0,21,92,9,0,101
"RÎMNICU DE JOS",CT,690,14,4,0,18,42,16,0,58
COMANA,CT,804,37,1,0,38,73,5,0,78
TĂTARU,CT,531,9,0,0,9,28,4,0,32
PELINU,CT,232,4,4,0,8,24,6,0,30
CORBU,CT,4554,140,28,0,168,497,80,0,577
VADU,CT,537,19,8,0,27,63,25,0,88
COSTINEŞTI,CT,958,49,2,0,51,135,55,0,190
SCHITU,CT,1758,62,11,0,73,246,32,0,278
CRUCEA,CT,921,27,6,0,33,84,27,0,111
GĂLBIORI,CT,254,7,0,0,7,32,2,0,34
BĂLTĂGEŞTI,CT,323,6,1,0,7,22,6,0,28
CRIŞAN,CT,291,6,0,0,6,32,2,0,34
STUPINA,CT,559,17,2,0,19,92,6,0,98
ŞIRIU,CT,175,3,0,0,3,13,0,0,13
CUMPĂNA,CT,11789,415,64,1,480,1497,155,2,1654
"CUZA VODĂ",CT,3108,38,2,0,40,192,14,0,206
DELENI,CT,328,26,1,0,27,83,7,6,96
PIETRENI,CT,692,31,1,0,32,166,12,6,184
ŞIPOTELE,CT,424,18,3,0,21,82,19,4,105
PETROŞANI,CT,455,41,5,0,46,113,14,7,134
DOBROMIR,CT,715,127,2,0,129,249,6,0,255
"DOBROMIRU DIN DEAL",CT,264,6,5,0,11,46,11,0,57
LESPEZI,CT,373,76,0,0,76,153,8,0,161
VĂLENI,CT,618,147,6,0,153,231,7,1,239
PĂDURENI,CT,117,1,3,0,4,24,6,0,30
CETATEA,CT,177,10,0,0,10,47,0,0,47
DUMBRĂVENI,CT,376,21,13,0,34,109,28,0,137
FURNICA,CT,52,11,14,0,25,26,24,0,50
FÎNTÎNELE,CT,1310,30,4,0,34,103,11,0,114
GÂRLICIU,CT,1298,19,2,0,21,117,13,3,133
GHINDĂREŞTI,CT,2237,21,4,0,25,128,11,0,139
GRĂDINA,CT,583,40,1,0,41,168,17,0,185
CHEIA,CT,295,18,6,0,24,82,11,0,93
HORIA,CT,698,16,17,0,33,72,25,0,97
TICHILEŞTI,CT,274,10,3,0,13,30,6,0,36
INDEPENDENŢA,CT,980,10,1,0,11,79,13,0,92
"MOVILA VERDE",CT,507,10,0,0,10,51,12,0,63
OLTENI,CT,315,10,2,0,12,39,10,0,49
TUFANI,CT,266,11,2,0,13,50,4,0,54
"FÎNTÎNA MARE",CT,291,10,0,0,10,19,2,0,21
"ION CORVIN",CT,504,23,10,0,33,136,17,7,160
VIILE,CT,787,32,2,2,36,177,11,22,210
RARIŞTEA,CT,195,5,4,0,9,58,16,0,74
CRÎNGU,CT,78,10,3,0,13,29,13,0,42
ISTRIA,CT,1109,31,4,0,35,161,20,0,181
NUNTAŞI,CT,868,18,3,0,21,75,10,0,85
LIMANU,CT,2769,58,6,0,64,279,24,0,303
"2 MAI",CT,2697,59,14,0,73,265,47,0,312
LIPNIŢA,CT,766,16,15,0,31,68,33,0,101
COSLUGEA,CT,616,13,2,0,15,48,4,0,52
CANLIA,CT,424,16,2,0,18,66,12,0,78
CARVĂN,CT,338,7,5,0,12,45,17,0,62
IZVOARELE,CT,96,13,10,0,23,29,12,0,41
GORUNI,CT,80,10,3,0,13,18,4,0,22
CUIUGIUC,CT,153,12,5,0,17,40,5,0,45
LUMINA,CT,7837,187,37,0,224,692,127,0,819
OITUZ,CT,693,9,1,0,10,50,6,0,56
SIBIOARA,CT,349,23,4,0,27,62,12,0,74
MERENI,CT,1110,23,1,0,24,96,7,0,103
OSMANCEA,CT,474,18,0,0,18,87,11,0,98
CIOBĂNIŢA,CT,227,14,4,0,18,40,11,0,51
"MIHAI VITEAZU",CT,1560,22,0,0,22,140,2,0,142
SINOIE,CT,1172,21,1,0,22,67,7,0,74
"MIHAIL KOGĂLNICEANU",CT,7138,206,25,0,231,705,74,0,779
PIATRA,CT,957,13,4,0,17,66,22,0,88
"PALAZU MIC",CT,266,2,6,0,8,15,11,0,26
"MIRCEA VODĂ",CT,1691,54,3,0,57,241,18,0,259
"SATU NOU",CT,2277,69,3,0,72,338,27,0,365
"NICOLAE BĂLCESCU",CT,2795,63,7,0,70,263,23,0,286
DOROBANŢU,CT,1516,36,0,0,36,143,0,0,143
OLTINA,CT,1426,31,8,0,39,151,18,0,169
RĂZOARELE,CT,507,12,8,0,20,79,26,0,105
"SATU NOU",CT,161,6,1,0,7,25,9,0,34
OSTROV,CT,2085,45,11,0,56,212,29,0,241
ALMĂLĂU,CT,684,18,6,0,24,81,17,0,98
ESECHIOI,CT,191,14,3,0,17,65,9,0,74
GÎRLIŢA,CT,241,25,2,0,27,102,14,0,116
GALIŢA,CT,559,28,7,0,35,85,11,0,96
BUGEAC,CT,155,8,3,0,11,35,11,0,46
PANTELIMON,CT,590,20,0,0,20,75,2,0,77
"PANTELIMON DE JOS",CT,217,5,1,0,6,16,6,0,22
RUNCU,CT,347,15,3,0,18,30,7,0,37
NISTOREŞTI,CT,233,6,2,0,8,20,5,0,25
PECINEAGA,CT,2667,55,13,0,68,185,28,0,213
PEŞTERA,CT,1544,35,5,0,40,207,14,0,221
"IVRINEZU MARE",CT,710,15,5,0,20,78,15,0,93
"IZVORU MARE",CT,593,26,8,0,34,78,11,0,89
"POARTA ALBĂ",CT,3925,124,11,477,612,431,37,477,945
NAZARCEA,CT,424,20,0,0,20,56,2,0,58
RASOVA,CT,2024,26,0,0,26,120,7,0,127
COCHIRLENI,CT,927,18,2,0,20,78,11,0,89
FĂCLIA,CT,695,23,4,0,27,66,9,0,75
SALIGNY,CT,705,35,5,0,40,112,16,0,128
"ŞTEFAN CEL MARE",CT,447,11,7,0,18,51,15,0,66
SARAIU,CT,614,146,19,0,165,320,32,39,391
DULGHERU,CT,445,33,9,0,42,133,12,18,163
SĂCELE,CT,1923,70,3,0,73,185,21,0,206
"SEIMENII MICI",CT,721,21,1,0,22,79,4,0,83
SEIMENI,CT,460,20,2,0,22,57,13,0,70
DUNĂREA,CT,559,27,6,0,33,90,10,0,100
SILIŞTEA,CT,549,29,11,0,40,129,19,0,148
"TEPEŞ VODĂ",CT,612,78,5,0,83,183,11,13,207
TÂRGUŞOR,CT,1080,47,12,0,59,186,26,0,212
MIREASA,CT,265,16,8,0,24,39,13,0,52
TOPALU,CT,1415,37,9,0,46,116,26,0,142
TOPRAISAR,CT,2913,92,16,0,108,379,49,0,428
BIRUINŢA,CT,644,16,1,0,17,65,4,0,69
MOVILIŢA,CT,916,21,2,0,23,94,15,0,109
POTÎRNICHEA,CT,400,24,12,0,36,73,32,0,105
TORTOMAN,CT,1462,43,4,0,47,195,14,0,209
TUZLA,CT,5981,173,32,0,205,563,77,0,640
"VALU LUI TRAIAN",CT,12611,353,38,129,520,1231,165,129,1525
VULTURU,CT,574,15,0,0,15,71,4,0,75
"SFÎNTU GHEORGHE",CV,52285,1246,155,0,1401,3747,385,4,4136
CHILIENI,CV,730,12,0,0,12,50,0,0,50
COŞENI,CV,422,5,0,0,5,23,8,0,31
"TÂRGU SECUIESC",CV,15394,160,14,0,174,769,120,0,889
LUNGA,CV,1298,13,3,0,16,94,15,0,109
BIBORŢENI,CV,592,15,0,0,15,58,5,0,63
BODOŞ,CV,347,5,5,0,10,13,6,0,19
CĂPENI,CV,875,0,1,0,1,14,5,0,19
"RACOŞUL DE SUS",CV,738,11,3,0,14,23,6,0,29
BARAOLT,CV,4702,54,6,0,60,221,24,0,245
MICLOŞOARA,CV,366,4,2,0,6,18,7,0,25
CHIURUŞ,CV,404,4,0,0,4,16,7,0,23
COVASNA,CV,8905,147,513,0,660,593,903,0,1496
"ÎNTORSURA BUZĂULUI",CV,5231,185,30,0,215,856,62,0,918
BRĂDET,CV,957,16,0,0,16,117,9,0,126
FLOROAIA,CV,1173,21,2,0,23,148,17,0,165
"AITA MARE",CV,723,3,1,0,4,12,7,0,19
"AITA MEDIE",CV,630,5,0,0,5,12,4,0,16
ARCUŞ,CV,1314,6,0,0,6,39,8,0,47
BARCANI,CV,1973,72,11,0,83,285,19,0,304
LĂDĂUŢI,CV,546,14,6,0,20,77,7,0,84
SĂRĂMĂŞ,CV,574,17,4,0,21,138,42,0,180
"BĂŢANII MARI",CV,1636,12,2,0,14,64,6,0,70
"BĂŢANII MICI",CV,452,3,3,0,6,6,7,0,13
HERCULIAN,CV,875,8,4,0,12,42,8,0,50
"AITA SEACĂ",CV,555,4,1,0,5,25,5,0,30
BELIN,CV,1070,15,3,0,18,83,12,1,96
BELIN-VALE,CV,1054,6,4,0,10,202,14,0,216
BIXAD,CV,1423,25,1,0,26,97,2,0,99
BODOC,CV,945,8,6,0,14,28,7,0,35
ZĂLAN,CV,522,4,3,0,7,8,9,0,17
OLTENI,CV,528,5,3,0,8,27,5,0,32
"BOROŞNEU MIC",CV,1605,10,8,0,18,35,12,0,47
"DOBOLII DE SUS",CV,188,1,1,0,2,3,7,0,10
LEŢ,CV,517,0,1,0,1,3,7,0,10
ŢUFALĂU,CV,175,2,1,0,3,12,6,0,18
BRATEŞ,CV,463,2,0,0,2,16,10,0,26
TELECHIA,CV,458,5,1,0,6,8,5,0,13
PACHIA,CV,265,0,0,0,0,8,6,0,14
BRĂDUŢ,CV,724,11,0,0,11,31,2,0,33
TĂLIŞOARA,CV,611,5,2,0,7,41,5,0,46
DOBOŞENI,CV,1410,9,2,0,11,71,5,0,76
FILIA,CV,975,22,1,0,23,47,3,0,50
BREŢCU,CV,2041,42,1,0,43,171,10,0,181
MĂRTĂNUŞ,CV,618,13,5,0,18,66,15,0,81
OITUZ,CV,258,5,0,0,5,41,7,0,48
CATALINA,CV,1117,7,0,0,7,38,3,0,41
IMENI,CV,250,3,0,0,3,8,8,0,16
HĂTUICA,CV,386,4,2,0,6,23,9,0,32
MĂRTINENI,CV,505,2,6,0,8,8,7,0,15
MĂRCUŞA,CV,511,6,0,0,6,20,7,0,27
CERNAT,CV,2726,21,15,0,36,126,24,0,150
ALBIŞ,CV,335,4,0,0,4,19,12,0,31
ICAFALĂU,CV,213,5,4,0,9,30,6,0,36
CHICHIŞ,CV,870,17,4,0,21,53,8,0,61
BĂCEL,CV,444,18,3,0,21,87,14,0,101
COMANDĂU,CV,820,4,5,0,9,23,12,0,35
DALNIC,CV,740,7,4,0,11,21,6,0,27
DOBÎRLĂU,CV,885,21,5,0,26,109,26,0,135
"VALEA DOBÎRLĂULUI",CV,251,7,0,0,7,29,5,0,34
MĂRCUŞ,CV,332,21,5,0,26,141,39,0,180
"LUNCA MĂRCUŞULUI",CV,295,22,7,0,29,79,18,0,97
ESTELNIC,CV,668,18,5,0,23,53,16,0,69
"VALEA SCURTĂ",CV,206,3,5,0,8,22,10,0,32
GHELINŢA,CV,3925,29,0,0,29,243,9,0,252
HARALE,CV,199,0,0,0,0,23,7,0,30
GHIDFALĂU,CV,917,8,2,0,10,24,13,0,37
ANGHELUŞ,CV,538,7,1,0,8,22,3,0,25
ZOLTAN,CV,349,4,0,0,4,13,0,0,13
FOTOŞ,CV,300,1,0,0,1,4,2,0,6
HĂGHIG,CV,1363,25,9,0,34,126,17,0,143
IARĂŞ,CV,347,4,6,0,10,63,21,0,84
ILIENI,CV,877,12,3,0,15,50,6,0,56
SÎNCRAIU,CV,344,2,0,0,2,16,7,0,23
"DOBOLII DE JOS",CV,438,2,6,0,8,15,11,0,26
LEMNIA,CV,1559,17,0,0,17,86,13,0,99
MALNAŞ,CV,418,4,0,0,4,15,3,0,18
MALNAŞ-BĂI,CV,358,10,8,0,18,15,15,0,30
"VALEA ZĂLANULUI",CV,104,6,5,0,11,14,9,0,23
MERENI,CV,720,9,2,0,11,46,5,0,51
LUTOASA,CV,353,6,3,0,9,20,3,0,23
MICFALĂU,CV,1484,25,1,0,26,59,4,0,63
MOACŞA,CV,740,6,2,0,8,17,14,0,31
PĂDURENI,CV,261,5,6,0,11,10,12,0,22
OJDULA,CV,2715,21,1,0,22,130,10,0,140
HILIB,CV,205,4,7,0,11,33,7,0,40
OZUN,CV,2188,19,5,0,24,85,12,0,97
SÎNTIONLUNCA,CV,615,2,4,0,6,16,12,0,28
LISNĂU,CV,443,7,5,0,12,34,17,0,51
BICFALĂU,CV,281,3,1,0,4,9,3,0,12
MĂGHERUŞ,CV,87,2,3,0,5,8,7,0,15
"LUNCA OZUNULUI",CV,148,3,1,0,4,34,9,0,43
POIAN,CV,1011,10,0,0,10,86,3,0,89
BELANI,CV,392,5,5,0,10,49,6,0,55
RECI,CV,1167,6,5,0,11,18,9,0,27
ANINOASA,CV,334,1,3,0,4,6,7,0,13
BITA,CV,229,0,6,0,6,3,6,0,9
SACIOVA,CV,105,3,2,0,5,17,9,0,26
"SITA BUZĂULUI",CV,2935,111,37,0,148,508,64,0,572
ZĂBRĂTĂU,CV,445,14,8,0,22,116,11,0,127
CRASNA,CV,459,12,9,0,21,98,10,0,108
SÎNZIENI,CV,2210,11,11,0,22,157,13,0,170
"CAŞINU MIC",CV,225,1,1,0,2,24,3,0,27
PETRICENI,CV,746,5,6,0,11,15,6,0,21
"VALEA SEACĂ",CV,515,6,1,0,7,16,3,0,19
TURIA,CV,2896,13,5,0,18,80,17,0,97
ALUNGENI,CV,239,6,0,0,6,31,6,0,37
"VALEA CRIŞULUI",CV,1402,15,0,0,15,44,3,0,47
CALNIC,CV,430,1,1,0,2,22,3,0,25
"VALEA MARE",CV,935,19,5,0,24,154,15,0,169
ARACI,CV,1496,29,6,0,35,101,15,2,118
ARIUŞD,CV,360,10,4,0,14,42,13,0,55
HETEA,CV,241,5,0,0,5,41,0,0,41
VÎLCELE,CV,1006,47,15,0,62,176,43,0,219
VÎRGHIŞ,CV,1500,19,3,0,22,49,5,0,54
ZAGON,CV,3196,34,9,0,43,179,23,0,202
PĂPĂUŢI,CV,1026,17,7,0,24,61,13,0,74
ZĂBALA,CV,2796,30,7,0,37,151,32,0,183
TAMAŞFALĂU,CV,422,0,2,0,2,14,7,0,21
SURCEA,CV,502,7,0,0,7,15,3,0,18
PETENI,CV,121,0,1,0,1,12,6,0,18
TÎRGOVIŞTE,DB,76758,4639,364,146,5149,12285,962,148,13395
MORENI,DB,16991,943,72,20,1035,2575,197,20,2792
COSTEŞTI,DB,662,58,5,0,63,166,16,1,183
BEREVOEŞTI,DB,556,62,3,0,65,165,10,0,175
FIENI,DB,5264,324,14,1,339,879,48,7,934
GĂEŞTI,DB,12735,815,78,194,1087,2338,205,194,2737
PUCIOASA,DB,10406,657,152,1,810,1851,381,50,2282
DIACONEŞTI,DB,844,22,5,0,27,168,15,0,183
GLODENI,DB,1036,31,11,0,42,199,35,0,234
MALURILE,DB,105,16,2,0,18,48,7,0,55
PUCIOASA-SAT,DB,349,24,1,0,25,78,7,0,85
RĂCARI,DB,1695,195,59,84,338,692,145,87,924
GHERGANI,DB,604,56,25,30,111,201,60,87,348
MAVRODIN,DB,807,112,29,28,169,300,85,28,413
GHIMPAŢI,DB,636,84,25,0,109,295,83,35,413
COLACU,DB,709,92,45,70,207,219,69,70,358
SĂBIEŞTI,DB,637,200,73,41,314,323,122,44,489
TITU,DB,8415,610,60,0,670,2044,184,0,2228
ANINOASA,DB,2006,123,16,0,139,496,53,0,549
VIFORÎTA,DB,1997,199,31,18,248,524,69,18,611
SĂTENI,DB,1288,133,4,0,137,340,25,0,365
BĂLENI-ROMÂNI,DB,3004,110,11,0,121,741,35,0,776
BĂLENI-SÎRBI,DB,3684,153,16,1,170,1450,66,1,1517
"GURA BĂRBULEŢULUI",DB,461,55,21,0,76,170,88,0,258
BĂRBULEŢU,DB,1350,77,6,0,83,533,55,0,588
BEZDEAD,DB,2926,59,14,0,73,346,48,0,394
MĂGURA,DB,838,70,14,0,84,178,37,0,215
BILCIUREŞTI,DB,1480,162,43,0,205,583,104,0,687
BRANIŞTEA,DB,2356,157,21,0,178,673,77,0,750
DÎMBOVICIOARA,DB,882,59,6,0,65,235,19,0,254
SĂVEŞTI,DB,134,24,6,0,30,66,11,0,77
BRĂNEŞTI,DB,3608,236,33,0,269,811,96,0,907
BREZOAELE,DB,1113,162,18,0,180,510,100,0,610
BREZOAIA,DB,1794,246,36,8,290,738,104,8,850
BUCIUMENI,DB,1510,48,8,0,56,272,13,0,285
"DEALU MARE",DB,1192,45,6,0,51,231,24,0,255
"VALEA LEURZII",DB,1052,77,3,0,80,376,19,0,395
BUCŞANI,DB,2976,130,7,0,137,602,35,0,637
HĂBENI,DB,1136,47,2,0,49,258,15,0,273
RACOVIŢA,DB,1037,32,0,0,32,178,19,0,197
RĂŢOAIA,DB,396,24,3,0,27,134,11,0,145
BUTIMANU,DB,1425,131,35,0,166,494,124,0,618
LUCIANCA,DB,400,27,8,0,35,108,32,0,140
CIOCĂNEŞTI,DB,1654,52,14,0,66,248,38,0,286
DECINDEA,DB,397,11,9,0,20,104,19,0,123
URZICEANCA,DB,1172,63,27,0,90,383,97,0,480
VIZUREŞTI,DB,827,177,35,0,212,385,63,0,448
CÎNDEŞTI-VALE,DB,999,25,13,0,38,305,42,2,349
DRAGODĂNEŞTI,DB,1052,62,16,0,78,367,60,7,434
"CÎNDEŞTI DEAL",DB,170,2,5,0,7,51,21,0,72
"VALEA MARE",DB,108,7,2,0,9,55,22,0,77
MĂNĂSTIREA,DB,409,64,6,0,70,189,14,0,203
GHERGHIŢEŞTI,DB,924,86,6,0,92,348,50,0,398
MISLEA,DB,649,46,7,0,53,195,28,0,223
"FRASIN DEAL",DB,567,71,9,0,80,239,27,0,266
COJASCA,DB,1554,226,42,0,268,523,130,0,653
IAZU,DB,2075,313,8,0,321,716,25,0,741
FÎNTÎNELE,DB,1868,547,49,0,596,723,100,0,823
LAZURI,DB,1540,192,38,0,230,606,94,0,700
COMIŞANI,DB,2800,162,26,0,188,899,83,0,982
CONŢEŞTI,DB,1165,186,57,0,243,507,146,1,654
BOTENI,DB,703,111,22,3,136,272,54,7,333
BĂLTENI,DB,1489,201,37,0,238,577,79,0,656
"CORBII MARI",DB,1387,163,35,0,198,520,98,0,618
"VADU STANCHII",DB,365,27,11,0,38,131,28,0,159
PETREŞTI,DB,956,95,22,0,117,369,78,0,447
GROZĂVEŞTI,DB,1613,279,37,0,316,680,92,0,772
UNGURENI,DB,1503,196,25,0,221,591,70,0,661
"SATU NOU",DB,390,75,11,0,86,200,27,0,227
CORNĂŢELU,DB,299,64,35,0,99,154,76,2,232
BOLOVANI,DB,520,89,44,0,133,252,114,0,366
ALUNIŞU,DB,260,24,7,0,31,94,30,0,124
BUJOREANCA,DB,365,17,7,0,24,98,51,0,149
CĂTUNU,DB,678,71,20,0,91,222,86,0,308
CORNEŞTI,DB,1343,154,39,0,193,360,90,0,450
CRIVĂŢU,DB,210,10,4,0,14,63,25,0,88
FRASINU,DB,499,23,11,0,34,76,32,0,108
IBRIANU,DB,609,32,11,0,43,170,33,0,203
POSTÎRNACU,DB,697,23,10,0,33,82,21,0,103
UNGURENI,DB,699,33,3,0,36,107,9,0,116
"COSTEŞTII DIN VALE",DB,1689,305,22,0,327,588,42,0,630
TOMŞANI,DB,1041,164,36,0,200,351,62,0,413
CREVEDIA,DB,1918,106,38,0,144,386,139,0,525
DÎRZA,DB,1421,89,31,0,120,270,82,0,352
SAMURCAŞI,DB,1209,61,39,0,100,323,143,0,466
COCANI,DB,369,32,16,0,48,130,106,1,237
BĂDULEŞTI,DB,1144,135,34,0,169,414,93,0,507
"PĂTROAIA VALE",DB,902,107,22,0,129,269,68,0,337
VOIA,DB,559,121,9,0,130,288,33,0,321
DĂRMĂNEŞTI,DB,3001,158,12,0,170,690,67,0,757
"MĂRGINENII DE SUS",DB,887,55,6,0,61,265,29,0,294
DOBRA,DB,1460,241,13,0,254,727,66,6,799
MĂRCEŞTI,DB,1544,135,13,0,148,524,41,12,577
DOICEŞTI,DB,3927,205,12,1,218,712,46,1,759
DRAGODANA,DB,1327,83,22,5,110,276,36,7,319
BURDUCA,DB,1026,173,23,0,196,375,37,14,426
"PICIOR DE MUNTE",DB,3189,200,16,21,237,794,62,22,878
DRAGOMIREŞTI,DB,1752,100,8,0,108,547,21,0,568
DECINDENI,DB,2029,102,1,0,103,777,18,0,795
RÎNCĂCIOV,DB,1617,63,8,0,71,440,20,0,460
UNGURENI,DB,1073,61,4,0,65,231,11,0,242
MOGOŞEŞTI,DB,482,84,12,0,96,203,23,0,226
GEANGOEŞTI,DB,274,29,3,0,32,74,10,0,84
"FINTA MARE",DB,1042,25,6,0,31,135,14,0,149
BECHINEŞTI,DB,622,54,7,0,61,114,18,0,132
GHEBOAIA,DB,1728,150,12,0,162,471,42,0,513
GLODENI,DB,2817,138,10,1,149,534,19,1,554
LĂCULEŢE,DB,702,35,3,0,38,110,16,0,126
"GURA FOII",DB,1903,280,63,1,344,949,176,1,1126
"GURA OCNIŢEI",DB,2916,146,24,1,171,524,49,1,574
ADÎNCA,DB,1548,82,7,0,89,348,38,0,386
SĂCUENI,DB,1524,122,6,0,128,465,36,0,501
"GURA ŞUŢII",DB,2787,396,30,69,495,1129,103,69,1301
SPERIEŢENI,DB,1487,199,19,0,218,518,42,20,580
HULUBEŞTI,DB,690,28,11,0,39,185,36,0,221
MĂGURA,DB,544,52,13,0,65,220,35,0,255
"BUTOIU DE JOS",DB,782,62,7,0,69,283,19,0,302
"BUTOIU DE SUS",DB,643,67,10,0,77,295,32,0,327
GHIRDOVENI,DB,2737,154,16,0,170,576,47,0,623
"I. L. CARAGIALE",DB,2113,86,10,386,482,411,36,386,833
MIJA,DB,646,34,3,0,37,85,8,0,93
"IEDERA DE JOS",DB,1202,47,10,0,57,160,24,0,184
COLIBAŞI,DB,440,29,10,0,39,81,19,0,100
"CRICOVU DULCE",DB,331,20,4,0,24,48,14,0,62
"IEDERA DE SUS",DB,1158,49,3,0,52,238,13,0,251
LUCIENI,DB,2055,107,7,0,114,510,33,0,543
OLTENI,DB,459,69,12,0,81,162,43,0,205
TELEŞTI,DB,1391,30,5,0,35,374,28,0,402
POTOCELU,DB,941,47,0,0,47,312,4,0,316
"SCHEIU DE JOS",DB,856,14,0,0,14,174,14,0,188
"SCHEIU DE SUS",DB,795,16,4,0,20,130,12,0,142
LUNGULEŢU,DB,3317,250,19,0,269,1312,83,0,1395
SERDANU,DB,1034,70,17,0,87,272,40,0,312
"MALU CU FLORI",DB,1916,80,23,17,120,522,114,18,654
MĂNEŞTI,DB,1097,55,16,0,71,381,33,0,414
"DRĂGĂEŞTI UNGURENI",DB,1080,41,11,0,52,299,34,0,333
"DRĂGĂEŞTI PĂMÎNTENI",DB,1793,188,12,0,200,610,50,0,660
MĂTĂSARU,DB,858,65,7,0,72,240,24,0,264
"ODAIA TURCULUI",DB,896,46,1,0,47,178,12,0,190
TEŢCOIU,DB,1102,62,6,0,68,219,26,0,245
POROINICA,DB,639,57,8,0,65,185,26,0,211
"PUŢU CU SALCIE",DB,777,51,1,0,52,158,14,0,172
MOGOŞANI,DB,1381,56,8,0,64,279,27,0,306
COJOCARU,DB,654,73,14,0,87,239,31,0,270
MERII,DB,788,64,7,0,71,226,19,0,245
ZĂVOIU,DB,741,25,5,0,30,138,18,0,156
LUNCA,DB,1001,32,6,0,38,193,16,0,209
MOROENI,DB,1229,63,15,0,78,271,34,0,305
PUCHENI,DB,484,42,16,0,58,136,38,0,174
GLOD,DB,1351,106,11,30,147,668,19,30,717
MUŞCEL,DB,62,2,5,0,7,14,5,0,19
MORTENI,DB,1180,130,11,0,141,676,30,0,706
NEAJLOVU,DB,1131,103,10,0,113,572,38,0,610
MOŢĂIENI,DB,1394,61,7,2,70,255,36,2,293
CUCUTENI,DB,375,20,7,0,27,83,17,0,100
NICULEŞTI,DB,1850,245,34,0,279,812,92,0,904
MOVILA,DB,485,55,27,0,82,135,66,0,201
CIOCĂNARI,DB,987,63,15,0,78,249,51,0,300
NUCET,DB,1847,341,33,0,374,780,81,0,861
CAZACI,DB,1192,146,24,0,170,427,65,0,492
ILFOVENI,DB,452,80,8,0,88,191,29,0,220
OCNIŢA,DB,3583,155,14,0,169,676,55,2,733
ODOBEŞTI,DB,1269,95,41,0,136,514,91,0,605
BRÎNCOVEANU,DB,535,118,15,0,133,267,28,0,295
MIULEŞTI,DB,423,62,10,0,72,148,14,0,162
CROVU,DB,1082,121,15,0,136,541,51,0,592
ZIDURILE,DB,661,69,10,0,79,262,33,0,295
PERŞINARI,DB,2322,153,21,34,208,707,48,46,801
"PUNTEA DE GRECI",DB,591,40,16,0,56,198,54,0,252
PETREŞTI,DB,1162,36,15,0,51,276,37,0,313
GRECI,DB,1271,96,9,0,105,395,47,0,442
IONEŞTI,DB,1515,104,9,0,113,395,69,0,464
POTLOGENI-DEAL,DB,145,12,7,0,19,78,21,0,99
PIETRARI,DB,1450,118,19,0,137,544,64,6,614
VALEA,DB,534,36,12,0,48,227,35,2,264
PIETROŞIŢA,DB,1839,115,23,0,138,448,69,0,517
"DEALU FRUMOS",DB,856,37,7,0,44,156,26,0,182
POIANA,DB,2852,203,25,0,228,1047,88,0,1135
POTLOGI,DB,2462,220,34,0,254,736,102,0,838
PITARU,DB,694,58,19,0,77,223,50,0,273
VLĂSCENI,DB,573,65,28,0,93,189,72,0,261
ROMÂNEŞTI,DB,2947,252,20,0,272,851,56,0,907
PRODULEŞTI,DB,1502,121,19,0,140,297,49,0,346
BROŞTENI,DB,532,27,5,0,32,115,17,0,132
"COSTEŞTII DIN DEAL",DB,759,124,22,0,146,324,59,0,383
PUCHENI,DB,1307,34,1,0,35,325,36,0,361
"VALEA LARGĂ",DB,218,3,4,0,7,39,11,0,50
RACIU,DB,1241,84,9,0,93,363,27,0,390
"ŞUŢA SEACĂ",DB,722,55,6,0,61,259,11,0,270
SILIŞTEA,DB,752,81,4,0,85,313,17,0,330
RĂSCĂEŢI,DB,1820,114,14,28,156,721,67,28,816
RĂZVAD,DB,3661,283,36,0,319,1002,130,0,1132
"VALEA VOIEVOZILOR",DB,2652,146,17,0,163,547,78,0,625
GORGOTA,DB,1081,51,6,0,57,206,23,0,229
"RÂU ALB DE JOS",DB,1205,107,32,0,139,669,104,0,773
RUNCU,DB,2245,63,16,53,132,461,50,54,565
BĂDENI,DB,823,58,11,0,69,221,27,3,251
BREBU,DB,540,15,9,8,32,125,23,8,156
BĂNEŞTI,DB,348,41,15,0,56,134,40,0,174
"PODU RIZII",DB,587,127,24,1,152,307,45,1,353
"MIRCEA VODĂ",DB,925,76,14,0,90,228,29,0,257
GHINEŞTI,DB,1004,143,20,0,163,363,44,0,407
"CUZA VODĂ",DB,310,37,11,0,48,84,25,0,109
"SLOBOZIA MOARĂ",DB,1689,199,34,24,257,732,109,38,879
ŞELARU,DB,722,63,30,0,93,196,76,0,272
FIERBINŢI,DB,1235,47,3,0,50,203,35,0,238
GLOGOVEANU,DB,593,77,24,0,101,212,75,0,287
TEIŞ,DB,2131,250,9,0,259,607,29,0,636
ŞOTÎNGA,DB,3800,445,22,0,467,1154,66,0,1220
TĂRTĂŞEŞTI,DB,1804,151,65,0,216,543,191,0,734
BÎLDANA,DB,1451,81,23,0,104,340,78,0,418
GULIA,DB,948,88,24,0,112,376,110,0,486
TĂTĂRANI,DB,886,55,9,0,64,359,32,0,391
GHEBOIENI,DB,1274,66,8,0,74,444,50,0,494
CĂPRIORU,DB,1376,119,16,0,135,595,27,0,622
PRIBOIU,DB,756,35,7,0,42,331,50,0,381
ULIEŞTI,DB,1066,48,8,0,56,164,32,0,196
CROITORI,DB,695,26,5,0,31,89,22,0,111
JUGURENI,DB,1263,72,14,0,86,261,38,0,299
"HANU LUI PALĂ",DB,263,9,6,0,15,31,12,0,43
ULMI,DB,1098,77,20,0,97,342,75,0,417
DUMBRAVA,DB,942,61,13,1,75,254,42,1,297
VIIŞOARA,DB,1133,118,11,0,129,336,30,0,366
MATRACA,DB,589,60,7,0,67,217,21,0,238
"VALEA LUNGĂ-CRICOV",DB,1032,56,10,0,66,184,31,0,215
"VALEA MARE",DB,442,25,2,0,27,77,11,0,88
"VALEA LUNGĂ OGREA",DB,1105,50,9,0,59,169,16,0,185
"VALEA LUNGĂ GORGOTA",DB,1052,34,9,0,43,159,26,0,185
"ŞTUBEIE TISA",DB,352,9,3,0,12,69,6,0,75
"VALEA MARE",DB,1225,74,20,0,94,386,72,0,458
"VALEA CASELOR",DB,605,45,2,0,47,225,25,0,250
VĂCĂREŞTI,DB,2579,103,12,0,115,621,49,0,670
BUNGETU,DB,1132,84,6,0,90,288,34,1,323
"BRĂTEŞTII DE JOS",DB,561,89,4,0,93,166,7,0,173
VĂLENI-DÎMBOVIŢA,DB,1924,40,12,0,52,507,57,0,564
MESTEACĂN,DB,233,5,1,0,6,92,14,0,106
VIŞINA,DB,2321,207,26,0,233,735,83,0,818
BROŞTENI,DB,929,76,15,0,91,305,35,0,340
VIŞINEŞTI,DB,790,79,16,0,95,212,45,0,257
URSEIU,DB,548,33,5,0,38,119,19,0,138
SULTANU,DB,252,22,2,0,24,99,19,0,118
ŞUVIŢA,DB,1522,41,15,0,56,259,55,0,314
VLĂDENI,DB,2305,80,8,0,88,300,35,0,335
"GEMENEA BRĂTULEŞTI",DB,978,15,5,0,20,185,22,0,207
ONCEŞTI,DB,728,31,12,0,43,237,35,0,272
VOINEŞTI,DB,1343,64,15,0,79,468,55,0,523
SUDULENI,DB,1317,20,9,0,29,270,51,0,321
MANGA,DB,666,26,11,0,37,192,46,0,238
VULCANA-BĂI,DB,1298,82,19,0,101,331,43,22,396
"VULCANA DE SUS",DB,1193,44,5,0,49,255,29,10,294
VULCANA-PANDELE,DB,2520,102,10,0,112,488,36,0,524
"GURA VULCANEI",DB,1713,48,9,0,57,255,17,0,272
CRAIOVA,DJ,254416,12085,1253,1354,14692,32253,3352,1439,37044
BĂILEŞTI,DJ,15097,428,65,0,493,1726,165,0,1891
BALASAN,DJ,490,4,0,0,4,31,1,0,32
GOLENŢI,DJ,416,76,8,0,84,188,21,0,209
BASARABI,DJ,883,79,10,0,89,226,18,0,244
"CIUPERCENII VECHI",DJ,1824,63,3,0,66,374,20,0,394
CALAFAT,DJ,11908,573,81,45,699,1920,221,66,2207
BECHET,DJ,3269,248,25,20,293,807,92,61,960
DĂBULENI,DJ,10250,295,24,0,319,2116,146,43,2305
FILIAŞI,DJ,11010,711,99,0,810,2501,303,35,2839
BÎLTA,DJ,917,154,21,0,175,406,49,0,455
FRATOŞTIŢA,DJ,2112,171,10,0,181,547,36,0,583
"RĂCARII DE SUS",DJ,963,72,3,0,75,316,14,2,332
SEGARCEA,DJ,6387,243,44,0,287,1390,115,12,1517
AFUMAŢI,DJ,918,20,4,0,24,136,23,0,159
BOURENI,DJ,856,44,6,0,50,134,34,0,168
COVEI,DJ,403,18,3,0,21,47,14,0,61
ALMĂJ,DJ,1099,80,24,0,104,241,74,0,315
ŞITOAIA,DJ,509,52,10,0,62,136,28,0,164
"AMĂRĂŞTII DE JOS",DJ,2207,100,21,0,121,536,79,14,629
PRAPOR,DJ,1117,75,12,0,87,343,43,0,386
OCOLNA,DJ,948,125,6,0,131,314,11,0,325
"AMĂRĂŞTII DE SUS",DJ,1327,202,25,0,227,661,139,65,865
"APELE VII",DJ,1710,89,30,0,119,367,81,0,448
ARGETOAIA,DJ,1766,68,9,0,77,440,49,0,489
SALCIA,DJ,960,31,4,0,35,227,29,0,256
PIRIA,DJ,295,13,0,0,13,110,19,0,129
LEORDOASA,DJ,385,7,6,0,13,80,9,0,89
NOVAC,DJ,217,10,7,0,17,83,17,0,100
BISTREŢ,DJ,1841,481,50,0,531,699,86,0,785
"BISTREŢU NOU",DJ,631,124,24,0,148,173,32,0,205
PLOSCA,DJ,737,241,32,0,273,346,56,0,402
BÎRCA,DJ,3134,120,23,0,143,540,95,1,636
BOTOŞEŞTI-PAIA,DJ,578,415,69,0,484,445,97,16,558
BRABOVA,DJ,450,112,81,0,193,196,145,8,349
URDINIŢA,DJ,236,71,22,0,93,119,42,0,161
"RĂCHITA DE JOS",DJ,229,104,23,0,127,137,45,0,182
MOSNA,DJ,132,45,5,0,50,97,20,0,117
BRALOŞTIŢA,DJ,621,59,11,0,70,210,29,0,239
SFÎRCEA,DJ,815,32,6,0,38,198,15,0,213
"VALEA FÎNTÎNILOR",DJ,522,32,1,0,33,159,5,0,164
CIOCANELE,DJ,630,54,19,0,73,210,31,0,241
SCHITU,DJ,391,23,1,0,24,107,2,0,109
BĂDOŞI,DJ,729,18,3,0,21,122,24,0,146
PRUNET,DJ,471,14,3,0,17,121,15,0,136
BRATOVOEŞTI,DJ,1116,44,2,0,46,272,22,0,294
"GEOROCU MARE",DJ,397,20,3,0,23,92,11,0,103
BRĂDEŞTI,DJ,1573,83,25,0,108,346,115,0,461
"BRĂDEŞTII BĂTRÎNI",DJ,327,16,8,0,24,128,30,0,158
TATOMIREŞTI,DJ,824,37,5,0,42,274,12,0,286
PISCANI,DJ,80,5,4,0,9,22,8,0,30
BREASTA,DJ,2110,91,12,0,103,436,81,0,517
"VALEA LUNGULUI",DJ,541,61,35,0,96,238,46,0,284
OBEDIN,DJ,597,49,4,0,53,174,25,0,199
BUCOVĂŢ,DJ,1634,157,73,0,230,461,196,0,657
"LEAMNA DE JOS",DJ,282,34,13,0,47,77,34,0,111
"LEAMNA DE SUS",DJ,321,59,26,0,85,127,50,0,177
SĂRBĂTOAREA,DJ,612,71,29,0,100,205,71,0,276
PALILULA,DJ,635,62,23,0,85,204,62,0,266
BULZEŞTI,DJ,646,33,22,0,55,162,72,1,235
SĂLIŞTE,DJ,525,71,35,0,106,217,82,5,304
CALOPĂR,DJ,1083,67,13,0,80,239,46,0,285
BELCINU,DJ,425,51,21,0,72,220,60,0,280
PANAGHIA,DJ,571,37,9,0,46,153,21,0,174
SĂLCUŢA,DJ,878,86,20,0,106,218,32,0,250
CARAULA,DJ,1937,501,75,27,603,885,145,85,1115
CARPEN,DJ,772,74,18,0,92,422,50,0,472
CLEANOV,DJ,1089,191,18,0,209,605,55,0,660
CASTRANOVA,DJ,1486,84,12,0,96,567,48,0,615
PUŢURI,DJ,1083,46,7,0,53,292,34,0,326
CATANE,DJ,1403,110,9,0,119,395,41,21,457
CĂLĂRAŞI,DJ,3275,164,32,0,196,796,85,8,889
SĂRATA,DJ,1674,87,6,0,93,665,35,23,723
CÂRCEA,DJ,2217,220,57,45,322,780,206,45,1031
CÂRNA,DJ,1104,201,22,0,223,408,46,0,454
CELARU,DJ,1469,38,8,0,46,206,44,0,250
"MAROTINU DE JOS",DJ,455,24,8,0,32,66,24,0,90
GHIZDĂVEŞTI,DJ,1215,80,13,0,93,288,46,0,334
"MAROTINU DE SUS",DJ,452,9,1,0,10,47,17,0,64
CERĂT,DJ,3143,371,26,0,397,961,58,0,1019
CERNĂTEŞTI,DJ,387,32,12,7,51,131,26,7,164
ŢIU,DJ,381,28,6,3,37,138,19,3,160
CORNIŢA,DJ,243,23,9,0,32,104,21,0,125
"RASNICU OGHIAN",DJ,424,39,3,0,42,93,13,0,106
CETATE,DJ,3860,790,31,119,940,3292,106,133,3531
MORENI,DJ,436,66,9,0,75,373,17,21,411
CIOROIAŞI,DJ,841,18,7,0,25,144,47,0,191
"CIOROIU NOU",DJ,408,18,6,0,24,127,29,0,156
"CIUPERCENII NOI",DJ,3382,463,31,0,494,1866,94,10,1970
SMÎRDAN,DJ,1036,83,6,0,89,374,26,0,400
COŞOVENI,DJ,2630,76,26,0,102,407,135,0,542
"COŢOFENII DIN DOS",DJ,846,52,12,0,64,218,37,0,255
POTMELŢU,DJ,423,17,7,0,24,79,23,0,102
MIHĂIŢA,DJ,631,67,22,0,89,179,44,0,223
"COŢOFENII DIN FAŢĂ",DJ,1313,135,11,0,146,427,59,0,486
BEHARCA,DJ,254,41,5,0,46,122,21,0,143
DANEŢI,DJ,3073,232,35,0,267,971,134,0,1105
BRANIŞTE,DJ,510,50,8,0,58,142,26,0,168
LOCUSTENI,DJ,475,30,11,0,41,122,32,0,154
BRABEŢI,DJ,848,94,33,0,127,335,92,0,427
DESA,DJ,3907,143,3,0,146,768,29,0,797
DIOŞTI,DJ,993,92,14,0,106,244,48,0,292
RADOMIR,DJ,893,33,6,0,39,134,21,0,155
CIOCĂNEŞTI,DJ,594,12,4,0,16,80,13,0,93
DOBREŞTI,DJ,332,18,5,0,23,98,10,0,108
MURTA,DJ,694,58,2,0,60,263,21,0,284
TOCENI,DJ,521,26,5,0,31,128,18,0,146
CĂCIULĂTEŞTI,DJ,412,7,4,0,11,64,16,0,80
DOBROTEŞTI,DJ,1377,78,26,0,104,371,70,0,441
VIIŞOARA,DJ,430,61,13,0,74,174,30,7,211
DRĂGOTEŞTI,DJ,369,91,12,0,103,157,32,7,196
BENEŞTI,DJ,349,82,7,5,94,119,24,5,148
POPÎNZĂLEŞTI,DJ,488,52,13,19,84,143,35,19,197
BUZDUC,DJ,123,34,12,9,55,60,22,9,91
DRĂNIC,DJ,818,13,1,0,14,73,15,0,88
PADEA,DJ,615,20,4,0,24,82,20,0,102
BOOVENI,DJ,284,8,0,0,8,28,5,0,33
FOIŞOR,DJ,218,12,4,0,16,45,22,0,67
FĂRCAŞ,DJ,1011,65,16,0,81,237,44,0,281
GOLUMBU,DJ,664,44,9,0,53,232,32,0,264
"GALICEA MARE",DJ,3343,59,13,0,72,947,76,4,1027
GALICIUICA,DJ,1161,121,21,0,142,484,53,0,537
GHERCEŞTI,DJ,845,54,19,0,73,284,88,5,377
GÎRLEŞTI,DJ,378,50,8,0,58,155,36,5,196
UNGURENI,DJ,254,43,25,0,68,117,63,3,183
GHIDICI,DJ,1850,453,78,78,609,930,161,78,1169
GHINDENI,DJ,1544,107,23,0,130,397,92,0,489
GIGHERA,DJ,967,58,9,0,67,375,65,23,463
NEDEIA,DJ,696,38,14,0,52,162,37,21,220
ZĂVAL,DJ,621,89,14,0,103,313,46,0,359
GIUBEGA,DJ,1753,94,26,0,120,374,92,0,466
GIURGIŢA,DJ,1936,103,36,0,139,517,116,0,633
CURMĂTURA,DJ,421,9,6,0,15,94,28,0,122
GÎNGIOVA,DJ,1159,28,5,0,33,146,22,0,168
COMOŞTENI,DJ,845,27,5,0,32,152,23,0,175
GOGOŞU,DJ,184,22,20,0,42,68,33,0,101
GOGOŞIŢA,DJ,154,11,3,0,14,76,26,0,102
ŞTEFĂNEL,DJ,152,11,5,0,16,84,40,0,124
GOICEA,DJ,2102,390,88,59,537,767,191,61,1019
GOIEŞTI,DJ,1150,48,14,0,62,276,69,0,345
MOGOŞEŞTI,DJ,483,18,10,0,28,96,19,0,115
MĂLĂEŞTI,DJ,480,28,9,0,37,159,34,0,193
ŢANDĂRA,DJ,432,37,12,0,49,144,28,0,172
BĂRBOI,DJ,309,57,14,10,81,113,34,10,157
GRECEŞTI,DJ,232,42,17,5,64,128,53,5,186
BUSU,DJ,541,73,13,11,97,240,39,11,290
GROPANELE,DJ,240,18,5,0,23,80,20,0,100
IŞALNIŢA,DJ,3434,238,74,59,371,1588,230,80,1898
IZVOARE,DJ,967,95,35,0,130,245,105,28,378
CORLATE,DJ,269,116,35,14,165,212,61,21,294
ÎNTORSURA,DJ,1220,94,26,0,120,282,85,0,367
LEU,DJ,2979,142,42,0,184,859,164,0,1023
ZĂNOAGA,DJ,954,25,11,0,36,203,59,0,262
LIPOVU,DJ,2174,23,8,0,31,92,21,0,113
"LIPOVU DE SUS",DJ,164,4,6,0,10,9,12,0,21
MAGLAVIT,DJ,2861,95,22,0,117,545,101,1,647
"MALU MARE",DJ,2173,72,24,0,96,283,66,7,356
PREAJBA,DJ,2020,33,9,0,42,208,65,0,273
"MĂCEŞU DE JOS",DJ,805,74,36,0,110,407,116,11,534
SĂPATA,DJ,266,22,31,0,53,86,55,0,141
"MĂCEŞU DE SUS",DJ,1037,97,21,0,118,228,38,0,266
MELINEŞTI,DJ,945,52,12,20,84,233,47,20,300
NEGOIEŞTI,DJ,1172,59,14,0,73,256,50,0,306
BODĂIEŞTI,DJ,606,24,5,0,29,99,17,0,116
"BODĂIEŞTII DE SUS",DJ,243,5,5,0,10,56,11,0,67
SPINENI,DJ,257,54,14,0,68,112,26,1,139
MISCHII,DJ,500,68,56,0,124,175,111,0,286
MLECĂNEŞTI,DJ,442,55,22,0,77,182,63,0,245
URECHEŞTI,DJ,404,36,17,0,53,149,79,0,228
CĂLINEŞTI,DJ,108,17,17,0,34,49,29,0,78
MÎRŞANI,DJ,3789,279,22,0,301,1170,121,59,1350
"MOŢĂŢEI GARĂ",DJ,693,37,3,0,40,134,12,0,146
MOŢĂŢEI,DJ,4510,194,14,0,208,945,70,0,1015
DOBRIDOR,DJ,642,25,8,0,33,145,29,0,174
MURGAŞI,DJ,863,133,44,0,177,385,103,12,500
"BALOTA DE JOS",DJ,716,237,35,0,272,440,63,0,503
VELESTI,DJ,379,67,26,0,93,349,55,0,404
NEGOI,DJ,1725,129,19,20,168,477,49,37,563
ORODEL,DJ,944,98,13,0,111,377,40,0,417
CORNU,DJ,431,35,14,0,49,144,41,0,185
TEIU,DJ,184,39,5,0,44,75,9,0,84
CĂLUGĂREI,DJ,517,84,11,0,95,274,47,0,321
OSTROVENI,DJ,2798,241,47,0,288,1123,119,0,1242
LIŞTEAVA,DJ,1228,87,13,0,100,439,33,0,472
PERIŞOR,DJ,1156,27,12,0,39,223,98,0,321
MĂRĂCINELE,DJ,217,5,5,0,10,51,28,0,79
PIELEŞTI,DJ,2576,50,119,0,169,206,191,0,397
CÎMPENI,DJ,626,21,4,0,25,89,15,0,104
"PISCU VECHI",DJ,1932,564,32,0,596,1045,81,0,1126
PISCULEŢ,DJ,246,87,6,0,93,122,15,0,137
PLENIŢA,DJ,3066,235,18,48,301,902,78,58,1038
"CASTRELE TRAIANE",DJ,654,43,4,0,47,161,13,10,184
PLEŞOI,DJ,1027,150,32,0,182,633,82,0,715
BRANIŞTE,DJ,678,74,17,0,91,167,37,0,204
"BALTA VERDE",DJ,425,33,10,0,43,90,20,0,110
PODARI,DJ,3332,95,8,4,107,455,73,5,533
LIVEZI,DJ,753,26,8,0,34,103,22,0,125
"GURA VĂII",DJ,372,28,13,0,41,94,28,0,122
"POIANA MARE",DJ,7406,376,38,139,553,1355,115,140,1610
"TUNARII VECHI",DJ,1084,37,5,0,42,189,17,0,206
"TUNARII NOI",DJ,415,17,10,0,27,126,17,0,143
PREDEŞTI,DJ,1669,111,52,0,163,438,201,0,639
RADOVAN,DJ,814,63,9,0,72,267,68,0,335
FÎNTÎNELE,DJ,77,3,6,0,9,22,19,0,41
TÎRNAVA,DJ,149,18,8,0,26,44,32,0,76
RAST,DJ,2864,188,28,0,216,631,70,0,701
"ROBĂNEŞTII DE JOS",DJ,505,37,14,0,51,176,46,3,225
GOLFIN,DJ,503,34,12,0,46,154,50,0,204
"LĂCRIŢA MARE",DJ,476,40,8,0,48,173,55,0,228
"ROBĂNEŞTII DE SUS",DJ,509,48,8,0,56,190,32,1,223
ROJIŞTE,DJ,1456,353,74,0,427,529,98,0,627
TÂMBUREŞTI,DJ,525,99,12,0,111,212,34,0,246
SADOVA,DJ,5691,392,36,29,457,2158,134,29,2321
"PISCU SADOVEI",DJ,958,95,3,0,98,282,16,0,298
SĂLCUŢA,DJ,877,57,5,0,62,113,20,0,133
TENCĂNĂU,DJ,674,19,0,0,19,115,0,0,115
SCĂEŞTI,DJ,894,86,21,0,107,351,84,12,447
"VALEA LUI PĂTRU",DJ,758,50,12,0,62,234,36,2,272
"SEACA DE CÎMP",DJ,780,65,5,0,70,245,38,37,320
"PISCU NOU",DJ,742,85,16,0,101,279,56,12,347
"SEACA DE PĂDURE",DJ,322,103,32,0,135,197,76,7,280
VELENI,DJ,315,50,7,0,57,149,38,0,187
"RĂCHITA DE SUS",DJ,141,27,7,0,34,68,26,6,100
SECU,DJ,648,46,16,0,62,307,58,0,365
"SMADOVICIOARA DE SECU",DJ,167,18,2,0,20,110,7,0,117
"SILIŞTEA CRUCII",DJ,1241,37,4,0,41,122,36,0,158
SOPOT,DJ,393,68,37,0,105,192,88,0,280
BELOŢ,DJ,255,40,36,0,76,118,68,0,186
SÎRSCA,DJ,141,12,13,0,25,43,43,0,86
BAŞCOV,DJ,293,29,13,0,42,168,24,0,192
PIETROAIA,DJ,344,12,2,0,14,79,22,0,101
ALBEŞTI,DJ,843,43,9,0,52,123,39,0,162
DUDOVICEŞTI,DJ,741,19,8,0,27,91,40,0,131
FLOREŞTI,DJ,594,18,8,0,26,70,32,0,102
IZVOR,DJ,564,12,5,0,17,110,22,0,132
LEŞILE,DJ,751,24,8,0,32,140,35,0,175
MILEŞTI,DJ,684,21,9,0,30,79,28,0,107
TĂLPAŞ,DJ,1001,63,16,0,79,364,69,0,433
TEASC,DJ,1358,26,4,0,30,246,39,0,285
SECUI,DJ,1187,46,14,0,60,230,43,0,273
TERPEZIŢA,DJ,710,83,30,0,113,367,105,21,493
CĂCIULATU,DJ,279,60,21,0,81,144,33,9,186
LAZU,DJ,272,44,18,0,62,132,41,13,186
TESLUI,DJ,471,78,20,0,98,169,46,0,215
"PREAJBA DE PĂDURE",DJ,662,159,29,0,188,328,57,0,385
ŢĂRŢĂL,DJ,274,63,12,0,75,130,31,0,161
URIENI,DJ,430,81,10,0,91,166,27,0,193
ŢUGLUI,DJ,2200,172,10,0,182,534,53,0,587
JIUL,DJ,217,24,13,0,37,80,25,0,105
UNIREA,DJ,3071,152,84,0,236,823,232,42,1097
URZICUŢA,DJ,1870,70,15,0,85,361,51,5,417
"URZICA MARE",DJ,391,19,13,0,32,84,24,0,108
"VALEA STANCIULUI",DJ,2399,148,38,0,186,653,136,0,789
"HOREZU POENARI",DJ,1931,140,15,0,155,516,58,0,574
VELA,DJ,346,76,29,0,105,148,49,7,204
BUCOVICIOR,DJ,323,19,2,0,21,104,20,0,124
ŞTIUBEI,DJ,82,22,9,0,31,37,17,7,61
GUBAUCEA,DJ,502,44,7,10,61,231,21,10,262
SUHARU,DJ,218,41,12,6,59,93,25,6,124
VERBIŢA,DJ,654,37,8,0,45,205,23,0,228
VERBICIOARA,DJ,387,56,9,0,65,120,24,0,144
VÎRTOP,DJ,1339,205,20,0,225,904,88,0,992
VÎRVOR,DJ,524,38,13,0,51,172,48,3,223
"VÎRVORU DE JOS",DJ,967,46,45,0,91,268,113,26,407
CIUTURA,DJ,594,37,22,0,59,227,85,22,334
"TÎRGU JIU",GJ,74689,3194,250,252,3696,10404,772,367,11543
ROMANEŞTI,GJ,736,19,3,0,22,150,13,0,163
DRĂGOENI,GJ,1482,46,5,0,51,204,11,0,215
BÎRSEŞTI,GJ,1512,61,1,0,62,256,14,0,270
IEZURENI,GJ,745,28,2,0,30,117,15,0,132
URSAŢI,GJ,596,11,4,0,15,124,6,0,130
MOTRU,GJ,15651,702,69,1,772,1902,157,1,2060
LEURDA,GJ,665,20,4,0,24,76,7,0,83
HORĂŞTI,GJ,419,11,2,0,13,63,11,0,74
PLOŞTINA,GJ,1086,38,5,0,43,291,9,0,300
ROŞIUŢA,GJ,495,23,2,0,25,165,13,0,178
RÎPA,GJ,284,13,3,0,16,53,5,0,58
BUMBEŞTI-JIU,GJ,6663,253,46,0,299,870,106,20,996
TETILA,GJ,1112,21,4,0,25,132,8,0,140
CURTIŞOARA,GJ,595,13,0,0,13,97,22,0,119
NOVACI,GJ,2791,57,13,0,70,430,66,18,514
POCIOVALIŞTEA,GJ,1459,26,10,0,36,173,41,0,214
BERCEŞTI,GJ,554,23,4,0,27,134,10,0,144
ROVINARI,GJ,10295,296,29,0,325,904,68,4,976
VÎRT,GJ,564,12,8,0,20,62,13,0,75
TISMANA,GJ,1798,73,27,0,100,326,74,0,400
CELEI,GJ,757,13,4,0,17,59,21,0,80
TOPEŞTI,GJ,862,20,3,0,23,107,17,0,124
POCRUIA,GJ,877,28,3,0,31,129,28,0,157
SOHODOL,GJ,752,10,3,0,13,96,6,0,102
COSTENI,GJ,907,32,6,0,38,94,19,0,113
"TÎRGU CĂRBUNEŞTI",GJ,4181,161,27,45,233,586,75,51,712
CREŢEŞTI,GJ,744,16,3,0,19,84,11,0,95
POJOGENI,GJ,850,37,8,0,45,164,40,0,204
ŞTEFĂNEŞTI,GJ,438,21,5,0,26,130,25,0,155
CĂRBUNEŞTI-SAT,GJ,558,26,5,0,31,144,20,0,164
COJANI,GJ,327,8,1,0,9,74,21,0,95
TURCENI,GJ,4060,123,10,19,152,520,57,19,596
MURGEŞTI,GJ,629,19,1,0,20,128,7,0,135
GÂRBOVU,GJ,747,17,3,0,20,163,12,0,175
"STRÂMBA JIU",GJ,1262,59,7,1,67,322,49,1,372
ŢICLENI,GJ,3962,146,9,0,155,592,42,0,634
ALBENI,GJ,1783,93,6,0,99,390,50,0,440
BOLBOCEŞTI,GJ,436,16,1,0,17,104,8,0,112
PRUNEŞTI,GJ,120,4,0,0,4,21,3,0,24
ALIMPEŞTI,GJ,1497,35,14,0,49,354,51,3,408
ANINOASA,GJ,1115,22,3,0,25,102,14,0,116
GROŞEREA,GJ,467,13,5,0,18,52,21,0,73
COSTEŞTI,GJ,808,11,7,0,18,64,13,0,77
STERPOAIA,GJ,701,9,5,0,14,130,16,0,146
ARCANI,GJ,1120,47,20,0,67,314,127,6,447
"BAIA DE FIER",GJ,2844,71,9,0,80,498,40,0,538
CERNĂDIA,GJ,679,44,7,0,51,182,19,0,201
BĂLĂNEŞTI,GJ,655,22,20,0,42,215,80,0,295
"VOITEŞTII DE VALE",GJ,522,22,19,0,41,277,97,0,374
GLODENI,GJ,654,51,12,0,63,369,81,0,450
CORNEŞTI,GJ,692,18,5,0,23,125,24,0,149
RASOVA,GJ,417,19,5,0,24,97,23,0,120
STOLOJANI,GJ,568,24,8,0,32,105,30,9,144
TĂLPĂŞEŞTI,GJ,474,12,6,0,18,99,24,0,123
TĂMĂŞEŞTI,GJ,546,19,5,0,24,100,18,0,118
BĂLEŞTI,GJ,1724,47,6,0,53,310,35,0,345
CEAURU,GJ,1953,54,6,0,60,264,24,0,288
BĂRBĂTEŞTI,GJ,723,39,3,0,42,182,29,0,211
PETREŞTI,GJ,665,28,9,0,37,103,33,0,136
BENGEŞTI,GJ,1246,20,1,0,21,164,43,0,207
BĂLCEŞTI,GJ,615,24,13,0,37,202,65,0,267
CIOCADIA,GJ,795,24,7,0,31,134,27,0,161
BERLEŞTI,GJ,699,14,6,0,20,82,15,0,97
"PÎRÎU VIU",GJ,996,11,3,0,14,93,21,0,114
BÎLTENI,GJ,1668,74,6,0,80,261,19,0,280
"PEŞTEANA JIU",GJ,1765,106,6,0,112,309,19,0,328
MOI,GJ,843,42,8,0,50,190,19,0,209
COCORENI,GJ,1081,21,3,0,24,143,16,0,159
VLĂDULENI,GJ,878,58,9,0,67,147,15,0,162
BOLBOŞI,GJ,912,36,1,0,37,154,11,0,165
BĂLĂCEŞTI,GJ,541,17,2,0,19,83,5,0,88
VALEA,GJ,1130,12,3,0,15,115,15,0,130
BORĂSCU,GJ,942,32,2,0,34,213,22,0,235
"MENŢII DIN DOS",GJ,585,12,4,0,16,138,13,0,151
MILUTA,GJ,508,18,6,0,24,73,9,0,82
CALAPĂRU,GJ,655,77,4,0,81,214,24,0,238
"CAPU DEALULUI",GJ,660,41,11,0,52,144,30,0,174
BRĂNEŞTI,GJ,573,10,2,0,12,58,19,0,77
PÎRÎU,GJ,485,5,1,0,6,51,10,0,61
BĂDEŞTI,GJ,175,5,0,0,5,15,5,0,20
BUMBEŞTI-PIŢIC,GJ,1041,15,6,0,21,123,35,0,158
CÎRLIGEI,GJ,177,2,0,0,2,23,14,0,37
POIENARI,GJ,585,12,3,0,15,73,15,0,88
BUSTUCHIN,GJ,915,24,6,0,30,170,21,0,191
"POIANA SECIURI",GJ,735,20,2,0,22,143,16,0,159
"VALEA POJARULUI",GJ,336,11,1,0,12,68,5,0,73
POIENIŢA,GJ,308,24,6,0,30,86,16,0,102
POJARU,GJ,402,13,10,0,23,52,16,0,68
CĂPRENI,GJ,803,18,2,0,20,137,32,4,173
"SATU NOU",GJ,538,10,4,0,14,149,29,5,183
BULBUCENI,GJ,375,22,6,0,28,116,19,0,135
"VALEA PERILOR",GJ,580,29,9,0,38,170,23,0,193
"VALEA MÎNĂSTIRII",GJ,364,11,0,0,11,90,11,0,101
LUPOAIA,GJ,770,17,7,0,24,156,19,0,175
"DEALU VIILOR",GJ,494,9,2,0,11,157,19,0,176
CIUPERCENI,GJ,420,15,7,0,22,90,37,0,127
"STRÎMBA VULCAN",GJ,291,8,3,0,11,50,30,0,80
VÎRTOPU,GJ,321,8,4,0,12,33,11,0,44
"PEŞTEANA VULCAN",GJ,257,14,9,0,23,53,33,0,86
CÎLNIC,GJ,659,22,9,0,31,104,38,0,142
"CÎLNICU DE SUS",GJ,652,27,4,0,31,106,28,0,134
HODOREASCA,GJ,330,22,5,0,27,49,13,0,62
PINOASA,GJ,196,20,5,0,25,48,16,0,64
CĂRPINIŞ,GJ,1594,77,10,0,87,341,40,0,381
DRĂGOIEŞTI,GJ,1040,28,29,0,57,183,67,0,250
DUMBRĂVENI,GJ,733,34,5,0,39,206,26,0,232
"ANINIŞU DIN VALE",GJ,777,24,4,0,28,176,17,0,193
CRUŞET,GJ,1345,19,6,0,25,190,55,0,245
MĂIAG,GJ,626,11,8,0,19,98,24,0,122
SLĂVUŢA,GJ,507,13,6,0,19,83,30,0,113
DĂNCIULEŞTI,GJ,655,20,6,0,26,90,40,0,130
RĂDINEŞTI,GJ,503,8,2,0,10,66,20,0,86
OBÎRŞIA,GJ,469,11,5,0,16,84,21,0,105
BRĂTUIA,GJ,751,26,8,0,34,182,45,0,227
DĂNEŞTI,GJ,1137,24,1,0,25,265,50,0,315
VĂCAREA,GJ,718,28,9,0,37,215,39,0,254
ŞASA,GJ,576,16,13,0,29,137,60,0,197
DRĂGOTEŞTI,GJ,990,15,2,0,17,128,17,0,145
COROBĂI,GJ,1124,26,6,0,32,141,13,0,154
DRĂGUŢEŞTI,GJ,894,28,9,0,37,165,21,0,186
IAŞI-GORJ,GJ,835,19,1,0,20,130,14,0,144
URECHEŞTI,GJ,747,34,3,0,37,176,31,0,207
TÎLVEŞTI,GJ,534,38,3,0,41,223,28,7,258
CÎRBEŞTI,GJ,1233,32,0,0,32,195,11,0,206
FĂRCĂŞEŞTI,GJ,583,18,7,0,25,128,23,0,151
"ROŞIA JIU",GJ,656,17,2,0,19,103,14,0,117
"PEŞTEANA DE JOS",GJ,679,27,5,0,32,165,21,0,186
TIMIŞENI,GJ,115,3,5,0,8,18,17,0,35
"VALEA CU APĂ",GJ,650,17,2,0,19,122,10,0,132
IORMĂNEŞTI,GJ,518,33,11,0,44,170,32,0,202
GLOGOVA,GJ,598,33,4,0,37,161,45,0,206
OLTEANU,GJ,450,18,8,0,26,127,26,0,153
GODINEŞTI,GJ,861,40,13,0,53,139,55,0,194
CÎLCEŞTI,GJ,260,15,10,0,25,51,36,0,87
"PÎRÎU DE PRIPOR",GJ,327,23,4,0,27,83,10,0,93
"PÎRÎU DE VALE",GJ,167,24,8,0,32,51,33,0,84
HUREZANI,GJ,1148,24,13,0,37,305,93,0,398
PLOPU,GJ,146,10,4,0,14,64,36,0,100
IONEŞTI,GJ,966,22,4,0,26,221,19,0,240
ILIEŞTI,GJ,438,26,5,0,31,99,12,0,111
PICU,GJ,530,27,5,0,32,147,13,0,160
VIDIN,GJ,227,10,0,0,10,38,5,0,43
"PÎRÎU BOIA",GJ,286,21,4,0,25,78,12,0,90
JUPÎNEŞTI,GJ,559,14,2,0,16,90,16,0,106
VIERŞANI,GJ,663,15,2,0,17,70,33,0,103
LELEŞTI,GJ,1031,46,15,0,61,283,71,0,354
FRĂTEŞTI,GJ,271,16,7,0,23,96,46,0,142
RASOVIŢA,GJ,183,8,7,0,15,52,19,0,71
LICURICI,GJ,624,26,10,0,36,128,34,0,162
NEGRENI,GJ,566,15,10,0,25,65,14,0,79
TOTEA,GJ,619,12,4,0,16,107,17,0,124
FRUNZA,GJ,590,14,4,0,18,111,26,0,137
"TÎRGU LOGREŞTI",GJ,570,22,6,0,28,161,35,0,196
"LOGREŞTI MOŞTENI",GJ,464,9,1,0,10,99,15,0,114
MĂRU,GJ,291,11,5,0,16,70,18,0,88
SEACA,GJ,247,6,4,0,10,55,12,0,67
MĂTĂSARI,GJ,3056,88,8,0,96,300,31,1,332
BRĂDET,GJ,539,6,3,0,9,53,5,0,58
RUNCUREL,GJ,237,13,1,0,14,41,2,0,43
CROICI,GJ,292,15,4,0,19,39,6,0,45
MUŞETEŞTI,GJ,743,14,5,0,19,147,30,0,177
STĂNCEŞTI,GJ,465,13,4,0,17,96,16,0,112
GRUI,GJ,453,15,4,0,19,71,14,0,85
NEGOMIR,GJ,1107,34,3,0,37,296,18,0,314
ARTANU,GJ,951,37,6,0,43,270,22,0,292
CONDEIEŞTI,GJ,813,36,11,0,47,243,30,0,273
CĂLUGĂRENI,GJ,915,28,6,0,34,187,21,0,208
PADEŞ,GJ,1302,28,11,0,39,253,42,0,295
"MOTRU SEC",GJ,1715,44,11,0,55,421,41,0,462
CERNA-SAT,GJ,51,4,0,0,4,21,17,0,38
PEŞTIŞANI,GJ,2649,58,29,0,87,423,119,0,542
BRĂDICENI,GJ,523,19,11,0,30,120,54,0,174
PLOPŞORU,GJ,1928,41,3,12,56,300,24,11,335
PISCURI,GJ,1018,38,3,0,41,290,33,5,328
VĂLENI,GJ,1493,76,4,0,80,324,15,0,339
POLOVRAGI,GJ,1870,72,19,0,91,521,77,1,599
RACOVIŢA,GJ,375,22,14,0,36,123,39,0,162
PRIGORIA,GJ,357,7,10,0,17,47,24,0,71
CĂLUGĂREASA,GJ,484,13,4,0,17,88,19,0,107
NEGOIEŞTI,GJ,252,4,0,0,4,29,6,0,35
DOBRANA,GJ,323,8,2,0,10,36,8,0,44
BUCŞANA,GJ,661,8,0,0,8,54,5,0,59
ZORLEŞTI,GJ,353,8,1,0,9,49,14,0,63
"ROŞIA DE AMARADIA",GJ,1129,12,2,0,14,153,15,0,168
SECIURILE,GJ,587,5,0,0,5,72,11,0,83
RUGET,GJ,488,10,1,0,11,85,8,0,93
ŞITOAIA,GJ,268,1,3,0,4,30,6,0,36
"VALEA MARE",GJ,674,32,6,0,38,246,32,0,278
BÎLTA,GJ,1398,57,9,0,66,693,97,0,790
RUNCU,GJ,1171,33,8,0,41,287,73,0,360
DOBRIŢA,GJ,794,51,16,10,77,299,84,10,393
SUSENI,GJ,241,18,20,9,47,97,49,50,196
SAMARINEŞTI,GJ,1123,66,19,0,85,388,76,3,467
LARGA,GJ,346,22,9,0,31,111,33,0,144
SĂCELU,GJ,1247,29,13,0,42,200,70,0,270
SĂULEŞTI,GJ,1231,49,12,0,61,243,59,0,302
BIBEŞTI,GJ,622,32,6,0,38,141,40,0,181
SÎMBOTIN,GJ,472,22,0,0,22,120,15,0,135
GORNĂCEL,GJ,483,6,5,0,11,75,8,0,83
SCHELA,GJ,513,28,7,0,35,101,24,0,125
BUDIENI,GJ,602,38,6,0,44,199,60,2,261
"PIŞTEŞTII DIN DEAL",GJ,874,63,7,0,70,144,25,0,169
COPĂCIOASA,GJ,702,32,8,2,42,122,27,2,151
SCOARŢA,GJ,727,23,13,0,36,124,64,0,188
BOBU,GJ,969,23,15,0,38,131,59,0,190
SLIVILEŞTI,GJ,859,36,6,0,42,120,23,0,143
STRÎMTU,GJ,417,28,9,0,37,137,28,0,165
MICULEŞTI,GJ,776,6,0,0,6,69,11,0,80
SURA,GJ,603,19,3,0,22,50,11,0,61
STĂNEŞTI,GJ,1134,19,3,0,22,175,42,0,217
CURPEN,GJ,755,7,7,0,14,66,16,0,82
STEJARI,GJ,840,17,6,0,23,72,25,0,97
PISCOIU,GJ,702,12,3,0,15,45,10,0,55
BALOŞANI,GJ,419,10,2,0,12,42,22,0,64
STOINA,GJ,1218,46,26,0,72,236,82,0,318
PĂIŞANI,GJ,666,17,1,0,18,131,25,0,156
TELEŞTI,GJ,1047,43,16,0,59,275,74,0,349
BUDUHALA,GJ,672,18,4,0,22,164,33,0,197
ŞOMĂNEŞTI,GJ,571,27,3,0,30,180,26,0,206
TURBUREA,GJ,1171,67,16,9,92,374,68,9,451
ŞIPOTU,GJ,726,56,8,22,86,226,43,23,292
POIANA,GJ,1193,56,10,18,84,366,42,18,426
COCOROVA,GJ,407,22,3,4,29,89,9,4,102
TURCINEŞTI,GJ,1337,30,3,0,33,299,34,0,333
RUGI,GJ,497,8,3,0,11,46,19,0,65
ŢÎNŢĂRENI,GJ,1871,84,0,0,84,330,8,0,338
FLOREŞTI,GJ,2326,158,14,0,172,560,42,0,602
CHICIORA,GJ,249,10,6,0,16,74,21,0,95
FÎNTÎNELE,GJ,788,24,0,0,24,184,12,0,196
URDARI,GJ,1345,28,5,0,33,267,14,0,281
HOTĂROASA,GJ,459,5,0,0,5,53,8,0,61
VĂGIULEŞTI,GJ,1097,17,7,0,24,144,36,0,180
COVRIGI,GJ,1006,27,2,0,29,143,26,0,169
ANDREEŞTI,GJ,870,14,6,0,20,119,44,0,163
VLADIMIR,GJ,901,6,6,0,12,66,27,0,93
FRASIN,GJ,561,8,7,0,15,78,26,0,104
GALAŢI,GL,261249,13870,838,506,15214,37545,1812,568,39925
TECUCI,GL,36334,1556,141,1,1698,5729,389,1,6119
BEREŞTI,GL,2688,69,4,0,73,475,41,1,517
"TÎRGU BUJOR",GL,3989,124,23,0,147,594,62,20,676
MOSCU,GL,1035,35,6,2,43,207,21,2,230
UMBRĂREŞTI,GL,915,15,3,0,18,148,9,0,157
BARCEA,GL,3818,105,14,0,119,718,43,3,764
PODOLENI,GL,1245,22,0,0,22,213,10,0,223
BĂLĂBĂNEŞTI,GL,625,31,10,0,41,165,40,0,205
BURSUCANI,GL,495,11,3,0,14,88,10,0,98
LUNGEŞTI,GL,476,27,5,0,32,160,19,0,179
BĂLĂŞEŞTI,GL,933,23,5,0,28,257,25,0,282
"CIUREŞTII NOI",GL,420,14,7,0,21,109,37,0,146
CIUREŞTI,GL,267,7,0,0,7,74,23,0,97
PUPEZENI,GL,151,6,4,0,10,56,21,0,77
BĂLENI,GL,1954,53,14,0,67,199,41,0,240
ROŞCANI,GL,495,12,2,0,14,128,16,0,144
BĂNEASA,GL,1217,69,7,0,76,379,26,10,415
BEREŞTI-MERIA,GL,435,11,6,0,17,84,19,0,103
SLIVNA,GL,565,8,4,0,12,60,26,0,86
PURICANI,GL,223,20,6,0,26,63,28,0,91
ALDEŞTI,GL,365,16,2,0,18,102,7,0,109
PLEŞA,GL,534,14,6,0,20,107,25,0,132
BALINTEŞTI,GL,801,22,8,0,30,202,34,0,236
BRANIŞTEA,GL,2268,63,3,0,66,286,25,0,311
"VASILE ALECSANDRI",GL,893,30,9,0,39,175,31,0,206
TRAIAN,GL,465,12,5,0,17,46,11,0,57
BRĂHĂŞEŞTI,GL,2296,92,20,0,112,445,74,2,521
TOFLEA,GL,4043,158,15,0,173,713,56,0,769
BUCIUMENI,GL,939,38,10,2,50,220,21,2,243
HĂNŢEŞTI,GL,392,13,8,0,21,82,19,0,101
VIZUREŞTI,GL,325,9,7,0,16,101,19,0,120
"TECUCELU SEC",GL,363,12,3,0,15,104,17,0,121
CAVADINEŞTI,GL,1068,44,14,0,58,259,61,0,320
GĂNEŞTI,GL,733,13,6,0,19,149,33,0,182
VĂDENI,GL,373,18,5,0,23,101,25,0,126
COMĂNEŞTI,GL,182,9,4,0,13,56,17,0,73
CERŢEŞTI,GL,699,18,7,0,25,99,22,0,121
CÎRLOMĂNEŞTI,GL,624,16,5,0,21,81,10,0,91
COTOROAIA,GL,581,11,5,0,16,109,25,0,134
CORNI,GL,702,12,5,0,17,118,19,0,137
MĂCIŞENI,GL,661,10,7,0,17,105,10,0,115
URLEŞTI,GL,387,26,7,0,33,86,15,0,101
COROD,GL,4002,88,24,0,112,717,78,7,802
BLÎNZI,GL,975,9,0,0,9,132,14,0,146
BRĂTULEŞTI,GL,492,16,0,0,16,80,11,0,91
CĂRĂPCEŞTI,GL,644,13,10,0,23,94,22,0,116
COSMEŞTI,GL,1265,30,8,0,38,167,42,0,209
COSMEŞTII-VALE,GL,959,31,0,0,31,146,13,0,159
BĂLTĂREŢI,GL,742,19,2,0,21,140,14,0,154
"FURCENII VECHI",GL,1281,19,6,0,25,203,37,0,240
"FURCENII NOI",GL,1291,31,5,0,36,283,22,6,311
"COSTACHE NEGRI",GL,2189,85,11,0,96,504,50,0,554
CUCA,GL,1834,58,14,0,72,265,44,0,309
CUDALBI,GL,6241,119,11,0,130,793,75,0,868
"CUZA VODĂ",GL,2302,58,2,0,60,294,15,0,309
DRĂGĂNEŞTI,GL,3712,62,16,0,78,512,36,0,548
"MALU ALB",GL,1746,28,0,0,28,293,4,0,297
DRĂGUŞENI,GL,1493,27,2,0,29,381,35,0,416
FUNDEANU,GL,752,14,0,0,14,166,5,0,171
NICOPOLE,GL,454,10,5,0,15,79,6,0,85
CĂUIEŞTI,GL,467,11,6,0,17,103,6,0,109
ŞTIEŢEŞTI,GL,254,18,2,0,20,62,6,0,68
ADAM,GL,595,17,5,0,22,157,19,0,176
GHINGHEŞTI,GL,225,12,0,0,12,72,9,0,81
FÎRŢĂNEŞTI,GL,2847,57,12,0,69,415,48,0,463
VIILE,GL,1287,38,4,0,42,213,22,0,235
FOLTEŞTI,GL,1820,36,11,0,47,197,51,0,248
STOICANI,GL,862,38,11,0,49,124,19,0,143
FRUMUŞIŢA,GL,2678,80,11,0,91,456,39,0,495
IJDILENI,GL,753,12,5,0,17,61,12,0,73
TĂMĂOANI,GL,966,29,5,0,34,161,21,0,182
FUNDENI,GL,681,13,0,0,13,87,16,0,103
LUNGOCI,GL,426,6,16,0,22,96,32,0,128
"HANU CONACHI",GL,2100,40,3,0,43,277,30,0,307
GHIDIGENI,GL,1665,21,5,0,26,107,19,0,126
GEFU,GL,830,5,0,0,5,79,4,0,83
GÎRBOVĂŢ,GL,213,10,6,0,16,38,12,0,50
TĂLPIGI,GL,1658,17,1,0,18,223,15,0,238
"SLOBOZIA CORNI",GL,639,13,8,0,21,158,17,0,175
GOHOR,GL,1345,35,4,0,39,293,50,0,343
IREASCA,GL,223,20,5,0,25,74,16,0,90
NĂRTEŞTI,GL,670,25,2,0,27,180,27,0,207
"GARA BERHECI",GL,547,9,1,0,10,176,37,0,213
GRIVIŢA,GL,2517,68,11,0,79,413,45,0,458
CĂLMĂŢUI,GL,573,43,6,0,49,151,16,0,167
INDEPENDENŢA,GL,3939,104,19,0,123,442,68,0,510
IVEŞTI,GL,4307,279,36,0,315,1238,100,2,1340
BUCEŞTI,GL,3697,96,22,0,118,661,80,0,741
JORĂŞTI,GL,916,46,6,0,52,236,30,0,266
LUNCA,GL,177,10,4,0,14,40,12,0,52
ZĂRNEŞTI,GL,289,33,3,0,36,77,11,0,88
LIEŞTI,GL,8930,193,35,0,228,1172,121,0,1293
MATCA,GL,9884,160,27,0,187,2060,216,0,2276
MĂSTĂCANI,GL,1922,38,10,0,48,285,53,0,338
CHIRAFTEI,GL,2209,51,8,6,65,279,46,6,331
MOVILENI,GL,2762,59,11,0,70,462,39,1,502
MUNTENI,GL,3023,62,13,0,75,682,40,0,722
FRUNZEASCA,GL,1006,19,8,1,28,177,12,1,190
ŢIGĂNEŞTI,GL,840,13,4,0,17,159,19,0,178
UNGURENI,GL,1136,22,2,0,24,175,10,0,185
NĂMOLOASA,GL,809,27,4,0,31,119,28,0,147
"NĂMOLOASA SAT",GL,925,46,5,0,51,304,30,0,334
NEGRILEŞTI,GL,1407,36,4,0,40,311,24,0,335
"SLOBOZIA BLĂNEASA",GL,761,30,8,0,38,248,31,0,279
NICOREŞTI,GL,1174,29,9,0,38,138,33,0,171
FÎNTÎNI,GL,497,18,7,0,25,101,18,0,119
"COASTA LUPEI",GL,268,4,9,0,13,55,23,0,78
"PISCU CORBULUI",GL,243,11,1,0,12,36,11,0,47
MĂLURENI,GL,164,5,3,0,8,25,9,0,34
IONĂŞEŞTI,GL,549,13,0,0,13,50,8,0,58
DOBRINEŞTI,GL,402,7,3,0,10,71,13,0,84
OANCEA,GL,1235,73,11,0,84,211,49,0,260
PECHEA,GL,9190,222,29,1,252,1323,134,1,1458
PISCU,GL,3585,160,27,0,187,668,96,0,764
VAMEŞ,GL,447,26,0,0,26,98,23,0,121
POIANA,GL,1021,57,15,43,115,406,89,43,538
VIŞINA,GL,395,19,4,0,23,184,25,2,211
PRIPONEŞTI,GL,781,19,6,0,25,90,23,0,113
CIORĂŞTI,GL,831,25,6,0,31,200,44,0,244
LIEŞTI,GL,170,14,8,0,22,49,23,0,72
RĂDEŞTI,GL,955,105,14,0,119,322,63,3,388
CRUCEANU,GL,242,25,3,0,28,78,8,0,86
REDIU,GL,1322,30,9,0,39,221,43,0,264
PLEVNA,GL,460,27,8,0,35,94,15,0,109
SCHELA,GL,2567,75,15,0,90,332,43,0,375
NEGREA,GL,538,16,3,0,19,96,19,0,115
SCÎNTEIEŞTI,GL,738,21,8,0,29,121,34,0,155
FÎNTÎNELE,GL,1283,44,7,0,51,197,26,0,223
"SLOBOZIA CONACHI",GL,2623,55,8,0,63,373,47,0,420
IZVOARELE,GL,837,15,6,0,21,121,17,0,138
SMÎRDAN,GL,2545,45,13,0,58,270,47,0,317
"MIHAIL KOGĂLNICEANU",GL,872,19,10,0,29,96,36,0,132
CIŞMELE,GL,1217,29,8,0,37,142,12,0,154
SMULŢI,GL,1154,52,13,0,65,321,75,44,440
SUCEVENI,GL,966,129,21,0,150,375,77,35,487
ROGOJENI,GL,462,54,10,0,64,190,27,0,217
SUHURLUI,GL,1165,20,10,0,30,196,22,0,218
ŞENDRENI,GL,2818,82,9,0,91,370,50,0,420
MOVILENI,GL,568,26,0,0,26,103,9,0,112
"ŞERBEŞTII VECHI",GL,665,21,1,0,22,84,4,0,88
"TUDOR VLADIMIRESCU",GL,4365,215,44,0,259,927,143,18,1088
TULUCEŞTI,GL,3571,81,26,0,107,434,72,0,506
TĂTARCA,GL,701,19,6,0,25,83,25,0,108
ŞIVIŢA,GL,2122,53,4,0,57,321,38,0,359
ŢEPU,GL,2031,49,10,0,59,591,60,10,661
UMBRĂREŞTI,GL,1718,20,10,0,30,269,40,1,310
UMBRĂREŞTI-DEAL,GL,2024,75,9,0,84,531,39,0,570
TORCEŞTI,GL,594,10,9,0,19,196,22,0,218
CONDREA,GL,569,15,9,0,24,89,13,0,102
SALCIA,GL,723,13,5,0,18,143,9,0,152
SILIŞTEA,GL,276,9,9,0,18,67,17,0,84
"VALEA MĂRULUI",GL,2181,56,23,0,79,351,52,13,416
MÎNDREŞTI,GL,810,33,4,15,52,246,25,42,313
VÎNĂTORI,GL,2340,88,21,0,109,420,78,0,498
"ODAIA MANOLACHE",GL,1603,63,14,0,77,220,25,0,245
COSTI,GL,1105,26,13,0,39,143,39,0,182
VÎRLEZI,GL,896,36,8,0,44,221,54,16,291
CRĂIEŞTI,GL,652,24,16,4,44,207,49,4,260
VLĂDEŞTI,GL,1089,37,7,0,44,192,47,0,239
BRĂNEŞTI,GL,887,17,1,0,18,105,20,0,125
GIURGIU,GR,57545,3281,252,392,3925,8891,661,401,9953
BOLINTIN-VALE,GR,6762,142,60,0,202,662,156,0,818
"MALU SPART",GR,2966,61,9,0,70,345,37,0,382
CRIVINA,GR,744,17,5,0,22,68,14,0,82
MIHĂILEŞTI,GR,4312,203,72,0,275,787,224,0,1011
POPEŞTI,GR,874,31,9,0,40,296,49,0,345
NOVACI,GR,937,14,12,0,26,194,36,0,230
ADUNAŢII-COPĂCENI,GR,2715,92,10,0,102,621,89,0,710
DĂRĂŞTI-VLAŞCA,GR,1645,75,18,0,93,291,61,0,352
VARLAAM,GR,477,17,8,0,25,130,31,0,161
MOGOŞEŞTI,GR,380,17,6,0,23,129,25,0,154
BĂNEASA,GR,2520,65,22,0,87,369,74,0,443
PIETRELE,GR,878,15,2,0,17,98,10,0,108
FRASINU,GR,346,18,4,0,22,65,19,0,84
"SFÎNTU GHEORGHE",GR,208,6,12,0,18,31,27,0,58
BOLINTIN-DEAL,GR,3596,89,28,0,117,337,90,3,430
"MIHAI VODĂ",GR,1593,35,15,0,50,111,42,0,153
BUCŞANI,GR,788,12,9,0,21,92,25,0,117
"VADU LAT",GR,553,7,5,0,12,88,31,0,119
PODIŞOR,GR,448,13,9,0,22,98,20,0,118
OBEDENI,GR,367,18,14,0,32,60,29,0,89
UIEŞTI,GR,256,16,6,0,22,123,22,0,145
GOLEASCA,GR,358,26,3,0,29,101,20,0,121
BULBUCATA,GR,1082,40,26,0,66,384,164,0,548
BUTURUGENI,GR,1619,70,13,0,83,520,93,0,613
PĂDURENI,GR,1198,59,10,0,69,356,60,0,416
POŞTA,GR,338,14,3,0,17,84,21,0,105
CĂLUGĂRENI,GR,1455,22,45,0,67,266,114,0,380
BRĂNIŞTARI,GR,603,20,13,0,33,90,73,0,163
UZUNU,GR,1195,16,4,0,20,112,34,0,146
HULUBEŞTI,GR,1323,26,3,0,29,253,44,0,297
CLEJANI,GR,1334,151,59,14,224,597,175,14,786
NEAJLOVU,GR,1135,211,39,18,268,641,119,18,778
COLIBAŞI,GR,1636,68,17,0,85,764,91,0,855
CÎMPURELU,GR,1085,27,7,0,34,420,40,0,460
COMANA,GR,1716,230,97,0,327,703,219,3,925
BUDENI,GR,581,135,69,0,204,280,139,0,419
FALAŞTOACA,GR,628,18,13,0,31,279,110,0,389
GRĂDIŞTEA,GR,1207,57,25,0,82,264,78,0,342
"VLAD ŢEPEŞ",GR,1336,188,67,0,255,529,155,0,684
COSOBA,GR,2152,66,16,0,82,229,33,0,262
"CREVEDIA MARE",GR,1203,64,12,0,76,266,41,0,307
DEALU,GR,1074,102,8,0,110,237,22,0,259
"CREVEDIA MICĂ",GR,1537,103,9,0,112,347,26,0,373
DAIA,GR,796,49,25,0,74,248,98,0,346
PLOPŞORU,GR,1337,32,13,0,45,148,56,0,204
STOENEŞTI,GR,1584,34,7,0,41,128,30,0,158
FLOREŞTI,GR,3371,78,22,0,100,347,62,0,409
PALANCA,GR,2198,27,9,0,36,132,31,0,163
FRĂTEŞTI,GR,2057,41,10,0,51,241,40,0,281
REMUŞ,GR,1679,38,53,0,91,198,75,0,273
CETATEA,GR,623,41,16,0,57,105,54,0,159
GĂISENI,GR,1830,42,12,0,54,275,65,0,340
CĂSCIOARELE,GR,1646,32,9,0,41,213,35,0,248
CĂRPENIŞU,GR,682,19,13,0,32,142,29,0,171
"PODU POPA NAE",GR,130,10,9,0,19,77,21,0,98
CETĂŢUIA,GR,144,13,12,0,25,38,29,0,67
GĂUJANI,GR,936,45,1,0,46,148,30,0,178
PIETRIŞU,GR,776,28,4,0,32,131,17,0,148
GHIMPAŢI,GR,1804,124,29,67,220,709,96,92,897
COPACIU,GR,745,53,14,19,86,343,56,19,418
NAIPU,GR,1272,57,19,56,132,471,66,56,593
"VALEA PLOPILOR",GR,520,90,3,0,93,252,13,0,265
GOGOŞARI,GR,645,49,31,0,80,170,56,0,226
RĂLEŞTI,GR,121,9,10,0,19,46,30,0,76
DRĂGHICEANU,GR,91,12,12,0,24,31,21,0,52
IZVORU,GR,530,44,24,0,68,143,41,0,184
GOSTINARI,GR,1523,131,24,0,155,552,87,0,639
MIRONEŞTI,GR,340,15,16,0,31,67,40,29,136
GOSTINU,GR,1559,288,22,0,310,815,83,0,898
GRĂDINARI,GR,843,51,24,0,75,258,65,0,323
TÎNTAVA,GR,1003,35,13,0,48,234,44,0,278
ZORILE,GR,848,53,10,0,63,220,27,0,247
GREACA,GR,1411,76,19,0,95,450,91,0,541
"PUŢU GRECI",GR,271,7,2,0,9,70,16,0,86
ZBOIU,GR,245,11,5,0,16,88,18,0,106
HERĂŞTI,GR,1715,45,12,0,57,343,85,0,428
HOTARELE,GR,2917,66,28,0,94,441,161,11,613
IEPUREŞTI,GR,843,29,42,0,71,161,116,0,277
GORNENI,GR,530,12,14,0,26,148,59,0,207
STÎLPU,GR,202,18,9,0,27,45,27,0,72
ISVOARELE,GR,1120,11,5,0,16,142,31,0,173
TEIUŞU,GR,176,11,2,0,13,52,8,0,60
IZVOARELE,GR,1036,28,11,0,39,131,26,0,157
CHIRIACU,GR,1040,27,5,0,32,208,42,0,250
"PETRU RAREŞ",GR,75,20,41,0,61,46,75,0,121
"VALEA BUJORULUI",GR,396,19,8,0,27,96,24,0,120
"DIMITRIE CANTEMIR",GR,136,8,13,0,21,31,44,0,75
"RADU VODĂ",GR,174,27,7,0,34,71,36,0,107
JOIŢA,GR,1785,72,16,0,88,249,63,2,314
BÎCU,GR,1236,53,22,0,75,212,99,0,311
"LETCA NOUĂ",GR,717,30,18,0,48,179,61,0,240
"LETCA VECHE",GR,755,60,21,0,81,276,56,0,332
MILCOVĂŢU,GR,1111,104,26,0,130,493,68,0,561
MALU,GR,1818,67,10,0,77,246,64,0,310
"MIHAI BRAVU",GR,1908,266,51,0,317,819,144,0,963
MÂRŞA,GR,2203,83,7,0,90,582,58,0,640
OGREZENI,GR,3056,59,25,0,84,344,83,0,427
HOBAIA,GR,737,19,4,0,23,73,13,0,86
OINACU,GR,1468,106,21,0,127,356,74,0,430
BRANIŞTEA,GR,823,36,7,0,43,211,33,0,244
COMASCA,GR,514,23,5,0,28,147,12,0,159
PRUNDU,GR,2800,68,6,0,74,474,49,0,523
PUIENI,GR,608,10,4,0,14,121,26,0,147
PUTINEIU,GR,1001,181,36,0,217,608,93,0,701
HODIVOAIA,GR,318,64,22,0,86,182,48,0,230
VIERU,GR,567,28,11,0,39,347,63,0,410
RĂSUCENI,GR,1101,207,67,0,274,601,219,2,822
CUCURUZU,GR,721,45,7,0,52,256,55,0,311
"ROATA MICĂ",GR,411,9,7,0,16,51,18,0,69
"ROATA DE JOS",GR,1908,79,13,0,92,355,60,0,415
CARTOJANI,GR,2977,24,7,0,31,267,34,0,301
SADINA,GR,1261,28,4,0,32,235,37,0,272
SĂBĂRENI,GR,2156,107,27,22,156,520,117,24,661
SCHITU,GR,180,30,6,0,36,78,28,0,106
BILA,GR,335,42,8,0,50,121,36,0,157
CĂMINEASCA,GR,426,30,10,0,40,133,37,0,170
VLAŞIN,GR,392,23,13,0,36,129,41,0,170
SINGURENI,GR,1182,51,26,0,77,349,74,10,433
CRÎNGURI,GR,590,14,8,0,22,187,23,0,210
STEJARU,GR,607,22,9,0,31,202,19,0,221
SLOBOZIA,GR,1989,92,24,0,116,627,162,0,789
STĂNEŞTI,GR,1058,19,10,0,29,77,39,0,116
GHIZDARU,GR,411,14,8,0,22,70,24,0,94
BĂLANU,GR,416,17,6,0,23,70,29,0,99
ONCEŞTI,GR,282,14,6,0,20,42,36,0,78
IANCULEŞTI,GR,220,22,9,0,31,124,18,0,142
STOENEŞTI,GR,1268,262,62,0,324,569,166,0,735
MIRĂU,GR,124,44,12,0,56,78,31,0,109
TOPORU,GR,1003,71,22,49,142,383,94,109,586
TOMULEŞTI,GR,498,64,30,26,120,214,76,57,347
ULMI,GR,922,25,16,0,41,116,33,0,149
POENARI,GR,1123,40,9,0,49,166,49,0,215
TRESTIENI,GR,1980,49,17,0,66,260,41,0,301
DRĂGĂNEASCA,GR,639,38,8,0,46,196,41,0,237
ICOANA,GR,908,18,1,0,19,118,4,0,122
GHIONEA,GR,465,32,8,0,40,138,29,0,167
"VALEA DRAGULUI",GR,2380,66,16,0,82,746,58,0,804
VĂRĂŞTI,GR,2836,158,35,0,193,1276,158,0,1434
DOBRENI,GR,1918,55,7,0,62,440,52,0,492
VEDEA,GR,2209,66,27,0,93,403,94,0,497
"VÂNĂTORII MICI",GR,818,21,5,0,26,104,23,0,127
IZVORU,GR,633,32,3,0,35,101,20,22,143
"VÎNĂTORII MARI",GR,935,30,4,0,34,145,33,0,178
"POIANA LUI STÎNGĂ",GR,566,34,9,0,43,113,23,0,136
CORBEANCA,GR,390,7,2,0,9,44,17,0,61
CUPELE,GR,368,23,5,0,28,70,11,0,81
DEVA,HD,56977,3665,345,27,4037,9741,799,260,10800
CRISTUR,HD,1405,44,1,0,45,223,19,60,302
SÎNTUHALM,HD,609,13,3,0,16,88,11,81,180
BRAD,HD,11581,653,35,32,720,1797,135,91,2023
"VALEA BRADULUI",HD,642,23,7,0,30,103,8,0,111
ŢĂRĂŢEL,HD,611,14,1,0,15,73,14,0,87
MESTEACĂN,HD,467,12,2,0,14,71,5,0,76
RUDA-BRAD,HD,162,8,3,0,11,31,12,0,43
HUNEDOARA,HD,58873,3945,250,75,4270,10484,512,178,11174
HĂŞDAT,HD,373,18,0,0,18,71,3,0,74
RĂCĂŞTIA,HD,537,41,0,0,41,113,4,0,117
BOŞ,HD,495,29,6,0,35,104,11,0,115
"PEŞTIŞU MARE",HD,1053,43,2,0,45,226,22,0,248
LUPENI,HD,22054,1269,83,37,1389,3500,199,37,3736
ORĂŞTIE,HD,18559,822,69,21,912,3186,213,36,3435
PETROŞANI,HD,35431,2098,143,62,2303,5798,316,98,6212
VULCAN,HD,23426,1328,68,1,1397,3663,169,0,3832
ANINOASA,HD,2443,104,2,0,106,380,18,0,398
ISCRONI,HD,1330,38,1,0,39,150,8,0,158
CĂLAN,HD,8159,421,22,2,445,1259,57,2,1318
"NĂDĂŞTIA DE JOS",HD,262,13,4,1,18,56,9,1,66
"NĂDĂŞTIA DE SUS",HD,226,13,5,0,18,88,21,0,109
STREI,HD,313,9,0,0,9,43,8,0,51
STREI-SĂCEL,HD,157,11,6,0,17,49,10,0,59
"VALEA SÎNGEORGIULUI",HD,258,9,5,0,14,76,6,0,82
BATIZ,HD,491,6,6,0,12,74,13,0,87
GRID,HD,205,5,2,0,7,35,7,0,42
SÎNCRAI,HD,258,7,0,0,7,45,5,0,50
"SÎNTĂMĂRIA DE PIATRĂ",HD,131,7,0,0,7,28,10,0,38
STREISÎNGEORGIU,HD,631,30,4,0,34,151,13,0,164
GEOAGIU,HD,2390,39,15,64,118,243,55,70,368
"AUREL VLAICU",HD,774,45,8,0,53,139,28,0,167
BOZEŞ,HD,175,4,1,0,5,30,8,0,38
CIGMĂU,HD,89,2,3,0,5,4,9,0,13
GEOAGIU-BĂI,HD,369,21,161,0,182,78,232,0,310
GELMAR,HD,384,29,1,0,30,93,10,9,112
HOMOROD,HD,292,7,5,0,12,60,9,0,69
RENGHET,HD,175,2,3,0,5,23,10,0,33
VĂLENI,HD,43,1,1,0,2,6,7,0,13
HAŢEG,HD,8070,635,123,0,758,2209,286,24,2519
NĂLAŢVAD,HD,313,43,0,0,43,136,14,0,150
"SILVAŞU DE JOS",HD,313,18,7,0,25,93,26,0,119
"SILVAŞU DE SUS",HD,272,34,26,0,60,104,36,0,140
PETRILA,HD,18194,1174,63,17,1254,3779,126,18,3923
CIMPA,HD,1429,86,9,0,95,531,18,0,549
JIEŢ,HD,563,15,0,0,15,145,6,0,151
SIMERIA,HD,9804,632,70,0,702,2104,184,20,2308
"SIMERIA VECHE",HD,357,31,0,0,31,106,10,0,116
UROI,HD,539,28,3,0,31,104,12,0,116
SÎNTANDREI,HD,949,53,12,0,65,209,37,0,246
URICANI,HD,7385,426,15,0,441,1275,37,0,1312
"CÎMPU LUI NEAG",HD,414,14,5,0,19,66,22,0,88
"BAIA DE CRIŞ",HD,608,27,3,0,30,146,22,0,168
LUNCA,HD,235,7,5,0,12,50,9,0,59
CĂRĂSTĂU,HD,162,10,6,0,16,45,12,0,57
RIŞCA,HD,190,17,2,0,19,61,14,0,75
RIŞCULIŢA,HD,411,19,3,0,22,89,13,0,102
ŢEBEA,HD,588,31,4,0,35,182,23,0,205
BALŞA,HD,234,7,1,1,9,54,10,2,66
ARDEU,HD,49,7,2,0,9,26,10,0,36
MADA,HD,89,5,2,0,7,29,12,0,41
VOIA,HD,70,5,4,0,9,30,13,4,47
VĂLIŞOARA,HD,48,7,3,0,10,19,6,0,25
"ALMAŞU MIC DE MUNTE",HD,60,5,5,0,10,17,17,0,34
POIANA,HD,85,3,2,0,5,22,14,0,36
POIENIŢA,HD,66,5,4,0,9,20,6,0,26
BARU,HD,1610,174,18,57,249,747,61,57,865
LIVADIA,HD,533,47,8,18,73,224,44,24,292
"VALEA LUPULUI",HD,163,23,7,9,39,106,31,9,146
BĂCIA,HD,818,29,10,0,39,161,30,0,191
TOTIA,HD,83,0,5,0,5,25,11,0,36
TÎMPA,HD,663,37,4,0,41,158,21,0,179
BĂIŢA,HD,1009,44,11,0,55,223,43,0,266
HĂRŢĂGANI,HD,615,10,1,0,11,89,27,0,116
"CĂINELU DE SUS",HD,339,9,6,0,15,69,11,0,80
ORMINDEA,HD,456,13,3,0,16,56,11,0,67
FIZEŞ,HD,259,12,5,0,17,71,16,0,87
LUNCA,HD,238,22,8,0,30,79,20,0,99
BĂNIŢA,HD,988,23,1,0,24,225,12,0,237
BĂTRÎNA,HD,96,11,5,0,16,38,9,0,47
BERIU,HD,585,20,2,0,22,105,15,0,120
CĂSTĂU,HD,1061,39,9,0,48,246,19,0,265
CUCUIŞ,HD,106,7,2,0,9,31,7,0,38
"ORĂŞTIOARA DE JOS",HD,285,12,2,0,14,83,11,0,94
SERECA,HD,208,9,2,0,11,58,7,0,65
SIBIŞEL,HD,571,10,6,0,16,85,16,0,101
BLĂJENI,HD,522,15,2,0,17,88,9,0,97
CRIŞ,HD,246,11,5,0,16,48,9,0,57
BLĂJENI-VULCAN,HD,80,8,5,0,13,28,8,0,36
REŢ,HD,81,0,0,0,0,14,4,0,18
BOŞOROD,HD,793,26,2,0,28,233,19,0,252
CHITID,HD,477,30,2,0,32,133,11,0,144
LUNCANI,HD,107,5,3,0,8,22,8,0,30
URSICI,HD,52,3,5,0,8,11,8,0,19
ALUN,HD,64,5,5,0,10,24,7,0,31
TÎRSA,HD,169,5,4,0,9,76,11,0,87
BRĂNIŞCA,HD,523,26,13,11,50,94,32,11,137
BOZ,HD,367,9,3,0,12,63,27,0,90
ROVINA,HD,187,12,4,0,16,39,12,0,51
TÎRNAVA,HD,100,4,2,0,6,21,15,0,36
TÎRNĂVIŢA,HD,143,7,2,0,9,31,11,0,42
"BRETEA ROMÂNĂ",HD,231,12,9,0,21,65,18,0,83
"BRETEA STREIULUI",HD,217,21,9,0,30,65,16,0,81
RUŞI,HD,210,9,6,0,15,62,12,1,75
BĂŢĂLAR,HD,201,11,5,0,16,66,10,0,76
"OCOLIŞU MARE",HD,176,10,4,0,14,78,28,0,106
COVRAGIU,HD,135,3,6,0,9,38,10,0,48
GÎNŢAGA,HD,230,17,3,0,20,80,11,0,91
MĂCEU,HD,263,5,6,0,11,63,13,0,76
PLOPI,HD,225,6,4,0,10,70,11,0,81
"VÎLCELELE BUNE",HD,324,27,8,0,35,111,20,0,131
VÎLCELE,HD,221,12,5,1,18,100,21,1,122
BUCEŞ,HD,131,11,3,0,14,45,23,0,68
BUCEŞ-VULCAN,HD,180,2,0,0,2,52,11,0,63
DUPĂPIATRĂ,HD,402,7,0,0,7,75,9,0,84
GROHOŢELE,HD,165,9,4,0,13,32,7,0,39
MIHĂILENI,HD,350,12,2,0,14,65,8,0,73
STĂNIJA,HD,322,10,3,0,13,54,6,0,60
BUCUREŞCI,HD,505,18,1,0,19,108,3,0,111
CURECHIU,HD,273,25,2,0,27,145,14,0,159
ROVINA,HD,129,3,4,0,7,30,6,0,36
MERIŞOR,HD,73,3,3,0,6,21,4,0,25
ŞESURI,HD,344,23,2,0,25,158,9,0,167
"BULZEŞTII DE SUS",HD,137,11,3,0,14,57,33,0,90
"BULZEŞTII DE JOS",HD,95,12,2,0,14,29,10,0,39
BUNILA,HD,66,6,0,0,6,20,7,0,27
"CERNIŞOARA FLORESE",HD,170,12,2,0,14,64,13,0,77
"POIENIŢA VOINII",HD,68,10,2,0,12,40,11,0,51
BURJUC,HD,140,12,5,0,17,44,13,0,57
TĂTĂRĂŞTI,HD,149,10,6,0,16,46,28,0,74
TISA,HD,94,5,0,0,5,18,8,0,26
GLODGHILEŞTI,HD,168,13,0,0,13,82,0,0,82
BRĂDĂŢEL,HD,119,3,5,0,8,27,11,0,38
CÂRJIŢI,HD,107,7,4,0,11,31,16,0,47
CHERGHEŞ,HD,73,6,4,0,10,32,10,0,42
POPEŞTI,HD,114,4,8,0,12,41,23,0,64
"ALMAŞU SEC",HD,167,17,3,0,20,54,17,0,71
COZIA,HD,134,10,0,0,10,34,13,0,47
CERBĂL,HD,177,26,6,0,32,87,23,0,110
FEREGI,HD,112,12,3,0,15,58,14,0,72
"POIANA RĂCHIŢELII",HD,101,7,4,0,11,53,12,0,65
"CERTEJU DE SUS",HD,1238,77,6,0,83,236,14,0,250
HONDOL,HD,443,23,2,0,25,98,14,0,112
SĂCĂRÎMB,HD,143,5,4,0,9,20,13,0,33
"BOCŞA MICĂ",HD,91,18,4,0,22,45,7,0,52
MĂGURA-TOPLIŢA,HD,84,14,1,0,15,38,5,0,43
"TOPLIŢA MUREŞULUI",HD,72,4,4,0,8,15,14,0,29
NOJAG,HD,202,8,8,0,16,36,14,0,50
VĂRMAGA,HD,246,6,7,0,13,66,26,0,92
ZDRAPŢI,HD,741,20,9,0,29,124,21,0,145
CRIŞCIOR,HD,2592,90,11,0,101,455,48,0,503
DENSUŞ,HD,499,29,18,0,47,216,46,0,262
PEŞTEANA,HD,300,16,1,0,17,119,21,0,140
PEŞTENIŢA,HD,217,16,2,0,18,61,6,0,67
ŞTEI,HD,158,11,5,0,16,92,19,0,111
POIENI,HD,70,5,5,0,10,35,7,0,42
DOBRA,HD,1313,52,20,0,72,370,90,0,460
LĂPUŞNIC,HD,395,14,8,0,22,88,25,0,113
RĂDULEŞTI,HD,153,5,7,0,12,45,10,0,55
STÎNCEŞTI,HD,105,9,6,0,15,38,9,0,47
ROŞCANI,HD,561,28,6,0,34,149,20,0,169
PANC,HD,145,16,7,0,23,52,17,0,69
"GENERAL BERTHELOT",HD,542,17,6,0,23,128,10,0,138
TUŞTEA,HD,227,13,3,0,16,66,13,0,79
GHELARI,HD,1531,68,3,0,71,349,24,0,373
RUDA,HD,138,14,6,0,20,44,14,0,58
PLOP,HD,23,11,7,0,18,12,13,0,25
GOVĂJDIA,HD,76,3,0,0,3,10,12,0,22
GURASADA,HD,598,15,3,0,18,113,33,0,146
CÎMPURI-SURDUC,HD,364,37,3,0,40,103,17,0,120
"BOIU DE SUS",HD,95,2,3,0,5,20,5,0,25
CĂRMĂZĂNEŞTI,HD,93,5,3,0,8,16,10,0,26
HĂRĂU,HD,662,22,7,0,29,75,15,0,90
BANPOTOC,HD,389,14,1,0,15,121,26,0,147
BÎRSĂU,HD,426,13,4,0,17,92,16,0,108
CHIMINDIA,HD,312,25,8,0,33,83,18,0,101
ILIA,HD,1456,97,10,0,107,346,32,0,378
"BRETEA MUREŞANĂ",HD,507,20,11,0,31,75,27,0,102
SÎRBI,HD,358,5,0,0,5,43,3,0,46
"VALEA LUNGĂ",HD,89,7,4,0,11,26,9,0,35
BACEA,HD,307,14,4,0,18,74,10,0,84
BRÎZNIC,HD,183,15,12,0,27,63,27,0,90
SĂCĂMAŞ,HD,174,6,2,0,8,37,6,0,43
"LĂPUGIU DE JOS",HD,381,11,5,0,16,62,29,0,91
OHABA,HD,406,23,7,0,30,145,73,0,218
"LĂPUGIU DE SUS",HD,306,17,7,0,24,133,24,0,157
LELESE,HD,162,5,2,0,7,45,9,0,54
CERIŞOR,HD,83,2,5,0,7,29,11,0,40
"RUNCU MARE",HD,86,2,2,0,4,31,6,0,37
"LUNCA CERNII DE JOS",HD,382,4,3,0,7,108,17,0,125
NEGOIU,HD,155,3,2,0,5,47,10,0,57
MERIA,HD,223,9,1,0,10,41,6,0,47
"LUNCOIU DE JOS",HD,886,25,1,0,26,187,15,0,202
"LUNCOIU DE SUS",HD,631,17,6,0,23,144,18,0,162
MĂRTINEŞTI,HD,233,12,9,0,21,55,23,0,78
"DÎNCU MARE",HD,196,12,3,0,15,91,30,0,121
"DÎNCU MIC",HD,88,10,10,1,21,30,37,1,68
JELEDINŢI,HD,214,8,2,0,10,40,11,0,51
TĂMĂŞASA,HD,93,4,5,0,9,28,18,0,46
"ORĂŞTIOARA DE SUS",HD,408,13,3,0,16,70,11,0,81
BUCIUM,HD,269,13,0,0,13,88,14,0,102
"LUDEŞTII DE JOS",HD,284,7,5,0,12,76,11,0,87
COSTEŞTI,HD,425,16,15,0,31,85,40,0,125
"GRĂDIŞTEA DE MUNTE",HD,138,4,4,0,8,46,11,0,57
"OCOLIŞU MIC",HD,303,13,2,0,15,68,16,0,84
"PESTIŞU MIC",HD,178,21,1,0,22,69,3,0,72
"ALMAŞU MIC",HD,55,5,8,0,13,9,10,0,19
CIULPĂZ,HD,93,6,0,0,6,28,7,0,35
JOSANI,HD,171,18,3,0,21,84,7,0,91
MĂNERĂU,HD,246,30,6,0,36,90,13,0,103
NANDRU,HD,139,13,5,0,18,58,15,0,73
"VALEA NANDRULUI",HD,124,8,1,0,9,34,9,0,43
PUI,HD,684,37,4,0,41,148,23,0,171
RUŞOR,HD,272,17,5,0,22,80,9,0,89
BĂIEŞTI,HD,191,17,5,0,22,63,20,1,84
GALAŢI,HD,394,17,4,0,21,132,11,0,143
FIZEŞTI,HD,263,10,0,0,10,46,2,0,48
ŞEREL,HD,368,12,4,0,16,115,17,0,132
"RÎU BĂRBAT",HD,152,9,0,0,9,39,9,0,48
HOBIŢA,HD,145,6,0,0,6,55,6,0,61
URIC,HD,255,18,5,0,23,120,15,0,135
PONOR,HD,368,6,4,0,10,79,7,0,86
OHABA-PONOR,HD,210,3,0,0,3,31,6,0,37
FEDERI,HD,201,5,3,0,8,32,5,0,37
BOIU,HD,131,9,2,0,11,50,13,0,63
BOBÎLNA,HD,396,14,7,0,21,87,20,0,107
FOLT,HD,137,4,1,0,5,25,9,0,34
RAPOLŢEL,HD,183,7,2,0,9,29,10,0,39
"RAPOLTU MARE",HD,764,11,0,0,11,137,11,0,148
RĂCHITOVA,HD,537,43,9,0,52,248,42,0,290
BOIŢA,HD,365,31,2,0,33,145,14,0,159
VĂLIOARA,HD,191,9,8,0,17,97,24,0,121
"RÂU DE MORI",HD,841,41,5,0,46,295,20,0,315
CLOPOTIVA,HD,693,27,13,0,40,227,29,0,256
OSTROV,HD,379,14,1,0,15,127,11,0,138
"VALEA DÎLJII",HD,192,17,0,0,17,101,13,0,114
UNCIUC,HD,181,10,6,0,16,88,19,0,107
SIBIŞEL,HD,307,20,11,0,31,135,25,0,160
RIBIŢA,HD,514,17,4,0,21,125,17,0,142
CRIŞAN,HD,359,33,13,0,46,129,22,0,151
"DUMBRAVA DE JOS",HD,142,6,4,0,10,47,11,0,58
"DUMBRAVA DE SUS",HD,56,4,2,0,6,16,17,0,33
UIBĂREŞTI,HD,60,6,6,0,12,22,7,0,29
ROMOS,HD,975,34,5,0,39,167,21,0,188
ROMOŞEL,HD,591,9,3,0,12,80,5,0,85
VAIDEI,HD,509,19,11,0,30,80,24,0,104
PIŞCHINŢI,HD,184,11,6,0,17,42,11,0,53
SARMIZEGETUSA,HD,465,42,5,0,47,229,34,33,296
BREAZOVA,HD,153,30,6,0,36,103,13,5,121
HOBIŢA-GRĂDIŞTE,HD,110,17,3,0,20,56,6,7,69
PĂUCINEŞTI,HD,149,11,3,0,14,77,9,9,95
ZEICANI,HD,106,12,9,0,21,52,18,4,74
"SĂLAŞU DE SUS",HD,424,36,7,0,43,165,31,0,196
"SĂLAŞU DE JOS",HD,196,12,2,0,14,66,15,0,81
"OHABA DE SUB PIATRĂ",HD,163,17,6,0,23,60,20,0,80
"RÎU ALB",HD,163,10,3,0,13,67,9,0,76
COROIEŞTI,HD,150,21,3,0,24,72,14,0,86
PAROŞ,HD,272,11,0,0,11,102,17,0,119
NUCŞOARA,HD,242,4,1,0,5,62,3,0,65
MĂLĂIEŞTI,HD,124,10,2,0,12,48,6,0,54
ZĂVOI,HD,105,11,1,0,12,31,6,0,37
"RÎU MIC",HD,143,5,0,0,5,56,7,0,63
SÂNTĂMĂRIA-ORLEA,HD,635,33,0,0,33,187,14,2,203
SUBCETATE,HD,480,28,5,0,33,135,17,4,156
BUCIUM-ORLEA,HD,175,9,4,0,13,75,9,5,89
BALOMIR,HD,269,27,3,0,30,138,7,4,149
CIOPEIA,HD,327,11,2,0,13,100,7,0,107
"BĂRĂŞTII HAŢEGULUI",HD,316,22,5,0,27,111,20,2,133
SĂCEL,HD,227,13,6,0,19,83,17,0,100
SÎNPETRU,HD,201,22,8,0,30,108,18,3,129
ŞOIMUŞ,HD,1088,39,9,0,48,235,48,0,283
BĂLATA,HD,357,17,9,0,26,80,27,0,107
BOHOLŢ,HD,271,8,7,0,15,43,22,0,65
FORNĂDIA,HD,179,11,1,0,12,43,8,0,51
SULIGHETE,HD,233,3,0,0,3,37,11,0,48
PĂULIŞ,HD,563,14,3,0,17,116,8,0,124
CHIŞCĂDAGA,HD,301,9,1,0,10,49,4,0,53
"TELIUCU INFERIOR",HD,1197,61,9,0,70,306,23,0,329
CINCIŞ-CERNA,HD,550,72,10,0,82,262,38,0,300
IZVOARELE,HD,76,16,3,0,19,34,15,0,49
"TELIUCU SUPERIOR",HD,268,12,3,0,15,68,6,0,74
LIVADA,HD,97,4,0,0,4,28,4,0,32
TOMEŞTI,HD,439,15,2,0,17,144,15,0,159
DOBROŢ,HD,332,7,0,0,7,60,12,0,72
TOPLIŢA,HD,154,8,3,0,11,48,13,0,61
HĂŞDĂU,HD,303,16,4,0,20,96,14,0,110
DĂBÎCA,HD,130,5,2,0,7,37,7,0,44
"DEALU MIC",HD,42,4,7,0,11,14,9,0,23
VĂLARI,HD,29,5,6,0,11,15,10,0,25
TOTEŞTI,HD,333,33,1,0,34,196,14,9,219
CÎRNEŞTI,HD,383,25,0,6,31,203,18,6,227
PĂCLIŞA,HD,510,72,18,20,110,285,64,20,369
REEA,HD,347,39,7,1,47,194,18,1,213
TURDAŞ,HD,412,42,2,2,46,109,21,2,132
PRICAZ,HD,1028,37,7,0,44,210,16,0,226
SPINI,HD,247,8,4,0,12,33,7,0,40
"VAŢA DE JOS",HD,878,24,5,0,29,158,16,0,174
CĂZĂNEŞTI,HD,164,2,3,0,5,15,5,0,20
BIRTIN,HD,250,22,3,0,25,76,9,0,85
PRĂVĂLENI,HD,230,10,0,0,10,38,2,0,40
CIUNGANI,HD,200,4,1,0,5,26,3,0,29
PRIHODIŞTE,HD,318,11,1,0,12,91,6,0,97
"TÎRNAVA DE CRIŞ",HD,670,16,4,0,20,107,9,0,116
OCIU,HD,406,10,4,0,14,69,11,0,80
VĂLIŞOARA,HD,617,13,3,0,16,126,19,0,145
"DEALU MARE",HD,162,15,2,0,17,43,10,0,53
SĂLIŞTIOARA,HD,237,13,4,0,17,72,7,0,79
VEŢEL,HD,896,29,11,0,40,196,48,0,244
MINTIA,HD,878,51,4,0,55,142,13,0,155
LEŞNIC,HD,463,29,6,0,35,120,37,0,157
"MUNCELU MIC",HD,100,6,5,0,11,23,11,0,34
"MUNCELU MARE",HD,66,5,12,0,17,18,14,0,32
VORŢA,HD,133,8,0,0,8,42,15,0,57
VISCA,HD,301,14,3,0,17,100,11,0,111
"VALEA POIENII",HD,116,5,0,0,5,38,15,0,53
COAJA,HD,106,4,0,0,4,26,5,0,31
ZAM,HD,554,21,8,0,29,127,45,0,172
POGĂNEŞTI,HD,217,6,9,0,15,42,16,0,58
ALMAŞ-SĂLIŞTE,HD,124,0,0,0,0,7,0,0,7
GODINEŞTI,HD,105,5,3,0,8,21,6,0,27
SĂLCIVA,HD,390,17,0,0,17,59,17,0,76
"MIERCUREA CIUC",HR,34335,967,120,166,1253,3533,303,169,4005
HARGHITA-BĂI,HR,190,2,2,0,4,7,7,0,14
GHEORGHENI,HR,16408,323,29,0,352,1387,124,0,1511
"LACU ROŞU",HR,77,2,10,0,12,13,23,0,36
"ODORHEIU SECUIESC",HR,31573,616,78,0,694,2922,195,0,3117
TOPLIŢA,HR,11542,252,38,0,290,1015,79,0,1094
ZENCANI,HR,1523,25,0,0,25,138,9,0,147
SECU,HR,62,0,2,0,2,5,4,0,9
"BĂILE TUŞNAD",HR,1368,21,96,0,117,103,192,0,295
BĂLAN,HR,6418,180,15,0,195,535,39,0,574
BORSEC,HR,2308,44,14,0,58,207,29,0,236
BETEŞTI,HR,646,2,0,0,2,16,5,0,21
"CRISTURU SECUIESC",HR,7335,82,15,0,97,371,32,0,403
FILIAŞ,HR,914,2,0,0,2,30,0,0,30
VLĂHIŢA,HR,6139,64,8,0,72,641,67,0,708
ATID,HR,1046,20,5,0,25,56,8,0,64
CRIŞENI,HR,565,4,5,0,9,22,8,0,30
CUŞMED,HR,345,3,1,0,4,11,6,0,17
ŞICLOD,HR,155,7,5,0,12,27,17,0,44
INLĂCENI,HR,127,7,3,0,10,26,6,0,32
AVRĂMEŞTI,HR,850,2,0,0,2,9,6,0,15
CECHEŞTI,HR,482,1,0,0,1,6,3,0,9
GOAGIU,HR,546,2,0,0,2,11,3,0,14
FIRTĂNUŞ,HR,267,0,0,0,0,3,0,0,3
BILBOR,HR,2252,40,5,0,45,327,17,0,344
BRĂDEŞTI,HR,1011,32,4,0,36,181,10,0,191
TÎRNOVIŢA,HR,608,10,2,0,12,84,8,0,92
CĂPÎLNIŢA,HR,1649,40,6,0,46,371,8,0,379
CÎRŢA,HR,844,26,1,0,27,106,14,0,120
INEU,HR,1422,30,1,0,31,142,6,0,148
CICEU,HR,2277,35,6,0,41,336,15,0,351
CIUCSÎNGEORGIU,HR,1615,17,1,0,18,258,10,0,268
"ARMĂŞENII NOI",HR,241,8,0,0,8,65,8,0,73
ARMĂŞENI,HR,709,12,3,0,15,145,8,0,153
BANCU,HR,1098,5,3,0,8,90,13,0,103
EGHERSEC,HR,226,17,2,0,19,32,12,0,44
CIUMANI,HR,3653,73,6,0,79,326,10,0,336
CORBU,HR,749,5,0,0,5,67,10,0,77
"CAPU CORBULUI",HR,409,8,2,0,10,89,11,0,100
CORUND,HR,4223,31,10,0,41,385,18,0,403
ATIA,HR,176,4,1,0,5,22,5,0,27
"FÎNTÎNA BRAZILOR",HR,249,6,0,0,6,64,5,0,69
"VALEA LUI PAVEL",HR,308,14,1,0,15,93,4,0,97
COZMENI,HR,1162,4,0,0,4,81,1,0,82
LĂZĂREŞTI,HR,476,5,0,0,5,23,9,0,32
DĂNEŞTI,HR,1856,27,4,0,31,214,11,0,225
DEALU,HR,1560,12,0,0,12,171,6,0,177
SÎNCRAI,HR,1064,3,32,0,35,225,13,0,238
ULCANI,HR,547,2,1,0,3,43,5,0,48
DITRĂU,HR,4328,27,6,0,33,226,46,0,272
JOLOTCA,HR,518,2,1,0,3,22,5,0,27
DÎRJIU,HR,541,1,0,0,1,20,4,0,24
MUJNA,HR,291,8,1,0,9,42,8,0,50
FELICENI,HR,1031,11,0,0,11,107,5,0,112
TĂURENI,HR,584,3,2,0,5,35,7,0,42
HOGHIA,HR,235,3,0,0,3,11,4,0,15
FORŢENI,HR,440,0,0,0,0,68,1,0,69
POLONIŢA,HR,287,1,0,0,1,45,5,0,50
TELEAC,HR,180,11,0,0,11,32,4,0,36
BÎRZAVA,HR,533,9,0,0,9,79,6,0,85
FRUMOASA,HR,1542,13,4,0,17,147,11,0,158
NICOLEŞTI,HR,923,7,2,0,9,111,11,0,122
GĂLĂUŢAŞ,HR,2019,40,5,0,45,181,18,0,199
JOSENI,HR,4082,51,2,0,53,353,19,0,372
BORZONT,HR,696,6,0,0,6,43,7,0,50
LĂZAREA,HR,2788,34,2,0,36,249,15,0,264
GHIDUŢ,HR,152,0,0,0,0,17,8,0,25
LELICENI,HR,443,16,0,0,16,60,9,0,69
FITOD,HR,397,4,1,0,5,85,4,0,89
MISENTEA,HR,879,13,4,0,17,88,7,0,95
LUETA,HR,3046,48,2,0,50,324,9,0,333
"VALEA RECE",HR,2116,32,0,0,32,563,17,0,580
"LUNCA DE JOS",HR,2077,13,3,0,16,215,7,0,222
"PUNTEA LUPULUI",HR,109,4,0,0,4,51,13,0,64
COMIAT,HR,309,0,6,0,6,55,7,0,62
"IZVORUL TROTUŞULUI",HR,590,0,9,0,9,77,9,0,86
"LUNCA DE SUS",HR,1358,30,5,0,35,235,8,0,243
PĂLTINIŞ-CIUC,HR,438,12,4,0,16,105,5,0,110
MORĂRENI,HR,643,12,2,0,14,74,9,0,83
PĂLTINIŞ,HR,428,5,0,0,5,24,5,0,29
LUPENI,HR,1594,9,0,0,9,147,0,0,147
BISERICANI,HR,595,13,5,0,18,115,8,0,123
BULGĂRENI,HR,230,4,0,0,4,59,7,0,66
PĂULENI,HR,297,7,0,0,7,22,3,0,25
MĂDĂRAŞ,HR,1835,18,4,0,22,241,10,0,251
MĂRTINIŞ,HR,536,23,5,0,28,56,16,0,72
CHINUŞU,HR,113,1,0,0,1,3,3,0,6
ALDEA,HR,322,0,5,0,5,6,5,0,11
BĂDENI,HR,163,4,2,0,6,35,9,0,44
SÎNPAUL,HR,409,10,1,0,11,26,3,0,29
GHIPEŞ,HR,171,3,0,0,3,5,0,0,5
COMĂNEŞTI,HR,177,0,4,0,4,1,7,0,8
RAREŞ,HR,109,6,0,0,6,12,4,0,16
ORĂŞENI,HR,199,7,3,0,10,36,9,0,45
PETRENI,HR,145,4,0,0,4,11,0,0,11
MEREŞTI,HR,1106,22,4,0,26,83,11,0,94
MIHĂILENI,HR,795,7,2,0,9,68,6,0,74
VĂCĂREŞTI,HR,488,6,4,0,10,36,6,0,42
NĂDEJDEA,HR,502,6,3,0,9,83,13,0,96
LIVEZI,HR,422,9,5,0,14,60,12,0,72
MUGENI,HR,930,8,1,0,9,37,3,0,40
LUTIŢA,HR,601,7,0,0,7,31,1,0,32
MĂTIŞENI,HR,110,2,1,0,3,14,4,0,18
DEJUŢIU,HR,158,1,3,0,4,9,3,0,12
ALUNIŞ,HR,131,3,0,0,3,10,0,0,10
BETA,HR,267,5,0,0,5,52,4,0,56
DOBENI,HR,480,8,2,0,10,65,5,0,70
TĂIETURA,HR,227,4,6,0,10,26,9,0,35
CRĂCIUNEL,HR,396,28,5,0,33,59,12,0,71
OCLAND,HR,590,10,0,0,10,30,1,0,31
PĂULENI-CIUC,HR,527,6,5,0,11,71,14,0,85
DELNIŢA,HR,538,13,1,0,14,80,12,0,92
ŞOIMENI,HR,485,15,2,0,17,62,11,0,73
"PLĂIEŞII DE JOS",HR,650,6,4,0,10,40,13,0,53
"PLĂIEŞII DE SUS",HR,606,10,1,0,11,67,9,0,76
IACOBENI,HR,295,4,0,0,4,20,8,0,28
"CASINU NOU",HR,561,13,4,0,17,86,11,0,97
"PORUMBENII MARI",HR,1011,18,2,0,20,68,5,0,73
"PORUMBENII MICI",HR,388,6,0,0,6,49,2,0,51
PRAID,HR,2981,53,35,0,88,219,66,0,285
"OCNA DE JOS",HR,1303,8,0,0,8,66,7,0,73
"OCNA DE SUS",HR,1165,4,0,0,4,37,0,0,37
BECAŞ,HR,104,2,1,0,3,30,1,0,31
RACU,HR,911,22,5,0,27,102,7,0,109
GÂRCIU,HR,394,5,4,0,9,30,5,0,35
REMETEA,HR,5180,103,10,0,113,664,27,0,691
"SATU MARE",HR,1625,16,2,0,18,177,6,0,183
SĂCEL,HR,93,2,2,0,4,9,5,0,14
VIDACUT,HR,243,2,1,0,3,6,6,0,12
"ŞOIMUŞU MIC",HR,342,5,3,0,8,13,6,0,19
"ŞOIMUŞU MARE",HR,252,9,0,0,9,20,4,0,24
HODOŞA,HR,1221,22,2,0,24,93,7,0,100
PLATONEŞTI,HR,388,12,5,0,17,78,13,0,91
FUNDOAIA,HR,477,7,8,0,15,86,12,0,98
SĂRMAŞ,HR,1193,36,0,0,36,155,7,0,162
SÂNCRĂIENI,HR,2117,24,0,0,24,238,7,0,245
SÂNMARTIN,HR,1820,33,1,0,34,158,7,0,165
SÂNTIMBRU,HR,1709,41,7,0,48,221,10,0,231
SECUIENI,HR,623,6,0,0,6,25,3,0,28
ELISENI,HR,942,11,0,0,11,34,1,0,35
BODOGAIA,HR,717,8,0,0,8,32,1,0,33
SICULENI,HR,2276,30,5,0,35,280,13,0,293
SÎNDOMINIC,HR,5193,79,1,0,80,582,10,0,592
SÎNSIMION,HR,1953,22,1,0,23,257,8,0,265
CETĂŢUIA,HR,840,15,3,0,18,126,12,0,138
SUBCETATE,HR,1505,26,5,0,31,149,20,0,169
SUSENI,HR,2435,28,13,0,41,166,19,0,185
CHILENI,HR,660,30,1,0,31,118,7,0,125
"VALEA STRÎMBĂ",HR,1113,5,5,0,10,63,10,0,73
LIBAN,HR,56,0,3,0,3,0,7,0,7
RUGĂNEŞTI,HR,709,10,5,0,15,65,12,0,77
COBĂTEŞTI,HR,446,21,8,0,29,42,10,0,52
CEHEŢEL,HR,105,7,0,0,7,12,5,0,17
TURDENI,HR,75,7,1,0,8,16,4,0,20
TĂRCEŞTI,HR,174,1,2,0,3,9,3,0,12
MIHĂILENI,HR,435,31,3,0,34,124,12,0,136
ŞIMONEŞTI,HR,1101,23,3,0,26,90,8,0,98
"MEDIŞORU MARE",HR,81,12,3,0,15,22,8,0,30
TOMEŞTI,HR,2166,41,1,0,42,223,2,0,225
TULGHEŞ,HR,2457,29,23,0,52,220,61,0,281
RECEA,HR,194,4,1,0,5,22,9,0,31
TUŞNAD,HR,726,16,4,0,20,52,17,0,69
"TUŞNADU NOU",HR,829,9,1,0,10,51,5,0,56
VRABIA,HR,166,7,2,0,9,36,5,0,41
ULIEŞ,HR,280,7,2,0,9,35,4,0,39
NICOLEŞTI,HR,176,4,0,0,4,15,2,0,17
DAIA,HR,216,3,3,0,6,9,5,0,14
IGHIU,HR,48,3,2,0,5,7,3,0,10
PETECU,HR,184,8,3,0,11,20,11,0,31
VĂRŞAG,HR,1324,32,1,0,33,206,9,0,215
VOŞLĂBENI,HR,991,31,25,0,56,207,51,2,260
"IZVORU MUREŞULUI",HR,663,38,13,0,51,198,30,0,228
ZETEA,HR,3691,42,1,0,43,421,24,0,445
"SUB CETATE",HR,658,2,0,0,2,32,8,0,40
ŞICASĂU,HR,139,0,0,0,0,7,7,0,14
IZVOARE,HR,315,2,7,0,9,7,19,0,26
BRAGADIRU,IF,17794,756,245,0,1001,2402,819,0,3221
BUFTEA,IF,18475,981,103,1,1085,2770,339,1,3110
CHITILA,IF,11237,574,100,0,674,1684,270,0,1954
RUDENI,IF,1113,25,3,0,28,134,25,0,159
MĂGURELE,IF,4868,257,86,0,343,789,276,0,1065
ALUNIŞU,IF,1196,27,4,0,31,114,15,1,130
VÂRTEJU,IF,2216,72,22,0,94,285,75,0,360
DUMITRANA,IF,873,34,4,0,38,86,29,0,115
ODĂILE,IF,1914,98,23,0,121,283,102,0,385
OTOPENI,IF,11586,724,210,0,934,1928,597,144,2669
PANTELIMON,IF,23513,911,131,0,1042,2843,465,0,3308
"POPEŞTI LEORDENI",IF,29892,1027,277,0,1304,3241,808,1,4050
VOLUNTARI,IF,34045,1718,320,0,2038,7053,1042,62,8157
"1 DECEMBRIE",IF,6648,209,51,0,260,777,166,0,943
AFUMAŢI,IF,6422,302,62,0,364,1144,185,0,1329
BALOTEŞTI,IF,5850,261,57,39,357,883,244,44,1171
SĂFTICA,IF,1135,76,18,0,94,217,64,0,281
BERCENI,IF,5956,279,98,0,377,948,358,1,1307
BRĂNEŞTI,IF,5704,301,65,0,366,1053,267,2,1322
PASĂREA,IF,870,101,33,13,147,225,85,32,342
ISLAZ,IF,1197,72,23,0,95,328,68,0,396
CERNICA,IF,2537,206,35,0,241,795,185,0,980
BĂLĂCEANCA,IF,2510,84,12,15,111,398,64,15,477
CĂLDĂRARU,IF,916,43,11,0,54,177,67,0,244
TÎNGANU,IF,2547,108,8,0,116,723,61,0,784
CHIAJNA,IF,7188,292,73,0,365,944,281,0,1225
ROŞU,IF,12477,356,99,0,455,1094,319,0,1413
CIOLPANI,IF,1907,102,33,0,135,283,84,0,367
PISCU,IF,794,48,28,0,76,161,52,0,213
LUPĂRIA,IF,1158,20,22,0,42,120,53,0,173
IZVORANI,IF,636,33,27,0,60,125,71,0,196
CIOROGÎRLA,IF,3069,126,37,0,163,440,204,0,644
DÎRVARI,IF,1681,31,15,0,46,143,30,1,174
CLINCENI,IF,3887,127,65,0,192,547,221,0,768
OLTENI,IF,1674,66,24,0,90,219,97,0,316
COPĂCENI,IF,2451,120,31,0,151,819,142,0,961
CORBEANCA,IF,2226,81,40,0,121,248,153,0,401
TAMAŞI,IF,1861,83,32,0,115,249,83,0,332
OSTRATU,IF,1142,56,32,0,88,124,108,0,232
PETREŞTI,IF,728,44,17,0,61,119,54,0,173
CORNETU,IF,4871,238,58,0,296,783,161,0,944
DASCĂLU,IF,1719,56,24,0,80,175,76,0,251
GAGU,IF,624,26,14,0,40,86,36,0,122
DĂRĂŞTI-ILFOV,IF,2299,52,9,0,61,241,61,0,302
DOBROEŞTI,IF,4879,243,51,0,294,821,145,0,966
FUNDENI,IF,3699,150,26,0,176,433,99,0,532
DOMNEŞTI,IF,6815,277,71,0,348,887,296,0,1183
ŢEGHEŞ,IF,764,26,13,0,39,141,45,0,186
DRAGOMIREŞTI-DEAL,IF,2294,78,22,0,100,271,89,0,360
ZURBAUA,IF,809,42,7,0,49,130,33,0,163
DRAGOMIREŞTI-VALE,IF,1285,72,26,0,98,231,53,0,284
GĂNEASA,IF,784,13,7,0,20,83,47,0,130
"MOARA DOMNEASCĂ",IF,537,22,4,0,26,85,28,0,113
COZIENI,IF,645,11,2,0,13,60,14,0,74
ŞINDRILIŢA,IF,1042,68,5,0,73,241,30,0,271
PITEASCA,IF,1026,15,5,0,20,151,13,0,164
GLINA,IF,4542,111,24,0,135,840,120,0,960
CĂŢELU,IF,2198,119,25,0,144,389,83,0,472
GRĂDIŞTEA,IF,1675,95,29,0,124,302,84,0,386
SITARU,IF,855,22,17,0,39,104,57,0,161
LIPIA,IF,1785,46,13,0,59,195,63,0,258
GRUIU,IF,1574,63,30,0,93,228,87,0,315
"ŞANŢU FLOREŞTI",IF,572,33,20,0,53,93,37,0,130
"SILIŞTEA SNAGOVULUI",IF,1795,114,45,0,159,335,114,0,449
JILAVA,IF,8646,258,271,913,1442,1116,391,912,2419
"MOARA VLĂSIEI",IF,3551,164,27,0,191,604,80,0,684
CĂCIULAŢI,IF,1548,38,8,0,46,157,52,0,209
MOGOŞOAIA,IF,6563,309,61,0,370,986,242,0,1228
MICŞUNEŞTII-MOARĂ,IF,1322,71,30,0,101,377,87,7,471
"MERII PETCHII",IF,913,33,7,0,40,163,52,5,220
PERIŞ,IF,4509,210,55,0,265,651,136,0,787
BURIAŞ,IF,1106,61,17,0,78,193,44,0,237
BĂLTENI,IF,401,33,19,0,52,119,45,0,164
PETRĂCHIOAIA,IF,1645,71,27,0,98,288,102,0,390
MĂINEASCA,IF,284,15,13,0,28,60,27,0,87
VÎNĂTORI,IF,371,35,18,0,53,114,39,0,153
SURLARI,IF,456,26,8,0,34,86,27,0,113
SNAGOV,IF,1739,94,53,0,147,258,136,0,394
GHERMĂNEŞTI,IF,2422,124,58,0,182,408,179,0,587
CIOFLICENI,IF,1011,50,15,0,65,146,44,0,190
TÎNCĂBEŞTI,IF,1468,57,13,0,70,207,66,0,273
"ŞTEFĂNEŞTII DE JOS",IF,3650,117,72,0,189,316,218,0,534
CREŢULEASCA,IF,1781,38,10,0,48,185,22,0,207
"ŞTEFĂNEŞTII DE SUS",IF,810,36,3,0,39,101,15,0,116
TUNARI,IF,4871,168,44,0,212,580,209,0,789
VIDRA,IF,3139,52,28,0,80,230,115,0,345
CREŢEŞTI,IF,2011,67,8,0,75,229,32,0,261
SINTEŞTI,IF,1917,51,13,0,64,182,58,0,240
SLOBOZIA,IL,40031,2483,190,278,2951,6110,419,285,6814
BORA,IL,1712,34,7,0,41,119,11,0,130
"SLOBOZIA NOUĂ",IL,2063,69,4,0,73,276,13,0,289
FETEŞTI,IL,28223,1513,149,31,1693,4990,365,55,5410
URZICENI,IL,14265,725,69,4,798,2195,184,18,2397
AMARA,IL,6587,221,90,0,311,830,251,0,1081
CĂZĂNEŞTI,IL,2885,123,12,15,150,442,43,21,506
FIERBINŢI-TÂRG,IL,1342,44,16,6,66,182,51,6,239
"FIERBINŢII DE SUS",IL,1552,30,21,0,51,177,45,9,231
"FIERBINŢII DE JOS",IL,912,40,10,0,50,190,25,0,215
ŢĂNDĂREI,IL,11481,345,36,4,385,1175,83,6,1264
ADÂNCATA,IL,1394,61,14,26,101,196,59,26,281
"PATRU FRAŢI",IL,633,15,11,0,26,75,47,1,123
ALBEŞTI,IL,538,25,12,0,37,102,23,0,125
MARSILIENI,IL,440,29,9,0,38,82,17,0,99
ALEXENI,IL,1884,131,16,0,147,338,44,0,382
ANDRĂŞEŞTI,IL,1462,41,6,0,47,124,23,0,147
ORBOEŞTI,IL,280,15,3,0,18,49,17,0,66
ARMĂŞEŞTI,IL,648,34,0,5,39,127,0,21,148
"MALU ROŞU",IL,1206,36,18,0,54,205,40,0,245
AXINTELE,IL,1351,69,36,0,105,291,95,0,386
HORIA,IL,493,14,7,0,21,48,12,0,60
BALACIU,IL,754,54,23,0,77,180,67,15,262
"CRĂSANII DE JOS",IL,272,37,20,0,57,68,37,0,105
COPUZU,IL,260,14,9,0,23,63,30,0,93
BĂRBULEŞTI,IL,3782,208,3,0,211,666,16,0,682
BĂRCĂNEŞTI,IL,1331,39,13,0,52,140,38,0,178
CONDEEŞTI,IL,1385,35,8,5,48,202,33,5,240
BORĂNEŞTI,IL,1536,26,7,0,33,317,32,0,349
SINTEŞTI,IL,322,24,0,8,32,93,0,24,117
BORDUŞANI,IL,2854,72,11,0,83,330,32,0,362
CEGANI,IL,1107,24,2,0,26,138,9,0,147
BUCU,IL,2069,52,9,0,61,242,24,0,266
BUEŞTI,IL,862,39,8,0,47,186,27,0,213
CIOCÂRLIA,IL,625,23,6,0,29,126,32,0,158
CIOCHINA,IL,1257,40,12,0,52,110,26,0,136
BORDUŞELU,IL,603,26,14,0,40,101,40,0,141
OREZU,IL,652,21,4,0,25,77,19,0,96
CIULNIŢA,IL,917,56,17,0,73,177,32,0,209
"ION GHICA",IL,453,29,6,0,35,97,16,0,113
POIANA,IL,610,76,16,0,92,212,29,0,241
COCORA,IL,1657,93,12,0,105,318,49,0,367
COLELIA,IL,940,41,5,30,76,167,32,54,253
COSÂMBEŞTI,IL,785,59,4,11,74,154,28,11,193
GIMBĂŞANI,IL,761,28,10,0,38,118,34,9,161
COŞERENI,IL,3670,113,17,1,131,539,87,7,633
DRĂGOEŞTI,IL,754,45,25,0,70,126,87,0,213
DRIDU,IL,2372,129,58,0,187,539,186,0,725
DRIDU-SNAGOV,IL,340,13,10,0,23,84,42,0,126
FĂCĂENI,IL,3896,142,22,0,164,499,73,0,572
PROGRESU,IL,511,36,6,0,42,104,8,0,112
GÂRBOVI,IL,3157,165,28,5,198,680,99,7,786
"GHEORGHE DOJA",IL,2216,31,3,0,34,206,33,0,239
"GHEORGHE LAZĂR",IL,1869,294,32,39,365,667,72,42,781
GIURGENI,IL,1170,73,3,0,76,245,7,22,274
GRINDU,IL,1652,121,26,0,147,325,59,0,384
GRIVIŢA,IL,1982,41,7,0,48,207,19,0,226
SMIRNA,IL,787,28,9,0,37,146,31,0,177
"GURA IALOMIŢEI",IL,979,26,4,0,30,126,11,0,137
LUCIU,IL,1106,54,3,0,57,366,26,0,392
"ION ROATĂ",IL,1696,94,15,0,109,340,45,0,385
BROŞTENI,IL,1182,27,5,0,32,206,12,0,218
JILAVELE,IL,2468,192,11,0,203,710,93,8,811
SLĂTIOARELE,IL,312,30,9,0,39,110,32,0,142
MAIA,IL,1379,43,18,0,61,191,46,0,237
MANASIA,IL,3805,133,19,0,152,658,58,0,716
MĂRCULEŞTI,IL,1342,34,4,0,38,151,25,13,189
"MIHAIL KOGĂLNICEANU",IL,2663,44,13,0,57,184,35,0,219
MILOŞEŞTI,IL,1472,82,8,0,90,408,32,34,474
NICOLEŞTI,IL,336,15,2,0,17,43,9,0,52
TOVĂRĂŞIA,IL,299,16,9,0,25,69,26,0,95
MOLDOVENI,IL,905,54,18,0,72,289,92,0,381
MOVILA,IL,1593,114,17,45,176,397,51,45,493
MOVILIŢA,IL,1972,59,20,0,79,305,123,0,428
MUNTENI-BUZĂU,IL,2818,77,23,0,100,308,87,0,395
OGRADA,IL,2365,115,12,26,153,390,36,55,481
PERIEŢI,IL,1066,32,8,0,40,80,24,0,104
PĂLTINIŞU,IL,910,23,4,0,27,92,18,0,110
FUNDATA,IL,381,22,6,0,28,77,14,0,91
MISLEANU,IL,676,16,4,0,20,54,24,0,78
PLATONEŞTI,IL,753,53,11,0,64,237,27,20,284
LĂCUSTENI,IL,810,96,11,0,107,274,23,1,298
BRAZII,IL,734,29,6,0,35,108,29,0,137
RĂSIMNICEA,IL,217,21,9,0,30,55,21,0,76
REVIGA,IL,1121,47,9,0,56,131,43,0,174
ROVINE,IL,737,15,5,0,20,46,20,0,66
CRUNŢI,IL,381,22,3,0,25,81,16,0,97
ROŞIORI,IL,1560,99,15,5,119,386,66,8,460
SĂLCIOARA,IL,911,23,5,0,28,96,23,0,119
RAŞI,IL,877,73,31,0,104,330,88,16,434
SĂRĂŢENI,IL,973,39,11,0,50,121,27,0,148
SĂVENI,IL,2514,112,17,0,129,760,68,0,828
FRĂŢILEŞTI,IL,340,37,7,0,44,132,23,0,155
SCÂNTEIA,IL,2250,130,23,0,153,477,51,0,528
IAZU,IL,857,50,5,21,76,142,17,21,180
"SFÂNTU GHEORGHE",IL,667,25,7,0,32,96,29,1,126
MALU,IL,879,35,9,0,44,123,39,0,162
SINEŞTI,IL,1211,30,27,0,57,175,87,0,262
LILIECI,IL,864,59,22,0,81,163,66,1,230
STELNICA,IL,1526,116,12,0,128,445,31,0,476
SUDIŢI,IL,1711,114,5,0,119,402,41,0,443
TRAIAN,IL,2518,163,6,0,169,536,30,0,566
"VALEA CIORII",IL,1466,53,3,31,87,279,32,33,344
"VALEA MĂCRIŞULUI",IL,984,76,15,0,91,271,50,3,324
GRINDAŞI,IL,396,18,3,0,21,60,22,0,82
VLĂDENI,IL,1677,90,7,0,97,317,18,0,335
IAŞI,IS,314313,16420,3553,607,20580,48531,8654,1440,58625
PAŞCANI,IS,28801,1804,123,1,1928,6141,400,45,6586
BLĂGEŞTI,IS,1159,106,8,0,114,402,30,0,432
GÂŞTEŞTI,IS,2533,89,3,0,92,607,29,1,637
LUNCA,IS,2143,73,14,0,87,571,37,1,609
SODOMENI,IS,996,13,7,0,20,188,16,0,204
BOŞTENI,IS,1231,75,4,0,79,292,10,0,302
HÎRLĂU,IS,7924,411,46,5,462,1434,133,6,1573
PÎRCOVACI,IS,2791,122,7,0,129,783,25,0,808
"PODU ILOAIEI",IS,6225,194,28,0,222,1167,101,0,1268
HOLM,IS,241,21,3,0,24,82,15,0,97
SCOBÂLŢENI,IS,984,41,3,0,44,270,23,0,293
BUDĂI,IS,779,14,0,23,37,188,26,23,237
COSIŢENI,IS,253,26,5,0,31,115,11,0,126
"TÂRGU FRUMOS",IS,11743,419,49,0,468,1893,149,14,2056
"ALEXANDRU I. CUZA",IS,627,56,3,0,59,268,28,0,296
SCHEIA,IS,1075,30,15,0,45,220,38,0,258
VOLINTIREŞTI,IS,602,39,5,0,44,249,26,0,275
ANDRIEŞENI,IS,1342,44,10,0,54,286,29,21,336
BUHĂENI,IS,523,22,4,0,26,107,27,0,134
SPINENI,IS,804,6,1,0,7,76,16,0,92
GLĂVĂNEŞTI,IS,568,16,4,0,20,66,11,0,77
ARONEANU,IS,1363,90,25,0,115,266,73,0,339
DOROBANŢ,IS,1147,69,11,0,80,412,56,0,468
"REDIU ALDEI",IS,346,5,12,0,17,92,24,0,116
ŞOROGARI,IS,339,18,7,0,25,69,24,0,93
BALŞ,IS,1193,47,3,0,50,351,26,0,377
BOURENI,IS,1370,49,2,0,51,322,25,24,371
"COASTA MĂGURII",IS,179,8,4,0,12,59,18,0,77
BĂLŢAŢI,IS,1594,21,1,0,22,185,11,0,196
MĂDÎRJEŞTI,IS,957,29,0,0,29,170,19,0,189
PODIŞU,IS,497,17,6,0,23,135,15,0,150
SÎRCA,IS,873,17,4,0,21,144,13,0,157
"VALEA OILOR",IS,532,20,2,0,22,64,9,0,73
BELCEŞTI,IS,3579,112,23,0,135,892,105,0,997
"SATU NOU",IS,1562,18,5,0,23,365,30,2,397
MUNTENI,IS,855,26,5,0,31,221,20,0,241
TANSA,IS,829,58,3,0,61,288,23,0,311
LITENI,IS,1101,22,5,0,27,354,21,0,375
ULMI,IS,499,94,7,0,101,263,25,0,288
BIVOLARI,IS,1854,70,11,12,93,276,45,12,333
TABĂRA,IS,887,18,5,0,23,107,36,0,143
SOLONEŢ,IS,603,15,5,0,20,82,14,0,96
BÎRNOVA,IS,1115,41,22,0,63,191,71,0,262
CERCU,IS,555,23,8,0,31,170,26,4,200
PĂUN,IS,1073,36,12,0,48,157,42,0,199
PIETRĂRIA,IS,796,47,13,0,60,202,63,0,265
TODIREL,IS,455,19,3,0,22,160,12,1,173
VIŞAN,IS,1309,26,6,0,32,115,27,0,142
BRĂEŞTI,IS,886,42,3,0,45,263,31,0,294
BUDA,IS,197,20,3,0,23,54,7,0,61
CRISTEŞTI,IS,766,37,5,0,42,270,18,0,288
ALBEŞTI,IS,561,21,7,0,28,176,22,4,202
BUTEA,IS,3196,75,13,0,88,563,52,9,624
MICLĂUŞENI,IS,344,25,21,0,46,47,39,0,86
CEPLENIŢA,IS,1184,24,6,0,30,214,19,0,233
BUHALNIŢA,IS,1181,63,8,0,71,322,34,0,356
"POIANA MĂRULUI",IS,797,14,5,0,19,266,12,0,278
ZLODICA,IS,244,16,5,0,21,72,17,0,89
CIOHORĂNI,IS,1508,71,14,0,85,395,33,0,428
CIORTEŞTI,IS,889,29,1,0,30,190,23,0,213
COROPCENI,IS,897,20,5,0,25,261,31,0,292
DELENI,IS,411,8,5,0,13,129,15,0,144
ROTĂRIA,IS,307,33,7,0,40,120,10,0,130
ŞERBEŞTI,IS,646,48,5,0,53,316,43,0,359
CIUREA,IS,2101,32,8,0,40,247,23,0,270
CURĂTURI,IS,210,6,5,0,11,56,20,2,78
DUMBRAVA,IS,1186,51,12,0,63,226,32,0,258
HLINCEA,IS,652,17,7,0,24,74,30,0,104
"LUNCA CETĂŢUII",IS,7554,364,37,1,402,1128,127,1,1256
"PICIORU LUPULUI",IS,501,41,6,0,47,155,21,21,197
SLOBOZIA,IS,368,15,11,0,26,95,17,0,112
"COARNELE CAPREI",IS,1735,60,4,0,64,514,38,14,566
ARAMA,IS,403,11,0,0,11,141,8,0,149
PETROŞICA,IS,69,6,1,0,7,23,19,0,42
OSOI,IS,1570,42,5,0,47,293,36,0,329
STÎNCA,IS,187,13,6,0,19,60,15,0,75
COMARNA,IS,3981,46,10,0,56,376,65,0,441
CURAGĂU,IS,121,10,2,0,12,55,7,0,62
COSTEŞTI,IS,1050,44,4,0,48,414,46,0,460
GIURGEŞTI,IS,365,21,5,0,26,189,30,0,219
COSTULENI,IS,1314,39,2,0,41,236,22,0,258
COVASNA,IS,883,58,16,0,74,339,43,0,382
COZIA,IS,3405,37,7,0,44,261,32,0,293
HILIŢA,IS,584,23,3,0,26,121,18,0,139
COTNARI,IS,1461,36,1,1,38,224,25,1,250
BAHLUIU,IS,269,14,2,0,16,69,13,0,82
HODORA,IS,1303,37,4,0,41,255,13,0,268
HORODIŞTEA,IS,470,7,5,0,12,56,15,0,71
CÎRJOAIA,IS,1377,14,6,0,20,228,26,0,254
"VALEA RACULUI",IS,268,16,4,0,20,95,10,0,105
ZBERENI,IS,631,10,7,0,17,164,19,0,183
LUPĂRIA,IS,277,5,3,0,8,79,15,0,94
COZMEŞTI,IS,1189,72,12,0,84,473,57,18,548
"PODOLENII DE SUS",IS,751,23,3,0,26,186,17,0,203
"PODOLENII DE JOS",IS,260,12,4,0,16,95,14,0,109
CRISTEŞTI,IS,2958,102,20,0,122,721,57,0,778
HOMIŢA,IS,282,10,7,0,17,76,16,0,92
CUCUTENI,IS,717,36,11,0,47,201,43,24,268
SĂCĂREŞTI,IS,339,54,6,0,60,170,43,19,232
DAGÎŢA,IS,1336,31,3,0,34,221,27,2,250
MĂNĂSTIREA,IS,904,15,0,0,15,203,22,0,225
BĂLUŞEŞTI,IS,149,5,4,0,9,25,5,0,30
BOATCA,IS,216,11,4,0,15,68,8,0,76
"PISCU RUSULUI",IS,397,16,4,0,20,63,11,0,74
POIENILE,IS,226,7,3,0,10,71,13,0,84
"ZECE PRĂJINI",IS,390,25,1,0,26,115,9,0,124
DELENI,IS,3486,97,13,0,110,680,53,0,733
MAXUT,IS,1874,68,16,0,84,412,43,0,455
SLOBOZIA,IS,962,22,4,0,26,190,12,0,202
FEREDENI,IS,647,16,1,0,17,200,14,0,214
POIANA,IS,908,33,4,0,37,166,19,0,185
DOBROVĂŢ,IS,1883,41,14,0,55,304,73,15,392
DOLHEŞTI,IS,561,55,7,6,68,276,29,12,317
BRĂDICEŞTI,IS,779,10,6,0,16,118,18,0,136
PIETRIŞ,IS,763,16,4,0,20,212,14,2,228
DRĂGUŞENI,IS,754,25,5,16,46,257,27,17,301
FRENCIUGI,IS,416,42,7,11,60,156,37,11,204
DUMEŞTI,IS,1380,63,2,0,65,305,14,0,319
PĂUŞEŞTI,IS,1368,24,2,0,26,181,9,0,190
CHILIŞOAIA,IS,154,6,1,0,7,51,11,0,62
HOISEŞTI,IS,627,11,4,0,15,78,9,0,87
BANU,IS,322,20,4,0,24,84,11,0,95
ERBICENI,IS,1939,92,9,0,101,471,40,0,511
BÎRLEŞTI,IS,571,14,9,0,23,89,42,0,131
TOTOEŞTI,IS,1303,42,11,0,53,252,27,0,279
SPINOASA,IS,244,2,6,0,8,35,17,0,52
SPRÎNCEANA,IS,314,12,3,0,15,74,9,0,83
FÂNTÂNELE,IS,1528,39,5,0,44,338,18,0,356
FOCURI,IS,2994,61,4,0,65,582,51,0,633
GOLĂIEŞTI,IS,1558,35,7,0,42,285,27,8,320
GRĂDINARI,IS,312,22,4,0,26,88,14,0,102
"COTU LUI IVAN",IS,319,6,1,0,7,48,7,0,55
PETREŞTI,IS,239,17,6,0,23,55,11,0,66
"PODU JIJIEI",IS,205,18,10,0,28,83,32,0,115
CILIBIU,IS,393,13,3,0,16,45,10,0,55
GORBAN,IS,596,20,5,0,25,135,26,0,161
"PODU HAGIULUI",IS,502,21,2,0,23,72,8,0,80
SCOPOSENI,IS,599,16,0,0,16,132,17,0,149
ZBEROAIA,IS,286,14,0,0,14,49,7,0,56
"GURA BOHOTIN",IS,400,25,3,0,28,89,9,0,98
GRAJDURI,IS,2347,40,5,0,45,150,14,0,164
"VALEA SATULUI",IS,3283,26,5,0,31,99,20,0,119
CĂRBUNARI,IS,910,12,3,0,15,38,4,0,42
PĂDURENI,IS,2019,6,7,0,13,53,22,0,75
"POIANA CU CETATE",IS,136,5,4,0,9,35,12,0,47
GROPNIŢA,IS,334,13,3,0,16,89,9,0,98
BULBUCANI,IS,532,24,4,0,28,111,17,0,128
FORĂŞTI,IS,421,10,0,0,10,97,16,0,113
MĂLĂEŞTI,IS,331,20,5,0,25,109,22,0,131
SĂVENI,IS,602,4,3,0,7,79,7,0,86
SÎNGERI,IS,312,29,8,0,37,112,21,0,133
GROZEŞTI,IS,925,19,5,0,24,146,15,21,182
"COLŢU CORNII",IS,455,10,1,0,11,96,10,12,118
HĂLĂUCEŞTI,IS,4016,64,10,0,74,377,37,1,415
LUNCAŞI,IS,782,34,7,0,41,203,22,0,225
"HĂRMĂNEŞTII VECHI",IS,1288,29,4,0,33,244,30,0,274
"HĂRMĂNEŞTII NOI",IS,703,43,7,0,50,279,27,0,306
HELEŞTENI,IS,648,26,6,0,32,211,24,0,235
HĂRMĂNEASA,IS,589,23,9,0,32,216,28,0,244
OBOROCENI,IS,625,22,3,0,25,170,14,1,185
MOVILENI,IS,163,14,2,0,16,60,14,0,74
"RUSENII VECHI",IS,534,9,6,0,15,52,14,0,66
HOLBOCA,IS,2896,58,11,0,69,308,38,0,346
DANCU,IS,6956,265,33,0,298,925,100,0,1025
"RUSENII NOI",IS,348,8,8,0,16,39,14,0,53
ORZENI,IS,629,29,2,0,31,97,17,3,117
CRISTEŞTI,IS,611,34,2,0,36,76,8,0,84
"VALEA LUNGĂ",IS,272,29,17,0,46,76,35,0,111
HORLEŞTI,IS,1555,56,13,0,69,403,41,0,444
BOGDĂNEŞTI,IS,529,36,12,0,48,97,28,0,125
SCOPOSENI,IS,228,7,4,0,11,42,9,0,51
RĂZBOIENI,IS,1683,57,3,0,60,434,18,0,452
BUZNEA,IS,1396,31,3,0,34,336,16,0,352
DĂDEŞTI,IS,222,9,7,0,16,64,14,0,78
GĂNEŞTI,IS,618,9,5,0,14,219,19,0,238
"ION NECULCE",IS,149,3,5,0,8,55,9,0,64
PRIGORENI,IS,530,13,8,0,21,141,11,0,152
IPATELE,IS,514,16,3,0,19,99,14,0,113
"CUZA VODĂ",IS,378,20,6,0,26,117,22,7,146
BÎCU,IS,434,10,4,0,14,145,15,10,170
LESPEZI,IS,815,18,2,0,20,131,20,0,151
HECI,IS,1773,36,5,0,41,270,30,0,300
BUDA,IS,870,13,10,0,23,256,26,0,282
BURSUC-DEAL,IS,678,41,9,0,50,226,28,0,254
DUMBRAVA,IS,567,41,7,0,48,178,30,0,208
LEŢCANI,IS,3553,119,12,0,131,542,48,0,590
BOGONOS,IS,645,44,7,0,51,243,21,1,265
COGEASCA,IS,1588,34,4,0,38,280,19,0,299
CUCUTENI,IS,381,34,2,0,36,128,16,0,144
LUNGANI,IS,862,52,2,0,54,231,27,16,274
CRUCEA,IS,1194,37,4,0,41,438,11,0,449
GOEŞTI,IS,699,24,5,0,29,172,16,0,188
ZMEU,IS,1297,315,7,0,322,711,17,0,728
MĂDÎRJAC,IS,1148,19,7,0,26,189,23,8,220
MIRCEŞTI,IS,1274,44,12,0,56,227,24,0,251
IUGANI,IS,1817,28,5,0,33,310,20,0,330
MIRONEASA,IS,3948,110,9,0,119,645,33,0,678
URŞIŢA,IS,462,32,3,0,35,132,9,0,141
MIROSLAVA,IS,3341,92,16,0,108,424,92,0,516
BALCIU,IS,1053,47,18,0,65,182,73,0,255
BRĂTULENI,IS,322,12,0,0,12,45,10,0,55
CIURBEŞTI,IS,958,37,9,0,46,194,43,0,237
CORNEŞTI,IS,1025,36,4,0,40,141,11,0,152
HORPAZ,IS,2077,68,16,0,84,290,80,0,370
URICANI,IS,935,66,9,0,75,244,32,0,276
"VALEA ADÎNCĂ",IS,4652,203,43,0,246,727,129,0,856
VOROVEŞTI,IS,762,37,3,0,40,153,15,0,168
MIROSLOVEŞTI,IS,1533,54,8,0,62,576,49,0,625
SOCI,IS,1073,84,6,0,90,426,12,0,438
VERŞENI,IS,968,32,6,0,38,310,52,0,362
MOGOŞEŞTI,IS,2347,73,16,0,89,364,54,0,418
MÎNJEŞTI,IS,494,34,7,0,41,125,11,0,136
HADÎMBU,IS,818,8,11,0,19,87,63,0,150
BUDEŞTI,IS,296,22,6,0,28,69,8,0,77
MOGOŞEŞTI-SIRET,IS,1379,84,8,0,92,393,44,0,437
"MUNCELU DE SUS",IS,1762,64,6,0,70,531,32,0,563
MOŞNA,IS,7939,80,5,0,85,517,50,0,567
MOŢCA,IS,3042,137,9,0,146,830,34,1,865
BOURENI,IS,1178,36,4,0,40,298,19,0,317
MOVILENI,IS,433,23,6,0,29,106,13,0,119
IEPURENI,IS,695,21,6,0,27,104,20,0,124
LARGA-JIJIA,IS,613,10,0,0,10,67,8,0,75
POTÎNGENI,IS,734,19,0,0,19,104,15,0,119
OŢELENI,IS,2068,62,9,0,71,411,35,0,446
HÎNDREŞTI,IS,874,22,4,13,39,170,31,13,214
PLUGARI,IS,1497,34,3,0,37,210,24,0,234
BOROSOAIA,IS,1214,35,8,0,43,211,18,0,229
POPEŞTI,IS,1777,65,11,0,76,332,40,0,372
OBRIJENI,IS,2557,13,9,0,22,49,21,0,70
DOROŞCANI,IS,480,18,2,0,20,110,19,0,129
HĂRPĂŞEŞTI,IS,751,25,9,0,34,161,21,0,182
POPRICANI,IS,2405,46,4,0,50,255,37,0,292
MOIMEŞTI,IS,379,9,1,0,10,78,10,0,88
ŢIPILEŞTI,IS,311,20,7,0,27,98,14,5,117
"COTU MORII",IS,226,11,4,0,15,58,13,0,71
VÎNĂTORI,IS,1275,28,13,0,41,189,30,0,219
VULTURI,IS,837,41,18,0,59,127,31,0,158
CÎRLIG,IS,692,24,7,0,31,153,36,0,189
"CUZA VODĂ",IS,507,22,3,0,25,94,6,0,100
PRISĂCANI,IS,1412,43,2,0,45,231,24,0,255
MĂCĂREŞTI,IS,956,16,8,0,24,81,18,0,99
MORENI,IS,794,27,5,0,32,173,19,0,192
PROBOTA,IS,976,9,5,0,14,110,16,0,126
BĂLTENI,IS,629,11,3,0,14,94,10,0,104
PERIENI,IS,1259,22,0,0,22,108,23,0,131
RĂCHITENI,IS,1544,13,2,0,15,243,13,0,256
IZVOARELE,IS,1171,25,6,0,31,233,15,0,248
RĂDUCĂNENI,IS,4922,119,20,23,162,713,66,30,809
BOHOTIN,IS,1306,30,10,0,40,177,19,17,213
ROŞU,IS,579,5,4,0,9,84,9,0,93
ISAIIA,IS,262,10,2,0,12,84,10,0,94
REDIU,IS,2828,69,6,0,75,292,38,0,330
BREAZU,IS,1565,64,7,0,71,248,23,0,271
HORLEŞTI,IS,1054,23,5,0,28,97,12,0,109
ROMÂNEŞTI,IS,724,22,12,0,34,145,24,0,169
AVÎNTU,IS,390,24,8,0,32,121,34,0,155
URSOAIA,IS,350,15,9,0,24,81,29,0,110
RĂDENI,IS,565,12,11,0,23,127,29,0,156
ROŞCANI,IS,553,11,9,0,20,158,19,0,177
RUGINOASA,IS,1566,37,59,0,96,237,102,0,339
DUMBRĂVIŢA,IS,2068,36,7,0,43,293,21,0,314
REDIU,IS,983,17,4,0,21,109,14,0,123
VASCANI,IS,401,9,4,0,13,92,14,0,106
SCÂNTEIA,IS,4818,56,16,0,72,401,60,5,466
BODEŞTI,IS,413,33,8,0,41,163,23,2,188
BOROŞEŞTI,IS,728,25,7,0,32,84,16,1,101
CIOCÎRLEŞTI,IS,244,22,10,0,32,87,24,0,111
"LUNCA RATEŞ",IS,329,15,6,0,21,56,15,0,71
REDIU,IS,168,10,5,0,15,38,8,0,46
"TUFEŞTII DE SUS",IS,220,8,0,0,8,58,8,0,66
"SCHITU DUCA",IS,479,6,7,0,13,84,31,0,115
POIENI,IS,661,29,1,0,30,152,20,0,172
"DUMITREŞTII GĂLĂŢII",IS,542,30,4,0,34,126,20,0,146
POCREACA,IS,331,37,12,0,49,122,29,0,151
POIANA,IS,364,28,7,0,35,91,27,0,118
"SATU NOU",IS,439,26,3,0,29,140,21,0,161
SLOBOZIA,IS,334,47,9,0,56,215,20,0,235
SCOBINŢI,IS,1504,83,21,0,104,422,51,0,473
BĂDENI,IS,1038,39,6,0,45,254,26,0,280
FETEŞTI,IS,1052,23,2,0,25,272,44,0,316
STICLĂRIA,IS,1440,40,26,0,66,373,76,1,450
ZAGAVIA,IS,945,27,11,0,38,191,39,0,230
OSOI,IS,810,27,4,0,31,211,16,7,234
SINEŞTI,IS,1295,51,4,0,55,466,35,53,554
BOCNIŢA,IS,263,12,4,0,16,87,14,14,115
STORNEŞTI,IS,803,48,11,0,59,330,29,35,394
SIREŢEL,IS,1885,67,4,0,71,444,19,0,463
SLOBOZIA,IS,653,23,2,0,25,192,15,0,207
HUMOSU,IS,588,19,2,0,21,306,16,0,322
STOLNICENI-PRĂJESCU,IS,1267,59,1,0,60,393,22,0,415
BRĂTEŞTI,IS,1385,31,5,0,36,311,19,0,330
COZMEŞTI,IS,1727,89,3,0,92,503,32,0,535
STRUNGA,IS,509,42,3,0,45,162,19,0,181
BRĂTULEŞTI,IS,580,21,10,0,31,117,25,0,142
CRIVEŞTI,IS,259,15,4,0,19,60,18,0,78
HĂBĂŞEŞTI,IS,325,11,3,0,14,92,21,0,113
CUCOVA,IS,123,6,6,0,12,32,15,0,47
FĂRCĂŞENI,IS,1632,25,7,0,32,245,12,0,257
ŞCHEIA,IS,913,46,7,0,53,175,24,0,199
CĂUEŞTI,IS,432,13,6,0,19,73,27,0,100
CIOCA-BOCA,IS,374,15,3,0,18,103,4,0,107
"POIANA ŞCHEII",IS,393,8,4,0,12,111,14,0,125
"SATU NOU",IS,292,15,7,0,22,105,19,0,124
ŞIPOTE,IS,727,11,3,0,14,97,12,0,109
"IAZU NOU",IS,815,16,1,0,17,239,12,0,251
CHIŞCĂRENI,IS,1242,32,7,0,39,234,21,0,255
HĂLCENI,IS,1186,21,8,0,29,173,18,0,191
TANSA,IS,1385,37,7,0,44,253,41,0,294
SUHULEŢ,IS,927,19,5,0,24,187,30,0,217
TĂTĂRUŞI,IS,1384,42,10,0,52,508,70,9,587
UDA,IS,1265,47,10,0,57,357,45,8,410
PIETROSU,IS,1143,39,5,0,44,336,29,2,367
IORCANI,IS,690,35,5,0,40,296,35,7,338
TODIREŞTI,IS,3159,71,11,0,82,859,31,0,890
BĂICENI,IS,279,17,10,0,27,134,17,0,151
STROEŞTI,IS,354,27,3,0,30,116,17,0,133
TOMEŞTI,IS,8712,303,26,5,334,1180,125,5,1310
CHICEREA,IS,1169,25,5,0,30,177,23,0,200
GORUNI,IS,1024,31,3,0,34,182,21,0,203
VLĂDICENI,IS,580,60,29,0,89,145,52,0,197
TRIFEŞTI,IS,1369,12,6,0,18,120,19,0,139
ZABOLOTENI,IS,592,10,0,0,10,79,4,0,83
HERMEZIU,IS,746,23,4,0,27,123,22,0,145
VLADOMIRA,IS,192,22,3,0,25,70,13,0,83
ŢIBANA,IS,719,37,4,0,41,164,14,0,178
"POIANA MĂNĂSTIRII",IS,367,8,3,0,11,77,14,0,91
ALEXENI,IS,614,13,4,0,17,126,14,0,140
"POIANA DE SUS",IS,447,21,2,0,23,114,11,0,125
DOMNIŢA,IS,1052,21,4,0,25,250,18,0,268
RUNCU,IS,407,9,3,0,12,88,11,0,99
GÎRBEŞTI,IS,1772,22,9,0,31,238,39,0,277
"VADU VEJEI",IS,267,9,2,0,11,51,10,0,61
ŢIBĂNEŞTI,IS,1862,37,3,0,40,282,22,0,304
RĂSBOIENI,IS,753,18,0,0,18,133,7,0,140
"GLODENII GÎNDULUI",IS,2048,25,2,0,27,341,17,0,358
JIGORENI,IS,569,10,2,0,12,88,5,0,93
VĂLENII,IS,223,5,1,0,6,45,7,0,52
TUNGUJEI,IS,468,25,5,0,30,120,9,2,131
RECEA,IS,119,0,0,0,0,25,10,0,35
GRIEŞTI,IS,198,12,2,0,14,46,9,0,55
CÎRNICENI,IS,1243,25,2,0,27,142,14,0,156
"MIHAIL KOGĂLNICEANU",IS,1085,51,2,0,53,232,16,0,248
STEJARII,IS,241,13,5,0,18,65,16,0,81
ŢIGĂNĂŞI,IS,1151,43,2,0,45,188,17,0,205
ŢUŢORA,IS,959,70,19,0,89,344,50,50,444
BOSIA,IS,1567,32,2,0,34,183,19,0,202
"COADA STÎNCII",IS,544,37,4,0,41,123,15,0,138
MÎNZĂTEŞTI,IS,837,24,4,0,28,152,19,1,172
UNGHENI,IS,527,15,5,0,20,82,18,0,100
"VALEA LUPULUI",IS,6820,316,41,0,357,1172,167,0,1339
"VALEA SEACĂ",IS,1648,36,2,0,38,356,24,0,380
CONŢEŞTI,IS,1476,35,3,0,38,444,23,0,467
TOPILE,IS,1834,71,2,0,73,451,31,0,482
STÎNCA,IS,439,27,2,0,29,77,4,0,81
VICTORIA,IS,1268,29,5,0,34,145,22,0,167
FRĂSULENI,IS,315,2,1,0,3,65,14,0,79
ICUŞENI,IS,827,10,1,0,11,49,18,0,67
SCULENI,IS,327,26,3,0,29,74,17,0,91
ŞENDRENI,IS,248,24,8,0,32,74,19,0,93
VÎNĂTORI,IS,1016,19,2,0,21,256,41,0,297
CRIVEŞTI,IS,1205,20,1,0,21,217,28,0,245
"GURA BÎDILIŢEI",IS,507,56,14,0,70,231,45,0,276
HÎRTOAPE,IS,923,35,11,0,46,327,46,0,373
VLĂDENI,IS,1427,44,2,0,46,251,21,0,272
BORŞA,IS,673,18,4,0,22,113,10,0,123
IACOBENI,IS,179,10,7,0,17,43,18,0,61
"ALEXANDRU CEL BUN",IS,405,40,5,0,45,114,19,0,133
BROŞTENI,IS,333,11,0,0,11,54,0,0,54
VÎLCELELE,IS,339,28,2,0,30,115,11,0,126
VOINEŞTI,IS,2878,67,9,0,76,401,42,0,443
SLOBOZIA,IS,1568,58,6,0,64,314,22,0,336
LUNGANI,IS,472,10,5,0,15,82,18,0,100
"SCHITU STAVNIC",IS,433,14,8,0,22,171,23,0,194
VOCOTEŞTI,IS,106,18,16,0,34,45,32,0,77
"DROBETA-TURNU SEVERIN",MH,90946,4347,462,262,5071,11890,1055,304,13249
ORŞOVA,MH,10692,497,102,8,607,1394,231,9,1634
"BAIA DE ARAMĂ",MH,2381,80,28,0,108,645,184,18,847
MĂRĂŞEŞTI,MH,1098,27,2,0,29,234,18,0,252
TITERLEŞTI,MH,410,5,3,0,8,99,15,0,114
NEGOEŞTI,MH,694,5,7,0,12,94,30,0,124
STREHAIA,MH,5988,385,43,19,447,1201,119,28,1348
CIOCHIUŢA,MH,789,42,8,0,50,147,15,0,162
"SLĂTINICU MARE",MH,288,14,3,0,17,58,8,0,66
COMANDA,MH,1275,71,7,2,80,532,30,10,572
"LUNCA BANULUI",MH,380,23,12,0,35,105,18,0,123
HURDUCEŞTI,MH,216,18,10,0,28,90,20,0,110
STĂNCEŞTI,MH,153,9,6,0,15,21,9,0,30
"VÎNJU MARE",MH,2906,105,17,0,122,526,44,0,570
BUCURA,MH,280,14,6,0,20,95,21,0,116
"NICOLAE BĂLCESCU",MH,643,12,1,0,13,100,18,0,118
"OREVIŢA MARE",MH,626,10,5,0,15,121,19,0,140
TRAIAN,MH,493,20,5,0,25,77,17,0,94
COMĂNEŞTI,MH,325,13,0,0,13,106,32,0,138
CRAINICI,MH,272,15,5,0,20,53,20,0,73
SĂRDĂNEŞTI,MH,208,14,7,0,21,40,15,0,55
IUPCA,MH,180,4,29,0,33,28,31,0,59
BALA,MH,686,32,38,0,70,172,60,0,232
BRATEŞUL,MH,105,14,5,0,19,28,6,0,34
"BALA DE SUS",MH,499,24,4,0,28,139,37,0,176
RUDINA,MH,392,7,5,0,12,48,16,0,64
VIDIMIREŞTI,MH,127,6,9,0,15,22,13,0,35
DÎLMA,MH,332,8,5,0,13,73,19,0,92
BALTA,MH,335,52,28,0,80,157,63,0,220
PREJNA,MH,233,30,11,1,42,97,33,1,131
COSTEŞTI,MH,138,24,7,0,31,66,22,0,88
GORNOVIŢA,MH,166,11,0,8,19,64,0,19,83
BĂLĂCIŢA,MH,990,56,19,0,75,257,52,23,332
GVARDINIŢA,MH,822,37,6,0,43,183,36,14,233
DOBRA,MH,370,69,17,0,86,173,55,4,232
BÎCLEŞ,MH,495,96,53,0,149,320,157,42,519
"PODU GROSULUI",MH,168,68,11,0,79,92,20,0,112
PETRA,MH,139,68,25,0,93,95,48,0,143
CORZU,MH,348,103,25,0,128,225,50,8,283
SMADOVIŢA,MH,380,168,36,0,204,246,58,0,304
BÎLVĂNEŞTI,MH,749,77,13,0,90,229,64,0,293
BRANIŞTEA,MH,1119,115,25,73,213,516,72,87,675
GOANŢA,MH,404,54,8,19,81,147,30,20,197
BREZNIŢA-MOTRU,MH,871,57,3,0,60,327,43,0,370
FĂUROAIA,MH,285,25,8,0,33,82,26,0,108
BREZNIŢA-OCOL,MH,1488,39,10,0,49,193,23,0,216
MAGHERU,MH,898,18,4,0,22,190,19,0,209
JIDOŞTIŢA,MH,917,47,5,0,52,230,70,0,300
BROŞTENI,MH,1223,36,11,0,47,196,70,0,266
"LUPŞA DE JOS",MH,1091,69,9,0,78,358,46,0,404
"BURILA MARE",MH,598,70,14,0,84,286,43,8,337
CRIVINA,MH,535,22,16,0,38,141,61,2,204
ŢIGĂNAŞI,MH,255,25,18,0,43,115,55,10,180
VRANCEA,MH,169,14,13,0,27,37,39,0,76
"IZVORU FRUMOS",MH,182,23,18,0,41,38,27,3,68
BUTOIEŞTI,MH,859,17,12,0,29,88,29,0,117
ARGINEŞTI,MH,474,32,3,0,35,128,17,0,145
"GURA MOTRULUI",MH,236,17,6,0,23,68,30,0,98
BUICEŞTI,MH,376,24,3,0,27,66,17,0,83
PLUTA,MH,350,11,1,0,12,95,25,0,120
TÎNŢARU,MH,289,26,6,0,32,76,22,0,98
CĂZĂNEŞTI,MH,721,46,40,0,86,178,122,0,300
SEVERINEŞTI,MH,980,81,33,0,114,302,104,0,406
CIREŞU,MH,390,36,26,0,62,162,62,0,224
CORCOVA,MH,1306,47,1,0,48,344,34,0,378
IMOASA,MH,302,15,5,0,20,71,16,0,87
CORDUN,MH,596,25,4,0,29,121,11,0,132
STEJARU,MH,442,40,3,0,43,144,14,0,158
JIROV,MH,1207,45,6,0,51,336,20,0,356
"MĂRU ROŞU",MH,494,20,3,0,23,107,10,0,117
CERNAIA,MH,416,36,7,0,43,84,13,0,97
CORLĂŢEL,MH,600,79,22,0,101,292,62,4,358
"VALEA ANILOR",MH,444,37,7,0,44,193,35,3,231
CUJMIR,MH,1802,46,42,5,93,398,104,5,507
AURORA,MH,555,8,0,0,8,108,15,0,123
"CUJMIRU MIC",MH,391,7,0,0,7,104,13,0,117
DEVESEL,MH,1003,36,15,0,51,246,60,0,306
BATOŢI,MH,346,27,15,0,42,69,40,0,109
BISTREŢU,MH,402,20,13,0,33,95,40,0,135
SCĂPĂU,MH,648,28,18,0,46,138,53,0,191
DÎRVARI,MH,1175,98,11,0,109,359,42,0,401
GEMENI,MH,913,70,0,0,70,396,35,0,431
DUBOVA,MH,418,18,57,0,75,77,72,0,149
EIBENTHAL,MH,250,30,6,0,36,98,22,0,120
"BAIA NOUĂ",MH,142,23,7,0,30,35,13,0,48
"DUMBRAVA DE JOS",MH,390,62,46,6,114,185,107,23,315
ALBULEŞTI,MH,459,54,15,27,96,202,63,27,292
"VALEA MARCULUI",MH,104,31,9,11,51,47,35,11,93
ROCŞORENI,MH,91,24,11,2,37,45,32,2,79
VLĂDICA,MH,61,14,15,0,29,26,35,1,62
EŞELNIŢA,MH,2393,72,1,0,73,466,33,0,499
FLOREŞTI,MH,1367,38,2,0,40,307,40,0,347
ZEGUJANI,MH,800,45,14,0,59,248,64,0,312
"GÂRLA MARE",MH,2596,116,17,0,133,498,59,36,593
GODEANU,MH,474,37,23,0,60,171,86,0,257
GOGOŞU,MH,922,34,15,0,49,355,58,0,413
"BALTA VERDE",MH,989,22,5,0,27,213,24,0,237
"BURILA MICĂ",MH,749,32,1,0,33,160,26,0,186
"OSTROVU MARE",MH,595,22,28,0,50,90,83,0,173
GRECI,MH,509,45,15,0,60,137,38,24,199
BÎLTANELE,MH,307,26,15,5,46,111,54,8,173
SĂLĂTRUC,MH,173,23,3,0,26,106,23,12,141
GROZEŞTI,MH,388,61,7,0,68,153,18,0,171
CÎRCENI,MH,788,99,8,0,107,265,38,0,303
ŞUŞIŢA,MH,388,57,23,0,80,115,43,0,158
GRUIA,MH,1397,51,7,0,58,399,31,0,430
IZVOARELE,MH,720,30,5,0,35,107,24,0,131
"POIANA GRUII",MH,132,25,8,0,33,48,18,0,66
HINOVA,MH,862,49,12,0,61,224,63,0,287
BISTRIŢA,MH,1155,108,32,0,140,290,64,0,354
"OSTROVU CORBULUI",MH,307,17,2,0,19,59,37,0,96
HUSNICIOARA,MH,557,17,9,0,26,90,34,0,124
PERI,MH,318,18,10,0,28,51,30,0,81
BĂDIŢEŞTI,MH,154,8,7,0,15,19,18,0,37
ILOVĂŢ,MH,1006,95,46,3,144,284,111,3,398
ILOVIŢA,MH,655,27,5,0,32,109,14,0,123
BAHNA,MH,421,21,7,0,28,114,21,0,135
ISVERNA,MH,1285,25,6,0,31,212,36,0,248
NADANOVA,MH,313,8,9,0,17,75,29,0,104
BUSEŞTI,MH,146,8,6,0,14,48,17,0,65
"IZVORU BÎRZII",MH,1101,41,8,0,49,204,48,0,252
BALOTEŞTI,MH,498,35,24,0,59,90,68,0,158
HALÎNGA,MH,733,22,3,0,25,78,21,0,99
JIANA,MH,566,129,16,0,145,348,48,4,400
"JIANA MARE",MH,571,85,5,0,90,389,23,0,412
"JIANA VECHE",MH,871,86,3,0,89,316,12,14,342
DĂNCEU,MH,983,88,25,0,113,350,84,29,463
CIOROBORENI,MH,523,109,20,0,129,322,52,8,382
LIVEZILE,MH,690,10,14,0,24,133,52,0,185
"IZVORU ANEŞTILOR",MH,367,10,11,0,21,80,32,0,112
"IZVORĂLU DE JOS",MH,148,4,8,0,12,29,27,0,56
MALOVĂŢ,MH,984,95,27,0,122,300,53,0,353
"23 AUGUST",MH,306,25,8,0,33,88,22,0,110
BOBAIŢA,MH,493,74,45,0,119,207,94,0,301
"OBÎRŞIA DE CÎMP",MH,634,63,14,0,77,228,40,16,284
IZIMŞA,MH,855,75,20,0,95,277,80,36,393
OBÎRŞIA-CLOŞANI,MH,841,44,9,0,53,284,34,0,318
OPRIŞOR,MH,1526,40,5,0,45,334,64,0,398
PRISĂCEAUA,MH,307,19,7,0,26,93,21,0,114
"PĂDINA MARE",MH,183,35,8,0,43,98,32,0,130
"PĂDINA MICĂ",MH,202,14,6,0,20,35,17,0,52
IABLANIŢA,MH,208,31,18,0,49,92,49,0,141
SLAŞOMA,MH,407,46,7,0,53,147,27,0,174
PĂTULELE,MH,2668,245,20,0,265,917,88,0,1005
VIAŞU,MH,417,42,8,0,50,155,35,0,190
PODENI,MH,565,55,9,0,64,294,38,0,332
GORNENŢI,MH,140,25,14,0,39,76,27,0,103
PONOARELE,MH,840,20,3,0,23,113,14,0,127
GHEORGHEŞTI,MH,547,11,8,0,19,91,23,0,114
GĂRDĂNEASA,MH,393,9,0,0,9,64,8,0,72
BÎRÎIACU,MH,228,12,8,0,20,54,12,0,66
"POROINA MARE",MH,319,10,7,0,17,92,31,0,123
STIGNIŢA,MH,325,14,10,0,24,68,40,0,108
"FÎNTÎNILE NEGRE",MH,132,8,8,0,16,18,16,0,34
PRISTOL,MH,797,115,22,0,137,333,45,0,378
COZIA,MH,438,39,9,0,48,210,24,0,234
PRUNIŞOR,MH,436,42,14,0,56,144,47,0,191
"FÎNTÎNA DOMNEASCĂ",MH,308,33,8,0,41,125,27,0,152
CERVENIŢA,MH,305,26,12,0,38,73,48,0,121
GHELMEGIOAIA,MH,306,8,10,0,18,78,40,0,118
ZEGAIA,MH,211,15,12,0,27,70,52,0,122
PUNGHINA,MH,991,80,6,0,86,430,18,0,448
RECEA,MH,809,41,8,0,49,194,16,0,210
CEARÎNGU,MH,123,21,4,0,25,84,11,0,95
DRINCEA,MH,285,62,19,0,81,173,31,0,204
ROGOVA,MH,1155,69,15,0,84,282,85,21,388
SALCIA,MH,2367,40,12,0,52,313,36,53,402
STÎNGĂCEAUA,MH,709,28,13,0,41,188,50,0,238
"SATU MARE",MH,356,43,2,0,45,183,59,0,242
SVINIŢA,MH,811,45,12,0,57,382,30,4,416
ŞIMIAN,MH,3448,169,36,0,205,613,138,0,751
CERNEŢI,MH,2877,173,18,2,193,1199,78,2,1279
DUDAŞU,MH,1114,111,16,0,127,279,35,0,314
"DEDOVIŢA NOUĂ",MH,326,18,22,0,40,139,51,0,190
POROINA,MH,244,29,10,0,39,75,28,0,103
ERGHEVIŢA,MH,276,39,12,0,51,132,23,0,155
"VALEA COPCII",MH,108,11,2,0,13,40,12,0,52
ŞIŞEŞTI,MH,986,131,26,0,157,428,71,28,527
COCOROVA,MH,568,92,14,0,106,238,56,0,294
NOAPTEŞA,MH,586,33,2,0,35,132,12,0,144
ŞOVARNA,MH,926,67,33,0,100,329,136,0,465
TÎMNA,MH,1509,66,36,0,102,303,96,0,399
IZVORĂLU,MH,278,11,7,0,18,161,39,0,200
PLOPI,MH,483,38,2,0,40,161,16,0,177
CREMENEA,MH,166,15,15,0,30,52,32,0,84
VÂNĂTORI,MH,918,32,3,0,35,230,49,15,294
ROŞIORI,MH,750,38,10,0,48,229,45,10,284
VÎNJULEŢ,MH,1453,317,8,176,501,662,44,195,901
VLĂDAIA,MH,408,17,11,0,28,134,53,0,187
ALMĂJEL,MH,571,69,16,0,85,235,46,0,281
SCORILA,MH,163,6,4,0,10,63,18,0,81
ŞTIRCOVIŢA,MH,162,14,5,0,19,44,21,0,65
VOLOIAC,MH,512,60,22,0,82,230,69,0,299
COTOROAIA,MH,446,41,5,0,46,99,12,0,111
LAC,MH,97,21,10,0,31,49,14,0,63
"VALEA BUNĂ",MH,300,33,13,0,46,104,32,0,136
VRATA,MH,1543,102,0,0,102,525,23,0,548
"BAIA MARE",MM,121372,5179,539,186,5904,16372,1344,246,17962
"SIGHETU MARMAŢIEI",MM,36093,1162,151,18,1331,4655,344,34,5033
"BAIA SPRIE",MM,10031,254,21,0,275,952,54,0,1006
CHIUZBAIA,MM,538,31,5,0,36,143,26,0,169
"SATU NOU DE SUS",MM,887,18,3,0,21,166,12,0,178
"TĂUŢII DE SUS",MM,2376,56,14,0,70,292,39,224,555
BORŞA,MM,22112,252,85,1,338,1893,183,1,2077
"BĂILE BORŞA",MM,1212,10,3,0,13,119,9,0,128
CAVNIC,MM,4285,112,28,0,140,458,51,1,510
DRAGOMIREŞTI,MM,2592,60,25,0,85,501,36,0,537
"SĂLIŞTEA DE SUS",MM,4258,103,4,0,107,806,36,0,842
SEINI,MM,6651,171,19,0,190,920,63,0,983
SĂBIŞA,MM,682,21,4,0,25,114,15,0,129
"VIILE APEI",MM,541,13,4,0,17,108,19,0,127
"ŞOMCUTA MARE",MM,3301,98,20,0,118,478,52,0,530
BUCIUMI,MM,641,36,9,0,45,228,23,0,251
BUTEASA,MM,320,6,4,0,10,54,7,0,61
"CODRU BUTESII",MM,203,5,5,0,10,63,7,0,70
"FINTEUŞU MARE",MM,531,25,3,0,28,132,18,0,150
HOVRILA,MM,220,5,3,0,8,64,8,0,72
CIOLT,MM,507,11,1,0,12,119,10,0,129
"VĂLENII ŞOMCUTEI",MM,632,13,8,0,21,152,18,0,170
BĂIŢA,MM,1566,46,18,0,64,219,38,0,257
"BOZÂNTA MARE",MM,561,12,3,0,15,140,16,0,156
NISTRU,MM,923,69,5,0,74,201,18,0,219
TĂUŢII-MĂGHERĂUŞ,MM,2950,89,11,0,100,453,59,0,512
BUŞAG,MM,552,22,4,0,26,102,15,0,117
MERIŞOR,MM,246,17,5,0,22,66,12,0,78
ULMOASA,MM,154,16,2,0,18,42,5,0,47
"TÎRGU LĂPUŞ",MM,4970,292,24,0,316,1229,74,0,1303
BOIERENI,MM,304,20,13,0,33,77,28,0,105
BORCUT,MM,412,9,4,0,13,119,6,0,125
CUFOAIA,MM,174,5,8,1,14,50,15,1,66
DĂMĂCUŞENI,MM,789,6,2,0,8,25,3,0,28
"DOBRICU LĂPUŞULUI",MM,319,8,4,0,12,70,16,0,86
DUMBRAVA,MM,179,10,5,0,15,44,12,0,56
FÎNTÎNELE,MM,207,5,0,0,5,53,0,0,53
GROAPE,MM,59,4,4,0,8,18,7,0,25
INĂU,MM,214,4,3,0,7,54,6,0,60
RĂZOARE,MM,1142,76,8,0,84,337,30,0,367
ROGOZ,MM,1267,37,0,0,37,238,4,0,242
ROHIA,MM,597,16,7,0,23,197,26,0,223
STOICENI,MM,216,7,1,0,8,44,4,0,48
CHELINŢA,MM,1151,31,5,0,36,363,19,0,382
ULMENI,MM,1227,53,2,0,55,260,22,0,282
ARDUZEL,MM,704,9,5,0,14,160,8,2,170
MÂNĂU,MM,893,36,3,0,39,245,10,0,255
SOMEŞ-UILEAC,MM,626,11,4,0,15,166,26,0,192
TOHAT,MM,200,5,1,0,6,60,8,0,68
ŢICĂU,MM,643,27,2,0,29,113,5,0,118
VICEA,MM,281,17,5,0,22,73,10,0,83
"VIŞEU DE SUS",MM,14833,238,28,0,266,1298,104,0,1402
ARDUSAT,MM,1550,41,5,0,46,204,34,0,238
"ARIEŞU DE CÎMP",MM,222,4,0,0,4,48,4,0,52
COLŢIREA,MM,357,27,7,0,34,128,19,0,147
ARINIŞ,MM,684,22,5,0,27,263,29,11,303
TĂMĂŞEŞTI,MM,173,12,11,0,23,76,52,2,130
"ASUAJU DE SUS",MM,770,30,10,0,40,273,41,0,314
"ASUAJU DE JOS",MM,262,20,8,0,28,107,30,0,137
"BĂIŢA DE SUB CODRU",MM,1194,41,4,0,45,312,26,0,338
URMENIŞ,MM,249,11,6,0,17,59,18,0,77
STRÎMBU-BĂIUŢ,MM,498,8,3,0,11,67,12,0,79
BĂIUŢ,MM,1288,16,1,0,17,136,12,0,148
"POIANA BOTIZII",MM,191,8,1,0,9,41,1,0,42
BĂSEŞTI,MM,455,11,2,0,13,90,20,0,110
ODEŞTI,MM,314,10,3,0,13,58,20,0,78
SĂLIŞTE,MM,76,5,9,0,14,35,16,2,53
STREMŢ,MM,232,4,5,0,9,52,16,0,68
BÂRSANA,MM,3288,80,50,0,130,686,85,0,771
NĂNEŞTI,MM,531,5,3,0,8,103,12,0,115
BICAZ,MM,442,8,0,0,8,110,10,0,120
CIUTA,MM,143,3,0,0,3,49,14,0,63
CORNI,MM,239,11,4,0,15,89,13,0,102
BISTRA,MM,812,23,5,0,28,189,12,2,203
"CRASNA VIŞEULUI",MM,1271,24,5,0,29,221,20,0,241
"VALEA VIŞEULUI",MM,1190,29,3,0,32,178,7,0,185
"LUNCA LA TISA",MM,701,9,1,0,10,76,9,0,85
TISA,MM,1196,22,3,0,25,158,9,0,167
"BOCICOIU MARE",MM,501,8,0,0,8,43,2,0,45
CRĂCIUNEŞTI,MM,1277,23,2,0,25,147,14,0,161
BOCICOEL,MM,544,17,8,0,25,138,15,0,153
"BOGDAN VODĂ",MM,1994,26,0,0,26,292,8,0,300
"BOIU MARE",MM,470,25,4,0,29,129,14,0,143
PRISLOP,MM,393,18,4,0,22,96,9,0,105
"FRÎNCENII BOIULUI",MM,49,9,4,0,13,25,9,0,34
ROMĂNEŞTI,MM,58,6,5,0,11,32,8,0,40
BOTIZA,MM,2114,81,7,0,88,510,29,0,539
SÎRBI,MM,675,9,2,0,11,98,5,0,103
BUDEŞTI,MM,1813,42,3,0,45,510,28,1,539
CORNEŞTI,MM,354,15,0,0,15,53,4,0,57
CĂLINEŞTI,MM,1184,24,3,0,27,131,16,0,147
VĂLENI,MM,1094,18,3,0,21,188,12,0,200
CERNEŞTI,MM,678,17,1,0,18,160,9,0,169
TRESTIA,MM,594,19,3,0,22,226,7,0,233
BREBENI,MM,170,5,4,0,9,63,14,0,77
MĂGURENI,MM,176,7,5,1,13,48,16,1,65
FÎNAŢE,MM,556,12,10,0,22,134,18,0,152
CIOCOTIŞ,MM,812,44,10,0,54,222,27,0,249
CICÎRLĂU,MM,1960,47,5,0,52,263,40,0,303
ILBA,MM,1104,23,5,0,28,149,23,0,172
"HANDALU ILBEI",MM,379,12,0,0,12,99,3,0,102
"CÎMPULUNG LA TISA",MM,2076,12,2,0,14,101,3,0,104
COAŞ,MM,1109,21,1,0,22,258,15,0,273
ÎNTRERÂURI,MM,68,6,5,0,11,28,7,0,35
COLTĂU,MM,2088,32,2,0,34,167,10,0,177
BERINŢA,MM,605,13,0,0,13,75,7,0,82
COPALNIC-DEAL,MM,77,8,4,0,12,16,4,0,20
FĂUREŞTI,MM,706,18,2,0,20,134,9,0,143
LĂSCHIA,MM,414,13,3,0,16,110,7,0,117
"PRELUCA NOUĂ",MM,262,4,0,0,4,54,8,0,62
VAD,MM,289,5,1,0,6,81,7,0,88
CĂRPINIŞ,MM,282,7,0,0,7,72,11,0,83
"CURTUIUŞU MIC",MM,210,3,0,0,3,36,10,0,46
"PRELUCA VECHE",MM,294,5,0,0,5,28,0,0,28
COPALNIC,MM,539,11,0,0,11,60,15,0,75
RUŞOR,MM,219,10,5,0,15,55,11,0,66
COPALNIC-MĂNĂŞTUR,MM,739,18,2,1,21,108,17,1,126
COROIENI,MM,338,10,5,0,15,68,15,3,86
BABA,MM,382,5,4,0,9,89,7,0,96
DRĂGHIA,MM,166,6,3,0,9,50,10,0,60
"DEALU MARE",MM,177,24,4,0,28,94,20,0,114
"VĂLENII LĂPUŞULUI",MM,732,9,2,0,11,189,15,0,204
CUPŞENI,MM,648,13,0,0,13,143,7,0,150
COSTENI,MM,346,3,2,0,5,58,7,0,65
LIBOTIN,MM,876,27,2,0,29,177,9,0,186
UNGURENI,MM,989,15,4,0,19,214,13,0,227
HĂRNICEŞTI,MM,458,6,0,0,6,52,5,0,57
MARA,MM,756,19,2,0,21,174,7,0,181
DESEŞTI,MM,761,20,9,0,29,196,14,0,210
CĂRBUNARI,MM,525,12,2,0,14,57,7,0,64
CHECHIŞ,MM,789,14,4,0,18,181,24,0,205
RUS,MM,537,12,5,0,17,89,33,0,122
ŞINDREŞTI,MM,494,8,6,0,14,97,9,0,106
UNGURAŞ,MM,399,21,3,0,24,136,6,0,142
DUMBRĂVIŢA,MM,950,27,2,0,29,263,17,0,280
FĂRCAŞA,MM,1463,64,9,0,73,383,24,14,421
BUZEŞTI,MM,531,18,8,0,26,141,27,6,174
SÎRBI,MM,425,41,5,0,46,219,28,5,252
TĂMAIA,MM,849,27,6,0,33,230,25,17,272
GÂRDANI,MM,1111,46,6,0,52,256,25,0,281
GIULEŞTI,MM,1052,21,8,0,29,112,16,0,128
BERBEŞTI,MM,1223,31,5,0,36,199,11,0,210
FEREŞTI,MM,393,15,5,0,20,106,9,0,115
GROŞI,MM,1181,26,2,0,28,214,29,0,243
OCOLIŞ,MM,377,12,2,0,14,42,10,0,52
"SATU NOU DE JOS",MM,932,22,2,0,24,108,7,0,115
"GROŞII ŢIBLEŞULUI",MM,1714,57,10,0,67,487,35,0,522
IEUD,MM,3494,83,18,0,101,593,51,8,652
LĂPUŞ,MM,3013,78,9,0,87,607,26,0,633
LEORDINA,MM,1987,40,7,0,47,327,31,0,358
IADĂRA,MM,788,28,8,0,36,218,21,0,239
LUCĂCEŞTI,MM,516,17,11,0,28,145,24,0,169
"DĂNEŞTII CHIOARULUI",MM,405,28,5,0,33,148,11,0,159
"MIREŞU MARE",MM,1140,33,10,0,43,291,48,0,339
"REMEŢI PE SOMEŞ",MM,469,17,3,0,20,175,30,0,205
TULGHIEŞ,MM,530,47,9,0,56,255,40,0,295
MOISEI,MM,7555,121,39,0,160,797,85,0,882
"OARŢA DE JOS",MM,368,6,4,0,10,82,21,0,103
"OARŢA DE SUS",MM,588,33,8,0,41,184,27,0,211
BREB,MM,884,8,3,0,11,80,12,0,92
HOTENI,MM,274,3,0,0,3,32,4,2,38
SAT-ŞUGATAG,MM,1002,8,1,0,9,148,6,0,154
"OCNA ŞUGATAG",MM,1366,64,37,0,101,221,69,0,290
ONCEŞTI,MM,1259,28,20,0,48,317,47,0,364
PETROVA,MM,1993,56,13,0,69,336,34,0,370
"POIENILE DE SUB MUNTE",MM,7415,310,8,0,318,2310,49,0,2359
"POIENILE IZEI",MM,761,40,10,0,50,367,34,0,401
LĂPUŞEL,MM,1235,25,5,0,30,212,20,0,232
SĂSAR,MM,1784,38,1,0,39,342,35,0,377
"BOZÎNTA MICĂ",MM,344,11,6,0,17,101,23,0,124
MOCIRA,MM,933,51,4,0,55,277,20,1,298
RECEA,MM,1034,56,7,0,63,332,26,5,363
BERCHEZ,MM,526,12,3,0,15,69,4,0,73
BERCHEZOAIA,MM,352,2,4,0,6,34,8,0,42
POSTA,MM,269,8,5,0,13,68,13,0,81
"REMETEA CHIOARULUI",MM,864,18,4,0,22,229,32,0,261
REMECIOARA,MM,220,16,0,0,16,43,10,0,53
PIATRA,MM,312,7,3,0,10,28,3,0,31
"TECEU MIC",MM,140,2,7,0,9,10,14,0,24
REMEŢI,MM,2135,47,13,0,60,275,22,0,297
REPEDEA,MM,3623,279,22,0,301,1257,51,0,1308
"RONA DE JOS",MM,1710,20,4,0,24,224,11,0,235
"RONA DE SUS",MM,3151,53,11,0,64,281,20,0,301
COŞTIUI,MM,607,14,2,0,16,78,8,0,86
ROZAVLEA,MM,2655,47,3,0,50,341,35,0,376
RUSCOVA,MM,4332,134,12,0,146,889,24,0,913
SARASĂU,MM,2236,24,5,0,29,219,17,0,236
SATULUNG,MM,1258,34,4,0,38,204,30,1,235
"ARIEŞU DE PĂDURE",MM,175,9,6,0,15,85,29,0,114
FERSIG,MM,579,26,2,0,28,179,26,5,210
MOGOŞEŞTI,MM,668,21,1,0,22,121,15,0,136
"FINTEUŞU MIC",MM,842,33,4,0,37,185,23,0,208
HIDEAGA,MM,552,35,8,0,43,147,31,1,179
PRIBILEŞTI,MM,616,15,2,0,17,143,8,0,151
SĂCĂLĂŞENI,MM,745,31,5,0,36,194,33,0,227
CORUIA,MM,664,13,2,0,15,106,10,0,116
CULCEA,MM,505,20,5,0,25,108,13,0,121
SĂCEL,MM,2822,56,2,0,58,412,20,0,432
SĂLSIG,MM,1272,51,7,0,58,428,32,0,460
SĂPÎNŢA,MM,2638,60,2,0,62,361,30,0,391
STRÎMTURA,MM,2106,42,16,0,58,378,32,0,410
GLOD,MM,512,25,4,0,29,174,11,0,185
SLĂTIOARA,MM,422,14,4,0,18,103,12,0,115
"SUCIU DE JOS",MM,842,23,6,0,29,243,25,0,268
"SUCIU DE SUS",MM,2091,64,8,0,72,409,26,2,437
LARGA,MM,282,13,0,0,13,96,9,0,105
ŞIEU,MM,1941,31,8,12,51,274,32,13,319
ŞISEŞTI,MM,1289,31,4,0,35,325,16,3,344
BONTĂIENI,MM,191,2,4,0,6,53,11,0,64
NEGREIA,MM,385,7,3,0,10,66,14,0,80
PLOPIŞ,MM,437,14,3,0,17,140,6,0,146
CETĂŢELE,MM,515,11,7,0,18,137,11,0,148
DĂNEŞTI,MM,519,5,4,0,9,88,19,0,107
ŞURDEŞTI,MM,1197,21,1,0,22,174,7,0,181
"VADU IZEI",MM,2051,45,5,0,50,280,33,0,313
"VALEA STEJARULUI",MM,389,12,6,0,18,95,13,0,108
"CURTUIUŞU MARE",MM,237,24,6,0,30,79,24,0,103
FERICEA,MM,364,13,10,0,23,69,32,0,101
MESTEACĂN,MM,291,34,11,0,45,67,25,0,92
VĂRAI,MM,216,12,6,0,18,68,20,0,88
"VALEA CHIOARULUI",MM,532,26,4,0,30,145,24,0,169
DURUŞA,MM,46,5,0,0,5,19,11,0,30
"VIMA MICĂ",MM,302,20,3,4,27,105,14,4,123
"DEALU CORBULUI",MM,82,5,2,0,7,17,5,0,22
PETERITEA,MM,196,10,1,0,11,51,14,0,65
SĂLNIŢA,MM,206,16,4,0,20,65,10,0,75
"VIMA MARE",MM,341,5,3,0,8,82,20,0,102
ASPRA,MM,40,2,2,0,4,11,7,0,18
JUGĂSTRENI,MM,41,3,2,0,5,14,6,0,20
"VIŞEU DE JOS",MM,4243,81,9,0,90,453,30,0,483
"TÎRGU MUREŞ",MS,124298,6184,686,443,7313,18055,1779,490,20324
REGHIN,MS,31088,1096,92,0,1188,4468,259,56,4783
SIGHIŞOARA,MS,27703,1028,183,10,1221,3190,311,26,3527
HETIUR,MS,846,24,3,0,27,73,7,0,80
TÂRNĂVENI,MS,20139,756,64,0,820,2686,179,16,2881
BOBOHALMA,MS,860,51,3,0,54,179,12,0,191
CUŞTELNIC,MS,456,16,3,0,19,101,3,0,104
IERNUT,MS,5054,164,19,0,183,643,42,0,685
CIPĂU,MS,884,20,0,0,20,94,13,0,107
DEAG,MS,285,5,3,0,8,40,10,0,50
LECHINŢA,MS,721,11,5,0,16,55,14,0,69
"OARBA DE MUREŞ",MS,97,7,2,0,9,23,5,0,28
SĂLCUD,MS,543,11,8,0,19,31,13,0,44
"SFÎNTU GHEORGHE",MS,328,20,4,0,24,88,8,0,96
LUDUŞ,MS,14544,697,93,14,804,2359,182,15,2556
"MIERCUREA NIRAJULUI",MS,3098,40,4,0,44,274,33,0,307
DUMITREŞTII,MS,253,2,2,0,4,15,7,0,22
TÂMPA,MS,432,4,3,0,7,13,6,0,19
"ŞARDU NIRAJULUI",MS,563,11,0,0,11,44,0,0,44
MOŞUNI,MS,327,4,3,0,7,21,11,0,32
BALDA,MS,914,10,3,0,13,95,7,0,102
SĂRMĂŞEL-GARĂ,MS,572,12,1,0,13,105,10,0,115
VIŞINELU,MS,374,25,4,0,29,133,20,0,153
SARMAŞU,MS,3004,113,14,0,127,647,64,0,711
LARGA,MS,154,3,3,0,6,14,5,0,19
SĂRMĂŞEL,MS,618,13,2,0,15,110,9,0,119
"SÂNGEORGIU DE PĂDURE",MS,3863,53,13,0,66,273,27,0,300
BEZID,MS,513,3,4,0,7,16,6,0,22
ILIEŞI,MS,364,8,3,0,11,23,4,0,27
SĂCĂDAT,MS,1163,12,0,0,12,62,3,0,65
SOVATA,MS,7022,149,122,0,271,576,244,0,820
UNGHENI,MS,3392,193,31,0,224,625,69,5,699
CERGHID,MS,405,23,3,0,26,118,16,0,134
MOREŞTI,MS,641,35,6,0,41,230,18,2,250
CERGHIZEL,MS,390,24,6,0,30,106,22,0,128
ŞĂUŞA,MS,199,10,2,0,12,75,11,0,86
VIDRASĂU,MS,911,51,25,0,76,360,48,2,410
ACĂŢARI,MS,1002,20,3,0,23,106,10,0,116
GRUIŞOR,MS,343,11,4,0,15,42,8,0,50
GĂIEŞTI,MS,295,6,2,0,8,28,3,0,31
MURGEŞTI,MS,420,5,0,0,5,58,13,0,71
ROTENI,MS,645,9,3,0,12,134,9,0,143
STEJERIŞ,MS,281,10,0,0,10,46,9,0,55
SUVEICA,MS,177,9,3,0,12,23,3,0,26
VĂLENII,MS,649,10,1,0,11,58,4,0,62
ADĂMUŞ,MS,1767,32,9,0,41,117,14,0,131
CORNEŞTI,MS,1005,65,10,0,75,211,18,0,229
CRĂIEŞTI,MS,876,14,2,0,16,93,5,0,98
DÎMBĂU,MS,890,12,1,0,13,63,5,0,68
ŢOPA,MS,289,11,5,0,16,58,13,0,71
ALBEŞTI,MS,3426,94,10,0,104,443,29,0,472
BOIU,MS,1205,22,4,0,26,115,20,0,135
ALUNIŞ,MS,1615,121,7,0,128,328,22,0,350
FIŢCĂU,MS,400,3,6,0,9,32,7,0,39
"LUNCA MUREŞULUI",MS,551,13,2,0,15,33,10,4,47
APOLD,MS,814,10,0,0,10,33,7,0,40
DAIA,MS,565,4,1,0,5,34,2,0,36
ŞAEŞ,MS,1084,15,2,0,17,112,7,0,119
AŢINTIŞ,MS,611,7,2,0,9,57,19,0,76
BOTEZ,MS,140,7,5,0,12,20,6,0,26
CECĂLACA,MS,321,7,2,0,9,40,12,0,52
IŞTIHAZA,MS,164,2,2,0,4,5,10,0,15
BAHNEA,MS,1573,33,8,0,41,254,20,0,274
BERNADEA,MS,141,0,2,0,2,21,13,0,34
LEPINDEA,MS,145,5,6,0,11,24,22,0,46
DAIA,MS,138,0,1,0,1,15,6,0,21
IDICIU,MS,248,4,0,0,4,79,11,0,90
GOGAN,MS,416,4,0,0,4,17,6,0,23
CUND,MS,174,3,3,0,6,7,9,0,16
BAND,MS,3109,19,4,0,23,123,21,0,144
ŢIPTELNIC,MS,91,1,4,0,5,17,12,0,29
"VALEA RECE",MS,218,3,0,0,3,8,6,0,14
MĂRĂŞEŞTI,MS,251,1,2,0,3,28,7,0,35
FÂNAŢE,MS,353,9,3,0,12,120,14,0,134
OROIU,MS,241,8,1,0,9,38,10,0,48
PETEA,MS,155,6,2,0,8,23,6,0,29
"DRĂCULEA BANDULUI",MS,100,3,0,0,3,28,6,0,34
"NEGRENII DE CÂMPIE",MS,99,5,3,0,8,15,7,0,22
"VALEA MARE",MS,166,10,7,0,17,45,17,0,62
BATOŞ,MS,1131,11,4,0,15,116,10,0,126
DEDRAD,MS,1305,22,5,0,27,145,15,1,161
GORENI,MS,499,9,2,0,11,120,7,0,127
UILA,MS,482,7,0,0,7,34,4,0,38
BĂGACIU,MS,1118,31,3,0,34,110,6,0,116
DELENII,MS,903,20,7,0,27,85,9,0,94
BĂLA,MS,450,14,3,0,17,97,16,0,113
ERCEA,MS,141,6,0,0,6,53,7,0,60
BĂLĂUŞERI,MS,964,2,3,0,5,29,7,0,36
AGRIŞTEU,MS,636,11,6,0,17,80,15,0,95
DUMITRENI,MS,376,22,2,0,24,57,7,0,64
FILITELNIC,MS,184,8,5,0,13,23,6,0,29
CHENDU,MS,1182,6,2,0,8,44,4,0,48
SENEREUŞ,MS,534,13,7,0,20,63,11,0,74
"BEICA DE JOS",MS,704,26,7,0,33,138,20,0,158
"BEICA DE SUS",MS,213,14,6,0,20,67,17,0,84
NADĂŞA,MS,187,15,16,0,31,53,25,0,78
CĂCUCIU,MS,113,14,11,0,25,60,31,0,91
ŞERBENI,MS,275,13,9,0,22,131,22,1,154
"SÎNMIHAI DE PĂDURE",MS,199,9,8,0,17,43,20,0,63
BERENI,MS,432,1,0,0,1,24,6,0,30
EREMIENI,MS,192,7,2,0,9,39,7,0,46
MĂRCULENI,MS,366,5,3,0,8,40,13,0,53
BICHIŞ,MS,162,1,0,0,1,3,6,0,9
GÎMBUŢ,MS,131,2,3,0,5,26,12,0,38
NANDRA,MS,121,9,3,0,12,34,6,0,40
OZD,MS,253,6,4,0,10,21,6,0,27
RANTA,MS,243,5,1,0,6,14,7,0,21
BOGATA,MS,1270,26,2,0,28,89,8,0,97
"FILPIŞU MARE",MS,640,11,2,0,13,96,15,0,111
"FILPIŞU MIC",MS,351,6,2,0,8,51,6,0,57
BREAZA,MS,1058,16,0,0,16,109,3,0,112
IDICEL-PĂDURE,MS,394,6,0,0,6,56,8,0,64
BRÎNCOVENEŞTI,MS,1337,15,2,0,17,77,8,0,85
IDICEL,MS,334,7,8,0,15,69,16,0,85
"SĂCALU DE PĂDURE",MS,276,8,5,0,13,73,25,0,98
"VĂLENII DE MUREŞ",MS,1022,38,1,0,39,71,10,0,81
"CEUAŞU DE CÎMPIE",MS,1335,18,1,0,19,166,15,0,181
BOZED,MS,125,10,4,0,14,37,11,0,48
CÎMPENIŢA,MS,727,10,1,0,11,108,11,0,119
CULPIU,MS,310,2,0,0,2,29,4,0,33
HERGHELIA,MS,320,15,18,0,33,101,46,0,147
PORUMBENI,MS,463,2,0,0,2,42,1,0,43
SĂBED,MS,620,15,1,0,16,51,7,0,58
VOINICENI,MS,916,37,7,0,44,196,32,0,228
GRINDENI,MS,467,4,1,0,5,37,10,0,47
CHEŢANI,MS,941,32,9,0,41,141,29,0,170
HĂDĂRENI,MS,674,35,6,0,41,92,20,0,112
CHIBED,MS,1357,14,6,0,20,83,10,0,93
"CHIHERU DE JOS",MS,347,19,2,0,21,120,18,1,139
"CHIHERU DE SUS",MS,307,10,3,0,13,62,14,0,76
"URISIU DE JOS",MS,253,7,7,0,14,66,18,0,84
"URISIU DE SUS",MS,349,13,7,0,20,95,21,0,116
COROISÎNMĂRTIN,MS,339,8,0,0,8,40,1,0,41
ŞOIMUŞ,MS,323,27,12,0,39,128,14,0,142
ODRIHEI,MS,392,30,2,0,32,88,12,0,100
COROI,MS,101,3,0,0,3,16,15,0,31
CORUNCA,MS,2661,59,19,0,78,296,47,0,343
BOZENI,MS,113,0,0,0,0,5,8,0,13
"SOCOLU DE CÎMPIE",MS,108,6,0,0,6,25,3,2,30
COZMA,MS,320,7,2,0,9,63,22,0,85
CRĂCIUNEŞTI,MS,1815,32,10,0,42,132,23,0,155
CORNEŞTI,MS,714,4,3,0,7,109,9,0,118
CINTA,MS,430,2,1,0,3,64,3,0,67
"BUDIU MIC",MS,304,2,1,0,3,28,7,0,35
CRĂIEŞTI,MS,514,24,2,0,26,141,15,26,182
MILĂŞEL,MS,147,3,4,0,7,53,12,4,69
LEFAIA,MS,48,4,8,0,12,23,11,0,34
CRISTEŞTI,MS,4223,156,9,0,165,691,45,0,736
VĂLURENI,MS,815,10,0,0,10,53,7,0,60
CUCERDEA,MS,583,12,1,0,13,61,5,0,66
"ŞEULIA DE MUREŞ",MS,473,12,0,0,12,64,11,0,75
BORD,MS,103,3,0,0,3,16,4,0,20
OROSIA,MS,135,23,1,0,24,38,9,0,47
PETRILACA,MS,441,23,5,0,28,113,22,0,135
DĂTĂŞENI,MS,277,10,0,0,10,52,10,0,62
CUCI,MS,673,16,6,0,22,145,21,0,166
DANEŞ,MS,1993,47,2,0,49,282,21,0,303
SELEUŞ,MS,1736,43,4,0,47,194,7,0,201
CRIŞ,MS,587,14,7,0,21,46,13,0,59
STEJĂRENII,MS,272,5,3,0,8,24,7,0,31
"BISTRA MUREŞULUI",MS,828,31,3,0,34,251,28,0,279
FILEA,MS,565,11,3,0,14,171,17,0,188
PIETRIŞ,MS,378,10,0,0,10,92,16,0,108
DEDA,MS,1524,45,3,0,48,447,45,0,492
EREMITU,MS,1454,18,2,0,20,169,16,0,185
CĂLUGĂRENI,MS,454,7,3,0,10,47,10,0,57
"CÎMPU CETĂŢII",MS,318,8,6,0,14,33,19,0,52
DĂMIENI,MS,185,8,0,0,8,39,6,0,45
MĂTRICI,MS,714,7,9,0,16,84,20,0,104
ERNEI,MS,1919,35,10,0,45,162,19,0,181
CĂLUŞERI,MS,472,7,2,0,9,34,9,0,43
DUMBRĂVIOARA,MS,1462,26,4,0,30,86,13,0,99
ICLAND,MS,315,8,0,0,8,15,3,0,18
SĂCĂRENI,MS,205,4,4,0,8,10,9,0,19
"SÎNGERU DE PĂDURE",MS,334,8,4,0,12,18,7,0,25
FĂRĂGĂU,MS,376,26,11,0,37,181,35,0,216
POARTA,MS,176,17,8,0,25,46,11,0,57
TONCIU,MS,700,155,7,0,162,260,9,0,269
FÎNTÎNELE,MS,1988,13,2,0,15,82,7,0,89
CĂLIMĂNEŞTI,MS,705,5,2,0,7,36,7,0,43
VIFOROASA,MS,656,3,5,0,8,41,12,0,53
BORDOŞIU,MS,245,3,4,0,7,17,10,0,27
CIBU,MS,90,2,0,0,2,13,6,0,19
ROUA,MS,283,4,0,0,4,9,6,0,15
GĂLEŞTI,MS,759,5,2,0,7,35,6,0,41
TROIŢA,MS,594,2,4,0,6,16,4,0,20
MAIAD,MS,227,11,4,0,15,21,8,0,29
SÂNVĂSII,MS,258,9,1,0,10,33,9,0,42
"ADRIANU MARE",MS,107,7,0,0,7,16,6,0,22
BEDENI,MS,118,4,0,0,4,8,0,0,8
GĂNEŞTI,MS,1773,26,6,0,32,169,13,0,182
PĂUCIŞOARA,MS,219,3,0,0,3,28,4,0,32
SEUCA,MS,958,12,2,0,14,48,9,0,57
"GHEORGHE DOJA",MS,398,6,1,0,7,13,7,0,20
ILIENI,MS,335,16,1,0,17,36,8,0,44
LEORDENI,MS,310,2,4,0,6,16,10,0,26
"SATU NOU",MS,610,1,2,0,3,10,9,0,19
TIRIMIA,MS,706,24,2,0,26,90,15,0,105
GHINDARI,MS,1246,15,2,0,17,79,6,0,85
"TREI SATE",MS,954,3,0,0,3,54,7,0,61
SOLOCMA,MS,255,10,6,0,16,39,12,0,51
ABUD,MS,110,2,0,0,2,15,4,0,19
GLODENI,MS,2008,14,3,0,17,81,6,0,87
MERIŞOR,MS,135,6,3,0,9,43,10,0,53
MOIŞA,MS,200,7,4,0,11,64,10,0,74
PĂCURENI,MS,181,2,2,0,4,24,10,0,34
PĂINGENI,MS,300,6,0,0,6,36,9,0,45
ILIOARA,MS,92,0,0,0,0,8,7,0,15
PĂDURENI,MS,356,8,0,0,8,38,8,0,46
"PETRILACA DE MUREŞ",MS,341,5,3,0,8,38,5,0,43
TELEAC,MS,336,5,0,0,5,80,14,0,94
GORNEŞTI,MS,1608,31,5,0,36,109,18,0,127
PERIŞ,MS,1500,13,4,0,17,72,11,0,83
"IARA DE MUREŞ",MS,245,1,0,0,1,5,5,0,10
"GREBENIŞU DE CÎMPIE",MS,1319,31,5,0,36,258,18,0,276
GURGHIU,MS,1635,34,6,0,40,235,16,0,251
ADRIAN,MS,227,30,7,0,37,90,23,0,113
CAŞVA,MS,669,12,3,0,15,119,19,1,139
COMORI,MS,158,7,0,0,7,52,9,0,61
GLĂJĂRIE,MS,1427,36,4,0,40,288,9,0,297
LARGA,MS,190,4,6,0,10,25,8,0,33
ORŞOVA,MS,662,23,0,0,23,142,15,0,157
HODAC,MS,2054,34,4,0,38,494,28,0,522
TOACA,MS,1541,33,3,0,36,306,19,0,325
"DUBIŞTEA DE PĂDURE",MS,373,9,1,0,10,99,10,0,109
HODOŞA,MS,166,3,2,0,5,44,9,0,53
IHOD,MS,95,1,0,0,1,28,7,0,35
ISLA,MS,223,2,1,0,3,17,9,0,26
SÎMBRIAŞ,MS,510,10,2,0,12,87,10,0,97
IBĂNEŞTI,MS,1825,73,14,0,87,459,37,0,496
IBĂNEŞTI-PĂDURE,MS,777,13,7,0,20,144,22,0,166
DULCEA,MS,906,28,2,0,30,212,11,0,223
ICLĂNZEL,MS,1031,13,1,0,14,139,17,0,156
"CĂPUŞU DE CÎMPIE",MS,620,15,6,0,21,96,22,3,121
"IDECIU DE JOS",MS,1741,68,10,0,78,339,35,0,374
IVĂNEŞTI,MS,361,8,1,0,9,40,13,0,53
POIENIŢA,MS,236,5,7,0,12,18,12,0,30
LIVEZENI,MS,1856,23,17,0,40,195,37,0,232
SÎNIŞOR,MS,203,4,2,0,6,18,7,0,25
LUNCA,MS,419,8,3,0,11,135,14,1,150
BĂIŢA,MS,624,11,3,0,14,258,18,0,276
FRUNZENI,MS,328,11,8,0,19,90,20,0,110
LOGIG,MS,324,10,1,0,11,104,11,0,115
SÎNTU,MS,265,11,0,0,11,73,14,0,87
"LUNCA BRADULUI",MS,1227,38,13,0,51,123,27,5,155
NEAGRA,MS,367,8,5,0,13,45,7,0,52
MĂDĂRAŞ,MS,1272,25,7,0,32,153,19,0,172
MĂGHERANI,MS,605,8,22,0,30,56,31,0,87
"ŞILEA NIRAJULUI",MS,328,1,0,0,1,41,5,0,46
TORBA,MS,126,5,0,0,5,31,9,0,40
MICA,MS,578,4,1,0,5,23,9,0,32
CEUAŞ,MS,707,2,0,0,2,30,5,0,35
DEAJ,MS,1186,7,0,0,7,68,11,0,79
HĂRĂNGLAB,MS,621,9,0,0,9,33,4,0,37
ŞOMOŞTELNIC,MS,208,6,0,0,6,39,9,0,48
ABUŞ,MS,242,9,0,0,9,40,10,0,50
"MIHEŞU DE CÎMPIE",MS,1238,13,2,0,15,104,16,0,120
RĂZOARE,MS,679,27,8,0,35,93,20,0,113
NADEŞ,MS,1181,11,0,0,11,50,3,0,53
MĂGHERUŞ,MS,103,4,5,0,9,9,6,0,15
PIPEA,MS,53,3,3,0,6,14,8,0,22
ŢIGMANDRU,MS,874,7,1,0,8,47,2,0,49
NEAUA,MS,309,6,2,0,8,50,10,0,60
VĂDAŞ,MS,298,8,0,0,8,33,6,0,39
GHINEŞTI,MS,216,4,0,0,4,18,8,0,26
SÎNSIMION,MS,56,0,0,0,0,4,3,0,7
RIGMANI,MS,196,1,3,0,4,10,3,0,13
OGRA,MS,1435,62,14,0,76,169,35,1,205
GIULUŞ,MS,112,8,3,0,11,37,11,0,48
LĂSCUD,MS,189,12,3,0,15,33,7,0,40
VAIDEIU,MS,100,5,2,0,7,13,7,0,20
"PAPIU ILARIAN",MS,688,13,1,0,14,94,8,0,102
PĂNET,MS,1936,97,9,0,106,332,17,0,349
BERGHIA,MS,998,16,1,0,17,93,15,0,108
CUIEŞD,MS,662,12,0,0,12,62,10,0,72
HĂRŢĂU,MS,282,11,2,0,13,55,10,0,65
"SÎNTIOANA DE MUREŞ",MS,1171,34,1,0,35,206,11,0,217
PĂSĂRENI,MS,699,11,4,0,15,78,11,0,89
GĂLĂŢENI,MS,552,5,2,0,7,27,4,0,31
BOLINTINENI,MS,178,2,3,0,5,54,21,0,75
PETELEA,MS,1994,16,4,0,20,139,14,0,153
HABIC,MS,201,5,6,0,11,53,36,1,90
POGĂCEAUA,MS,1069,31,1,0,32,213,9,0,222
VĂLENI,MS,413,30,6,0,36,121,24,0,145
RĂSTOLIŢA,MS,1468,42,2,0,44,233,19,0,252
"SÎNMĂRTINU DE CÎMPIE",MS,731,20,2,0,22,94,10,0,104
"NIMA RÎCIULUI",MS,134,3,5,0,8,31,29,0,60
ULIEŞ,MS,603,6,6,0,12,64,10,0,74
RÎCIU,MS,1340,37,5,0,42,224,20,0,244
RUŞII-MUNŢI,MS,1263,47,5,0,52,294,25,0,319
MAIOREŞTI,MS,195,20,2,0,22,64,11,0,75
MORĂRENI,MS,319,9,3,0,12,99,16,0,115
SASCHIZ,MS,1392,34,8,0,42,153,21,0,174
"MIHAI VITEAZU",MS,242,12,1,0,13,49,12,0,61
CLOAŞTERF,MS,156,5,3,0,8,14,9,0,23
SĂRĂŢENI,MS,1234,11,0,0,11,56,6,0,62
SÂNGER,MS,1280,16,1,0,17,119,14,0,133
CIPĂIENI,MS,593,15,0,0,15,79,8,0,87
"SÎNCRAIU DE MUREŞ",MS,5182,187,38,0,225,756,98,0,854
NAZNA,MS,2109,122,5,0,127,449,47,0,496
"SÎNGEORGIU DE MUREŞ",MS,7883,377,35,0,412,1286,140,22,1448
COTUŞ,MS,403,11,5,0,16,75,7,0,82
SÎNPAUL,MS,1421,30,6,0,36,77,13,0,90
CHIRILEU,MS,686,21,7,0,28,92,18,0,110
"DILEU NOU",MS,139,15,0,0,15,27,6,0,33
SÎNMĂRGHITA,MS,197,13,6,0,19,27,11,0,38
"VALEA IZVOARELOR",MS,959,36,3,0,39,182,16,0,198
"SÎNPETRU DE CÎMPIE",MS,850,20,3,0,23,95,10,0,105
BÎRLIBAŞ,MS,97,4,2,0,6,15,5,0,20
DÎMBU,MS,459,10,2,0,12,69,9,0,78
"SATU NOU",MS,159,7,9,0,16,32,15,0,47
"SÎNGEORGIU DE CÎMPIE",MS,286,13,2,0,15,61,11,0,72
TUŞINU,MS,400,5,9,0,14,63,27,1,91
"SÎNTANA DE MUREŞ",MS,2932,76,12,0,88,416,37,0,453
CURTENI,MS,830,19,5,0,24,135,16,0,151
CHINARI,MS,592,17,2,0,19,79,14,0,93
BĂRDEŞTI,MS,401,26,4,0,30,96,27,0,123
SOLOVĂSTRU,MS,1396,47,7,0,54,264,22,0,286
JABENIŢA,MS,977,29,6,0,35,157,16,0,173
STÎNCENI,MS,1208,31,3,0,34,190,17,0,207
SUPLAC,MS,648,22,4,0,26,148,13,0,161
IDRIFAIA,MS,514,6,4,0,10,55,11,0,66
"LASLĂU MARE",MS,296,6,5,0,11,89,25,0,114
"LASLĂU MIC",MS,413,7,1,0,8,56,11,0,67
SUSENI,MS,1393,28,3,0,31,118,6,0,124
LUIERIU,MS,541,21,3,0,24,130,21,0,151
ŞĂULIA,MS,1570,51,16,0,67,412,71,0,483
ŞINCAI,MS,846,14,3,0,17,66,14,0,80
LECHINCIOARA,MS,79,16,2,0,18,26,10,0,36
PUSTA,MS,98,2,1,0,3,21,11,0,32
ŞINCAI-FÎNAŢE,MS,173,4,1,0,5,37,8,0,45
TĂURENI,MS,762,16,7,0,23,161,19,0,180
"VALEA LARGĂ",MS,2025,42,2,0,44,170,6,0,176
"VALEA FRĂŢIEI",MS,496,9,4,0,13,28,5,0,33
VĂRGATA,MS,647,5,1,0,6,26,4,0,30
GRÎUŞORUL,MS,138,1,0,0,1,6,9,0,15
VADU,MS,200,2,0,0,2,14,6,0,20
VALEA,MS,546,9,1,0,10,53,7,0,60
VĂTAVA,MS,642,23,7,0,30,152,23,0,175
DUMBRAVA,MS,562,14,2,0,16,118,9,0,127
"RÎPA DE JOS",MS,377,16,7,0,23,147,23,8,178
VEŢCA,MS,384,3,1,0,4,49,9,0,58
JACODU,MS,192,6,9,0,15,27,21,0,48
VIIŞOARA,MS,621,13,2,0,15,51,13,0,64
SÎNTIOANA,MS,432,19,4,0,23,97,11,0,108
ORMENIŞ,MS,345,2,2,0,4,47,4,0,51
VÎNĂTORI,MS,1429,45,4,0,49,196,9,0,205
ARCHITA,MS,711,19,1,0,20,104,18,0,122
FELEAG,MS,165,5,3,0,8,42,26,0,68
MURENI,MS,280,3,1,0,4,35,8,0,43
ŞOARD,MS,593,7,2,0,9,100,11,0,111
VOIVODENI,MS,1302,24,1,0,25,138,17,0,155
TOLDAL,MS,183,13,6,0,19,33,16,0,49
ZAGĂR,MS,1002,29,1,0,30,203,15,0,218
"ZAU DE CÎMPIE",MS,2225,53,4,0,57,212,21,0,233
BĂRBOŞI,MS,385,5,4,0,9,35,8,0,43
PIATRA-NEAMŢ,NT,95657,6378,502,175,7055,19542,1215,211,20968
ROMAN,NT,58343,2825,267,7,3099,9544,663,7,10214
BICAZ,NT,3187,357,26,0,383,913,72,1,986
CAPŞA,NT,1074,87,10,1,98,309,26,1,336
DODENI,NT,2023,121,8,0,129,477,29,2,508
"IZVORU MUNTELUI",NT,405,12,17,0,29,150,32,0,182
"IZVORUL ALB",NT,129,19,3,0,22,65,29,0,94
POTOCI,NT,208,11,6,0,17,68,9,0,77
SECU,NT,66,1,3,0,4,26,12,0,38
ROZNOV,NT,4605,274,67,4,345,1091,160,29,1280
CHINTINICI,NT,967,47,2,0,49,198,19,1,218
SLOBOZIA,NT,2786,89,8,0,97,571,62,1,634
"TÎRGU NEAMŢ",NT,18083,1217,209,12,1438,5063,535,16,5614
AGAPIA,NT,1463,295,45,0,340,538,81,23,642
FILIOARA,NT,859,63,8,28,99,308,35,28,371
SĂCĂLUŞEŞTI,NT,535,37,8,0,45,162,18,0,180
VARATEC,NT,738,181,35,73,289,329,73,73,475
VIIŞOARA,NT,930,58,16,26,100,213,45,64,322
VADURI,NT,872,34,18,0,52,146,52,0,198
BISTRIŢA,NT,1854,124,39,0,163,505,94,11,610
VĂDURELE,NT,1400,57,11,0,68,349,29,0,378
BAHNA,NT,545,15,4,0,19,100,16,0,116
BROŞTENI,NT,394,14,8,0,22,88,35,0,123
"ŢUŢCANII DIN VALE",NT,254,6,0,0,6,81,13,0,94
BĂHNIŞOARA,NT,366,13,2,0,15,111,12,0,123
IZVOARE,NT,1070,12,5,0,17,120,22,0,142
BĂLŢĂTEŞTI,NT,1726,114,71,0,185,578,123,0,701
"VALEA SEACĂ",NT,1227,47,2,0,49,427,37,0,464
"VALEA ARINI",NT,497,12,1,0,13,161,21,0,182
BICAZ-CHEI,NT,2974,125,9,0,134,1010,40,4,1054
IVANEŞ,NT,701,54,6,8,68,413,23,17,453
"BICAZU ARDELEAN",NT,1374,67,2,0,69,491,22,27,540
TELEC,NT,1524,52,8,0,60,478,32,13,523
TICOŞ,NT,258,14,3,1,18,103,24,1,128
BIRA,NT,645,11,1,0,12,153,19,0,172
REDIU,NT,764,25,12,0,37,249,38,0,287
NEGREŞTI,NT,159,15,4,0,19,43,11,0,54
BÎRGAUANI,NT,955,38,8,0,46,221,32,9,262
BREAZA,NT,176,8,2,0,10,54,19,0,73
CERTIENI,NT,178,11,10,0,21,81,22,2,105
HÎRTOP,NT,193,22,7,0,29,84,32,4,120
BĂLĂNEŞTI,NT,540,27,4,0,31,178,32,5,215
TALPA,NT,569,61,12,0,73,276,35,0,311
VLĂDICENI,NT,487,41,17,0,58,211,62,14,287
BODEŞTI,NT,1790,72,9,0,81,491,64,7,562
CORNI,NT,121,16,18,1,35,68,48,5,121
OŞLOBENI,NT,774,25,1,0,26,217,36,22,275
"BODEŞTII DE JOS",NT,1260,44,6,0,50,371,67,2,440
BOGHICEA,NT,1005,33,3,0,36,217,19,0,236
SLOBOZIA,NT,595,29,7,0,36,129,25,0,154
CĂUŞENI,NT,137,11,8,0,19,45,13,0,58
NISTRIA,NT,207,14,5,0,19,56,5,0,61
BORCA,NT,882,57,11,10,78,301,38,10,349
MĂDEI,NT,907,25,6,3,34,330,15,3,348
"PÎRÎUL CÎRJEI",NT,596,25,5,0,30,254,11,0,265
SABASA,NT,1723,102,13,0,115,684,60,0,744
"PÎRÎUL PÎNTEI",NT,429,21,6,12,39,144,12,12,168
SOCI,NT,726,56,8,0,64,377,15,0,392
BORLEŞTI,NT,2332,111,10,1,122,699,66,10,775
MASTACĂN,NT,1545,44,3,0,47,337,24,0,361
RUSENI,NT,3085,104,16,0,120,704,45,2,751
ŞOVOAIA,NT,423,12,7,0,19,83,16,0,99
NECHIT,NT,238,29,23,0,52,90,33,0,123
BOTEŞTI,NT,353,18,6,0,24,107,21,0,128
NISIPOREŞTI,NT,2039,34,7,0,41,250,30,0,280
BARTICEŞTI,NT,1752,52,6,0,58,398,23,0,421
BOZIENI,NT,926,13,0,0,13,270,0,0,270
CUCI,NT,683,10,3,0,13,158,15,0,173
IUCŞA,NT,632,4,0,0,4,101,11,0,112
BRUSTURI,NT,1556,75,14,20,109,490,57,20,567
GROŞI,NT,391,11,2,0,13,89,8,0,97
POIANA,NT,652,37,3,0,40,234,17,0,251
TÎRZIA,NT,620,14,7,0,21,146,18,0,164
BISTRICIOARA,NT,608,25,8,0,33,177,37,0,214
CEAHLĂU,NT,1430,116,25,45,186,481,93,47,621
CÎNDESTI,NT,1321,31,3,0,34,300,16,0,316
VĂDURELE,NT,1054,17,6,0,23,216,15,0,231
BĂRCĂNEŞTI,NT,704,31,7,0,38,250,11,0,261
PĂDURENI,NT,317,27,4,0,31,82,8,0,90
CORDUN,NT,2340,58,12,0,70,337,37,0,374
SIMIONEŞTI,NT,720,42,6,0,48,152,8,6,166
PILDEŞTI,NT,3484,48,6,0,54,430,22,1,453
COSTIŞA,NT,1430,129,15,0,144,468,43,30,541
MĂNOAIA,NT,771,43,8,0,51,281,25,16,322
FRUNZENI,NT,541,65,8,0,73,203,22,0,225
DORNEŞTI,NT,214,75,13,8,96,117,28,9,154
CRĂCĂOANI,NT,1817,68,21,0,89,395,75,0,470
MAGAZIA,NT,551,25,7,0,32,196,20,0,216
"CRACĂUL NEGRU",NT,884,28,4,0,32,260,11,0,271
"MITOCU BĂLAN",NT,260,21,6,0,27,102,14,0,116
HUISUREZ,NT,632,79,8,10,97,367,23,12,402
DĂMUC,NT,1798,237,27,22,286,988,79,22,1089
DOBRENI,NT,1482,68,16,0,84,446,112,5,563
BĂLUŞEŞTI,NT,105,11,6,0,17,42,22,0,64
DOCHIA,NT,1902,77,12,0,89,463,60,0,523
DOLJEŞTI,NT,1012,30,3,0,33,259,14,5,278
ROTUNDA,NT,1325,89,16,0,105,231,42,0,273
BUHONCA,NT,563,11,1,0,12,126,7,1,134
BURUIENEŞTI,NT,3082,38,7,0,45,475,20,0,495
VAD,NT,698,44,11,0,55,175,54,0,229
BORNIŞ,NT,101,6,10,0,16,31,22,0,53
MASTACĂN,NT,161,5,11,5,21,45,26,5,76
UNGHI,NT,94,5,5,0,10,22,11,0,33
HLĂPEŞTI,NT,676,15,1,0,16,99,23,4,126
DRĂGĂNEŞTI,NT,579,14,6,0,20,136,33,0,169
ORŢĂŞTI,NT,278,18,3,0,21,91,21,0,112
ŞOIMĂREŞTI,NT,379,20,4,0,24,119,31,0,150
CORHANA,NT,509,19,4,0,23,119,8,0,127
CÂRLIG,NT,473,15,2,0,17,94,17,0,111
ROŞIORI,NT,268,10,10,0,20,60,18,0,78
DULCEŞTI,NT,915,28,0,0,28,170,21,0,191
BRĂŞĂUŢI,NT,587,20,1,0,21,236,24,0,260
"DUMBRAVA ROŞIE",NT,3167,109,11,0,120,647,49,0,696
IZVOARE,NT,1025,18,4,0,22,257,32,0,289
CUT,NT,2172,66,9,0,75,490,50,0,540
FARCAŞA,NT,1145,65,9,7,81,383,40,7,430
FRUMOSU,NT,766,104,19,19,142,389,44,19,452
STEJARU,NT,637,105,9,2,116,349,20,2,371
BUDEŞTI,NT,865,13,5,0,18,132,25,0,157
FĂUREI,NT,623,15,4,0,19,199,42,0,241
CLIMEŞTI,NT,231,7,5,0,12,50,14,0,64
GÂDINŢI,NT,2055,55,3,5,63,360,30,5,395
GHERĂEŞTI,NT,4217,92,9,0,101,808,32,0,840
"GHERĂEŞTII NOI",NT,489,12,1,0,13,93,11,0,104
TEŢCANI,NT,741,22,7,0,29,141,17,0,158
GHINDĂOANI,NT,1652,88,4,1,93,599,52,3,654
GIROV,NT,1401,59,4,0,63,304,44,0,348
CĂCIULEŞTI,NT,578,21,6,0,27,141,40,0,181
"GURA VĂII",NT,630,18,4,0,22,122,14,0,136
TURTUREŞTI,NT,504,47,11,0,58,160,46,0,206
BOŢEŞTI,NT,423,11,3,0,14,76,22,0,98
DOINA,NT,237,9,5,0,14,63,23,0,86
DĂNEŞTI,NT,246,9,2,0,11,61,9,0,70
VERŞEŞTI,NT,261,19,13,0,32,83,39,0,122
GÎRCINA,NT,2303,38,9,0,47,386,40,0,426
ALMAŞ,NT,560,27,3,0,30,171,28,0,199
CUEJDIU,NT,1051,21,2,0,23,296,8,0,304
GRINŢIEŞ,NT,1380,63,6,0,69,468,46,24,538
BRADU,NT,673,38,2,0,40,223,15,11,249
TOPOLIŢA,NT,1369,31,6,0,37,396,30,0,426
CURECHIŞTEA,NT,599,56,35,0,91,210,52,0,262
GRUMĂZEŞTI,NT,2437,59,8,0,67,629,44,0,673
BUHALNIŢA,NT,700,73,7,5,85,239,39,5,283
HANGU,NT,1470,133,18,13,164,565,58,16,639
CHIRIŢENI,NT,407,22,5,5,32,131,21,5,157
GROZĂVEŞTI,NT,356,11,4,0,15,120,9,0,129
RUGINEŞTI,NT,301,11,1,6,18,75,19,6,100
HORIA,NT,3364,69,7,0,76,506,41,6,553
"COTU VAMEŞ",NT,2747,68,13,0,81,465,39,0,504
ICUŞEŞTI,NT,611,14,7,0,21,181,32,0,213
BĂLUŞEŞTI,NT,1972,45,7,0,52,479,24,0,503
ROCNA,NT,453,4,4,0,8,76,15,0,91
MESTEACĂN,NT,435,37,12,0,49,75,19,0,94
SPIRIDONEŞTI,NT,190,5,7,0,12,50,12,0,62
IZVORU,NT,376,11,4,0,15,129,15,2,146
RECEA,NT,663,42,9,0,51,142,17,0,159
STEJARU,NT,667,27,4,0,31,163,22,0,185
"ION CREANGĂ",NT,2151,36,5,0,41,424,43,6,473
AVEREŞTI,NT,781,18,4,0,22,255,50,2,307
MĂRGINENI,NT,1817,59,5,0,64,410,41,7,458
HÎRŢEŞTI,NT,184,10,9,0,19,79,20,0,99
HOISEŞTI,NT,790,21,4,0,25,163,20,0,183
ITRINEŞTI,NT,232,15,2,1,18,106,21,0,127
MOLDOVENI,NT,1039,24,8,0,32,155,40,0,195
HOCIUNGI,NT,716,15,4,0,19,187,49,6,242
NEGREŞTI,NT,1207,44,5,0,49,283,50,0,333
POIANA,NT,322,19,3,0,22,91,23,0,114
ONICENI,NT,646,13,5,0,18,160,31,0,191
GORUN,NT,226,24,5,0,29,113,9,0,122
MĂRMURENI,NT,351,16,4,0,20,78,12,0,90
SOLCA,NT,984,31,0,0,31,317,15,0,332
"VALEA ENEI",NT,297,12,6,0,18,100,10,0,110
PĂSTRĂVENI,NT,1446,51,14,0,65,351,28,0,379
RĂDENI,NT,1364,75,14,0,89,329,63,0,392
"LUNCA MOLDOVEI",NT,252,20,4,0,24,131,7,0,138
PÂNCEŞTI,NT,978,14,3,0,17,219,27,8,254
CIUREA,NT,201,8,4,0,12,64,11,0,75
PETRICANI,NT,1443,29,8,0,37,325,32,0,357
BOIŞTEA,NT,749,48,5,0,53,413,20,0,433
TÎRPEŞTI,NT,1140,30,6,0,36,322,25,0,347
ŢOLICI,NT,1351,118,6,0,124,507,26,0,533
LUMINIŞ,NT,2158,77,11,11,99,620,42,12,674
POIENI,NT,1095,14,1,0,15,256,9,0,265
NEGULEŞTI,NT,571,19,3,0,22,190,8,0,198
"PIATRA ŞOIMULUI",NT,3076,68,6,0,74,603,33,0,636
DOLHEŞTI,NT,2337,61,14,1,76,724,30,1,755
PIPIRIG,NT,895,66,8,0,74,396,24,3,423
BOBOIEŞTI,NT,1306,29,5,0,34,431,12,9,452
LEGHIN,NT,525,29,5,5,39,169,13,5,187
STÎNCA,NT,1253,58,16,0,74,410,35,1,446
PLUTON,NT,841,12,5,0,17,264,9,0,273
PÎNGĂRĂCIOR,NT,1726,40,10,0,50,280,46,0,326
PÎNGARAŢI,NT,617,47,29,0,76,172,51,2,225
STEJARU,NT,881,51,8,0,59,173,25,0,198
OANŢU,NT,1287,21,1,0,22,255,11,0,266
PODOLENI,NT,4362,198,31,0,229,1316,121,31,1468
NEGRITEŞTI,NT,295,18,3,0,21,129,11,0,140
DREPTU,NT,960,46,5,9,60,372,32,9,413
"POIANA LARGULUI",NT,765,100,52,0,152,391,126,10,527
"PETRU VODĂ",NT,1084,249,54,37,340,615,82,38,735
"POIANA TEIULUI",NT,1321,91,18,0,109,386,48,2,436
POIENARI,NT,970,26,10,0,36,199,59,3,261
SĂCĂLENI,NT,279,6,2,0,8,45,19,0,64
OGLINZI,NT,3296,88,27,0,115,845,157,0,1002
UNGHENI,NT,427,20,8,0,28,163,15,0,178
RĂUCEŞTI,NT,2587,106,26,0,132,927,136,0,1063
SĂVEŞTI,NT,366,12,9,0,21,93,25,0,118
BORŞENI,NT,295,20,5,0,25,95,22,0,117
"VALEA ALBĂ",NT,341,13,5,0,18,104,15,0,119
"RĂZBOIENII DE JOS",NT,627,22,23,0,45,260,68,0,328
RĂZBOIENI,NT,495,50,12,0,62,171,35,0,206
BEŢEŞTI,NT,635,16,3,0,19,179,15,0,194
REDIU,NT,1914,24,1,0,25,290,33,3,326
POLOBOC,NT,1217,45,5,0,50,379,29,0,408
SOCEA,NT,637,9,2,0,11,203,11,0,214
ROMÂNI,NT,781,43,1,0,44,276,21,2,299
SILIŞTEA,NT,1883,71,10,0,81,534,43,1,578
GOŞMANI,NT,811,24,6,0,30,228,21,0,249
"BOZIENII DE SUS",NT,304,7,1,0,8,42,25,19,86
RUGINOASA,NT,1304,30,5,0,35,252,37,28,317
SAGNA,NT,3191,132,12,0,144,814,50,0,864
LUŢCA,NT,394,35,8,0,43,144,26,0,170
VULPĂŞEŞTI,NT,685,13,3,0,16,113,29,9,151
TRAIAN,NT,1017,39,27,0,66,220,35,0,255
SĂBĂOANI,NT,8574,198,19,0,217,1231,59,1,1291
SĂVINEŞTI,NT,5579,244,31,7,282,1194,95,24,1313
"DUMBRAVA DEAL",NT,352,20,3,0,23,133,15,3,151
SECUIENI,NT,975,16,5,5,26,151,22,5,178
BAŞTA,NT,537,38,17,0,55,127,33,0,160
BUTNĂREŞTI,NT,940,26,5,7,38,200,21,7,228
GIULEŞTI,NT,214,2,1,0,3,27,16,0,43
STĂNIŢA,NT,398,12,4,0,16,65,23,1,89
CHICEREA,NT,213,48,12,3,63,58,20,3,81
GHIDION,NT,310,11,6,0,17,79,19,0,98
"POIENILE OANCEI",NT,190,2,0,0,2,46,13,0,59
TODIRENI,NT,244,25,5,0,30,77,14,0,91
VEJA,NT,246,7,1,0,8,51,13,0,64
SOCI,NT,271,15,10,0,25,95,32,0,127
GHIGOIEŞTI,NT,474,13,9,0,22,107,35,0,142
CÎRLIGI,NT,426,43,13,0,56,180,39,0,219
"ŞTEFAN CEL MARE",NT,1420,79,6,0,85,296,61,0,357
TARCĂU,NT,1650,60,14,0,74,382,52,0,434
STRAJA,NT,534,17,12,0,29,146,29,0,175
CAZACI,NT,426,16,6,0,22,135,16,0,151
BRATEŞ,NT,276,36,17,5,58,117,40,5,162
TAŞCA,NT,1407,80,4,0,84,578,34,2,614
NEAGRA,NT,793,52,11,1,64,373,46,4,423
TAZLĂU,NT,2293,57,5,1,63,318,30,1,349
ADJUDENI,NT,4118,64,17,0,81,621,59,0,680
TĂMĂŞENI,NT,3722,58,6,0,64,611,32,0,643
TIMIŞEŞTI,NT,1043,68,9,0,77,394,41,0,435
DUMBRAVA,NT,1003,33,11,0,44,212,39,0,251
PLĂIEŞU,NT,638,38,2,0,40,203,13,0,216
PREUTEŞTI,NT,443,48,12,0,60,179,21,0,200
ZVORĂNEŞTI,NT,142,12,6,0,18,63,13,0,76
TRIFEŞTI,NT,2609,37,8,0,45,358,65,1,424
"MIRON COSTIN",NT,1542,26,7,0,33,200,24,0,224
TUPILAŢI,NT,1483,61,13,0,74,487,90,0,577
TOTOIEŞTI,NT,291,8,14,0,22,60,32,0,92
"ŢIBUCANII DE JOS",NT,330,12,4,0,16,92,24,0,116
DAVIDENI,NT,793,25,11,0,36,147,49,0,196
ŢIBUCANI,NT,2173,35,8,0,43,381,48,0,429
URECHENI,NT,2541,93,16,1,110,697,97,1,795
INGĂREŞTI,NT,732,8,6,0,14,172,12,0,184
"VALEA URSULUI",NT,741,16,4,0,20,148,16,0,164
BUCIUM,NT,567,11,3,0,14,89,12,0,101
CHILII,NT,922,22,2,0,24,208,19,0,227
GIURGENI,NT,506,10,3,0,13,120,18,0,138
"MUNCELU DE JOS",NT,314,14,0,1,15,78,10,2,90
MORENI,NT,569,28,4,0,32,137,28,0,165
VĂLENI,NT,571,9,3,0,12,75,22,0,97
VÎNĂTORI-NEAMŢ,NT,4427,265,371,13,649,1347,720,15,2082
LUNCA,NT,1018,41,6,1,48,264,18,1,283
NEMŢIŞOR,NT,1327,50,4,13,67,403,25,13,441
"MĂNĂSTIREA NEAMŢ",NT,216,70,44,0,114,105,64,0,169
TRAIAN,NT,886,37,10,0,47,260,30,0,290
ZĂNEŞTI,NT,4180,185,22,1,208,1258,102,1,1361
SLATINA,OT,69874,4583,384,92,5059,12182,864,126,13172
CARACAL,OT,28546,1836,141,30,2007,5986,381,134,6501
BALŞ,OT,17378,771,119,0,890,2337,267,0,2604
CORABIA,OT,13872,982,76,37,1095,2849,186,42,3077
VÎRTOPU,OT,348,9,5,0,14,31,15,0,46
"TUDOR VLADIMIRESCU",OT,503,41,3,0,44,82,4,1,87
DRĂGĂNEŞTI-OLT,OT,7101,399,58,0,457,1263,136,0,1399
COMANI,OT,2479,181,14,0,195,537,48,0,585
PIATRA-OLT,OT,1894,153,20,0,173,487,45,5,537
"BISTRIŢA NOUĂ",OT,435,37,16,0,53,139,43,0,182
"CRIVA DE SUS",OT,961,56,6,0,62,226,61,3,290
ENOŞEŞTI,OT,267,28,3,0,31,87,14,0,101
PIATRA,OT,1678,90,21,0,111,447,67,3,517
POTCOAVA,OT,3198,142,24,0,166,830,93,0,923
SINEŞTI,OT,1591,48,6,0,54,409,42,0,451
SCORNICEŞTI,OT,3739,126,33,23,182,444,79,23,546
"MĂRGINENI SLOBOZIA",OT,1586,25,12,0,37,268,55,0,323
NEGRENI,OT,999,33,9,0,42,244,30,0,274
BIRCII,OT,886,47,3,0,50,171,21,0,192
MOGOŞEŞTI,OT,443,17,17,0,34,70,31,0,101
CONSTANTINEŞTI,OT,449,15,6,0,21,113,25,0,138
TEIUŞ,OT,464,27,3,0,30,66,10,0,76
ŞUICA,OT,196,16,4,0,20,39,7,0,46
JITARU,OT,833,20,8,0,28,131,26,0,157
CHIŢEASCA,OT,383,5,7,0,12,63,13,0,76
BALDOVINEŞTI,OT,505,23,43,0,66,152,92,12,256
PIETRIŞ,OT,282,19,25,0,44,124,48,3,175
GUBANDRU,OT,98,27,39,3,69,64,41,3,108
BĂBICIU,OT,1735,199,31,67,297,796,144,85,1025
BĂLTENI,OT,1366,85,11,0,96,356,42,0,398
"BĂRĂŞTII DE VEDE",OT,682,48,23,9,80,291,133,9,433
"BĂRĂŞTII DE CEPTURI",OT,417,40,17,4,61,154,52,4,210
MOŢOEŞTI,OT,59,5,9,0,14,36,25,0,61
BÎRZA,OT,910,89,3,0,92,243,22,0,265
BRANEŢ,OT,1271,71,5,0,76,245,15,0,260
BOBICEŞTI,OT,849,48,8,0,56,244,34,0,278
BECHET,OT,303,21,2,0,23,151,21,0,172
CHINTEŞTI,OT,213,14,8,0,22,59,10,0,69
LEOTEŞTI,OT,1269,52,4,0,56,255,36,0,291
BRASTAVĂŢU,OT,2731,120,13,53,186,597,71,112,780
CRUŞOVU,OT,902,50,10,31,91,228,31,31,290
BREBENI,OT,2218,57,22,0,79,317,76,0,393
BRÎNCOVENI,OT,872,87,5,0,92,321,53,0,374
OCIOGI,OT,913,51,6,0,57,254,48,0,302
VĂLENI,OT,407,36,11,0,47,140,23,0,163
BUCINIŞU,OT,1639,98,6,0,104,453,48,0,501
CĂLUI,OT,753,64,13,0,77,275,66,17,358
"GURA CĂLUIU",OT,494,52,7,0,59,225,26,2,253
CEZIENI,OT,983,65,14,0,79,272,52,0,324
BONDREA,OT,188,29,9,0,38,61,17,0,78
CORLĂTEŞTI,OT,275,35,10,0,45,91,19,0,110
CILIENI,OT,2682,113,16,0,129,756,71,17,844
CÎRLOGANI,OT,1182,30,11,0,41,204,41,0,245
CEPARI,OT,744,34,15,0,49,228,36,0,264
COLONEŞTI,OT,595,117,21,17,155,500,83,17,600
BĂTĂRENI,OT,158,51,41,12,104,97,65,12,174
MĂRUNŢEI,OT,351,59,12,16,87,154,54,18,226
VLAICI,OT,281,133,77,0,210,168,124,14,306
CORBU,OT,851,100,12,25,137,318,60,27,405
BUZEŞTI,OT,520,51,13,12,76,290,63,12,365
MILCOVENI,OT,360,43,8,9,60,134,18,9,161
COTEANA,OT,1870,111,20,5,136,493,96,9,598
CRÎMPOIA,OT,2296,145,18,0,163,631,68,0,699
BUTA,OT,635,11,0,0,11,104,19,0,123
CUNGREA,OT,707,9,1,0,10,40,13,0,53
CEPEŞTI,OT,660,14,4,0,18,49,18,0,67
SPĂTARU,OT,238,2,5,0,7,25,17,0,42
CURTIŞOARA,OT,1317,22,15,0,37,194,42,0,236
DOBROTINET,OT,1339,49,14,0,63,353,63,0,416
PROASPEŢI,OT,968,38,6,0,44,190,20,0,210
DĂNEASA,OT,1173,131,26,0,157,383,72,0,455
BERINDEI,OT,442,77,19,0,96,162,45,0,207
CIOFLANU,OT,513,30,7,0,37,134,28,0,162
PESTRA,OT,437,16,12,0,28,82,23,0,105
ZĂNOAGA,OT,349,35,6,0,41,109,16,0,125
DEVESELU,OT,1605,124,23,0,147,549,74,75,698
COMANCA,OT,1031,80,5,39,124,550,41,39,630
CURTIŞOARA,OT,620,20,11,0,31,208,64,0,272
HOREZU,OT,400,29,17,0,46,211,46,0,257
DOBROSLOVENI,OT,1112,38,1,0,39,181,18,0,199
FRĂSINETU,OT,335,28,5,0,33,142,33,0,175
POTOPINU,OT,549,18,0,0,18,67,10,0,77
REŞCA,OT,1004,38,7,0,45,221,21,0,242
DOBROTEASA,OT,1301,25,7,0,32,297,98,0,395
DOBRUN,OT,598,126,8,0,134,267,33,7,307
"ROŞIENII MARI",OT,618,108,9,0,117,287,32,16,335
DRĂGHICENI,OT,1519,36,7,0,43,277,23,0,300
FĂGEŢELU,OT,444,13,19,0,32,84,60,0,144
CHILIA,OT,254,17,11,0,28,109,55,0,164
FĂLCOIU,OT,2030,97,7,0,104,451,60,22,533
FĂRCAŞELE,OT,967,32,7,0,39,128,24,3,155
"FĂRCAŞU DE JOS",OT,1456,55,6,0,61,270,26,6,302
GHIMPAŢI,OT,718,41,5,0,46,179,16,3,198
HOTĂRANI,OT,742,58,5,0,63,227,20,14,261
GĂNEASA,OT,1500,42,11,0,53,396,102,0,498
DRANOVĂŢU,OT,905,29,11,0,40,295,80,0,375
IZVORU,OT,571,31,10,0,41,225,72,0,297
GĂVĂNEŞTI,OT,611,114,21,0,135,270,63,10,343
BĂLEASA,OT,682,44,18,0,62,307,53,7,367
BROŞTENI,OT,316,58,16,0,74,152,35,3,190
"GHIMPEŢENII NOI",OT,401,11,3,0,14,176,10,6,192
GHIMPEŢENI,OT,826,26,6,0,32,370,41,21,432
GIUVĂRĂŞTI,OT,1891,69,8,0,77,479,36,0,515
GÎRCOV,OT,1249,45,5,17,67,438,22,26,486
URSA,OT,718,36,3,6,45,138,13,6,157
GOSTAVĂŢU,OT,1298,50,8,0,58,207,33,0,240
SLĂVENI,OT,1117,74,14,0,88,304,35,0,339
GRĂDINARI,OT,811,35,9,0,44,164,32,0,196
PETCULEŞTI,OT,851,111,4,0,115,285,36,0,321
"SATU NOU",OT,229,18,9,0,27,88,51,0,139
GRĂDINILE,OT,1227,104,6,0,110,430,17,16,463
GROJDIBODU,OT,1763,51,7,0,58,338,29,2,369
HOTARU,OT,601,27,6,0,33,136,17,1,154
"GURA PADINII",OT,1459,338,17,53,408,783,58,53,894
IANCA,OT,2147,144,12,5,161,915,43,26,984
POTELU,OT,1014,142,25,0,167,473,71,21,565
"IANCU JIANU",OT,2766,76,6,0,82,299,38,0,337
DOBRICENI,OT,796,28,4,0,32,126,17,0,143
ICOANA,OT,550,67,26,0,93,251,86,4,341
FLORU,OT,374,35,15,0,50,192,51,4,247
URSOAIA,OT,558,69,20,0,89,209,55,14,278
IPOTEŞTI,OT,1207,45,9,0,54,186,44,0,230
IZBICENI,OT,3866,49,5,0,54,501,53,0,554
IZVOARELE,OT,940,12,2,0,14,97,14,0,111
ALIMĂNEŞTI,OT,1894,20,1,0,21,250,25,0,275
LELEASCA,OT,456,29,9,0,38,108,33,0,141
TONEŞTI,OT,295,8,8,0,16,35,26,0,61
URŞI,OT,398,12,4,0,16,100,39,0,139
MĂRUNŢEI,OT,2017,65,13,0,78,204,40,0,244
BĂLĂNEŞTI,OT,1150,25,6,0,31,163,27,0,190
"MALU ROŞU",OT,115,7,5,0,12,21,17,0,38
MIHĂEŞTI,OT,688,35,26,0,61,210,47,0,257
BUŞCA,OT,551,35,10,0,45,176,36,0,212
"MILCOVU DIN VALE",OT,199,47,14,0,61,106,40,0,146
ULMI,OT,552,45,12,0,57,161,45,0,206
"MILCOVU DIN DEAL",OT,492,18,11,0,29,79,34,0,113
MORUNGLAV,OT,1217,32,9,0,41,152,23,0,175
BĂRĂŞTI,OT,287,15,3,0,18,38,8,0,46
MORUNEŞTI,OT,501,26,4,0,30,100,17,0,117
MOVILENI,OT,1756,533,26,14,573,918,67,14,999
BACEA,OT,1078,192,18,0,210,635,53,16,704
"NICOLAE TITULESCU",OT,996,90,15,39,144,364,56,52,472
OBÎRŞIA,OT,565,37,5,11,53,226,24,11,261
"CÎMPU PĂRULUI",OT,258,46,12,0,58,112,27,8,147
TABONU,OT,116,20,4,0,24,76,14,0,90
COTENI,OT,177,23,1,0,24,74,17,3,94
"OBÎRŞIA NOUĂ",OT,977,25,11,10,46,174,32,10,216
OBOGA,OT,1381,212,34,4,250,601,117,4,722
OPORELU,OT,877,36,11,0,47,206,58,0,264
OPTAŞI,OT,1019,98,31,0,129,493,124,31,648
ORLEA,OT,1889,77,5,0,82,524,36,0,560
"OSICA DE JOS",OT,1274,146,47,0,193,476,108,11,595
VLĂDULENI,OT,494,18,3,0,21,97,26,0,123
"OSICA DE SUS",OT,2296,93,13,0,106,452,66,0,518
GRECI,OT,826,34,10,0,44,148,32,0,180
TOMENI,OT,376,32,3,0,35,84,8,0,92
OLARI,OT,1104,31,6,0,37,159,17,0,176
PÎRŞCOVENI,OT,1346,53,12,0,65,247,43,0,290
"MIERLEŞTII DE SUS",OT,1683,30,5,0,35,279,65,0,344
PLEŞOIU,OT,1314,40,8,1,49,404,71,1,476
DOBA,OT,1145,28,8,0,36,256,60,0,316
POBORU,OT,608,57,20,0,77,239,64,0,303
CORNĂŢELU,OT,775,35,6,0,41,265,47,0,312
SEACA,OT,221,26,2,0,28,84,7,0,91
PRISEACA,OT,1393,28,6,0,34,264,64,0,328
RADOMIREŞTI,OT,1074,135,31,0,166,316,82,0,398
CRĂCIUNEI,OT,568,47,8,0,55,122,19,0,141
CĂLINEŞTI,OT,665,49,7,0,56,175,45,0,220
POIANA,OT,248,41,9,0,50,92,20,0,112
REDEA,OT,1725,71,12,31,114,281,67,41,389
REDIŞOARA,OT,406,65,11,0,76,173,24,0,197
"VALEA SOARELUI",OT,218,21,1,0,22,87,9,0,96
ROTUNDA,OT,2269,65,5,0,70,388,41,1,430
RUSĂNEŞTI,OT,2608,157,20,0,177,616,79,0,695
JIENI,OT,971,38,6,0,44,164,26,0,190
VITĂNEŞTI,OT,1562,132,23,0,155,983,148,31,1162
SCĂRIŞOARA,OT,1843,73,6,0,79,337,31,0,368
PLĂVICENI,OT,589,21,6,0,27,117,20,0,137
SCHITU,OT,1116,65,11,0,76,329,47,0,376
GRECI,OT,733,42,9,0,51,193,35,62,290
LISA,OT,312,14,6,0,20,81,18,0,99
SEACA,OT,1474,80,15,0,95,275,35,0,310
SÎMBUREŞTI,OT,858,38,29,0,67,387,162,28,577
SLĂTIOARA,OT,2179,153,28,0,181,619,131,19,769
ALUNIŞU,OT,373,29,20,0,49,114,76,0,190
PROFA,OT,447,13,6,0,19,65,30,0,95
SPINENI,OT,546,54,19,0,73,142,57,0,199
SPRÎNCENATA,OT,1122,19,6,0,25,111,33,0,144
"BÎRSEŞTII DE SUS",OT,339,31,7,0,38,78,38,0,116
FRUNZARU,OT,526,19,13,0,32,69,20,0,89
STOENEŞTI,OT,1876,89,17,0,106,405,57,0,462
STOICĂNEŞTI,OT,2208,77,3,0,80,488,57,0,545
STREJEŞTI,OT,840,42,4,0,46,186,29,0,215
COLIBAŞI,OT,398,18,8,0,26,62,22,0,84
"STREJEŞTII DE SUS",OT,1314,61,7,0,68,324,34,0,358
STUDINA,OT,1303,28,8,0,36,242,33,0,275
STUDINIŢA,OT,964,36,8,0,44,117,18,0,135
ŞERBĂNEŞTI,OT,1722,103,29,0,132,589,80,20,689
"ŞERBĂNEŞTII DE SUS",OT,630,34,8,0,42,160,23,4,187
ŞOPÂRLIŢA,OT,1003,62,17,0,79,322,47,0,369
"ŞTEFAN CEL MARE",OT,971,138,18,0,156,321,48,23,392
"IANCA NOUĂ",OT,497,28,5,0,33,117,21,4,142
TĂTULEŞTI,OT,430,68,44,0,112,164,112,6,282
BĂRBĂLĂI,OT,180,47,34,0,81,91,69,4,164
MIRCEŞTI,OT,136,33,40,0,73,66,57,6,129
"CHERLEŞTII DIN DEAL",OT,1328,69,17,0,86,350,97,0,447
COMĂNIŢA,OT,775,39,10,0,49,188,50,0,238
POTLOGENI,OT,1279,35,1,0,36,358,6,0,364
"TIA MARE",OT,1268,55,7,0,62,396,31,0,427
DOANCA,OT,1048,27,5,0,32,277,30,0,307
TOPANA,OT,287,21,10,0,31,95,54,0,149
CÎNDELEŞTI,OT,77,5,3,0,8,33,19,0,52
COJGĂREI,OT,128,15,9,0,24,54,43,0,97
UNGURENI,OT,99,5,5,0,10,20,25,0,45
TRAIAN,OT,2512,126,6,0,132,560,25,19,604
TUFENI,OT,1247,31,11,0,42,191,57,1,249
STOBORĂŞTI,OT,962,24,5,0,29,105,18,0,123
URZICA,OT,1185,28,2,0,30,247,33,0,280
STĂVARU,OT,615,31,4,0,35,165,29,0,194
"VALEA MARE",OT,1287,28,7,0,35,199,46,0,245
RECEA,OT,557,30,7,0,37,184,28,0,212
BÎRCA,OT,649,68,16,0,84,257,113,0,370
TURIA,OT,506,55,10,0,65,182,55,0,237
VĂDASTRA,OT,1172,173,22,0,195,512,70,23,605
VĂDĂSTRIŢA,OT,2698,108,124,0,232,557,188,0,745
VĂLENI,OT,1684,64,13,0,77,344,80,3,427
MANDRA,OT,518,57,5,0,62,180,25,0,205
POGANU,OT,875,27,14,0,41,224,77,0,301
CĂZĂNEŞTI,OT,730,15,6,0,21,160,53,0,213
DUMITREŞTI,OT,623,15,8,0,23,136,55,0,191
VIŞINA,OT,2417,153,21,37,211,790,63,62,915
"VIŞINA NOUĂ",OT,1446,45,8,0,53,248,35,0,283
VITOMIREŞTI,OT,417,12,15,2,29,97,27,2,126
BULIMANU,OT,174,8,8,0,16,54,27,0,81
DEJEŞTI,OT,584,35,3,0,38,120,24,0,144
DONEŞTI,OT,184,3,0,3,6,34,12,4,50
TREPTENI,OT,281,12,39,0,51,40,52,1,93
VÎLCELE,OT,1324,70,30,10,110,464,133,10,607
BĂRCĂNEŞTI,OT,620,38,13,0,51,175,35,0,210
VLĂDILA,OT,1681,99,7,0,106,346,40,0,386
VOINEASA,OT,707,94,12,0,106,273,34,0,307
MĂRGĂRITEŞTI,OT,590,129,17,0,146,297,53,4,354
RACOVIŢA,OT,438,69,25,0,94,185,43,0,228
GROPŞANI,OT,663,66,7,0,73,395,28,0,423
PRISACA,OT,314,42,6,0,48,127,19,0,146
"VALEA SATULUI",OT,807,39,18,0,57,311,73,0,384
VULTUREŞTI,OT,600,21,6,0,27,87,17,5,109
"VALEA LUI ALB",OT,483,14,6,0,20,91,22,3,116
DIENCI,OT,778,21,11,0,32,168,62,6,236
PLOIEŞTI,PH,192355,12394,744,273,13411,31447,1745,496,33688
CÂMPINA,PH,31521,1940,228,51,2219,5059,529,155,5743
AZUGA,PH,4013,174,64,28,266,543,116,28,687
BĂICOI,PH,15941,839,87,37,963,2722,239,37,2998
BOLDEŞTI-SCĂENI,PH,8579,390,46,1,437,1473,145,1,1619
SECIU,PH,813,43,3,0,46,112,7,0,119
"PODU VADULUI",PH,1395,116,31,0,147,343,61,0,404
"BREAZA DE JOS",PH,2005,95,31,0,126,233,59,0,292
"BREAZA DE SUS",PH,7272,342,125,27,494,937,292,27,1256
"GURA BELIEI",PH,1104,33,12,0,45,108,28,0,136
NISTOREŞTI,PH,1104,24,9,0,33,114,29,0,143
"VALEA TÎRSEI",PH,1225,27,5,0,32,75,16,0,91
BUŞTENI,PH,8322,483,328,0,811,1408,627,0,2035
COMARNIC,PH,4851,114,19,0,133,478,53,0,531
POIANA,PH,2360,32,10,0,42,227,27,0,254
"PODU LUNG",PH,500,9,4,0,13,89,17,0,106
GHIOŞEŞTI,PH,1595,44,10,0,54,207,26,0,233
POSADA,PH,1171,41,10,0,51,118,23,1,142
MIZIL,PH,12590,650,71,15,736,2066,156,15,2237
PLOPENI,PH,7664,437,20,0,457,1195,50,1,1246
SINAIA,PH,9884,706,385,0,1091,1729,842,0,2571
PRĂJANI,PH,1035,62,11,0,73,188,30,0,218
SLĂNIC,PH,2440,103,73,0,176,348,185,0,533
GROŞANI,PH,1401,39,5,0,44,139,20,0,159
URLAŢI,PH,9390,368,41,0,409,1324,127,5,1456
"VĂLENII DE MUNTE",PH,11141,770,135,0,905,2214,307,23,2544
ADUNAŢI,PH,1695,52,5,0,57,238,32,0,270
ALBEŞTI-PALEOLOGU,PH,1455,34,5,0,39,182,20,0,202
"VADU PĂRULUI",PH,1556,26,4,0,30,174,21,0,195
ALBEŞTI-MURU,PH,897,31,5,0,36,153,17,0,170
CIOCENI,PH,706,12,3,0,15,122,13,0,135
ALUNIŞ,PH,1932,73,23,0,96,447,70,0,517
OSTROVU,PH,799,25,6,0,31,165,22,0,187
APOSTOLACHE,PH,1664,40,9,0,49,252,45,0,297
"ARICEŞTII RAHTIVANI",PH,2253,77,10,0,87,287,38,0,325
NEDELEA,PH,1958,41,8,0,49,219,24,0,243
STOENEŞTI,PH,1150,49,6,0,55,159,17,138,314
"TÎRGŞORU NOU",PH,904,28,10,0,38,118,34,178,330
BUDA,PH,421,29,10,0,39,95,27,0,122
"ARICEŞTII ZELETIN",PH,955,33,8,0,41,191,31,0,222
"BABA ANA",PH,1555,32,4,0,36,187,24,0,211
CONDURATU,PH,987,46,12,0,58,158,27,0,185
CIREŞANU,PH,670,42,9,0,51,146,21,0,167
"SATU NOU",PH,94,5,0,0,5,14,6,0,20
"BALTA DOAMNEI",PH,1183,50,11,1,62,277,38,1,316
BÎRA,PH,768,16,4,0,20,95,19,1,115
BĂLŢEŞTI,PH,1517,54,3,0,57,222,16,0,238
"PODENII VECHI",PH,1414,36,5,0,41,191,21,0,212
BĂNEŞTI,PH,2755,121,20,24,165,422,67,24,513
URLETA,PH,2068,114,13,17,144,338,34,31,403
BĂRCĂNEŞTI,PH,2720,78,9,0,87,269,13,0,282
GHIGHIU,PH,613,47,9,0,56,128,20,0,148
PUŞCAŞI,PH,338,18,1,0,19,43,8,0,51
ROMÂNEŞTI,PH,1590,43,3,0,46,171,21,0,192
TĂTĂRANI,PH,2549,72,13,0,85,339,44,0,383
BĂTRÂNI,PH,1681,68,7,0,75,383,25,0,408
BERCENI,PH,2066,92,17,0,109,354,48,0,402
CORLĂTEŞTI,PH,1194,60,6,0,66,194,15,0,209
"CARTIERUL DÎMBU",PH,389,21,9,0,30,76,16,0,92
CĂTUNU,PH,536,29,6,0,35,119,9,0,128
"MOARA NOUĂ",PH,855,33,8,37,78,152,30,37,219
BERTEA,PH,2550,63,13,0,76,370,40,0,410
BLEJOI,PH,3179,131,9,0,140,522,37,3,562
PLOIEŞTIORI,PH,2851,123,11,0,134,431,40,0,471
ŢÎNŢĂRENI,PH,1402,37,5,0,42,201,24,0,225
BOLDEŞTI,PH,670,41,1,0,42,114,15,0,129
GRADIŞTEA,PH,723,14,4,0,18,78,13,0,91
BĂTEŞTI,PH,1442,94,13,9,116,299,25,9,333
"BRAZII DE JOS",PH,626,26,8,0,34,128,23,4,155
"BRAZII DE SUS",PH,1360,91,6,2,99,330,28,2,360
POPEŞTI,PH,1458,99,6,0,105,300,26,3,329
NEGOIEŞTI,PH,1552,78,11,0,89,267,23,0,290
STEJARU,PH,499,38,4,0,42,131,9,0,140
"BREBU MÎNĂSTIREI",PH,2376,68,40,0,108,251,99,0,350
"BREBU MEGIEŞESC",PH,2539,75,13,0,88,297,63,0,360
PIETRICEAUA,PH,947,22,8,0,30,125,16,0,141
"PODU CHEII",PH,147,7,3,0,10,47,11,0,58
BUCOV,PH,4313,128,21,10,159,497,45,11,553
CHIŢORANI,PH,1322,49,8,0,57,186,16,0,202
PLEAŞA,PH,3642,150,9,0,159,545,41,0,586
CĂLUGĂRENI,PH,953,54,5,1,60,157,25,1,183
CĂRBUNEŞTI,PH,1408,29,11,0,40,198,34,0,232
"CEPTURA DE JOS",PH,1846,74,17,0,91,262,57,2,321
"CEPTURA DE SUS",PH,498,27,5,0,32,99,19,0,118
ŞOIMEŞTI,PH,632,22,4,0,26,98,14,0,112
ROTARI,PH,636,19,1,0,20,126,18,0,144
"MALU ROŞU",PH,135,11,1,0,12,30,13,0,43
CERAŞU,PH,1262,23,4,1,28,221,33,1,255
"VALEA BORULUI",PH,696,14,3,0,17,89,17,0,106
SLON,PH,1719,69,5,0,74,536,23,0,559
CHIOJDEANCA,PH,784,27,2,0,29,152,24,1,177
TRENU,PH,466,7,3,0,10,106,12,0,118
"CIORANII DE JOS",PH,3471,113,20,0,133,726,85,0,811
"CIORANII DE SUS",PH,1857,49,10,0,59,406,39,0,445
"COCORĂŞTII COLŢ",PH,1410,41,4,0,45,216,24,0,240
"COCORĂŞTII GRIND",PH,959,42,8,0,50,212,17,0,229
"COCORĂŞTII MISLII",PH,1575,71,6,0,77,239,17,0,256
GORUNA,PH,1253,50,5,0,55,224,19,0,243
COLCEAG,PH,1108,52,8,0,60,169,30,0,199
VÎLCELELE,PH,422,15,1,0,16,61,9,0,70
INOTEŞTI,PH,1467,45,4,0,49,186,23,0,209
PAREPA-RUŞANI,PH,790,32,11,0,43,98,22,0,120
"CORNU DE JOS",PH,2833,199,105,0,304,651,192,2,845
"CORNU DE SUS",PH,864,31,11,0,42,197,33,0,230
"COSMINA DE JOS",PH,850,23,10,0,33,90,32,0,122
"DRAJNA DE JOS",PH,2145,98,33,31,162,441,92,31,564
"DRAJNA DE SUS",PH,1240,28,18,0,46,146,60,0,206
OGRETIN,PH,1066,17,9,0,26,82,19,0,101
DRĂGĂNEŞTI,PH,1015,33,9,1,43,130,22,1,153
BĂRĂITARU,PH,688,21,6,0,27,77,19,0,96
BELCIUG,PH,438,23,7,0,30,86,18,0,104
"CORNU DE JOS",PH,494,15,4,0,19,71,12,0,83
MERI,PH,839,28,2,0,30,94,10,0,104
HĂTCĂRĂU,PH,363,22,5,0,27,53,10,0,63
DUMBRAVA,PH,1329,96,14,0,110,341,29,0,370
ZĂNOAGA,PH,808,58,11,0,69,321,24,0,345
CIUPELNIŢA,PH,1370,92,8,0,100,393,27,0,420
DUMBRĂVEŞTI,PH,1184,46,1,0,47,180,17,0,197
PLOPENI,PH,1317,53,1,0,54,223,9,0,232
SFÎRLEANCA,PH,507,26,2,0,28,70,10,0,80
FÂNTÂNELE,PH,1628,81,14,0,95,320,64,0,384
"FILIPEŞTII DE PĂDURE",PH,4137,174,14,0,188,609,63,0,672
DIŢEŞTI,PH,3136,153,17,0,170,497,40,0,537
MINIERI,PH,1113,78,6,0,84,289,16,0,305
"FILIPEŞTII DE TÎRG",PH,2214,65,10,0,75,319,34,0,353
BRĂTĂŞANCA,PH,1658,47,8,0,55,337,30,0,367
"MĂRGINENII DE JOS",PH,2740,45,12,0,57,193,33,0,226
FLOREŞTI,PH,4294,263,18,0,281,880,73,0,953
CĂTINA,PH,1962,49,10,0,59,219,35,0,254
"FULGA DE JOS",PH,1203,60,5,0,65,279,35,0,314
"FULGA DE SUS",PH,1410,14,3,0,17,163,33,0,196
GHERGHIŢA,PH,990,33,5,0,38,199,33,1,233
MALAMUC,PH,324,21,6,0,27,82,17,0,99
INDEPENDENŢA,PH,191,4,3,0,7,30,13,0,43
GORGOTA,PH,1204,36,0,0,36,171,15,0,186
POTIGRAFU,PH,1059,37,6,0,43,136,21,0,157
"POIENARII APOSTOLI",PH,1143,42,4,0,46,204,23,0,227
CRIVINA,PH,794,41,3,0,44,104,11,0,115
GORNET,PH,1954,85,9,0,94,389,38,0,427
CUIB,PH,261,28,8,0,36,87,15,0,102
NUCET,PH,150,20,4,0,24,63,7,0,70
GORNET-CRICOV,PH,784,18,3,0,21,112,22,0,134
COŞERELE,PH,653,12,6,0,18,95,18,0,113
DOBROTA,PH,381,5,8,0,13,23,12,0,35
"GURA VADULUI",PH,1169,28,6,0,34,136,17,1,154
PERŞUNARI,PH,663,15,2,0,17,74,20,0,94
"GURA VITIOAREI",PH,1672,40,5,0,45,232,19,0,251
FĂGETU,PH,957,37,2,0,39,196,16,0,212
"POIANA COPĂCENI",PH,845,45,7,0,52,147,10,1,158
"BUGHEA DE JOS",PH,864,16,10,0,26,123,23,0,146
FUNDENI,PH,519,28,13,0,41,85,18,0,103
IORDĂCHEANU,PH,1006,27,5,0,32,134,22,0,156
MOCEŞTI,PH,970,25,1,0,26,194,16,0,210
"VALEA CUCULUI",PH,1051,14,7,0,21,98,18,0,116
VĂRBILA,PH,1169,27,7,0,34,114,14,0,128
IZVOARELE,PH,1973,50,14,0,64,338,44,0,382
HOMORÎCIU,PH,1737,36,5,0,41,300,53,0,353
SCHIULEŞTI,PH,1007,58,13,0,71,265,29,0,294
"MALU VÎNĂT",PH,690,34,8,0,42,128,25,1,154
JUGURENI,PH,405,20,8,0,28,91,22,0,113
LAPOŞ,PH,928,115,9,0,124,350,55,0,405
LIPĂNEŞTI,PH,1431,106,24,0,130,350,45,0,395
ŞIPOTU,PH,1850,66,15,0,81,335,39,0,374
ZAMFIRA,PH,919,79,22,0,101,236,40,0,276
MĂGURELE,PH,2725,81,10,0,91,394,38,0,432
"COADA MALULUI",PH,676,33,10,0,43,147,22,0,169
IAZU,PH,523,28,2,0,30,96,9,0,105
MĂGURENI,PH,3670,96,16,0,112,521,43,0,564
"LUNCA PRAHOVEI",PH,926,38,4,0,42,153,17,0,170
"COCORĂŞTII CAPLII",PH,683,29,14,0,43,162,20,0,182
MĂNECIU-UNGURENI,PH,2721,62,6,0,68,438,30,1,469
GHEABA,PH,2368,63,19,0,82,396,57,0,453
MĂNECIU-PĂMÎNTENI,PH,3383,83,18,0,101,515,60,0,575
CHEIA,PH,324,32,46,0,78,67,113,0,180
MĂNEŞTI,PH,879,24,10,0,34,159,31,10,200
ZALHANAUA,PH,799,25,5,0,30,136,13,2,151
"COADA IZVORULUI",PH,767,31,6,0,37,145,17,3,165
BĂLTIŢA,PH,720,26,8,0,34,102,14,3,119
"OLARII VECHI",PH,608,46,6,0,52,149,16,0,165
OLARI,PH,588,36,11,0,47,141,29,1,171
FÂNARI,PH,325,28,6,0,34,76,20,0,96
PĂCUREŢI,PH,1036,47,11,0,58,163,27,0,190
MATIŢA,PH,654,25,6,0,31,117,15,0,132
PĂULEŞTI,PH,2620,120,14,0,134,433,77,0,510
COCOŞEŞTI,PH,791,32,7,0,39,156,16,0,172
GĂGENI,PH,1857,172,7,0,179,495,42,1,538
PLOPU,PH,871,36,11,0,47,164,29,0,193
NISIPOASA,PH,676,33,0,0,33,140,17,0,157
GÂLMEIA,PH,199,9,6,0,15,21,11,0,32
HÂRŞA,PH,209,1,1,0,2,40,5,0,45
SĂLCIOARA,PH,1263,33,7,0,40,146,17,0,163
"VALEA DULCE",PH,807,37,2,0,39,225,11,1,237
POPEŞTI,PH,472,15,4,0,19,121,14,0,135
MEHEDINŢA,PH,1321,25,6,0,31,108,20,0,128
"POIANA CÂMPINA",PH,2924,139,21,0,160,452,66,0,518
PIETRIŞU,PH,477,16,2,0,18,73,6,0,79
BOBOLIA,PH,886,47,10,0,57,173,24,0,197
"POIENARII BURCHII",PH,954,22,5,0,27,90,35,0,125
CĂRBUNARI,PH,612,9,1,0,10,53,15,0,68
"POIENARII RALI",PH,845,34,11,0,45,110,38,0,148
OLOGENI,PH,1085,30,8,0,38,188,26,0,214
TĂTĂRĂI,PH,454,10,8,0,18,47,27,0,74
BODEŞTI,PH,658,12,8,0,20,99,28,0,127
"NUCŞOARA DE JOS",PH,1258,40,13,0,53,199,27,0,226
"VALEA PLOPULUI",PH,776,61,41,0,102,313,84,0,397
TÎRLEŞTI,PH,479,16,0,0,16,90,0,0,90
PREDEAL,PH,734,19,1,0,20,128,11,0,139
ZÎMBROAIA,PH,143,8,4,0,12,20,13,0,33
"VITIOARA DE SUS",PH,998,56,15,0,71,170,29,0,199
"PROVIŢA DE JOS",PH,920,50,20,0,70,170,55,0,225
DRĂGĂNEASA,PH,930,57,15,0,72,198,25,0,223
"PROVIŢA DE SUS",PH,1364,55,12,0,67,268,51,0,319
IZVORU,PH,308,3,5,0,8,66,15,0,81
"PUCHENII MARI",PH,1045,25,7,0,32,163,35,0,198
PIETROŞANI,PH,1934,39,3,0,42,162,18,0,180
"PUCHENII MOŞNENI",PH,1202,40,6,0,46,150,20,0,170
MIROSLĂVEŞTI,PH,1525,46,4,9,59,182,19,9,210
ODĂILE,PH,1316,26,4,0,30,151,11,0,162
MĂLĂIEŞTI,PH,655,33,3,0,36,128,8,0,136
"MOARA DOMNEASCĂ",PH,799,19,1,0,20,96,16,0,112
BUDA,PH,847,17,5,0,22,62,9,0,71
PALANCA,PH,863,25,2,0,27,80,12,0,92
GOGA,PH,374,16,2,0,18,66,10,0,76
SICRITA,PH,400,10,4,0,14,38,8,0,46
RÎFOV,PH,289,12,0,0,12,62,7,0,69
BUCHILAŞI,PH,123,7,3,0,10,14,5,0,19
SALCIA,PH,812,28,3,0,31,165,23,0,188
SĂLCIILE,PH,1480,68,27,27,122,277,86,54,417
SCORŢENI,PH,1212,47,7,0,54,138,30,0,168
MISLEA,PH,1527,33,2,0,35,171,22,0,193
"BORDENII MARI",PH,1200,78,6,0,84,396,25,0,421
SÎRCA,PH,825,50,0,0,50,151,22,0,173
SECĂRIA,PH,1031,37,1,24,62,292,18,39,349
SÎNGERU,PH,1951,51,7,0,58,373,32,0,405
"MIREŞU MARE",PH,1187,20,6,0,26,218,24,0,242
BUTUCI,PH,417,17,6,0,23,138,22,0,160
TISA,PH,556,18,4,0,22,85,16,0,101
STARCHIOJD,PH,2559,51,4,0,55,338,31,0,369
"VALEA ANEI",PH,444,5,1,0,6,86,15,0,101
SURANI,PH,1418,55,16,0,71,361,55,0,416
TĂRICENI,PH,1555,55,10,0,65,194,36,0,230
ŞIRNA,PH,615,21,4,0,25,83,14,0,97
VARNIŢA,PH,749,28,1,0,29,122,12,0,134
HĂBUD,PH,645,32,4,0,36,145,20,0,165
BRĂTEŞTI,PH,412,40,7,0,47,125,18,0,143
MĂGURA,PH,429,14,6,0,20,66,13,0,79
ŞOIMARI,PH,1408,27,7,0,34,222,36,0,258
LOPATNIŢA,PH,570,14,1,0,15,98,11,0,109
"PLAIU CÂMPINEI",PH,662,17,1,0,18,111,2,0,113
SECIURI,PH,297,4,4,0,8,22,6,0,28
"LUNCA MARE",PH,385,16,2,0,18,40,12,0,52
VISTIERU,PH,475,7,7,0,14,65,9,0,74
ŞOTRILE,PH,844,17,3,0,20,63,4,0,67
SCURTEŞTI,PH,635,28,2,0,30,166,16,0,182
ŞTEFEŞTI,PH,1276,48,9,0,57,232,29,0,261
TALEA,PH,870,46,4,0,50,238,26,0,264
TĂTARU,PH,242,11,3,0,14,42,18,0,60
PODGORIA,PH,496,6,6,0,12,31,14,0,45
TEIŞANI,PH,1460,42,9,0,51,212,27,0,239
"VALEA STÎLPULUI",PH,179,8,5,0,13,43,13,0,56
OLTENI,PH,1425,46,9,0,55,240,42,0,282
TELEGA,PH,3792,127,32,0,159,472,84,0,556
BUŞTENARI,PH,504,25,4,0,29,104,9,0,113
MELICEŞTI,PH,403,17,1,0,18,49,6,0,55
TINOSU,PH,927,47,4,0,51,117,16,0,133
PREDEŞTI,PH,544,21,5,0,26,87,14,0,101
PISCULEŞTI,PH,515,27,4,0,31,73,8,0,81
STREJNICU,PH,5585,287,26,0,313,1178,117,0,1295
"TÎRGŞORU VECHI",PH,1941,76,15,0,91,330,50,0,380
STĂNCEŞTI,PH,813,49,8,0,57,165,23,0,188
TOMŞANI,PH,1289,52,5,0,57,237,22,0,259
MAGULA,PH,1099,49,4,0,53,221,9,0,230
LOLOIASCA,PH,1189,52,6,0,58,195,27,0,222
"VADU SĂPAT",PH,1354,37,9,0,46,267,37,0,304
ARVA,PH,1106,32,10,0,42,136,19,0,155
"VALEA CĂLUGĂREASCĂ",PH,2376,100,9,0,109,273,24,0,297
"VALEA NICOVANI",PH,1154,31,6,0,37,126,25,0,151
DÎRVARI,PH,469,18,0,0,18,89,6,0,95
COSLEGI,PH,539,18,3,0,21,64,11,0,75
RADILA,PH,241,24,2,0,26,78,6,0,84
PANTAZI,PH,951,11,2,0,13,92,14,0,106
RACHIERI,PH,1170,54,3,0,57,155,8,0,163
"VALEA POPII",PH,754,20,2,0,22,93,7,0,100
"VALEA MANTEI",PH,91,0,4,0,4,7,11,0,18
TEŞILA,PH,3529,46,17,0,63,261,60,0,321
TRĂISTENI,PH,2040,17,5,0,22,179,34,0,213
VĂRBILĂU,PH,2909,147,16,0,163,444,60,0,504
LIVADEA,PH,878,28,10,0,38,138,29,0,167
"POIANA VĂRBILĂU",PH,1056,21,2,0,23,134,13,0,147
COŢOFENEŞTI,PH,711,47,11,0,58,162,22,0,184
VÎLCĂNEŞTI,PH,2165,85,7,0,92,259,16,0,275
CÎRJARI,PH,611,17,2,0,19,69,4,0,73
TRESTIOARA,PH,374,25,4,0,29,66,7,0,73
SIBIU,SB,141546,7584,1214,81,8879,21027,2790,175,23992
PĂLTINIŞ,SB,26,2,12,0,14,3,35,0,38
MEDIAŞ,SB,47471,1884,146,41,2071,5340,341,72,5753
"IGHIŞU NOU",SB,1348,35,2,0,37,140,12,0,152
AGNITA,SB,8332,158,17,0,175,651,47,0,698
COVEŞ,SB,500,9,4,0,13,105,8,0,113
RUJA,SB,974,18,1,0,19,112,4,0,116
AVRIG,SB,8212,178,28,0,206,733,81,0,814
MÎRŞA,SB,2641,65,5,0,70,259,14,0,273
BRADU,SB,889,11,5,0,16,72,15,0,87
SĂCĂDATE,SB,504,14,2,0,16,46,10,0,56
GLÎMBOACA,SB,182,5,0,0,5,30,17,0,47
CISNĂDIOARA,SB,645,21,11,0,32,46,24,0,70
CISNĂDIE,SB,17362,691,49,0,740,1982,119,0,2101
"COPŞA MICĂ",SB,4633,74,11,0,85,280,33,0,313
DUMBRĂVENI,SB,4874,133,11,0,144,539,36,0,575
"ŞAROŞ PE TÎRNAVE",SB,1427,23,0,0,23,123,5,0,128
ERNEA,SB,382,11,1,0,12,94,5,0,99
"MIERCUREA SIBIULUI",SB,1720,44,2,0,46,198,14,0,212
"APOLDU DE SUS",SB,1464,16,2,0,18,64,8,0,72
DOBÂRCA,SB,658,10,6,0,16,74,20,0,94
"OCNA SIBIULUI",SB,3348,97,5,0,102,402,33,1,436
TOPÎRCEA,SB,115,4,4,0,8,13,17,0,30
SĂLIŞTE,SB,2397,61,8,0,69,342,55,0,397
GALEŞ,SB,272,10,6,0,16,52,21,0,73
VALE,SB,305,19,9,0,28,55,18,0,73
SIBIEL,SB,330,5,10,0,15,34,32,0,66
FÂNTÂNELE,SB,150,7,2,0,9,31,11,0,42
SĂCEL,SB,436,14,2,0,16,99,15,0,114
MAG,SB,365,1,2,0,3,37,10,0,47
AMNAŞ,SB,341,8,2,0,10,46,23,0,69
ACILIU,SB,169,6,9,0,15,46,25,0,71
TĂLMACIU,SB,5468,143,9,0,152,676,45,0,721
"COLONIA TĂLMACIU",SB,221,8,1,0,9,37,5,0,42
TĂLMĂCEL,SB,912,11,2,0,13,90,10,0,100
ALMA,SB,656,15,0,0,15,109,13,0,122
GIACĂŞ,SB,202,16,6,0,22,61,12,0,73
ŞMIG,SB,724,15,2,0,17,138,12,0,150
ALŢINA,SB,1069,27,7,0,34,287,39,22,348
BENEŞTI,SB,224,33,7,0,40,73,34,0,107
"GHIJASA DE SUS",SB,120,9,4,0,13,48,14,0,62
"APOLDU DE JOS",SB,857,25,9,0,34,130,31,0,161
SÎNGĂTIN,SB,206,3,2,0,5,54,21,0,75
"ARPAŞU DE JOS",SB,918,33,0,0,33,120,16,0,136
"ARPAŞU DE SUS",SB,1017,11,6,0,17,71,22,0,93
"NOUL ROMÂN",SB,303,4,2,0,6,55,10,0,65
AŢEL,SB,1143,25,2,0,27,135,4,0,139
DUPUŞ,SB,211,10,3,0,13,27,7,0,34
AGÎRBICIU,SB,1198,23,2,0,25,104,4,0,108
ŞOALA,SB,274,12,3,0,15,43,9,0,52
"AXENTE SEVER",SB,2021,38,11,0,49,206,25,0,231
BAZNA,SB,1456,20,16,0,36,118,41,0,159
BOIAN,SB,1172,9,7,0,16,120,19,0,139
VELŢ,SB,456,12,5,0,17,80,13,0,93
BIERTAN,SB,1365,22,9,16,47,141,21,16,178
RICHIŞ,SB,639,11,3,0,14,28,4,0,32
"COPŞA MARE",SB,396,12,3,0,15,73,11,0,84
"IGHIŞU VECHI",SB,199,9,2,0,11,34,7,0,41
BÎRGHIŞ,SB,646,17,4,0,21,42,14,0,56
APOŞ,SB,268,7,1,0,8,32,4,0,36
PELIŞOR,SB,401,8,1,0,9,42,9,0,51
ZLAGNA,SB,146,9,2,0,11,17,6,0,23
VECERD,SB,92,16,8,0,24,30,16,0,46
PĂUCEA,SB,357,6,1,0,7,58,7,0,65
ROMANEŞTI,SB,61,0,3,0,3,4,3,0,7
BLĂJEL,SB,1498,26,2,0,28,120,10,0,130
BOIŢA,SB,1299,69,9,0,78,229,30,0,259
BRATEIU,SB,1954,36,8,0,44,279,21,0,300
BUZD,SB,958,4,3,0,7,107,5,0,112
BRĂDENI,SB,746,28,1,0,29,127,9,0,136
RETIŞ,SB,375,18,4,0,22,74,22,0,96
ŢELINE,SB,96,12,2,0,14,39,7,0,46
BRUIU,SB,416,2,0,0,2,29,8,0,37
ŞOMARTIN,SB,326,5,0,0,5,24,8,0,32
CHIRPĂR,SB,986,11,9,0,20,89,18,0,107
VĂRD,SB,285,7,1,0,8,57,3,0,60
VESEUD,SB,152,6,3,0,9,21,7,0,28
SĂSĂUŞ,SB,110,6,7,0,13,21,29,0,50
CÎRŢA,SB,951,22,5,0,27,96,15,0,111
CÎRŢIŞOARA,SB,1072,46,15,0,61,223,67,0,290
CRISTIAN,SB,3381,81,11,0,92,444,60,0,504
DÎRLOS,SB,1904,58,5,0,63,241,24,0,265
CURCIU,SB,718,15,5,0,20,138,8,0,146
"VALEA LUNGĂ",SB,206,13,2,0,15,47,5,0,52
"GURA RÂULUI",SB,2913,89,27,0,116,698,70,26,794
HOGHILAG,SB,990,16,0,0,16,157,6,0,163
PROD,SB,204,7,2,0,9,67,14,0,81
VALCHID,SB,624,7,0,0,7,77,2,0,79
IACOBENI,SB,832,3,0,0,3,108,3,0,111
STEJĂRIŞU,SB,421,7,2,0,9,45,4,0,49
NETUŞ,SB,397,24,2,0,26,66,9,0,75
NOIŞTAT,SB,452,6,1,0,7,42,2,0,44
MOVILE,SB,284,12,0,0,12,59,6,0,65
JINA,SB,2755,144,11,0,155,942,76,0,1018
LASLEA,SB,1279,16,0,0,16,211,10,0,221
MĂLÎNCRAV,SB,992,16,2,0,18,102,10,0,112
FLOREŞTI,SB,106,8,0,0,8,18,6,0,24
ROANDOLA,SB,249,3,0,0,3,10,12,0,22
"NOU SĂSESC",SB,606,10,4,0,14,21,7,0,28
LOAMNEŞ,SB,502,27,1,0,28,126,11,0,137
MÎNDRA,SB,282,21,8,0,29,67,13,0,80
ALĂMOR,SB,619,10,0,0,10,57,9,0,66
ARMENI,SB,433,5,2,0,7,32,6,0,38
HAŞAG,SB,533,13,0,0,13,97,24,0,121
LUDOŞ,SB,581,17,4,0,21,101,38,0,139
MARPOD,SB,544,14,12,0,26,52,28,0,80
ILIMBAV,SB,163,7,3,0,10,27,14,0,41
MERGHINDEAL,SB,678,17,0,0,17,117,11,10,138
"DEALU FRUMOS",SB,550,17,2,0,19,107,3,5,115
MICĂSASA,SB,1127,25,3,0,28,163,16,0,179
ŢAPU,SB,645,10,0,0,10,52,6,0,58
CHESLER,SB,57,1,3,0,4,14,12,0,26
MIHĂILENI,SB,246,3,2,0,5,29,2,0,31
METIŞ,SB,243,3,0,0,3,32,4,0,36
RĂVĂŞEL,SB,277,2,3,0,5,35,9,0,44
MOŞNA,SB,2055,40,1,0,41,235,11,0,246
"ALMA VII",SB,332,14,11,3,28,45,5,0,50
NEMŞA,SB,471,24,2,0,26,76,12,0,88
NOCRICH,SB,1121,19,5,0,24,56,11,0,67
HOSMAN,SB,709,5,3,0,8,38,5,0,43
FOFELDEA,SB,301,14,6,0,20,69,17,0,86
"GHIJASA DE JOS",SB,83,1,1,0,2,6,9,0,15
ŢICHINDEAL,SB,129,3,2,0,5,12,13,0,25
ORLAT,SB,2644,31,8,0,39,256,21,0,277
PĂUCA,SB,663,40,2,0,42,159,15,0,174
"BOGATU ROMÂN",SB,357,11,0,0,11,50,9,0,59
BROŞTENI,SB,280,36,2,0,38,133,7,0,140
PRESACA,SB,308,44,8,0,52,120,14,0,134
"POIANA SIBIULUI",SB,1782,24,7,0,31,216,49,1,266
POPLACA,SB,1420,22,4,0,26,145,14,0,159
"PORUMBACU DE JOS",SB,870,9,4,0,13,75,16,0,91
"PORUMBACU DE SUS",SB,678,25,14,0,39,123,52,0,175
SCOREIU,SB,558,25,4,0,29,90,25,0,115
SĂRATA,SB,283,10,2,0,12,42,8,0,50
COLUN,SB,147,3,3,0,6,44,5,0,49
"SEBEŞU DE SUS",SB,612,14,0,5,19,120,34,0,154
RACOVIŢA,SB,1717,61,3,0,64,239,12,0,251
RĂŞINARI,SB,4407,74,11,0,85,393,43,0,436
"RÎU SADULUI",SB,480,23,4,0,27,93,9,0,102
ROŞIA,SB,1187,52,5,0,57,176,15,0,191
NOU,SB,1315,28,1,0,29,134,9,0,143
DAIA,SB,753,14,1,0,15,83,9,0,92
CAŞOLŢ,SB,595,10,1,0,11,85,6,0,91
CORNĂŢEL,SB,397,12,3,0,15,73,23,0,96
SADU,SB,2082,55,11,0,66,282,37,0,319
SLIMNIC,SB,2302,49,6,0,55,303,28,0,331
RUŞI,SB,734,37,1,0,38,86,4,0,90
VESEUD,SB,161,17,7,0,24,48,12,0,60
"ŞEICA MARE",SB,2704,84,24,2,110,402,64,2,468
BOARTA,SB,340,16,1,0,17,55,10,0,65
BUIA,SB,487,2,0,0,2,29,1,0,30
ŞTENEA,SB,124,3,5,0,8,19,13,0,32
PETIŞ,SB,48,2,0,0,2,2,1,0,3
"ŞEICA MICĂ",SB,1035,26,3,0,29,133,21,0,154
SOROŞTIN,SB,430,22,2,0,24,156,12,0,168
ŞELIMBĂR,SB,6976,210,42,0,252,720,147,0,867
VEŞTEM,SB,1393,48,10,0,58,212,19,0,231
MOHU,SB,613,9,0,0,9,57,5,0,62
BUNGARD,SB,483,10,1,0,11,60,7,0,67
"ŞURA MARE",SB,3011,73,3,0,76,291,18,0,309
HAMBA,SB,698,10,3,0,13,85,15,0,100
"ŞURA MICĂ",SB,1950,32,2,0,34,155,19,0,174
RUSCIORI,SB,583,10,3,0,13,69,12,0,81
TILIŞCA,SB,847,21,12,0,33,161,32,0,193
ROD,SB,325,14,3,0,17,37,18,0,55
TÎRNAVA,SB,2518,28,1,0,29,219,10,0,229
"TURNU ROŞU",SB,1476,44,15,0,59,170,35,0,205
"SEBEŞU DE JOS",SB,461,21,9,0,30,91,27,0,118
"VALEA VIILOR",SB,1264,32,1,0,33,151,8,13,172
MOTIŞ,SB,553,10,2,0,12,36,10,1,47
VURPĂR,SB,2041,58,4,0,62,269,18,0,287
ZALĂU,SJ,57183,2722,219,141,3082,9222,553,141,9916
STÎNA,SJ,243,8,0,0,8,67,11,0,78
"CEHU SILVANIEI",SJ,4441,74,11,0,85,358,26,0,384
"HOROATU CEHULUI",SJ,142,4,2,0,6,34,11,0,45
MOTIŞ,SJ,601,10,5,0,15,58,6,0,64
NADIŞ,SJ,424,5,2,0,7,78,14,0,92
ULCIUG,SJ,757,7,0,0,7,73,5,0,78
JIBOU,SJ,8157,369,25,0,394,1641,78,0,1719
CUCEU,SJ,403,12,2,0,14,94,10,0,104
HUSIA,SJ,206,4,1,0,5,45,10,0,55
RONA,SJ,308,8,5,0,13,68,16,0,84
VAR,SJ,431,15,2,0,17,106,6,0,112
"ŞIMLEU SILVANIEI",SJ,11376,383,31,0,414,1706,108,15,1829
CEHEI,SJ,787,55,2,0,57,277,17,0,294
PUSTA,SJ,1384,23,0,0,23,317,2,0,319
AGRIJ,SJ,828,24,4,0,28,221,32,2,255
"RĂSTOLŢU- DEŞERT",SJ,278,13,6,0,19,64,16,0,80
ALMAŞU,SJ,816,12,2,0,14,86,6,0,92
JEBUCU,SJ,287,1,4,0,5,57,7,0,64
MESTEACĂNU,SJ,292,1,4,0,5,46,11,0,57
PETRINZEL,SJ,98,3,2,0,5,20,12,0,32
STANA,SJ,107,2,5,0,7,6,8,0,14
ŢĂUDU,SJ,103,6,0,0,6,23,9,0,32
BĂBENI,SJ,463,18,2,0,20,111,21,0,132
CIOCMANI,SJ,469,20,1,0,21,101,36,0,137
CLIŢ,SJ,177,7,5,0,12,32,15,0,47
PIROŞA,SJ,82,6,1,0,7,31,11,0,42
POIENIŢA,SJ,177,2,1,0,3,53,19,0,72
BĂLAN,SJ,767,14,4,0,18,177,34,0,211
CHECHIŞ,SJ,478,27,22,0,49,163,83,0,246
CHENDREA,SJ,668,45,5,0,50,269,25,0,294
GĂLPÎIA,SJ,336,46,13,0,59,171,34,0,205
"GÎLGĂU ALMAŞULUI",SJ,819,56,5,0,61,212,41,0,253
BĂNIŞOR,SJ,540,23,12,0,35,152,35,1,188
BAN,SJ,364,14,6,0,20,81,26,0,107
PECEIU,SJ,755,36,12,0,48,263,44,0,307
BENESAT,SJ,351,12,3,0,15,34,13,1,48
ALUNIŞ,SJ,458,5,2,0,7,66,16,0,82
BIUŞA,SJ,397,11,4,0,15,73,15,0,88
BOBOTA,SJ,1173,39,6,0,45,260,33,0,293
DERŞIDA,SJ,1489,35,2,0,37,257,19,0,276
ZALNOC,SJ,381,8,4,0,12,73,9,0,82
BOCŞA,SJ,769,31,5,0,36,162,22,0,184
BORLA,SJ,1320,32,0,0,32,166,5,0,171
SĂLĂJENI,SJ,442,10,3,0,13,92,17,0,109
CÎMPIA,SJ,207,8,3,0,11,59,18,0,77
BOGHIŞ,SJ,1247,25,6,0,31,312,15,0,327
BOZIEŞ,SJ,209,11,5,0,16,76,5,0,81
BODIA,SJ,219,15,7,0,22,94,24,0,118
BOGDANA,SJ,366,18,4,0,22,97,34,0,131
RĂSTOLŢ,SJ,173,15,9,0,24,75,32,0,107
"SÎNGEORGIU DE MESEŞ",SJ,227,6,6,0,12,56,27,0,83
BUCIUMI,SJ,992,36,18,0,54,355,96,0,451
CAMĂR,SJ,1342,62,4,0,66,489,11,0,500
DUMUSLĂU,SJ,34,4,4,0,8,15,12,0,27
CARASTELEC,SJ,826,49,6,0,55,148,28,0,176
CHIEŞD,SJ,1577,20,3,0,23,218,9,0,227
"SIGHETU SILVANIEI",SJ,401,7,5,0,12,69,15,0,84
CIZER,SJ,1301,11,4,0,15,227,24,0,251
PLESCA,SJ,163,8,1,0,9,61,26,0,87
PRIA,SJ,327,8,7,0,15,70,40,0,110
COŞEIU,SJ,358,13,0,0,13,68,9,0,77
ARCHID,SJ,383,10,6,0,16,138,8,0,146
CHILIOARA,SJ,242,15,10,0,25,94,44,0,138
CRASNA,SJ,3728,121,7,0,128,869,26,0,895
HUSENI,SJ,414,14,5,0,19,153,12,0,165
MARIN,SJ,752,3,4,0,7,187,30,0,217
RATIN,SJ,406,3,6,0,9,75,14,0,89
CREACA,SJ,363,15,6,0,21,86,26,0,112
BREBI,SJ,443,25,4,0,29,168,18,0,186
JAC,SJ,569,73,17,1,91,229,49,4,282
BRUSTURI,SJ,132,13,6,0,19,39,20,0,59
LUPOAIA,SJ,240,31,4,0,35,100,21,0,121
BORZA,SJ,150,11,10,0,21,47,25,0,72
PRODĂNEŞTI,SJ,208,12,2,0,14,62,5,0,67
CIGLEAN,SJ,119,6,6,0,12,23,14,0,37
CRISTOLŢ,SJ,507,7,0,0,7,75,6,0,81
MUNCEL,SJ,138,4,1,0,5,39,6,0,45
"POIANA ONŢII",SJ,66,5,2,0,7,21,7,0,28
VĂLENI,SJ,327,13,2,0,15,49,12,0,61
CRIŞENI,SJ,1454,34,3,0,37,230,11,0,241
CRISTUR-CRIŞENI,SJ,415,7,3,0,10,49,5,0,54
GÎRCEIU,SJ,658,11,11,0,22,104,24,0,128
CUZĂPLAC,SJ,446,23,5,0,28,73,14,0,87
GĂLĂŞENI,SJ,86,9,4,0,13,15,13,0,28
MIERŢA,SJ,109,6,2,0,8,38,18,0,56
PETRINDU,SJ,339,14,5,1,20,77,16,1,94
RUGINOASA,SJ,76,7,9,0,16,13,28,0,41
TĂMASA,SJ,255,27,3,0,30,91,10,0,101
DOBRIN,SJ,350,40,8,0,48,117,18,0,135
DOBA,SJ,492,18,9,0,27,89,17,1,107
NAIMON,SJ,119,11,5,0,16,27,11,0,38
VERVEGHIU,SJ,379,11,5,0,16,74,8,0,82
DRAGU,SJ,519,15,4,0,19,108,29,0,137
ADALIN,SJ,119,11,5,0,16,23,23,0,46
UGRUŢIU,SJ,19,0,11,0,11,1,30,0,31
VOIVODENI,SJ,242,10,6,0,16,92,44,0,136
"FILDU DE JOS",SJ,185,7,3,0,10,59,17,0,76
"FILDU DE MIJLOC",SJ,317,14,3,0,17,127,18,0,145
"FILDU DE SUS",SJ,321,14,5,0,19,133,17,0,150
TETIŞU,SJ,245,6,2,0,8,46,11,0,57
"BÎRSĂU MARE",SJ,179,15,2,0,17,44,12,0,56
CĂPÎLNA,SJ,242,12,8,0,20,60,30,0,90
CHIZENI,SJ,83,11,6,0,17,30,11,0,41
GLOD,SJ,390,10,11,0,21,54,24,0,78
GÎLGĂU,SJ,513,34,5,0,39,168,31,0,199
DOBROCINA,SJ,140,14,5,0,19,52,22,0,74
FODORA,SJ,351,22,4,0,26,104,27,0,131
GÎRBOU,SJ,485,8,6,0,14,73,14,0,87
SOLOMON,SJ,286,9,6,0,15,96,24,0,120
CĂLACEA,SJ,222,8,5,0,13,63,32,0,95
POPTELEAC,SJ,258,11,7,0,18,50,19,0,69
CERNUC,SJ,145,3,7,0,10,31,25,0,56
BEZDED,SJ,98,1,7,0,8,27,26,0,53
FABRICA,SJ,83,3,0,0,3,27,9,0,36
HALMĂŞD,SJ,879,23,7,0,30,168,20,0,188
ALEUŞ,SJ,239,7,4,0,11,61,13,0,74
CERIŞA,SJ,450,15,2,0,17,99,2,0,101
DRIGHIU,SJ,315,13,3,0,16,52,14,0,66
HERECLEAN,SJ,451,13,5,0,18,87,30,0,117
BADON,SJ,563,23,4,0,27,113,31,1,145
BOCŞIŢA,SJ,67,8,2,0,10,27,20,0,47
DIOŞOD,SJ,692,14,0,0,14,127,13,0,140
GURUSLĂU,SJ,521,21,5,0,26,107,9,1,117
PANIC,SJ,885,14,0,0,14,97,3,0,100
BAICA,SJ,100,8,5,0,13,26,6,0,32
MILUANI,SJ,21,1,2,0,3,5,28,0,33
HIDA,SJ,885,24,4,0,28,136,15,0,151
RACÎŞ,SJ,410,3,7,0,10,64,17,0,81
TRESTIA,SJ,243,4,1,0,5,68,14,0,82
"SÎNPETRU ALMAŞULUI",SJ,337,19,3,0,22,55,19,0,74
STUPINI,SJ,106,7,1,0,8,22,25,0,47
PĂDURIŞ,SJ,30,6,8,0,14,10,24,0,34
STÎRCIU,SJ,777,39,12,0,51,198,74,0,272
ŞEREDEIU,SJ,200,5,5,0,10,73,37,0,110
"HOROATU CRASNEI",SJ,771,12,6,0,18,104,25,0,129
HUREZ,SJ,280,4,12,0,16,40,26,0,66
DĂBÎCENI,SJ,157,13,1,0,14,54,9,0,63
NEGRENI,SJ,85,7,2,0,9,23,9,0,32
"PERII VADULUI",SJ,95,7,0,0,7,16,11,0,27
PODIŞU,SJ,115,2,2,0,4,13,10,0,23
RĂSTOCI,SJ,111,9,1,0,10,38,9,0,47
ROGNA,SJ,60,3,6,0,9,8,8,0,16
ŞASA,SJ,49,4,5,0,9,14,10,0,24
ILEANDA,SJ,1012,33,8,0,41,169,32,1,202
DOLHENI,SJ,78,4,3,0,7,8,7,0,15
LUMINIŞU,SJ,75,4,4,0,8,15,13,0,28
IP,SJ,1443,17,3,0,20,186,11,0,197
"COSNICIU DE JOS",SJ,521,14,4,0,18,95,8,0,103
"COSNICIU DE SUS",SJ,249,10,0,0,10,63,4,0,67
ZĂUAN,SJ,813,10,0,0,10,97,14,0,111
LETCA,SJ,439,7,1,0,8,71,20,0,91
CIULA,SJ,79,5,2,0,7,35,18,0,53
COZLA,SJ,200,10,5,0,15,55,9,0,64
CUCIULAT,SJ,141,14,2,0,16,48,10,0,58
LEMNIU,SJ,351,17,7,0,24,119,33,0,152
PURCĂREŢ,SJ,85,5,4,0,9,21,13,0,34
ŞOIMUŞENI,SJ,58,8,6,0,14,28,22,0,50
TOPLIŢA,SJ,96,10,3,0,13,44,10,0,54
VĂLIŞOARA,SJ,22,1,2,0,3,4,6,0,10
CORMENIŞ,SJ,153,17,6,0,23,47,18,0,65
"VALEA LOZNEI",SJ,153,5,2,0,7,41,24,0,65
LOZNA,SJ,478,22,5,0,27,119,50,0,169
MARCA,SJ,1152,42,8,0,50,288,22,0,310
PORŢ,SJ,234,7,5,0,12,60,9,0,69
LEŞMIR,SJ,339,3,1,0,4,56,3,0,59
ŞUMAL,SJ,417,3,0,0,3,37,4,0,41
MĂERIŞTE,SJ,610,8,5,0,13,98,19,0,117
"GIURTELECU ŞIMLEULUI",SJ,715,8,3,0,11,79,13,0,92
CRIŞTELEC,SJ,419,24,3,0,27,147,21,0,168
DOH,SJ,176,4,6,0,10,35,20,0,55
MĂLĂDIA,SJ,157,3,0,0,3,40,14,0,54
"UILEACU ŞIMLEULUI",SJ,373,12,1,0,13,60,7,0,67
"MESEŞENII DE JOS",SJ,545,16,4,0,20,131,19,0,150
AGHIREŞ,SJ,1195,34,3,0,37,233,23,0,256
FETINDIA,SJ,156,6,2,0,8,41,23,0,64
"MESEŞENII DE SUS",SJ,660,13,3,0,16,122,39,0,161
MIRŞID,SJ,546,23,2,0,25,114,15,1,130
FIRMINIŞ,SJ,121,2,3,0,5,27,14,0,41
MOIGRAD-POROLISSUM,SJ,445,9,2,0,11,73,9,0,82
POPENI,SJ,749,24,5,0,29,176,19,0,195
NĂPRADEA,SJ,653,19,3,0,22,83,14,0,97
CHEUD,SJ,697,25,5,0,30,151,25,0,176
SOMEŞ-GURUSLĂU,SJ,359,2,6,0,8,50,23,0,73
TRANIŞ,SJ,282,11,4,0,15,51,12,0,63
VĂDURELE,SJ,164,3,3,0,6,23,5,0,28
BILGHEZ,SJ,342,12,2,0,14,56,7,0,63
NUŞFALĂU,SJ,2708,81,18,0,99,565,42,0,607
PERICEI,SJ,2348,27,4,0,31,565,15,0,580
BĂDĂCIN,SJ,586,12,8,0,20,79,18,0,97
SICI,SJ,156,12,6,0,18,39,21,0,60
PLOPIŞ,SJ,823,5,1,0,6,99,16,0,115
IAZ,SJ,605,11,1,0,12,121,16,0,137
FĂGETU,SJ,533,30,10,0,40,151,24,3,178
"POIANA BLENCHII",SJ,606,19,1,0,20,174,21,0,195
GOSTILA,SJ,335,25,7,0,32,106,18,0,124
ROMÂNAŞI,SJ,794,25,8,0,33,197,38,0,235
CHICHIŞA,SJ,186,7,3,0,10,45,20,0,65
CIUMĂRNA,SJ,339,17,5,0,22,82,30,0,112
PĂUŞA,SJ,403,14,5,0,19,94,23,0,117
"POARTA SĂLAJULUI",SJ,385,10,6,0,16,51,19,0,70
ROMITA,SJ,246,9,0,0,9,44,19,0,63
RUS,SJ,610,44,1,0,45,122,20,1,143
FÎNTÎNELE-RUS,SJ,151,13,8,0,21,42,18,0,60
BUZAŞ,SJ,114,8,2,0,10,31,9,0,40
SĂLĂŢIG,SJ,407,7,0,0,7,85,4,0,89
BULGARI,SJ,193,6,1,0,7,55,9,0,64
DEJA,SJ,989,9,6,0,15,195,13,0,208
MINEU,SJ,271,12,5,0,17,42,10,0,52
NOŢIG,SJ,384,16,1,0,17,94,10,0,104
SÎG,SJ,576,11,0,0,11,80,7,0,87
FIZEŞ,SJ,278,7,4,0,11,60,16,0,76
MAL,SJ,888,11,6,0,17,128,19,0,147
SÎRBI,SJ,219,7,4,0,11,70,16,0,86
TUSA,SJ,563,10,3,0,13,65,16,0,81
"SÎNMIHAIU ALMAŞULUI",SJ,884,28,12,0,40,162,39,0,201
BERCEA,SJ,131,10,0,0,10,29,6,0,35
"SÎNTĂ MĂRIA",SJ,314,6,0,0,6,75,19,0,94
SOMEŞ-ODORHEI,SJ,1110,22,3,0,25,196,26,0,222
INĂU,SJ,490,7,7,0,14,136,32,0,168
ŞOIMUŞ,SJ,255,13,7,0,20,85,33,0,118
BÎRSA,SJ,87,4,9,0,13,18,12,0,30
DOMNIN,SJ,261,12,2,0,14,72,25,0,97
SURDUC,SJ,1082,46,6,0,52,220,30,0,250
BRÎGLEZ,SJ,225,12,3,0,15,55,14,0,69
CRISTOLŢEL,SJ,360,9,1,0,10,64,13,0,77
SOLONA,SJ,194,4,6,0,10,49,21,0,70
TEŞTIOARA,SJ,65,9,8,0,17,22,15,0,37
TIHĂU,SJ,888,43,7,0,50,199,26,0,225
TURBUŢA,SJ,244,6,6,0,12,32,8,0,40
ŞAMŞUD,SJ,910,27,8,0,35,269,15,0,284
"VALEA POMILOR",SJ,471,17,3,0,20,84,8,0,92
ŞĂRMĂŞAG,SJ,3898,56,6,0,62,408,22,0,430
ILIŞUA,SJ,573,5,0,0,5,101,7,0,108
LOMPIRT,SJ,689,4,0,0,4,66,3,0,69
MOIAD,SJ,184,10,0,0,10,43,7,0,50
ŞIMIŞNA,SJ,719,18,4,0,22,151,21,0,172
HĂŞMAŞ,SJ,238,11,6,0,17,91,18,0,109
TREZNEA,SJ,640,17,5,0,22,148,29,0,177
BOZNA,SJ,191,5,2,0,7,59,18,0,77
"VALCĂU DE JOS",SJ,736,29,4,0,33,159,13,0,172
"VALCĂU DE SUS",SJ,708,15,2,0,17,284,9,0,293
PREOTEASA,SJ,510,9,1,0,10,138,6,0,144
LAZURI,SJ,210,7,0,0,7,93,6,0,99
"SUB CETATE",SJ,296,7,1,0,8,114,10,0,124
VÎRŞOLŢ,SJ,1415,11,5,0,16,166,9,0,175
RECEA,SJ,484,18,3,0,21,95,25,0,120
ZALHA,SJ,227,9,0,0,9,31,10,0,41
CEACA,SJ,175,12,2,0,14,46,12,0,58
"VALEA HRANEI",SJ,66,4,6,0,10,18,20,0,38
CIURENI,SJ,112,4,5,0,9,32,10,0,42
"VALEA LUNGĂ",SJ,119,3,0,0,3,14,0,0,14
DOLU,SJ,48,5,1,0,6,11,7,0,18
SUTORU,SJ,105,16,6,0,22,27,11,0,38
ZIMBOR,SJ,504,9,4,0,13,44,18,0,62
"SÎNCRAIU ALMAŞULUI",SJ,145,9,0,0,9,41,31,0,72
"SATU MARE",SM,100055,3988,313,70,4371,12884,835,363,14082
SĂTMĂREL,SM,1172,17,2,0,19,166,7,0,173
CAREI,SM,20424,528,65,33,626,2191,142,34,2367
IANCULEŞTI,SM,293,12,2,0,14,71,9,0,80
ARDUD,SM,3905,76,13,0,89,385,34,0,419
"BABA NOVAC",SM,469,20,4,0,24,78,11,0,89
GERĂUŞA,SM,432,5,3,0,8,60,17,0,77
MĂDĂRAS,SM,959,25,3,0,28,116,11,0,127
LIVADA,SM,4099,46,15,0,61,272,43,0,315
ADRIAN,SM,431,4,2,0,6,16,4,0,20
DUMBRAVA,SM,955,16,0,0,16,117,10,0,127
"LIVADA MICĂ",SM,250,3,0,0,3,30,10,0,40
NEGREŞTI-OAŞ,SM,12372,366,33,54,453,1624,119,58,1801
TUR,SM,1586,41,2,0,43,315,9,0,324
TĂŞNAD,SM,6197,176,13,1,190,809,68,1,878
BLAJA,SM,169,10,2,0,12,39,10,0,49
CIG,SM,367,6,0,0,6,58,6,0,64
SĂRĂUAD,SM,839,10,0,0,10,99,11,0,110
"VALEA MORII",SM,145,5,1,0,6,18,5,0,23
ACÎŞ,SM,1499,33,2,0,35,173,9,0,182
MIHĂIENI,SM,360,4,3,0,7,12,7,0,19
UNIMĂT,SM,334,6,4,0,10,41,14,0,55
AGRIŞ,SM,1138,43,10,0,53,178,16,0,194
CIUPERCENI,SM,489,7,4,0,11,51,11,0,62
ANDRID,SM,987,23,2,0,25,142,22,0,164
DINDEŞTI,SM,608,9,3,0,12,43,6,0,49
IRINA,SM,420,2,3,0,5,21,6,0,27
APA,SM,1905,80,15,0,95,340,46,2,388
SOMEŞENI,SM,238,7,9,0,16,47,17,0,64
BĂTARCI,SM,1870,59,2,0,61,448,10,0,458
COMLĂUŞA,SM,896,43,4,0,47,237,12,0,249
TĂMĂŞENI,SM,323,5,4,0,9,33,9,0,42
BELTIUG,SM,1111,13,2,0,15,90,17,0,107
BOLDA,SM,51,2,4,0,6,11,6,0,17
GHIRIŞA,SM,572,33,2,0,35,113,5,0,118
GIUNGI,SM,110,2,2,0,4,20,12,0,32
RĂTEŞTI,SM,624,4,2,0,6,83,12,0,95
ŞANDRA,SM,216,0,7,0,7,41,10,0,51
BERVENI,SM,1698,16,3,0,19,91,6,0,97
LUCĂCENI,SM,1237,49,5,0,54,276,24,0,300
BIXAD,SM,2357,31,3,0,34,217,5,0,222
BOINEŞTI,SM,1420,24,1,0,25,164,5,0,169
TRIP,SM,2474,41,5,0,46,235,18,0,253
"BÎRSĂU DE SUS",SM,1328,28,5,0,33,377,28,18,423
"BÎRSĂU DE JOS",SM,519,23,7,0,30,168,43,0,211
BOGDAND,SM,763,8,1,0,9,59,5,0,64
BABŢA,SM,524,9,2,0,11,72,13,0,85
CORUND,SM,368,10,7,0,17,74,10,0,84
SER,SM,579,5,4,0,9,65,9,0,74
BOTIZ,SM,3090,53,1,0,54,326,21,0,347
CĂLINEŞTI-OAŞ,SM,2225,48,5,0,53,242,12,2,256
COCA,SM,855,26,1,1,28,108,5,1,114
LECHINŢA,SM,657,16,1,0,17,151,2,0,153
"PĂŞUNEA MARE",SM,318,11,3,0,14,58,6,0,64
CĂMĂRZANA,SM,1997,43,7,0,50,307,21,28,356
CĂMIN,SM,1164,6,1,0,7,106,2,0,108
CĂPLENI,SM,2662,35,2,0,37,272,5,0,277
CĂUAŞ,SM,547,24,4,0,28,133,16,0,149
GHILEŞTI,SM,79,8,3,0,11,14,10,1,25
RĂDULEŞTI,SM,95,4,3,0,7,19,16,0,35
"ADY ENDRE",SM,111,6,2,0,8,14,5,0,19
HOTOAN,SM,138,6,3,0,9,26,12,0,38
GHENCI,SM,1033,12,4,0,16,71,15,0,86
CEHĂLUŢ,SM,504,4,5,0,9,39,7,0,46
CEHAL,SM,659,11,1,0,12,147,14,6,167
ORBĂU,SM,181,10,6,0,16,40,12,0,52
CERTEZE,SM,2841,133,13,0,146,471,42,0,513
"HUTA CERTEZE",SM,960,23,0,0,23,138,12,0,150
MOIŞENI,SM,1134,17,6,0,23,144,12,0,156
CIUMEŞTI,SM,1121,8,1,0,9,199,8,0,207
CRAIDOROLŢ,SM,848,25,5,0,30,149,18,0,167
CRIŞENI,SM,147,15,5,0,20,44,13,0,57
"ERIU SÎNCRAI",SM,495,10,2,0,12,70,14,0,84
"SATU MIC",SM,169,17,5,0,22,52,17,0,69
CRUCIŞOR,SM,466,4,4,0,8,88,19,0,107
IEGHERIŞTE,SM,436,16,4,0,20,76,10,0,86
"POIANA CODRULUI",SM,1226,43,3,0,46,274,8,1,283
"CULCIU MARE",SM,676,7,2,0,9,78,13,0,91
APATEU,SM,273,6,2,0,8,39,6,0,45
CĂRĂŞEU,SM,934,5,0,0,5,59,5,0,64
COROD,SM,412,2,0,0,2,35,8,0,43
"CULCIU MIC",SM,591,7,3,0,10,27,7,0,34
LIPĂU,SM,464,10,6,0,16,45,19,0,64
DOBA,SM,998,14,3,0,17,115,12,0,127
BOGHIŞ,SM,658,1,3,0,4,26,11,0,37
DACIA,SM,132,12,3,0,15,56,19,0,75
PAULIAN,SM,414,14,5,0,19,84,12,0,96
TRAIAN,SM,171,12,7,0,19,48,17,0,65
DOROLŢ,SM,1442,15,5,0,20,79,9,0,88
ATEA,SM,315,4,4,0,8,11,5,0,16
DARA,SM,1020,3,1,0,4,33,2,0,35
PETEA,SM,334,3,3,0,6,20,12,0,32
FOIENI,SM,1614,31,4,0,35,248,6,0,254
"GHERŢA MICĂ",SM,2774,88,8,0,96,475,32,0,507
HALMEU,SM,3031,150,13,0,163,582,26,0,608
BĂBEŞTI,SM,332,2,4,0,6,21,6,0,27
DOBOLŢ,SM,343,2,0,0,2,29,6,0,35
MESTEACĂN,SM,364,14,3,0,17,86,8,0,94
HODOD,SM,708,16,5,0,21,122,5,0,127
"GIURTELECU HODODULUI",SM,478,4,3,0,7,56,24,0,80
LELEI,SM,462,2,5,0,7,86,11,0,97
"NADIŞU HODODULUI",SM,625,26,7,0,33,206,23,0,229
"HOMORODU DE MIJLOC",SM,556,21,2,0,23,113,14,0,127
CHILIA,SM,184,9,6,0,15,38,16,0,54
"HOMORODU DE JOS",SM,300,5,5,0,10,38,13,0,51
NECOPOI,SM,176,4,4,0,8,25,15,0,40
SOLDUBA,SM,206,8,5,0,13,53,17,0,70
LAZURI,SM,2423,48,4,0,52,219,16,0,235
BERCU,SM,520,3,2,0,5,34,7,0,41
NISIPENI,SM,737,7,1,0,8,63,7,0,70
NOROIENI,SM,332,4,0,0,4,28,1,0,29
PELEŞ,SM,744,3,4,0,7,17,6,0,23
PELIŞOR,SM,225,1,2,0,3,21,5,0,26
"MEDIEŞU AURIT",SM,2166,59,11,0,70,349,42,0,391
IOJIB,SM,932,16,2,0,18,104,10,0,114
POTĂU,SM,844,42,6,0,48,161,21,0,182
ROMÂNEŞTI,SM,648,13,1,0,14,146,11,0,157
BĂBĂŞEŞTI,SM,531,6,5,0,11,95,21,0,116
"MEDIEŞ RÎTURI",SM,234,15,1,0,16,61,13,0,74
"MEDIEŞ VII",SM,150,3,0,0,3,32,19,0,51
MICULA,SM,2584,108,6,0,114,434,26,0,460
"MICULA NOUĂ",SM,620,31,0,0,31,153,7,0,160
"MOFTINU MARE",SM,1163,8,5,0,13,101,13,0,114
"MOFTINU MIC",SM,1041,15,2,0,17,161,18,0,179
DOMĂNEŞTI,SM,898,12,1,0,13,124,13,0,137
SÎNMICLĂUŞ,SM,447,1,4,0,5,40,14,0,54
ODOREU,SM,4003,79,8,0,87,375,29,0,404
BERINDAN,SM,105,3,1,0,4,8,5,0,13
MĂRTINEŞTI,SM,714,13,0,0,13,86,7,0,93
"ORAŞU NOU",SM,1607,16,6,0,22,111,10,0,121
"ORAŞU NOU-VII",SM,343,10,2,0,12,50,9,0,59
PRILOG,SM,522,12,0,0,12,111,5,0,116
"PRILOG VII",SM,243,10,7,0,17,81,24,0,105
"REMETEA OAŞULUI",SM,436,13,2,0,15,37,8,0,45
PĂULEŞTI,SM,1407,58,17,0,75,233,48,0,281
AMAŢI,SM,902,9,0,0,9,95,12,0,107
AMBUD,SM,947,19,3,0,22,83,48,0,131
HRIP,SM,543,3,0,0,3,32,5,0,37
PETIN,SM,620,16,2,0,18,61,4,0,65
RUŞENI,SM,196,17,0,0,17,42,14,0,56
PETREŞTI,SM,1316,14,7,0,21,163,11,0,174
"DINDEŞTIU MIC",SM,326,12,5,0,17,48,7,0,55
PIR,SM,1141,14,1,0,15,83,6,0,89
SĂRVĂZEL,SM,105,4,1,0,5,24,6,0,30
PIŞCOLT,SM,1789,18,3,0,21,202,16,0,218
RESIGHEA,SM,346,16,9,0,25,58,19,0,77
"SCĂRIŞOARA NOUĂ",SM,335,12,12,0,24,84,35,0,119
ACIUA,SM,66,10,14,0,24,20,37,0,57
BICĂU,SM,104,4,6,0,10,38,18,0,56
BORLEŞTI,SM,624,15,4,0,19,92,27,0,119
POMI,SM,719,18,0,0,18,109,21,0,130
PORUMBEŞTI,SM,1203,17,0,0,17,160,8,0,168
CIDREAG,SM,853,18,5,0,23,116,8,0,124
RACŞA,SM,2212,491,11,0,502,1073,26,36,1135
"RACŞA VII",SM,222,26,5,0,31,124,8,0,132
SANISLĂU,SM,2596,38,4,0,42,224,26,0,250
HOREA,SM,121,6,6,0,12,27,21,0,48
"MARNA NOUĂ",SM,288,15,4,0,19,107,10,0,117
SANTĂU,SM,1422,30,2,0,32,146,13,0,159
CHEREUŞA,SM,475,6,0,0,6,57,6,0,63
SUDURĂU,SM,141,7,3,0,10,17,4,0,21
SĂCĂŞENI,SM,820,14,2,0,16,51,3,0,54
CHEGEA,SM,137,5,2,0,7,31,9,0,40
SĂUCA,SM,332,12,0,0,12,65,8,0,73
BECHENI,SM,418,12,3,0,15,48,5,0,53
CEAN,SM,223,16,5,0,21,60,14,0,74
SILVAŞ,SM,123,8,12,0,20,34,18,0,52
SOCOND,SM,532,29,6,0,35,169,12,0,181
CUŢA,SM,263,12,3,0,15,50,17,0,67
SOCONZEL,SM,241,6,4,0,10,74,10,0,84
HODIŞA,SM,183,12,5,0,17,66,18,0,84
STÎNA,SM,794,24,0,0,24,248,4,0,252
"SUPURU DE JOS",SM,1012,26,7,0,33,146,31,0,177
DOBRA,SM,768,1,3,0,4,28,11,0,39
GIOROCUTA,SM,585,34,7,0,41,144,18,0,162
"HUREZU MARE",SM,284,16,2,0,18,53,24,0,77
RACOVA,SM,155,4,5,0,9,29,8,0,37
SECHEREŞA,SM,55,7,4,0,11,16,11,0,27
"SUPURU DE SUS",SM,414,14,6,0,20,94,24,0,118
"TARNA MARE",SM,1645,45,5,0,50,350,16,0,366
BOCICĂU,SM,485,15,6,0,21,128,10,0,138
"VALEA SEACĂ",SM,967,24,7,0,31,206,18,0,224
TEREBEŞTI,SM,607,12,1,0,13,78,4,0,82
GELU,SM,422,25,3,0,28,124,12,0,136
PIŞCARI,SM,387,9,0,0,9,141,12,0,153
PORTIŢA,SM,146,7,7,0,14,28,20,0,48
TIREAM,SM,1395,15,6,0,21,94,14,0,108
VEZENDIU,SM,373,6,5,0,11,62,22,0,84
TÎRŞOLŢ,SM,2149,21,1,0,22,212,5,0,217
ALICENI,SM,340,6,2,0,8,39,6,0,45
TURŢ,SM,5105,152,22,1,175,864,39,1,904
"GHERŢA MARE",SM,1344,28,5,0,33,195,9,0,204
TURULUNG,SM,2123,6,7,0,13,116,15,0,131
DRĂGUŞENI,SM,1125,33,6,0,39,200,8,0,208
"TURULUNG VII",SM,160,0,1,0,1,7,1,0,8
URZICENI,SM,1095,15,0,0,15,123,17,0,140
"URZICENI PĂDURE",SM,156,9,7,0,16,23,10,0,33
"VALEA VINULUI",SM,1622,65,25,0,90,321,90,0,411
VAMA,SM,3329,64,5,0,69,366,28,0,394
VETIŞ,SM,1888,18,1,0,19,103,8,0,111
DECEBAL,SM,1103,32,1,0,33,153,11,0,164
OAR,SM,1355,6,0,0,6,21,5,0,26
"VIILE SATU MARE",SM,2029,23,5,0,28,113,18,1,132
CIONCHEŞTI,SM,237,7,5,0,12,38,15,0,53
MEDIŞA,SM,186,2,2,0,4,47,12,0,59
TĂTĂREŞTI,SM,570,18,5,0,23,99,23,0,122
SUCEAVA,SV,104085,7660,783,207,8650,23450,2153,259,25862
"CÂMPULUNG MOLDOVENESC",SV,16750,946,144,48,1138,3434,331,48,3813
FĂLTICENI,SV,26106,1754,167,133,2054,6920,437,141,7498
RĂDĂUŢI,SV,28030,2169,151,50,2370,6989,404,107,7500
"VATRA DORNEI",SV,14079,879,610,35,1524,3268,995,43,4306
HOLDA,SV,1009,35,4,0,39,286,17,0,303
BROŞTENI,SV,2759,85,20,1,106,495,48,1,544
COTÂRGAŞI,SV,1054,22,1,0,23,279,14,0,293
FRASIN,SV,417,21,4,0,25,146,16,0,162
DÂRMOXA,SV,121,6,9,0,15,63,17,0,80
CAJVANA,SV,6838,194,22,0,216,1761,83,4,1848
DOLHASCA,SV,2937,89,14,0,103,512,70,0,582
POIANA,SV,372,2,5,0,7,74,12,0,86
GULIA,SV,1751,55,2,0,57,306,14,0,320
PROBOTA,SV,1466,45,7,0,52,352,48,0,400
POIENARI,SV,240,7,4,0,11,84,10,0,94
"SILIŞTEA NOUĂ",SV,590,12,5,0,17,74,17,0,91
BUDENI,SV,1126,24,4,0,28,201,20,0,221
"VALEA POIENEI",SV,408,6,0,0,6,79,8,0,87
FRASIN,SV,2428,92,18,0,110,466,56,3,525
BUCŞOAIA,SV,1278,102,5,0,107,425,16,0,441
DOROTEIA,SV,737,33,6,0,39,200,18,0,218
PLUTONIŢA,SV,926,59,8,0,67,274,28,0,302
"GURA HUMORULUI",SV,13130,790,101,25,916,2874,305,25,3204
VORONEŢ,SV,672,36,37,0,73,156,53,0,209
LITENI,SV,3885,76,11,0,87,610,40,0,650
ROTUNDA,SV,1845,12,0,0,12,251,17,0,268
ROŞCANI,SV,979,21,9,0,30,246,30,0,276
CORNI,SV,650,14,3,0,17,99,13,0,112
SILIŞTEA,SV,658,1,2,0,3,117,15,0,132
MILIŞĂUŢI,SV,3181,124,4,0,128,918,34,1,953
BĂDEUŢI,SV,1245,50,4,0,54,385,19,0,404
SALCEA,SV,2555,193,13,0,206,855,49,0,904
PLOPENI,SV,1891,150,8,0,158,521,51,0,572
MERENI,SV,1154,86,11,1,98,319,24,2,345
VĂRATEC,SV,1230,95,5,0,100,448,30,0,478
PRELIPCA,SV,1069,132,6,0,138,464,30,0,494
SIRET,SV,8196,467,54,0,521,2121,144,0,2265
SOLCA,SV,2089,109,18,0,127,541,50,1,592
"VICOVU DE SUS",SV,9425,672,30,21,723,3897,138,21,4056
BIVOLĂRIA,SV,2505,374,16,0,390,1093,45,0,1138
ADÂNCATA,SV,2433,110,13,0,123,557,43,0,600
CĂLUGĂRENI,SV,629,30,13,0,43,218,50,0,268
FETEŞTI,SV,464,20,4,0,24,130,18,0,148
ARBORE,SV,4439,268,34,0,302,1524,102,0,1626
CLIT,SV,1043,76,4,0,80,345,28,0,373
BODNĂRENI,SV,253,31,9,0,40,97,17,0,114
BAIA,SV,4621,80,22,0,102,980,55,0,1035
BOGATA,SV,1086,32,11,0,43,278,29,0,307
BĂLĂCEANA,SV,1221,75,16,0,91,337,61,0,398
BĂLCĂUŢI,SV,1221,41,6,0,47,348,31,2,381
NEGOSTINA,SV,1108,68,7,0,75,320,25,0,345
GROPENI,SV,298,9,2,0,11,79,19,0,98
BERCHIŞEŞTI,SV,1963,213,13,0,226,738,94,0,832
CORLATA,SV,399,27,4,0,31,204,20,0,224
BILCA,SV,3069,173,19,0,192,933,61,7,1001
BOGDĂNEŞTI,SV,3262,86,21,0,107,915,75,30,1020
BOROAIA,SV,1560,67,45,0,112,435,121,0,556
GIULEŞTI,SV,451,23,11,0,34,128,21,0,149
BĂRĂŞTI,SV,815,31,7,0,38,309,18,0,327
SĂCUŢA,SV,467,12,4,0,16,205,18,0,223
MOIŞA,SV,563,17,8,0,25,212,34,0,246
BOSANCI,SV,5533,389,29,0,418,1732,95,0,1827
CUMPĂRĂTURA,SV,299,13,7,0,20,113,13,0,126
BOTOŞANA,SV,2098,154,5,0,159,839,37,1,877
BREAZA,SV,1291,47,4,0,51,396,28,0,424
BRODINA,SV,1267,67,5,0,72,432,19,0,451
"BRODINA DE JOS",SV,660,19,5,0,24,164,15,0,179
FALCĂU,SV,1081,101,19,0,120,395,55,0,450
BUNEŞTI,SV,556,26,3,0,29,218,21,13,252
PODENI,SV,463,26,4,0,30,151,10,0,161
PETIA,SV,630,29,2,0,31,174,18,0,192
UNCEŞTI,SV,545,33,4,12,49,213,26,12,251
BURLA,SV,1674,79,4,0,83,433,19,0,452
"PÎRTEŞTII DE SUS",SV,1566,108,5,0,113,576,22,25,623
CACICA,SV,1096,36,9,0,45,269,64,20,353
"SOLONEŢU NOU",SV,681,22,7,0,29,193,26,16,235
RUNCU,SV,162,8,10,0,18,30,42,6,78
CALAFINDEŞTI,SV,1999,231,6,0,237,883,24,0,907
"BOTOŞANIŢA MARE",SV,286,20,9,0,29,128,23,0,151
"CAPU CÂMPULUI",SV,1926,193,19,42,254,867,72,80,1019
CIOCĂNEŞTI,SV,906,48,9,19,76,395,25,19,439
BOTOŞ,SV,337,32,19,12,63,162,26,12,200
"CIPRIAN PORUMBESCU",SV,1566,55,10,0,65,308,41,0,349
"CÎRLIBABA NOUĂ",SV,1563,47,9,0,56,445,34,8,487
COMĂNEŞTI,SV,971,37,15,0,52,270,40,0,310
HUMORENI,SV,904,24,4,0,28,195,11,0,206
"CORNU LUNCII",SV,1047,84,3,0,87,386,29,10,425
BĂIŞEŞTI,SV,1201,79,10,0,89,461,42,9,512
BRĂIEŞTI,SV,1018,40,4,0,44,354,19,0,373
DUMBRAVA,SV,439,15,3,0,18,138,4,0,142
"SASCA NOUĂ",SV,187,11,4,0,15,89,14,0,103
"SASCA MICĂ",SV,613,40,11,0,51,202,32,2,236
ŞINCA,SV,143,11,5,0,16,60,11,1,72
"SASCA MARE",SV,547,22,6,0,28,184,24,6,214
PĂISENI,SV,634,20,4,0,24,249,9,9,267
COŞNA,SV,1245,81,10,0,91,323,26,0,349
CRUCEA,SV,1257,64,3,0,67,388,22,0,410
CHIRIL,SV,454,15,2,0,17,145,26,0,171
DĂRMĂNEŞTI,SV,1791,22,10,0,32,292,41,0,333
MĂRIŢEI,SV,1460,43,2,0,45,369,25,0,394
CĂLINEŞTI,SV,516,14,9,0,23,82,32,0,114
CĂLINEŞTI-VASILACHE,SV,164,13,9,0,22,55,13,0,68
DĂNILA,SV,873,56,12,1,69,270,36,1,307
DOLHEŞTII-MARI,SV,1421,75,12,0,87,422,41,0,463
"DOLHEŞTII MICI",SV,1000,35,5,0,40,271,29,0,300
"VALEA BOUREI",SV,609,18,5,0,23,158,18,0,176
"DORNA CANDRENILOR",SV,1715,91,12,0,103,530,35,1,566
"POIANA NEGRII",SV,786,41,5,0,46,295,25,2,322
DORNA-ARINI,SV,545,12,7,0,19,126,14,0,140
COZĂNEŞTI,SV,1278,63,11,0,74,391,29,0,420
RUSCA,SV,685,27,20,0,47,255,34,0,289
DORNEŞTI,SV,3576,193,10,0,203,961,36,0,997
IAZ,SV,225,6,5,0,11,87,6,0,93
MĂZĂNĂEŞTI,SV,511,6,4,0,10,132,15,1,148
DRĂGOIEŞTI,SV,1528,64,22,0,86,415,80,32,527
LUCĂCEŞTI,SV,220,10,7,0,17,106,20,0,126
DRĂGUŞENI,SV,1822,35,16,0,51,331,51,0,382
BROŞTENI,SV,272,17,4,0,21,105,23,0,128
DUMBRĂVENI,SV,6727,579,53,0,632,2365,154,0,2519
SĂLĂGENI,SV,405,16,5,0,21,97,19,0,116
"FÂNTÂNA MARE",SV,871,34,8,0,42,275,37,0,312
"COTU BĂII",SV,781,33,5,0,38,182,23,0,205
PRAXIA,SV,130,11,2,0,13,42,17,0,59
SPĂTĂREŞTI,SV,367,29,4,0,33,119,13,0,132
FÎNTÎNELE,SV,891,35,5,0,40,181,15,0,196
SLOBOZIA,SV,172,8,4,0,12,43,6,0,49
BĂNEŞTI,SV,932,45,5,0,50,232,22,0,254
STAMATE,SV,1540,50,9,0,59,338,30,0,368
"COTU DOBEI",SV,147,22,10,0,32,57,22,0,79
FORĂŞTI,SV,496,12,3,0,15,125,14,0,139
ANTOCENI,SV,256,12,5,0,17,57,14,0,71
ONICENI,SV,798,19,5,0,24,162,33,0,195
ROŞIORI,SV,294,9,5,0,14,92,27,0,119
RUŞI,SV,326,10,3,0,13,125,11,0,136
ŢOLEŞTI,SV,340,5,3,0,8,78,4,0,82
BOURA,SV,462,13,1,0,14,112,12,0,124
MANOLEA,SV,598,25,2,0,27,176,18,0,194
UIDEŞTI,SV,134,7,2,0,9,60,15,0,75
"FRĂTĂUŢII NOI",SV,3165,153,8,0,161,799,46,0,845
COSTIŞA,SV,1290,79,13,0,92,406,28,0,434
"FRĂTĂUŢII VECHI",SV,2686,112,12,0,124,754,36,0,790
MĂNEUŢI,SV,1752,63,10,0,73,576,21,0,597
FRUMOSU,SV,1833,75,2,0,77,419,14,0,433
DEIA,SV,688,27,0,0,27,229,12,0,241
DRAGOŞA,SV,353,8,2,0,10,82,3,0,85
"FUNDU MOLDOVEI",SV,1582,62,5,0,67,434,32,0,466
COLACU,SV,816,47,5,0,52,278,14,0,292
BOTUŞ,SV,983,29,5,0,34,260,22,0,282
GĂLĂNEŞTI,SV,2276,55,6,0,61,548,26,0,574
GRĂMEŞTI,SV,1674,46,14,0,60,315,41,0,356
BĂLINEŞTI,SV,582,16,9,0,25,112,19,0,131
"BOTOŞANIŢA MICĂ",SV,197,2,4,0,6,62,8,0,70
GRĂNICEŞTI,SV,1900,132,9,2,143,655,31,2,688
DUMBRAVA,SV,331,41,13,0,54,137,21,1,159
"GURA SOLCII",SV,578,31,4,0,35,243,20,0,263
IACOBEŞTI,SV,447,35,8,0,43,182,22,4,208
ROMÂNEŞTI,SV,540,29,6,0,35,193,23,0,216
"SLOBOZIA SUCEVEI",SV,566,34,13,0,47,147,27,1,175
HĂNŢEŞTI,SV,2608,104,13,0,117,840,63,0,903
ARŢARI,SV,506,20,10,0,30,147,16,0,163
HÂRTOP,SV,2013,126,10,0,136,856,31,0,887
"HORODNIC DE JOS",SV,1983,84,10,0,94,707,42,0,749
"HORODNIC DE SUS",SV,3979,322,27,0,349,1663,87,2,1752
HORODNICENI,SV,901,63,8,0,71,274,46,0,320
BOTEŞTI,SV,382,26,4,0,30,102,25,0,127
BRĂDĂŢEL,SV,448,10,7,0,17,148,15,0,163
MIHĂIEŞTI,SV,637,32,4,0,36,185,17,0,202
ROTOPĂNEŞTI,SV,505,25,2,0,27,105,13,0,118
IACOBENI,SV,1516,105,6,0,111,573,47,7,627
MESTECĂNIŞ,SV,263,27,2,0,29,116,8,0,124
IASLOVĂŢ,SV,3084,234,15,0,249,1136,61,0,1197
ILIŞEŞTI,SV,1915,94,50,23,167,711,108,57,876
BRAŞCA,SV,302,16,8,0,24,118,27,0,145
IPOTEŞTI,SV,4108,644,44,0,688,1539,103,0,1642
TIŞĂUŢI,SV,983,96,13,0,109,349,53,0,402
LISAURA,SV,905,88,8,0,96,346,39,0,385
"IZVOARELE SUCEVEI",SV,715,30,3,0,33,210,13,0,223
BOBEICA,SV,346,14,5,0,19,102,9,0,111
BRODINA,SV,585,10,2,0,12,153,36,0,189
MARGINEA,SV,8372,547,40,0,587,2893,168,0,3061
MĂLINI,SV,2833,73,14,0,87,852,54,0,906
PÎRAIE,SV,1548,33,9,0,42,487,21,0,508
"POIANA MĂRULUI",SV,1025,17,3,0,20,239,15,0,254
VĂLENI-STÎNIŞOARA,SV,649,17,3,0,20,242,17,0,259
"MĂNĂSTIREA HUMORULUI",SV,2048,84,7,0,91,431,52,0,483
PLEŞA,SV,171,2,8,0,10,34,11,0,45
"POIANA MICULUI",SV,841,20,15,0,35,228,27,0,255
"MITOCU DRAGOMIRNEI",SV,2881,205,39,0,244,1042,140,1,1183
MITOCAŞI,SV,702,28,4,0,32,240,23,0,263
LIPOVENI,SV,390,16,0,0,16,98,7,0,105
"MOARA NICA",SV,2601,121,12,0,133,642,37,0,679
"MOARA CARP",SV,709,38,3,0,41,207,13,0,220
FRUMOASA,SV,201,14,5,0,19,73,17,0,90
LITENI,SV,737,23,4,0,27,161,16,0,177
"VORNICENII MARI",SV,215,10,5,0,15,49,17,0,66
MOLDOVA-SULIŢA,SV,1042,29,8,0,37,259,16,0,275
BENIA,SV,531,25,1,0,26,179,11,0,190
MOLDOVIŢA,SV,1887,79,15,0,94,424,44,0,468
ARGEL,SV,823,20,4,0,24,204,16,0,220
DEMACUŞA,SV,808,25,1,0,26,198,12,0,210
RAŞCA,SV,655,14,0,0,14,147,11,0,158
BAINEŢ,SV,251,14,3,0,17,79,13,0,92
CLIMĂUŢI,SV,318,9,4,0,13,63,15,0,78
VICŞANI,SV,187,7,3,0,10,54,7,0,61
MUŞENIŢA,SV,309,14,4,0,18,87,13,0,100
VĂŞCĂUŢI,SV,501,14,5,0,19,77,13,0,90
OSTRA,SV,2796,83,12,0,95,606,22,1,629
PANACI,SV,669,25,13,0,38,280,32,0,312
COVERCA,SV,666,30,0,0,30,346,13,1,360
PĂLTINIŞ,SV,269,25,8,0,33,132,19,0,151
GLODU,SV,282,15,7,0,22,137,16,0,153
PĂLTINOASA,SV,2619,111,31,0,142,969,91,0,1060
"CAPU CODRULUI",SV,2143,84,15,0,99,746,28,3,777
PĂTRĂUŢI,SV,3889,219,32,0,251,1311,96,0,1407
"PÎRTEŞTII DE JOS",SV,1592,85,6,0,91,531,42,2,575
DELENI,SV,574,29,6,0,35,166,22,0,188
"VÎRFU DEALULUI",SV,138,2,6,0,8,31,12,0,43
"POIANA STAMPEI",SV,1603,115,4,0,119,638,23,0,661
DORNIŞOARA,SV,253,35,9,0,44,122,19,0,141
POIENI-SOLCA,SV,1714,55,2,0,57,503,27,0,530
POJORÎTA,SV,2211,179,97,13,289,749,132,14,895
"VALEA PUTNEI",SV,297,23,3,0,26,83,7,0,90
ARGHIRA,SV,927,34,11,0,45,271,45,0,316
BASARABI,SV,1420,28,2,0,30,406,20,0,426
"BAHNA ARIN",SV,178,29,0,0,29,101,13,0,114
PREUTEŞTI,SV,1529,65,9,0,74,625,51,0,676
HUŞI,SV,559,47,7,0,54,262,21,0,283
LEUCUŞEŞTI,SV,924,57,7,0,64,407,31,0,438
PUTNA,SV,2093,295,97,0,392,826,156,0,982
"GURA PUTNEI",SV,1096,33,0,0,33,370,10,0,380
RĂDĂŞENI,SV,2241,91,18,0,109,728,87,0,815
LĂMĂŞENI,SV,1045,29,5,0,34,393,26,1,420
POCOLENI,SV,165,12,0,0,12,51,12,0,63
RÎŞCA,SV,2260,66,12,0,78,690,50,0,740
JAHALIA,SV,248,9,6,0,15,70,14,0,84
BUDA,SV,604,14,12,0,26,214,32,4,250
DUMBRĂVENI,SV,318,13,3,0,16,116,14,0,130
SLĂTIOARA,SV,635,28,8,0,36,231,27,0,258
SADOVA,SV,2065,101,3,0,104,633,26,0,659
"SATU MARE",SV,2375,88,8,1,97,609,33,1,643
ŢIBENI,SV,1156,37,0,0,37,250,10,0,260
SIMINICEA,SV,2107,133,7,0,140,489,41,0,530
GRIGOREŞTI,SV,260,14,9,0,23,60,29,0,89
SLATINA,SV,1558,35,5,34,74,635,36,35,706
HERLA,SV,1100,65,6,0,71,545,36,9,590
GĂINEŞTI,SV,1625,69,5,18,92,780,32,18,830
STRAJA,SV,4511,252,40,0,292,1426,75,1,1502
STROIEŞTI,SV,2135,89,10,0,99,526,39,0,565
ZAHAREŞTI,SV,612,13,5,0,18,189,26,0,215
STULPICANI,SV,2329,133,14,0,147,694,30,0,724
NEGRILEASA,SV,839,26,5,0,31,245,9,0,254
"VADU NEGRILESEI",SV,465,14,3,0,17,181,20,0,201
GEMENEA,SV,645,13,2,0,15,172,12,0,184
SLĂTIOARA,SV,501,20,8,0,28,168,14,0,182
SUCEVIŢA,SV,1372,151,31,0,182,458,68,2,528
VOIEVODEASA,SV,1035,100,10,0,110,446,22,0,468
"NEAGRA ŞARULUI",SV,1609,120,5,0,125,559,28,1,588
"ŞARU DORNEI",SV,943,29,3,0,32,287,19,0,306
"GURA HAITII",SV,485,31,0,0,31,188,7,0,195
"SĂRIŞORU MARE",SV,451,20,0,0,20,164,4,0,168
"SFÎNTU ILIE",SV,3909,245,20,0,265,905,51,0,956
FLORINTA,SV,172,4,0,0,4,42,8,0,50
ŞCHEIA,SV,3208,216,49,0,265,893,104,0,997
MIHOVENI,SV,1820,71,3,0,74,461,32,0,493
ŞERBĂUŢI,SV,1620,66,4,0,70,408,34,0,442
CĂLINEŞTI,SV,983,26,6,0,32,274,21,0,295
TODIREŞTI,SV,1216,47,3,0,50,302,38,0,340
COSTÎNA,SV,931,45,14,0,59,273,46,21,340
PĂRHĂUŢI,SV,1015,28,8,0,36,188,22,0,210
SOLONEŢ,SV,1294,41,8,0,49,239,25,0,264
UDEŞTI,SV,1976,94,9,0,103,510,62,1,573
POIENI-SUCEAVA,SV,466,67,16,0,83,202,41,0,243
CHILIŞENI,SV,628,20,4,0,24,302,22,0,324
ŞTIRBĂŢ,SV,455,50,12,0,62,163,38,0,201
RACOVA,SV,240,19,2,0,21,111,15,0,126
RUŞII-MĂNĂSTIOARA,SV,426,37,3,0,40,137,32,0,169
LUNCUŞOARA,SV,521,111,9,0,120,253,29,0,282
REUSENI,SV,522,28,4,0,32,194,30,0,224
PLĂVĂLARI,SV,885,79,5,0,84,364,23,0,387
ULMA,SV,551,16,7,0,23,145,8,0,153
LUPCINA,SV,788,33,7,0,40,325,36,0,361
NISIPITU,SV,356,24,3,0,27,130,11,0,141
"VADU MOLDOVEI",SV,1196,60,9,0,69,399,56,14,469
DUMBRĂVIŢA,SV,826,24,3,0,27,196,27,0,223
NIGOTEŞTI,SV,358,15,11,0,26,86,18,0,104
MOVILENI,SV,230,3,7,0,10,63,9,0,72
MESTECENI,SV,159,4,6,0,10,41,18,0,59
IONEASA,SV,281,18,7,0,25,101,20,0,121
CIUMULEŞTI,SV,693,135,19,0,154,289,44,0,333
"VALEA MOLDOVEI",SV,1329,35,13,0,48,336,23,0,359
MIRONU,SV,1561,55,2,0,57,594,14,0,608
VAMA,SV,2704,77,14,16,107,470,38,16,524
STRÎMTURA,SV,1037,13,7,0,20,179,48,2,229
MOLID,SV,522,28,6,0,34,165,20,0,185
"PRISACA DORNEI",SV,684,40,3,0,43,167,24,0,191
"VATRA MOLDOVIŢEI",SV,1821,86,15,0,101,440,62,0,502
CIUMÎRNA,SV,381,10,1,0,11,122,11,0,133
PALTINU,SV,1368,27,0,0,27,348,18,0,366
VEREŞTI,SV,1256,65,4,0,69,327,23,0,350
HANCEA,SV,889,21,2,0,23,261,16,0,277
COROCĂIEŞTI,SV,2332,107,12,0,119,583,41,0,624
BURSUCENI,SV,1149,53,5,0,58,327,23,0,350
"VICOVU DE JOS",SV,5142,320,23,0,343,1864,74,0,1938
VOITINEL,SV,3251,395,18,31,444,1315,55,31,1401
VOLOVĂŢ,SV,4190,307,6,0,313,1508,31,2,1541
PLEŞEŞTI,SV,499,12,8,0,20,150,25,0,175
"VALEA GLODULUI",SV,734,30,4,0,34,164,11,0,175
GIURGEŞTI,SV,590,10,2,0,12,100,17,0,117
HREAŢCA,SV,329,7,4,0,11,70,14,0,84
MEREŞTI,SV,201,11,5,0,16,66,22,0,88
JACOTA,SV,114,8,4,0,12,29,14,0,43
OSOI,SV,275,8,3,0,11,75,19,0,94
ZAMOSTEA,SV,1234,40,8,0,48,423,36,0,459
CIOMÎRTAN,SV,465,16,8,0,24,158,22,0,180
LUNCA,SV,208,6,2,0,8,67,10,0,77
NICANI,SV,409,28,7,0,35,154,16,0,170
TĂUTEŞTI,SV,150,12,5,0,17,63,16,0,79
ZVORIŞTEA,SV,777,24,2,50,76,159,28,50,237
DEALU,SV,654,23,0,0,23,118,16,0,134
BUDA,SV,930,46,0,0,46,263,12,0,275
STÎNCA,SV,476,9,5,0,14,90,14,0,104
STÎNCUŢA,SV,130,2,3,0,5,38,17,0,55
POIANA,SV,453,61,7,0,68,205,39,2,246
ŞERBĂNEŞTI,SV,925,32,3,1,36,259,24,1,284
SLOBOZIA,SV,490,16,9,0,25,106,18,0,124
TULCEA,TL,72841,3193,353,96,3642,9514,965,336,10815
BABADAG,TL,7961,257,36,0,293,764,77,0,841
ISACCEA,TL,3826,94,7,0,101,368,33,1,402
REVĂRSAREA,TL,407,10,2,0,12,33,13,0,46
MĂCIN,TL,9055,220,18,0,238,880,58,0,938
SULINA,TL,3454,110,38,0,148,418,58,0,476
BAIA,TL,2368,72,7,0,79,246,23,2,271
CAMENA,TL,309,21,4,0,25,51,10,0,61
CAUGAGIA,TL,181,7,8,0,15,29,11,0,40
PANDURU,TL,319,8,1,0,9,19,6,0,25
"CEAMURLIA DE SUS",TL,540,13,1,0,14,31,4,0,35
BEIDAUD,TL,429,20,13,0,33,120,41,0,161
NEATÎRNAREA,TL,383,10,3,0,13,71,16,0,87
"SARIGHIOL DE DEAL",TL,465,48,5,0,53,160,41,0,201
BEŞTEPE,TL,1418,21,3,0,24,141,12,0,153
"BĂLTENII DE JOS",TL,57,6,3,0,9,12,11,0,23
LETEA,TL,241,11,3,0,14,28,6,0,34
PERIPRAVA,TL,180,7,8,0,15,20,16,0,36
"C.A. ROSETTI",TL,243,11,4,0,15,46,10,1,57
CARCALIU,TL,2538,33,7,0,40,274,24,0,298
"CIŞMEAUA NOUĂ",TL,36,13,4,0,17,27,5,0,32
CASIMCEA,TL,1115,38,4,0,42,196,25,0,221
CORUGEA,TL,336,8,1,0,9,30,6,0,36
RAHMAN,TL,249,22,3,0,25,64,6,0,70
RĂZBOIENI,TL,495,11,0,0,11,92,8,0,100
"CEAMURLIA DE JOS",TL,988,25,4,0,29,70,12,0,82
LUNCA,TL,1039,30,5,0,35,86,12,0,98
PĂTLĂGEANCA,TL,172,17,5,0,22,40,14,0,54
CEATALCHIOI,TL,387,13,6,0,19,59,21,0,80
PLAURU,TL,36,4,13,0,17,13,16,0,29
"MIRCEA VODĂ",TL,407,9,3,0,12,42,5,1,48
CERNA,TL,1716,46,4,0,50,234,10,0,244
TRAIAN,TL,821,20,4,0,24,85,20,0,105
"GENERAL PRAPORGESCU",TL,154,9,3,0,12,25,11,0,36
"CHILIA VECHE",TL,1670,28,13,0,41,148,34,0,182
CIUCUROVA,TL,1117,32,4,0,36,161,21,0,182
ATMAGEA,TL,150,2,5,0,7,11,9,0,20
"FÎNTÎNA MARE",TL,442,16,5,0,21,61,12,0,73
CRIŞAN,TL,380,19,19,0,38,66,45,0,111
CARAORMAN,TL,249,6,0,0,6,36,7,0,43
"MILA 23",TL,382,10,20,0,30,52,40,0,92
DĂENI,TL,1665,19,5,0,24,122,10,0,132
DOROBANŢU,TL,636,22,7,0,29,156,17,2,175
CÎRJELARI,TL,362,9,5,0,14,25,11,0,36
MEŞTERU,TL,127,4,2,0,6,12,2,0,14
FRECĂŢEI,TL,1016,32,4,0,36,81,16,0,97
CATALOI,TL,1037,22,0,0,22,95,22,0,117
POŞTA,TL,525,31,19,0,50,73,37,0,110
TELIŢA,TL,438,7,3,0,10,63,28,0,91
GRECI,TL,4354,74,12,0,86,288,36,0,324
GRINDU,TL,1139,17,1,0,18,98,10,0,108
HAMCEARCA,TL,281,9,1,0,10,31,10,0,41
BALABANCEA,TL,271,22,7,0,29,69,17,0,86
NIFON,TL,539,9,4,0,13,41,12,0,53
CLOŞCA,TL,98,10,6,0,16,35,12,0,47
FLOREŞTI,TL,223,12,2,0,14,69,18,0,87
HORIA,TL,831,48,8,0,56,213,28,2,243
I.C.BRĂTIANU,TL,959,21,7,0,28,77,34,0,111
IZVOARELE,TL,1309,16,2,0,18,110,16,0,126
ALBA,TL,207,13,13,0,26,24,16,0,40
IULIA,TL,261,16,7,0,23,47,13,0,60
JIJILA,TL,3501,33,1,0,34,364,14,0,378
GARVĂN,TL,1103,17,9,0,26,130,28,0,158
SĂLCIOARA,TL,1052,62,14,0,76,257,26,0,283
VIŞINA,TL,598,26,4,0,30,87,17,0,104
JURILOVCA,TL,2056,66,18,0,84,329,41,0,370
LUNCAVIŢA,TL,2927,41,15,0,56,221,42,0,263
RACHELU,TL,623,14,9,0,23,84,18,0,102
MAHMUDIA,TL,2212,93,24,0,117,386,61,0,447
GORGOVA,TL,105,12,2,0,14,36,10,0,46
MALIUC,TL,328,8,4,0,12,43,15,0,58
PARTIZANI,TL,363,11,4,0,15,45,7,0,52
"SATU NOU",TL,567,26,3,0,29,105,13,0,118
"MIHAI BRAVU",TL,555,8,5,0,13,27,10,0,37
TURDA,TL,986,20,2,0,22,106,11,0,117
LĂSTUNI,TL,418,32,7,0,39,69,14,0,83
RÎNDUNICA,TL,529,40,2,0,42,82,5,0,87
"MIHAIL KOGĂLNICEANU",TL,1643,45,2,0,47,163,11,0,174
MURIGHIOL,TL,1212,30,43,0,73,102,88,0,190
COLINA,TL,125,3,4,0,7,24,13,0,37
"DUNAVĂŢU DE JOS",TL,526,11,7,0,18,31,30,0,61
"DUNAVĂŢU DE SUS",TL,122,1,10,0,11,3,21,0,24
PLOPUL,TL,507,13,6,0,19,32,11,0,43
SARINASUF,TL,363,18,3,0,21,54,11,0,65
TRESTENIC,TL,268,10,9,0,19,31,13,0,44
NALBANT,TL,777,8,2,0,10,75,13,0,88
"NICOLAE BĂLCESCU",TL,1040,24,2,0,26,141,12,0,153
NICULIŢEL,TL,3791,100,25,0,125,498,77,1,576
VICTORIA,TL,179,8,9,0,17,27,26,0,53
NUFĂRU,TL,1044,19,11,0,30,123,48,0,171
MALCOCI,TL,1020,45,3,0,48,135,22,0,157
OSTROV,TL,1587,69,5,0,74,424,25,5,454
PARDINA,TL,471,21,8,0,29,43,17,0,60
PECENEAGA,TL,1425,35,2,0,37,217,22,0,239
SABANGIA,TL,457,7,3,0,10,43,12,0,55
VISTERNA,TL,331,7,4,0,11,33,6,0,39
ENISALA,TL,788,6,0,0,6,93,7,0,100
ZEBIL,TL,1133,18,2,0,20,94,9,0,103
SARICHIOI,TL,3005,54,11,0,65,317,27,0,344
"SFÎNTU GHEORGHE",TL,711,31,37,0,68,81,49,0,130
"SLAVA CERCHEZĂ",TL,1041,6,0,0,6,75,21,0,96
"SLAVA RUSĂ",TL,921,8,2,0,10,58,14,0,72
SMÎRDAN,TL,901,8,1,0,9,58,6,0,64
MINERI,TL,1418,17,3,0,20,120,7,0,127
PARCHEŞ,TL,650,6,0,0,6,43,2,0,45
SOMOVA,TL,1946,23,1,0,24,122,24,1,147
STEJARU,TL,512,19,5,0,24,79,17,1,97
"MINA ALTÎN TEPE",TL,348,16,2,0,18,70,11,0,81
"VASILE ALECSANDRI",TL,393,20,9,0,29,78,16,0,94
TOPOLOG,TL,1894,70,9,0,79,365,34,0,399
CALFA,TL,102,7,4,0,11,16,6,0,22
CERBU,TL,183,3,2,0,5,8,8,0,16
"FĂGĂRAŞU NOU",TL,517,9,4,0,13,45,9,0,54
LUMINIŢA,TL,210,11,3,0,14,39,8,0,47
MĂGURELE,TL,199,7,8,0,15,39,17,0,56
"SÎMBĂTA NOUĂ",TL,435,13,3,0,16,62,16,0,78
TURCOAIA,TL,2711,65,4,0,69,336,14,0,350
"VALEA NUCARILOR",TL,816,22,11,0,33,119,26,0,145
AGIGHIOL,TL,1429,16,1,0,17,109,12,0,121
IAZURILE,TL,678,18,3,0,21,112,14,0,126
"VALEA TEILOR",TL,1129,12,0,0,12,167,14,0,181
VĂCĂRENI,TL,1816,33,3,0,36,163,26,0,189
TIMIŞOARA,TM,279461,17006,2456,235,19697,41055,6170,1037,48262
LUGOJ,TM,38734,2274,155,16,2445,6296,473,18,6787
MĂGURI,TM,762,47,9,0,56,100,13,0,113
TAPIA,TM,253,10,9,0,19,61,20,0,81
BUZIAŞ,TM,4688,232,139,46,417,648,271,47,966
BACOVA,TM,1608,39,6,0,45,144,22,0,166
SILAGIU,TM,658,26,4,0,30,119,9,0,128
CIACOVA,TM,2303,94,10,0,104,225,35,13,273
CEBZA,TM,611,52,15,0,67,123,42,0,165
MACEDONIA,TM,366,23,4,0,27,64,20,0,84
OBAD,TM,517,10,2,0,12,104,16,0,120
PETROMAN,TM,565,23,3,0,26,93,19,0,112
DETA,TM,5803,257,14,0,271,622,55,6,683
OPATIŢA,TM,565,18,0,0,18,64,8,0,72
FĂGET,TM,3293,250,24,0,274,923,75,13,1011
BĂTEŞTI,TM,398,28,2,0,30,137,11,0,148
"BEGHEIU MIC",TM,277,15,3,0,18,90,6,0,96
BICHIGI,TM,500,54,12,0,66,184,25,0,209
BRĂNEŞTI,TM,409,23,4,0,27,133,21,0,154
"BUNEA MARE",TM,172,2,0,0,2,39,4,0,43
"COLONIA MICĂ",TM,269,33,2,0,35,131,17,0,148
JUPÂNEŞTI,TM,149,7,3,0,10,47,3,0,50
POVÂRGINA,TM,135,2,0,0,2,30,7,0,37
TEMEREŞTI,TM,436,62,6,0,68,231,18,11,260
GĂTAIA,TM,2746,137,23,0,160,427,55,20,502
SCULIA,TM,1621,131,8,0,139,419,26,65,510
BUTIN,TM,318,15,8,0,23,76,14,0,90
PERCOSOVA,TM,226,3,6,0,9,19,18,0,37
"ŞEMLACU MARE",TM,268,11,11,0,22,40,34,0,74
"ŞEMLACU MIC",TM,147,5,6,0,11,18,14,0,32
JIMBOLIA,TM,11087,377,44,0,421,1042,154,19,1215
RECAŞ,TM,4874,167,40,0,207,747,101,0,848
BAZOŞ,TM,789,32,9,0,41,116,36,0,152
HERNEACOVA,TM,367,23,9,0,32,86,24,0,110
IZVIN,TM,1300,148,14,0,162,338,42,0,380
PETROVASELO,TM,207,15,12,0,27,40,25,0,65
STANCIOVA,TM,304,16,3,0,19,32,22,0,54
"SÂNNICOLAU MARE",TM,11818,528,64,16,608,1419,129,16,1564
BALINŢ,TM,420,22,16,0,38,75,50,0,125
BODO,TM,402,10,2,0,12,21,13,0,34
FĂDIMAC,TM,190,7,9,0,16,53,18,0,71
TÎRGOVIŞTE,TM,275,17,5,0,22,67,9,0,76
BANLOC,TM,1356,65,3,0,68,184,10,0,194
OFSENIŢA,TM,331,17,3,0,20,51,6,0,57
PARTOŞ,TM,372,8,1,0,9,31,10,0,41
SOCA,TM,449,46,6,0,52,137,21,0,158
BARA,TM,139,19,23,2,44,55,45,2,102
DOBREŞTI,TM,33,11,10,0,21,18,28,0,46
LĂPUŞNIC,TM,38,13,7,0,20,20,12,0,32
RĂDMĂNEŞTI,TM,48,13,7,0,20,17,17,0,34
"BEBA VECHE",TM,856,33,9,0,42,214,30,0,244
CHERESTUR,TM,417,16,0,0,16,99,9,0,108
"BECICHERECU MIC",TM,2659,94,30,0,124,403,104,0,507
BELINŢ,TM,1187,56,13,0,69,308,53,0,361
BABŞA,TM,190,9,3,0,12,38,17,0,55
GRUNI,TM,177,17,4,0,21,77,32,0,109
CHIZĂTĂU,TM,630,23,7,0,30,114,39,0,153
BETHAUSEN,TM,697,37,3,0,40,189,14,0,203
CLADOVA,TM,368,46,3,0,49,154,11,2,167
CLICIOVA,TM,344,24,3,0,27,139,14,0,153
CUTINA,TM,242,17,5,0,22,60,18,0,78
LEUCUŞEŞTI,TM,354,34,1,0,35,148,19,0,167
NEVRINCEA,TM,189,26,2,0,28,63,13,0,76
BILED,TM,3392,76,14,0,90,342,43,0,385
BIRDA,TM,920,33,8,0,41,262,25,0,287
BERECUŢA,TM,148,23,7,0,30,49,12,0,61
MÂNĂSTIRE,TM,176,23,8,0,31,57,19,0,76
SÂNGEORGE,TM,440,21,1,0,22,88,11,0,99
BÎRNA,TM,422,21,7,0,28,79,19,0,98
BOTINEŞTI,TM,164,12,6,0,18,60,15,0,75
DRINOVA,TM,162,18,4,0,22,81,12,0,93
JUREŞTI,TM,187,8,3,0,11,65,12,0,77
POGĂNEŞTI,TM,271,20,5,0,25,85,16,0,101
BOGDA,TM,255,9,8,0,17,39,34,0,73
BUZAD,TM,152,14,9,0,23,39,20,0,59
BOLDUR,TM,488,34,5,0,39,111,23,0,134
JABĂR,TM,359,18,6,0,24,69,27,0,96
OHABA-FORGACI,TM,634,24,6,0,30,111,30,0,141
SINERSIG,TM,501,44,7,0,51,129,21,0,150
BRESTOVĂŢ,TM,232,7,3,0,10,24,6,0,30
COŞARII,TM,110,4,2,0,6,6,5,0,11
TEŞ,TM,229,22,3,0,25,64,13,0,77
BUCOVĂŢ,TM,1259,49,14,0,63,172,39,1,212
"BAZOŞU NOU",TM,294,18,18,0,36,70,29,0,99
CĂRPINIŞ,TM,3508,228,20,0,248,567,46,0,613
"IECEA MICĂ",TM,1035,42,9,0,51,152,18,0,170
CENAD,TM,3889,93,13,0,106,266,40,0,306
CENEI,TM,1821,55,12,0,67,188,33,0,221
BOBDA,TM,777,34,3,0,37,83,13,0,96
CHECEA,TM,1662,40,13,6,59,135,29,6,170
"CHEVEREŞU MARE",TM,1081,30,8,0,38,77,24,0,101
DRAGŞINA,TM,489,34,12,0,46,96,40,0,136
VUCOVA,TM,314,19,7,0,26,61,33,0,94
"COMLOŞU MARE",TM,2935,88,14,0,102,413,47,22,482
"COMLOŞU MIC",TM,890,28,0,0,28,119,6,0,125
LUNGA,TM,451,23,4,0,27,96,24,0,120
COŞTEIU,TM,1893,86,19,0,105,293,41,0,334
HEZERIŞ,TM,221,20,4,0,24,76,10,0,86
PĂRU,TM,195,12,4,0,16,48,11,0,59
ŢIPARI,TM,721,16,5,0,21,68,10,0,78
"VALEA LUNGĂ ROMÂNĂ",TM,123,6,0,0,6,22,9,0,31
CRICIOVA,TM,594,40,5,0,45,253,23,0,276
CIREŞU,TM,290,12,5,0,17,87,25,0,112
JDIOARA,TM,463,32,4,0,36,194,22,0,216
CURTEA,TM,534,46,5,0,51,191,28,0,219
COŞAVA,TM,456,16,1,0,17,116,24,0,140
DAROVA,TM,1730,28,1,0,29,244,15,0,259
HODOŞ,TM,299,14,2,0,16,51,9,0,60
"SACOŞU MARE",TM,716,24,6,0,30,89,16,0,105
DENTA,TM,1950,57,6,0,63,290,22,0,312
BREŞTEA,TM,407,13,2,0,15,91,19,0,110
"ROVINIŢA MARE",TM,306,16,8,0,24,47,11,0,58
"DUDEŞTII NOI",TM,2833,104,10,0,114,366,47,0,413
"DUDEŞTII VECHI",TM,3095,66,13,0,79,202,38,0,240
CHEGLEVICI,TM,575,11,3,0,14,30,13,0,43
DUMBRAVA,TM,902,19,1,0,20,117,10,1,128
BUCOVĂŢ,TM,420,12,4,0,16,153,13,0,166
RĂCHITA,TM,923,41,4,0,45,159,13,0,172
DUMBRĂVIŢA,TM,9573,490,85,0,575,1419,308,0,1727
FIBIŞ,TM,1403,35,11,0,46,239,50,0,289
FÎRDEA,TM,583,55,29,2,86,182,50,6,238
DRĂGSINEŞTI,TM,385,25,9,0,34,136,17,0,153
"GLADNA ROMÂNA",TM,450,48,15,0,63,145,31,0,176
FOENI,TM,992,30,7,0,37,134,31,0,165
CRUCENI,TM,447,9,4,0,13,35,10,0,45
GAVOJDIA,TM,1095,57,11,0,68,211,25,0,236
JENA,TM,419,14,3,0,17,76,15,0,91
LUGOJEL,TM,569,25,5,0,30,105,23,0,128
SĂLBĂGEL,TM,246,17,1,0,18,109,11,0,120
GHILAD,TM,1541,57,5,0,62,179,25,0,204
GAD,TM,115,5,8,0,13,9,14,0,23
GHIRODA,TM,4425,355,57,1,413,1057,166,1,1224
GIARMATA-VII,TM,1549,126,19,0,145,393,56,0,449
GHIZELA,TM,375,24,6,0,30,87,20,0,107
PANIOVA,TM,207,16,7,0,23,45,19,0,64
ŞANOVIŢA,TM,394,24,2,0,26,75,12,0,87
GIARMATA,TM,4926,201,39,0,240,664,98,0,762
CERNETEAZ,TM,1105,53,15,0,68,154,48,0,202
GIERA,TM,644,23,0,0,23,58,2,0,60
GRĂNICERII,TM,203,13,6,0,19,29,8,0,37
TOAGER,TM,311,8,2,0,10,36,13,0,49
GIROC,TM,9120,489,84,0,573,1426,287,0,1713
CHIŞODA,TM,3095,201,28,0,229,557,97,0,654
GIULVĂZ,TM,1041,48,8,0,56,148,19,0,167
"CRAI NOU",TM,340,15,8,0,23,53,28,0,81
IVANDA,TM,481,25,5,0,30,103,15,0,118
RUDNA,TM,582,11,9,0,20,39,16,0,55
GOTTLOB,TM,1834,76,8,0,84,247,22,0,269
VIZEJDIA,TM,372,9,4,0,13,33,7,0,40
"IECEA MARE",TM,2181,57,12,0,69,318,41,0,359
"JAMU MARE",TM,1183,54,4,0,58,159,21,0,180
CLOPODIA,TM,576,23,4,0,27,86,13,0,99
FERENDIA,TM,350,27,3,0,30,64,19,0,83
GHERMAN,TM,193,9,10,0,19,45,19,0,64
LĂŢUNAŞ,TM,198,9,5,0,14,31,22,0,53
JEBEL,TM,2994,247,37,0,284,708,113,74,895
LENAUHEIM,TM,1560,44,9,0,53,164,25,0,189
BULGĂRUŞ,TM,1801,50,3,0,53,211,20,0,231
GRABĂŢ,TM,1772,40,5,0,45,146,19,0,165
LIEBLING,TM,2853,100,12,0,112,342,47,0,389
CERNA,TM,190,4,12,0,16,22,37,0,59
IOSIF,TM,297,16,5,0,21,61,13,0,74
LIVEZILE,TM,900,29,1,0,30,94,5,0,99
DOLAŢ,TM,446,19,0,0,19,58,6,0,64
LOVRIN,TM,3401,103,13,0,116,384,43,0,427
MARGINA,TM,971,58,7,0,65,308,22,0,330
BREAZOVA,TM,213,26,10,0,36,106,19,0,125
"COŞTEIU DE SUS",TM,175,13,7,0,20,56,16,0,72
GROŞI,TM,71,6,6,0,12,21,14,0,35
SINTEŞTI,TM,407,34,7,0,41,152,31,0,183
MAŞLOC,TM,864,17,17,0,34,82,28,0,110
ALIOŞ,TM,686,48,16,0,64,151,56,10,217
"REMETEA MICĂ",TM,459,15,3,0,18,72,12,0,84
MĂNĂŞTIUR,TM,970,41,2,0,43,190,14,0,204
PĂDURANI,TM,61,9,7,0,16,24,10,0,34
REMETEA-LUNCĂ,TM,324,28,1,0,29,125,7,0,132
MORAVIŢA,TM,1001,52,0,0,52,136,10,0,146
DEJAN,TM,218,15,3,0,18,34,8,0,42
"GAIU MIC",TM,132,26,4,0,30,45,9,0,54
"STAMORA GERMANĂ",TM,828,25,2,0,27,94,10,0,104
"MOŞNIŢA NOUĂ",TM,3446,242,39,0,281,647,151,0,798
ALBINA,TM,324,17,7,0,24,62,29,0,91
"MOŞNIŢA VECHE",TM,2437,174,38,0,212,480,91,0,571
URSENI,TM,1375,61,11,0,72,179,34,0,213
NĂDRAG,TM,2181,124,19,0,143,622,56,0,678
CRIVINA,TM,240,24,6,0,30,105,19,0,124
NIŢCHIDORF,TM,1069,44,4,0,48,174,21,0,195
BLAJOVA,TM,87,8,8,0,16,38,18,0,56
DUBOZ,TM,150,15,5,0,20,44,28,0,72
"OHABA LUNGĂ",TM,314,19,4,0,23,100,13,0,113
DUBEŞTI,TM,197,11,5,0,16,59,11,0,70
IERŞNIC,TM,135,19,7,0,26,72,23,2,97
"OHABA ROMÂNĂ",TM,172,25,6,0,31,63,13,0,76
ORŢIŞOARA,TM,2119,97,10,0,107,301,46,0,347
CĂLACEA,TM,605,21,8,0,29,119,31,0,150
CORNEŞTI,TM,528,16,7,3,26,57,29,3,89
SECEANI,TM,472,23,3,0,26,68,15,0,83
OTELEC,TM,657,9,7,0,16,51,16,0,67
IOHANISFELD,TM,843,29,0,0,29,117,7,0,124
PARŢA,TM,1891,109,17,0,126,335,73,0,408
PĂDURENI,TM,1503,37,10,0,47,155,44,0,199
"PECIU NOU",TM,2963,94,18,0,112,340,56,0,396
DINIAŞ,TM,885,25,11,0,36,109,29,0,138
"SÎNMARTINU SÎRBESC",TM,810,28,10,0,38,88,32,0,120
PERIAM,TM,4135,144,57,0,201,473,173,0,646
PESAC,TM,1826,133,12,0,145,456,45,0,501
PIETROASA,TM,276,19,2,0,21,133,6,0,139
"CRIVINA DE SUS",TM,168,20,5,0,25,101,11,0,112
FĂRĂŞEŞTI,TM,179,17,3,0,20,97,4,0,101
POIENI,TM,215,19,1,0,20,141,14,0,155
PIŞCHIA,TM,1063,46,12,0,58,155,23,0,178
"BENCECU DE JOS",TM,322,50,12,0,62,174,37,0,211
"BENCECU DE SUS",TM,762,39,5,0,44,200,20,0,220
MURANI,TM,482,22,5,0,27,78,24,1,103
RACOVIŢA,TM,680,42,13,0,55,140,35,0,175
CĂPĂT,TM,210,14,3,0,17,45,15,0,60
DRĂGOIEŞTI,TM,313,5,6,0,11,45,15,0,60
FICĂTAR,TM,321,12,4,0,16,49,11,0,60
HITIAŞ,TM,675,32,10,0,42,141,20,0,161
SÂRBOVA,TM,231,19,7,0,26,40,11,0,51
"REMETEA MARE",TM,1384,44,14,0,58,212,49,0,261
IANOVA,TM,785,30,14,0,44,128,42,0,170
"SACOŞU TURCESC",TM,752,37,3,0,40,124,28,0,152
BERINI,TM,403,6,3,0,9,31,14,0,45
ICLODA,TM,213,13,9,0,22,38,29,0,67
OTVEŞTI,TM,283,9,3,0,12,39,12,0,51
"STAMORA ROMÂNĂ",TM,216,6,12,0,18,41,41,0,82
ULIUC,TM,569,35,11,0,46,93,24,0,117
UNIP,TM,179,8,4,0,12,42,24,0,66
SARAVALE,TM,2123,87,8,0,95,277,16,1,294
SATCHINEZ,TM,2473,100,12,0,112,390,50,0,440
BĂRĂTEAZ,TM,566,25,1,0,26,83,12,0,95
HODONI,TM,999,53,7,0,60,162,18,0,180
SĂCĂLAZ,TM,5169,207,42,0,249,760,150,2,912
"BEREGSĂU MARE",TM,1814,131,11,4,146,390,55,22,467
"BEREGSĂU MIC",TM,750,26,5,0,31,105,19,0,124
"SÂNPETRU MARE",TM,1818,60,1,0,61,179,17,1,197
IGRIŞ,TM,948,21,8,0,29,70,22,0,92
SECAŞ,TM,220,12,6,0,18,41,13,0,54
CRIVOBARA,TM,58,4,5,0,9,14,13,0,27
SÎNANDREI,TM,3509,130,20,0,150,482,79,0,561
CARANI,TM,1691,68,2,0,70,228,21,0,249
COVACI,TM,769,44,8,0,52,124,37,0,161
"SÎNMIHAIU ROMÂN",TM,3065,124,15,0,139,382,56,0,438
"SÎNMIHAIU GERMAN",TM,857,55,8,0,63,169,22,0,191
UTVIN,TM,2410,182,27,0,209,531,71,0,602
ŞAG,TM,3125,104,23,0,127,512,125,0,637
ŞANDRA,TM,2030,88,13,0,101,312,49,0,361
UIHEI,TM,470,22,3,0,25,109,16,0,125
ŞTIUCA,TM,873,52,7,0,59,353,21,0,374
DRAGOMIREŞTI,TM,288,21,3,0,24,96,12,0,108
OLOŞAG,TM,283,7,8,0,15,32,30,0,62
ZGRIBEŞTI,TM,184,6,6,0,12,44,17,0,61
"TEREMIA MARE",TM,2281,93,10,0,103,261,23,1,285
NERĂU,TM,932,26,6,0,32,123,14,3,140
"TEREMIA MICĂ",TM,561,21,8,0,29,83,14,0,97
"COLONIA FABRICII",TM,673,59,4,0,63,204,17,0,221
BALOŞEŞTI,TM,113,10,2,0,12,70,7,0,77
"LUNCANII DE JOS",TM,296,24,5,0,29,104,8,0,112
ROMÂNEŞTI,TM,416,33,16,0,49,199,39,0,238
TOMEŞTI,TM,269,51,6,0,57,149,11,0,160
TOMNATIC,TM,3085,99,1,0,100,304,13,0,317
"TOPOLOVĂŢU MARE",TM,938,46,10,0,56,135,33,0,168
CRALOVĂŢ,TM,90,3,7,0,10,10,25,0,35
ICTAR-BUDINŢI,TM,328,26,10,0,36,74,55,0,129
IOSIFALĂU,TM,440,15,6,0,21,57,14,0,71
SUŞTRA,TM,322,14,6,0,20,63,17,0,80
TORMAC,TM,1404,20,0,0,20,62,15,0,77
CADAR,TM,218,11,6,0,17,49,18,0,67
ŞIPET,TM,685,28,7,0,35,106,15,0,121
SUDRIAŞ,TM,640,32,2,0,34,149,17,1,167
SĂCENI,TM,171,37,6,0,43,79,9,0,88
"SURDUCU MIC",TM,261,22,12,0,34,104,29,0,133
SUSANI,TM,321,31,9,0,40,94,14,0,108
"TRAIAN VUIA",TM,364,35,8,0,43,174,22,0,196
UIVAR,TM,1150,44,9,0,53,178,22,1,201
PUSTINIŞ,TM,595,31,6,0,37,115,20,0,135
RĂUŢI,TM,503,27,3,0,30,89,11,0,100
"SÂNMARTINU MAGHIAR",TM,220,13,0,0,13,34,6,0,40
VARIAŞ,TM,3587,128,16,0,144,465,52,18,535
GELU,TM,1184,52,10,0,62,233,39,0,272
"SÎNPETRU MIC",TM,456,11,7,0,18,58,14,0,72
VĂLCANI,TM,1131,67,4,0,71,200,16,0,216
"VICTOR VLAD DELAMARINA",TM,377,34,10,0,44,119,29,0,148
HERENDEŞTI,TM,370,17,5,0,22,104,28,0,132
HONORICI,TM,244,8,4,0,12,51,12,0,63
PĂDURENI,TM,147,10,5,0,15,55,9,0,64
"PETROASA MARE",TM,877,38,3,0,41,177,13,0,190
VIŞAG,TM,286,20,8,0,28,64,29,0,93
VOITEG,TM,1652,100,28,0,128,257,59,0,316
FOLEA,TM,362,22,6,0,28,61,14,0,75
ALEXANDRIA,TR,42781,2456,186,12,2654,6814,407,13,7234
"ROSIORI DE VEDE",TR,25837,1152,109,82,1343,3565,266,86,3917
"TURNU MĂGURELE",TR,24192,1044,83,0,1127,3265,216,18,3499
VIDELE,TR,8927,399,51,45,495,1450,152,45,1647
COŞOAIA,TR,276,16,8,0,24,59,24,0,83
ZIMNICEA,TR,12609,570,40,22,632,2058,95,55,2208
BALACI,TR,813,41,9,0,50,208,49,24,281
TECUCI,TR,550,25,3,0,28,124,57,23,204
BĂBĂIŢA,TR,2412,158,12,0,170,508,32,0,540
BECIU,TR,806,88,4,0,92,296,34,0,330
SMÂRDAN,TR,461,37,3,0,40,172,19,0,191
BEUCA,TR,922,51,14,53,118,157,28,53,238
PLOPI,TR,157,13,8,0,21,60,18,11,89
BLEJEŞTI,TR,1866,202,38,0,240,640,132,14,786
BACIU,TR,883,58,19,0,77,284,51,3,338
SERICU,TR,340,89,17,0,106,185,29,1,215
BOGDANA,TR,738,85,33,0,118,242,80,0,322
ULMENI,TR,566,40,6,0,46,173,32,0,205
URLUIU,TR,505,54,40,0,94,199,103,0,302
BOTOROAGA,TR,1052,34,13,0,47,126,36,0,162
CĂLUGARU,TR,687,32,3,0,35,86,9,0,95
TÎRNAVA,TR,1042,32,21,0,53,135,51,0,186
TUNARI,TR,153,7,7,0,14,26,18,0,44
"VALEA CIREŞULUI",TR,1205,16,11,0,27,79,26,0,105
BRAGADIRU,TR,3207,86,23,0,109,375,65,0,440
BRÎNCENI,TR,2305,77,7,0,84,543,49,0,592
BUJORENI,TR,456,79,39,0,118,190,98,5,293
PRUNARU,TR,353,43,14,0,57,138,43,4,185
BUJORU,TR,1472,36,7,0,43,157,32,0,189
BUZESCU,TR,3502,55,7,0,62,499,72,1,572
CĂLINEŞTI,TR,1171,55,5,0,60,337,37,40,414
LICURICIU,TR,403,25,7,33,65,111,36,33,180
COPĂCEANCA,TR,744,59,11,0,70,199,43,76,318
ANTONEŞTI,TR,246,33,7,19,59,110,16,19,145
CĂLMĂŢUIU,TR,558,56,7,0,63,222,29,0,251
CARAVANEŢI,TR,210,17,2,0,19,71,23,0,94
BUJORU,TR,211,34,16,0,50,98,31,0,129
"NICOLAE BĂLCESCU",TR,564,47,5,0,52,149,23,0,172
"CĂLMĂŢUIU DE SUS",TR,652,41,3,0,44,244,14,0,258
IONAŞCU,TR,284,12,10,0,22,35,16,0,51
BĂCĂLEŞTI,TR,799,12,8,0,20,132,23,0,155
CERVENIA,TR,2460,122,27,0,149,523,79,0,602
"CIOLĂNEŞTII DIN DEAL",TR,1326,35,12,0,47,186,55,0,241
"CIOLĂNEŞTII DIN VALE",TR,470,17,3,0,20,88,22,0,110
BALDOVINEŞTI,TR,353,12,2,0,14,65,7,0,72
CIUPERCENI,TR,828,113,24,0,137,276,58,25,359
POIANA,TR,513,100,28,37,165,188,47,38,273
CONŢEŞTI,TR,2708,424,42,49,515,1215,117,49,1381
COSMEŞTI,TR,834,70,6,0,76,413,37,27,477
CIUPERCENI,TR,1201,68,2,0,70,361,23,24,408
CRÂNGU,TR,850,87,17,0,104,215,54,15,284
SECARA,TR,294,58,17,0,75,174,30,18,222
CREVENICU,TR,716,22,8,0,30,144,50,0,194
RĂDULEŞTI,TR,433,6,5,0,11,66,15,0,81
CRÎNGENI,TR,1215,47,9,0,56,220,30,0,250
"BALTA SĂRATĂ",TR,626,21,11,0,32,129,32,0,161
DOROBANŢU,TR,222,21,13,0,34,71,35,0,106
STEJARU,TR,144,11,12,0,23,68,44,0,112
DIDEŞTI,TR,960,24,7,0,31,129,23,0,152
DOBROTEŞTI,TR,2648,37,21,0,58,289,67,0,356
MERIŞANI,TR,960,23,5,0,28,166,27,0,193
DRACEA,TR,1043,73,17,0,90,340,52,16,408
ZLATA,TR,63,16,8,0,24,29,17,0,46
FLORICA,TR,181,25,6,0,31,65,27,13,105
DRĂCŞENEI,TR,618,34,2,0,36,117,13,8,138
DRĂCŞANI,TR,328,24,6,0,30,106,25,9,140
ODOBEASCA,TR,427,7,4,0,11,90,12,7,109
"DRĂGĂNEŞTI DE VEDE",TR,1176,27,6,0,33,99,16,0,115
VĂCĂREŞTI,TR,543,18,4,0,22,60,8,0,68
DRĂGĂNEŞTI-VLAŞCA,TR,2776,43,27,0,70,262,66,0,328
VĂCENI,TR,218,10,7,0,17,30,17,0,47
COMOARA,TR,358,44,18,0,62,155,45,0,200
FÂNTÂNELE,TR,1355,157,50,0,207,526,120,0,646
FRĂSINET,TR,1497,122,10,0,132,463,52,0,515
CLĂNIŢA,TR,555,55,9,0,64,261,39,0,300
FRUMOASA,TR,1254,98,17,0,115,357,71,0,428
PĂULEASCA,TR,418,27,8,0,35,73,24,0,97
FURCULEŞTI,TR,1413,30,2,0,32,161,41,8,210
SPĂTĂREI,TR,827,28,8,0,36,81,22,0,103
VOIEVODA,TR,529,23,5,0,28,71,15,0,86
GĂLĂTENI,TR,1235,49,3,0,52,455,27,0,482
BÎSCOVENI,TR,852,27,3,0,30,117,23,0,140
GRATIA,TR,948,37,7,0,44,260,34,0,294
CIURARI-DEAL,TR,1169,52,12,0,64,231,47,0,278
ISLAZ,TR,3550,148,32,0,180,634,86,14,734
MOLDOVENI,TR,777,24,7,0,31,130,28,0,158
IZVOARELE,TR,2079,54,10,0,64,444,43,2,489
LISA,TR,1293,16,4,0,20,106,24,0,130
VÎNĂTORI,TR,545,14,2,0,16,69,14,0,83
LIŢA,TR,2213,75,16,0,91,402,81,0,483
LUNCA,TR,1536,12,6,0,18,106,37,0,143
PRUNDU,TR,1162,27,2,0,29,153,3,0,156
MAVRODIN,TR,2024,54,11,0,65,270,43,0,313
MĂGURA,TR,1465,167,24,0,191,518,92,49,659
GURUIENI,TR,773,135,20,0,155,341,60,38,439
MĂLDĂENI,TR,3459,146,27,28,201,618,72,28,718
"MERENII DE JOS",TR,1317,41,11,0,52,194,29,0,223
"MERENII DE SUS",TR,834,15,0,0,15,118,16,0,134
CERNETU,TR,1105,26,7,0,33,111,33,0,144
"VALEA PĂRULUI",TR,661,18,2,0,20,84,18,0,102
MÎRZĂNEŞTI,TR,510,22,7,0,29,73,27,0,100
TELEORMANU,TR,742,24,4,0,28,119,27,0,146
MOŞTENI,TR,1178,59,18,63,140,404,51,63,518
NANOV,TR,3073,97,14,0,111,410,49,0,459
NĂSTURELU,TR,1274,90,1,0,91,315,5,0,320
ZIMNICELE,TR,812,15,1,0,16,81,11,0,92
NECŞEŞTI,TR,459,30,6,0,36,108,24,0,132
GÎRDEŞTI,TR,438,19,5,0,24,83,18,0,101
NENCIULEŞTI,TR,1517,91,11,0,102,458,58,0,516
"PĂRU ROTUND",TR,469,14,0,0,14,55,5,0,60
OLTENI,TR,1504,45,6,0,51,175,29,0,204
"PERII BROŞTENI",TR,897,10,0,0,10,90,14,0,104
"ORBEASCA DE JOS",TR,1798,62,10,0,72,280,61,12,353
"ORBEASCA DE SUS",TR,2427,108,22,0,130,425,74,25,524
LĂCENI,TR,1957,56,15,0,71,287,36,24,347
PERETU,TR,6026,101,10,0,111,535,43,0,578
PIATRA,TR,2552,56,20,0,76,294,70,0,364
PIETROŞANI,TR,2120,86,19,0,105,456,99,32,587
PLOPII-SLĂVITEŞTI,TR,571,28,2,0,30,178,43,18,239
BRÎNCOVEANCA,TR,831,18,6,39,63,164,25,39,228
DUDU,TR,620,40,6,0,46,174,22,9,205
PLOSCA,TR,4789,68,10,0,78,392,54,0,446
POENI,TR,1138,49,6,0,55,118,30,0,148
PREAJBA,TR,328,23,3,0,26,66,11,0,77
VĂTAŞI,TR,482,5,5,0,10,25,6,0,31
CĂTUNU,TR,362,10,13,0,23,52,32,0,84
POROSCHIA,TR,2869,195,33,29,257,1120,120,29,1269
CALOMFIREŞTI,TR,858,70,11,0,81,329,29,0,358
PURANI,TR,1163,31,3,10,44,190,13,10,213
PUTINEIU,TR,1069,47,8,1,56,271,52,1,324
BĂDULEASA,TR,579,41,22,0,63,126,55,0,181
RĂDOIEŞTI-VALE,TR,528,134,4,0,138,341,27,0,368
RĂDOIEŞTI-DEAL,TR,829,46,7,0,53,293,18,0,311
CETATEA,TR,319,23,10,0,33,126,25,0,151
RĂSMIREŞTI,TR,664,26,12,0,38,68,35,0,103
SAELELE,TR,1266,92,8,0,100,458,55,56,569
PLEAŞOV,TR,684,39,12,0,51,245,45,31,321
SALCIA,TR,792,60,21,0,81,187,46,16,249
BĂNEASA,TR,710,110,25,0,135,288,72,15,375
"TUDOR VLADIMIRESCU",TR,598,72,11,0,83,200,34,34,268
SĂCENI,TR,572,27,7,0,34,155,40,0,195
CIURARI,TR,376,21,8,0,29,92,17,0,109
SCRIOAŞTEA,TR,1870,93,7,0,100,381,38,0,419
BREBINA,TR,640,29,13,0,42,103,23,0,126
CUCUEŢI,TR,683,24,9,0,33,104,18,0,122
"SCURTU MARE",TR,878,45,8,0,53,290,37,33,360
DRĂCEŞTI,TR,281,37,15,0,52,136,35,3,174
ALBENI,TR,166,6,13,0,19,73,31,0,104
SEACA,TR,1229,52,5,0,57,229,41,14,284
NĂVODARI,TR,703,49,3,0,52,187,20,6,213
SEGARCEA-VALE,TR,824,54,12,0,66,222,54,1,277
OLTEANCA,TR,728,27,21,0,48,162,49,0,211
SEGARCEA-DEAL,TR,937,53,13,0,66,211,33,3,247
SFINŢEŞTI,TR,920,25,5,0,30,129,14,0,143
SILIŞTEA,TR,1093,46,7,0,53,237,37,0,274
BUTEŞTI,TR,507,13,7,0,20,37,11,0,48
"SILIŞTEA MICĂ",TR,271,15,3,0,18,40,6,0,46
SILIŞTEA-GUMEŞTI,TR,1992,71,29,0,100,315,72,1,388
UDENI,TR,354,15,6,0,21,101,44,0,145
SÎRBENI,TR,544,16,6,0,22,73,23,0,96
"SÎRBENII DE JOS",TR,213,19,2,0,21,44,11,0,55
"SLOBOZIA MÂNDRA",TR,1362,93,21,31,145,391,99,78,568
SMÎRDIOASA,TR,1528,57,9,0,66,317,36,0,353
ŞOIMU,TR,363,38,12,0,50,107,31,0,138
STEJARU,TR,611,73,23,0,96,308,63,5,376
SOCETU,TR,651,83,13,0,96,277,62,8,347
BRATCOVU,TR,111,30,11,0,41,71,28,5,104
GRESIA,TR,99,29,6,0,35,73,26,4,103
SUHAIA,TR,1870,42,11,0,53,182,41,0,223
ŞTOROBĂNEASA,TR,1425,45,13,24,82,261,39,26,326
BEIU,TR,1152,59,15,0,74,219,45,5,269
TALPA-OGRĂZILE,TR,761,81,28,83,192,221,62,83,366
TALPA-BÎSCOVENI,TR,708,59,10,18,87,239,24,40,303
"TĂTĂRĂŞTII DE JOS",TR,1207,29,17,0,46,149,53,0,202
SLĂVEŞTI,TR,776,21,9,0,30,216,27,0,243
"TĂTĂRĂŞTII DE SUS",TR,1085,25,8,0,33,176,23,0,199
UDUPU,TR,1211,30,9,0,39,193,42,0,235
TRAIAN,TR,1494,77,10,0,87,523,80,0,603
TRIVALEA-MOŞTENI,TR,772,32,2,0,34,132,9,0,141
BRĂTĂŞANI,TR,516,20,13,0,33,54,23,0,77
DEPARAŢI,TR,868,13,6,0,19,61,16,0,77
TROIANUL,TR,2134,84,14,0,98,363,47,0,410
VATRA,TR,168,5,0,0,5,25,2,0,27
DULCENI,TR,69,5,2,0,7,14,17,0,31
ŢIGĂNEŞTI,TR,4211,183,23,13,219,1032,76,28,1136
UDA-CLOCOCIOV,TR,634,53,9,0,62,230,40,28,298
UDA-PACIUREA,TR,650,53,8,0,61,154,30,23,207
VEDEA,TR,505,33,4,0,37,186,23,0,209
ALBEŞTI,TR,550,59,9,0,68,298,55,0,353
COŞOTENI,TR,456,63,15,0,78,191,50,0,241
DULCEANCA,TR,437,85,12,0,97,204,28,0,232
MERI,TR,383,54,3,0,57,181,27,0,208
VIIŞOARA,TR,1386,24,12,0,36,141,46,0,187
PURANI,TR,603,31,11,0,42,159,44,18,221
SILIŞTEA,TR,698,58,22,41,121,241,70,41,352
VITANESTI,TR,955,52,15,0,67,323,80,32,435
"VÎRTOAPELE DE SUS",TR,838,74,19,0,93,247,68,0,315
"VÎRTOAPELE DE JOS",TR,742,35,8,0,43,213,39,0,252
GĂRĂGĂU,TR,591,32,4,0,36,122,24,0,146
ZÎMBREASCA,TR,1190,54,4,78,136,344,29,104,477
"RÂMNICU VÂLCEA",VL,98694,4813,392,8,5213,13936,1096,9,15041
DRĂGĂŞANI,VL,17234,601,64,0,665,2081,197,9,2287
BĂBENI,VL,7615,228,41,0,269,1238,165,20,1423
CURĂTURILE,VL,1082,40,150,0,190,177,225,0,402
PRAJILA,VL,1025,63,10,0,73,180,26,0,206
GĂTEJEŞTI,VL,321,2,1,0,3,39,11,0,50
LIVADIA,VL,1552,78,430,0,508,351,741,0,1092
OLĂNEŞTI,VL,1337,49,13,0,62,234,46,0,280
CHEIA,VL,899,43,6,0,49,157,36,0,193
BĂLCEŞTI,VL,1863,62,14,0,76,270,46,0,316
BENEŞTI,VL,367,6,3,0,9,37,8,0,45
GORUNEŞTI,VL,647,22,5,0,27,91,25,0,116
IRIMEŞTI,VL,463,5,9,0,14,38,17,0,55
OTETELIŞU,VL,847,19,2,0,21,80,10,0,90
"DEALU ALUNIŞ",VL,2104,49,2,0,51,175,21,0,196
ROŞIOARA,VL,1484,22,4,0,26,235,10,0,245
"TÂRGU GÂNGULEŞTI",VL,929,19,4,0,23,92,13,0,105
PĂSCOAIA,VL,168,6,9,0,15,47,13,0,60
"VALEA LUI STAN",VL,439,57,4,0,61,145,9,0,154
BREZOI,VL,4611,146,14,0,160,522,61,0,583
CĂLINEŞTI,VL,545,17,8,0,25,90,18,0,108
CĂLIMĂNEŞTI,VL,7388,313,624,0,937,1083,1039,0,2122
URŞANI,VL,392,21,1,0,22,65,6,0,71
HOREZU,VL,3386,161,28,0,189,591,109,0,700
RÎMEŞTI,VL,383,10,2,0,12,57,3,0,60
"ROMANII DE JOS",VL,628,39,11,0,50,123,64,0,187
"ROMANII DE SUS",VL,837,25,6,0,31,131,9,0,140
TĂNĂSEŞTI,VL,130,5,0,0,5,14,3,0,17
"GURA SUHAŞULUI",VL,1382,34,3,0,37,184,16,0,200
OCNIŢA,VL,1442,18,6,0,24,153,20,0,173
IGOIU,VL,1485,16,5,0,21,96,12,0,108
BODEŞTI,VL,305,0,1,0,1,10,5,0,15
COLTEŞTI,VL,1323,14,0,0,14,152,13,0,165
ROŞIA,VL,481,10,7,0,17,72,8,0,80
AMĂRĂŞTI,VL,867,6,7,1,14,73,23,1,97
NEMOIU,VL,657,6,5,0,11,47,14,0,61
BODEŞTI,VL,777,16,8,0,24,123,30,0,153
BĂRBĂTEŞTI,VL,1272,48,26,0,74,194,51,0,245
BÎRZEŞTI,VL,786,20,40,0,60,82,46,0,128
BERISLĂVEŞTI,VL,776,19,6,0,25,105,20,0,125
DÎNGEŞTI,VL,276,9,3,0,12,63,9,0,72
RĂDĂCINEŞTI,VL,552,22,7,0,29,82,10,0,92
ROBAIA,VL,197,3,5,0,8,27,6,0,33
SCĂUENI,VL,405,5,1,0,6,63,9,0,72
BOIŞOARA,VL,1023,13,2,0,15,207,17,0,224
BUDEŞTI,VL,1276,27,7,0,34,158,23,0,181
LINIA,VL,546,9,3,0,12,54,10,0,64
BARZA,VL,861,22,5,0,27,116,13,0,129
BÎRSEŞTI,VL,751,14,5,0,19,95,17,0,112
RUDA,VL,450,9,4,0,13,48,12,0,60
BERCIOIU,VL,289,10,2,0,12,55,9,0,64
RACOVIŢA,VL,851,12,1,0,13,123,8,0,131
OLTENI,VL,1487,43,18,0,61,213,51,0,264
LUNCA,VL,581,9,7,0,16,118,16,0,134
BOGDĂNEŞTI,VL,682,21,7,0,28,103,24,0,127
"GURA VĂII",VL,1154,17,7,0,24,122,16,0,138
BUNEŞTI,VL,942,30,0,0,30,122,13,0,135
TITIRECI,VL,867,16,1,0,17,91,9,0,100
TEIUŞU,VL,442,11,7,0,18,42,10,0,52
ARMĂŞEŞTI,VL,509,8,2,0,10,60,11,0,71
CERNIŞOARA,VL,701,18,1,0,19,122,14,0,136
GROŞI,VL,764,13,1,0,14,92,17,0,109
MĂDULARI,VL,554,10,1,0,11,97,9,0,106
OBÎRŞIA,VL,444,9,5,0,14,61,10,0,71
"CÎINENII MICI",VL,492,16,2,0,18,64,16,0,80
"CÎINENII MARI",VL,609,19,7,0,26,73,22,0,95
GREBLEŞTI,VL,577,26,4,0,30,124,41,0,165
ROBEŞTI,VL,172,5,4,1,10,26,22,1,49
ULMETU,VL,1142,19,2,0,21,137,19,0,156
VEŢELU,VL,436,9,4,0,13,47,16,0,63
BĂLTENI,VL,308,4,6,0,10,28,8,0,36
HOTĂRASA,VL,312,5,9,0,14,47,14,0,61
COSTEŞTI,VL,1554,36,4,0,40,262,28,0,290
BISTRIŢA,VL,720,71,30,0,101,189,43,0,232
PIETRENI,VL,443,13,4,0,17,59,18,0,77
CREŢENI,VL,878,20,4,0,24,196,25,0,221
IZVORU,VL,474,17,8,0,25,65,19,0,84
STREMINOASA,VL,494,21,3,0,24,82,9,0,91
DĂEŞTI,VL,848,11,6,0,17,156,22,0,178
SÎNBOTIN,VL,706,29,2,1,32,115,6,1,122
FEDELEŞOIU,VL,853,19,4,0,23,140,23,0,163
BĂBUEŞTI,VL,73,0,1,0,1,3,6,0,9
UDREŞTI,VL,808,14,18,0,32,221,87,0,308
"DEALU SCHEIULUI",VL,237,12,4,0,16,83,30,0,113
"LĂUNELE DE JOS",VL,357,7,12,0,19,150,89,0,239
CERETU,VL,312,11,5,0,16,116,39,0,155
BĂBENI-OLTEŢU,VL,889,15,1,0,16,95,9,0,104
BUDEŞTI,VL,660,27,5,0,32,171,10,0,181
DRĂGOEŞTI,VL,1683,45,13,0,58,266,72,0,338
MĂRCUŞU,VL,657,7,4,0,11,73,7,0,80
MILEŞTI,VL,516,18,3,0,21,72,18,0,90
FÎRTĂŢEŞTI,VL,330,4,6,0,10,71,16,0,87
BECŞANI,VL,376,9,0,0,9,88,26,0,114
DOZEŞTI,VL,1406,5,11,0,16,197,33,0,230
GIULEŞTI,VL,990,23,5,0,28,154,28,0,182
FRÎNCEŞTI,VL,615,20,2,0,22,69,7,0,76
MĂNĂILEŞTI,VL,647,15,4,0,19,86,26,0,112
GENUNENI,VL,418,17,4,0,21,45,11,0,56
COŞANI,VL,1155,27,5,0,32,103,16,0,119
DEZROBIŢI,VL,569,65,11,0,76,129,22,0,151
MOŞTENI,VL,658,22,3,0,25,90,23,0,113
VIIŞOARA,VL,231,7,6,0,13,60,17,0,77
GALICEA,VL,951,27,10,0,37,127,36,0,163
TEIU,VL,351,22,4,0,26,104,18,0,122
"VALEA RÎULUI",VL,359,16,4,0,20,64,18,0,82
COCORU,VL,545,18,2,0,20,68,11,0,79
"BRATIA DIN VALE",VL,379,13,3,0,16,37,8,0,45
"BRATIA DIN DEAL",VL,278,9,6,0,15,41,19,0,60
CREMENARI,VL,336,16,6,0,22,74,24,0,98
ŞTIRBEŞTI,VL,488,20,6,0,26,40,21,0,61
GHIOROIU,VL,489,21,7,0,28,87,35,1,123
POIENARI,VL,228,13,4,0,17,49,17,0,66
GLĂVILE,VL,865,22,0,0,22,138,17,0,155
ANINOASA,VL,156,8,7,0,15,57,23,0,80
OLTEANCA,VL,588,6,7,0,13,144,45,0,189
POPEŞTI,VL,756,18,3,0,21,83,15,0,98
BLIDARI,VL,858,14,1,0,15,116,18,0,134
TULEI-CÎMPENI,VL,341,5,2,0,7,45,22,0,67
VĂTĂŞEŞTI,VL,205,8,3,0,11,35,17,0,52
GRĂDIŞTEA,VL,354,2,5,0,7,39,19,0,58
"VALEA GRĂDIŞTEI",VL,117,7,7,0,14,20,12,0,32
DOBRICEA,VL,650,11,3,0,14,72,10,0,82
ŢUŢURU,VL,1058,59,11,0,70,196,29,0,225
SPÎRLENI,VL,756,19,9,0,28,91,18,0,109
GUŞOIANCA,VL,478,9,1,0,10,70,9,0,79
IONEŞTI,VL,1129,17,5,0,22,121,15,0,136
DELURENI,VL,879,10,5,0,15,61,11,0,72
FOTEŞTI,VL,694,13,4,0,17,63,9,0,72
MARCEA,VL,693,17,4,0,21,70,20,0,90
LALOŞU,VL,763,10,0,0,10,39,8,0,47
MOLOGEŞTI,VL,522,14,2,0,16,38,8,0,46
BERBEŞTI,VL,364,6,0,0,6,35,9,0,44
OLTEŢANI,VL,203,6,3,0,9,29,8,0,37
LĂCUSTENI,VL,418,9,3,0,12,53,15,0,68
CONTEA,VL,249,8,1,0,9,24,10,0,34
GĂNEŞTI,VL,456,13,2,0,15,98,8,0,106
LĂDEŞTI,VL,743,11,7,0,18,132,58,10,200
GĂGENI,VL,192,1,4,0,5,46,34,0,80
CHIRICEŞTI,VL,412,17,6,0,23,127,32,0,159
OLTEANCA,VL,81,4,1,0,5,33,17,0,50
SĂRULEŞTI,VL,1143,19,3,0,22,167,28,0,195
BROŞTENI,VL,548,8,5,0,13,58,27,0,85
LIVEZI,VL,598,7,7,0,14,62,19,0,81
PLEŞOIU,VL,328,6,3,0,9,48,15,0,63
LUNGEŞTI,VL,829,17,2,0,19,63,19,0,82
STĂNEŞTI-LUNCA,VL,814,11,0,0,11,69,7,0,76
FUMURENI,VL,565,9,0,0,9,40,15,0,55
DUMBRAVA,VL,319,5,2,0,7,21,7,0,28
MALAIA,VL,873,33,12,0,45,191,26,0,217
CIUNGETU,VL,401,9,8,0,17,41,24,0,65
SĂLIŞTEA,VL,240,9,2,0,11,61,18,0,79
MATEEŞTI,VL,1085,16,2,0,18,143,17,0,160
GRECI,VL,479,9,3,0,12,78,14,0,92
TURCEŞTI,VL,1004,12,14,0,26,88,26,0,114
OVESELU,VL,798,14,8,0,22,105,52,0,157
POPEŞTI,VL,378,11,2,0,13,77,19,0,96
ŞTEFĂNEŞTI,VL,250,3,2,0,5,44,8,0,52
MĂDULARI,VL,642,31,6,0,37,173,27,0,200
BĂLŞOARA,VL,262,9,2,0,11,82,18,0,100
BĂNŢEŞTI,VL,258,8,2,0,10,95,14,0,109
MĂLDĂREŞTI,VL,1509,31,5,0,36,166,17,0,183
TELECHEŞTI,VL,133,3,0,0,3,14,12,0,26
BULETA,VL,1193,31,9,0,40,189,26,0,215
MĂGURA,VL,724,23,13,0,36,100,33,0,133
VULPUEŞTI,VL,643,19,5,0,24,95,14,0,109
BÎRSEŞTI,VL,671,15,3,0,18,78,14,0,92
STUPĂREI,VL,718,34,7,0,41,221,36,0,257
MIHĂEŞTI,VL,910,21,30,0,51,107,61,0,168
GURIŞOARA,VL,762,23,2,0,25,112,14,0,126
MILCOIU,VL,601,11,5,0,16,95,30,0,125
IZBĂSEŞTI,VL,204,10,5,0,15,40,18,0,58
CIUTEŞTI,VL,234,18,7,0,25,46,13,0,59
MITROFANI,VL,577,9,0,0,9,64,9,0,73
RACU,VL,239,1,4,0,5,20,8,0,28
MUEREASCA,VL,931,5,1,0,6,93,16,0,109
"MUEREASCA DE SUS",VL,1161,35,18,0,53,177,39,0,216
ROTĂRĂŞTI,VL,915,15,3,0,18,140,50,1,191
"CORBII DIN VALE",VL,328,16,5,0,21,66,29,0,95
ŞERBĂNEASA,VL,756,26,5,0,31,121,9,0,130
PREDEŞTI,VL,682,16,1,0,17,82,11,0,93
GÎLTOFANI,VL,137,4,3,0,7,27,20,0,47
OLANU,VL,469,9,2,0,11,63,8,0,71
"CASA VECHE",VL,587,10,1,0,11,58,9,0,67
CIOBOŢI,VL,602,14,6,0,20,70,16,0,86
DRĂGIOIU,VL,491,24,3,0,27,104,16,0,120
STOICĂNEŞTI,VL,350,4,2,0,6,71,23,0,94
ORLEŞTI,VL,1505,35,5,0,40,238,33,0,271
SILEA,VL,879,26,5,0,31,165,19,0,184
OTEŞANI,VL,1124,25,3,0,28,130,16,0,146
CÎRSTĂNEŞTI,VL,1120,16,5,0,21,94,13,0,107
PIETRARI,VL,1081,36,9,0,45,146,45,0,191
PĂUŞEŞTI-MĂGLAŞI,VL,1285,39,0,0,39,189,17,0,206
"VALEA CHEII",VL,925,35,6,0,41,112,21,0,133
BARCANELE,VL,495,16,2,0,18,100,14,0,114
PĂUŞEŞTI,VL,774,28,12,0,40,144,40,0,184
CERNELELE,VL,521,12,5,0,17,57,19,0,76
BUZDUGAN,VL,400,11,1,0,12,67,7,0,74
PERIŞANI,VL,470,16,4,0,20,95,10,0,105
MLĂCENI,VL,440,16,7,0,23,130,18,0,148
POIANA,VL,489,11,2,0,13,129,8,0,137
SPINU,VL,301,12,3,0,15,44,7,0,51
PODENI,VL,53,2,5,0,7,13,7,0,20
PESCEANA,VL,1363,12,2,0,14,129,26,0,155
PIETRARI,VL,1383,25,5,0,30,184,37,0,221
"PIETRARII DE SUS",VL,1138,11,3,0,14,103,14,0,117
DĂEŞTI,VL,774,6,5,0,11,126,29,0,155
MEIENI,VL,382,7,3,0,10,114,16,0,130
POPEŞTI,VL,510,18,4,0,22,153,38,0,191
URŞI,VL,854,19,0,0,19,342,39,0,381
PRUNDENI,VL,1295,38,12,0,50,159,34,0,193
CĂLINA,VL,1185,22,5,0,27,145,15,0,160
BĂRBUCENI,VL,991,15,4,0,19,118,15,0,133
RACOVIŢA,VL,768,22,16,0,38,109,35,0,144
"GRUIU LUPULUI",VL,123,12,12,0,24,30,14,0,44
TUŢULEŞTI,VL,118,11,3,0,14,35,8,0,43
BALOTA,VL,318,6,4,0,10,28,15,0,43
BĂIAŞA,VL,622,11,7,0,18,78,13,0,91
CIOCÎLTEI,VL,504,5,0,0,5,76,0,0,76
CUENI,VL,510,5,3,0,8,53,16,0,69
BĂRBĂRIGENI,VL,169,4,2,0,6,30,10,0,40
ROŞIILE,VL,878,6,1,0,7,51,17,0,68
ROMÂNEŞTI,VL,843,5,0,0,5,41,8,0,49
ZGUBEA,VL,277,10,5,0,15,48,12,0,60
PERTEŞTI,VL,53,4,3,0,7,16,14,0,30
RUNCU,VL,441,9,9,0,18,78,25,0,103
"VALEA BABEI",VL,208,7,7,0,14,30,16,0,46
SURPAŢI,VL,114,5,0,0,5,27,8,0,35
SĂLĂTRUCEL,VL,1172,22,3,0,25,223,28,0,251
ŞERBĂNEŞTI,VL,399,7,3,0,10,63,12,0,75
PĂTEŞTI,VL,103,6,2,0,8,35,6,0,41
SEACA,VL,89,4,5,0,9,19,6,0,25
SCUNDU,VL,980,33,8,0,41,352,51,25,428
CRÎNGU,VL,656,27,4,0,31,259,35,0,294
SINEŞTI,VL,700,7,1,0,8,79,18,0,97
MIJLOCU,VL,823,8,7,0,15,90,15,0,105
POPEŞTI,VL,530,6,3,0,9,55,9,0,64
MOGEŞTI,VL,821,15,12,0,27,125,26,1,152
MILOSTEA,VL,647,7,0,0,7,84,18,0,102
RUGETU,VL,536,15,1,0,16,102,16,0,118
GORUNEŞTI,VL,364,4,5,0,9,59,9,0,68
SLĂTIOARA,VL,412,13,1,0,14,54,9,0,63
STĂNEŞTI,VL,422,12,3,0,15,78,15,0,93
VÎRLENI,VL,378,13,4,0,17,59,15,0,74
"LINIA DEALULUI",VL,136,8,1,0,9,28,15,0,43
STOENEŞTI,VL,898,22,9,0,31,147,37,0,184
BÎRLOGU,VL,299,10,4,0,14,86,17,0,103
DOBRICENI,VL,1035,33,3,0,36,154,25,0,179
"PISCU MARE",VL,503,7,5,0,12,56,23,0,79
ZMEURĂTU,VL,142,16,6,0,22,43,29,0,72
URŞI,VL,1183,38,4,0,42,283,19,0,302
STOILEŞTI,VL,607,19,8,0,27,164,30,0,194
GEAMĂNA,VL,780,16,5,0,21,105,13,0,118
BÎRSOIU,VL,524,12,11,0,23,114,35,0,149
STROEŞTI,VL,754,13,0,0,13,96,18,0,114
CIREŞU,VL,659,16,5,0,21,89,18,0,107
DIANU,VL,410,16,6,0,22,66,19,0,85
OBROCEŞTI,VL,279,8,1,0,9,44,10,0,54
POJOGI-CERNA,VL,209,5,12,0,17,22,22,0,44
MĂZILI,VL,1323,35,9,0,44,140,24,0,164
VERDEA,VL,440,11,2,0,13,44,3,0,47
ŞIRINEASA,VL,1186,20,4,0,24,121,17,0,138
CIORĂŞTI,VL,491,14,3,0,17,69,14,0,83
SLĂVITEŞTI,VL,254,4,4,0,8,26,7,0,33
ŞTEFĂNEŞTI,VL,957,24,3,0,27,97,6,0,103
ŞERBĂNEŞTI,VL,689,28,1,0,29,117,9,0,126
DOBRUŞA,VL,1037,39,8,0,47,156,32,1,189
UŞUREI,VL,449,13,5,0,18,81,18,0,99
ŞUŞANI,VL,948,12,6,0,18,123,28,0,151
STOICULEŞTI,VL,309,16,1,0,17,63,8,0,71
RÎMEŞTI,VL,894,11,2,0,13,121,19,0,140
BĂROIU,VL,319,14,6,0,20,41,11,0,52
TETOIU,VL,546,6,4,0,10,41,18,0,59
ŢEPEŞTI,VL,703,5,0,0,5,68,24,0,92
NENCIULEŞTI,VL,277,14,6,0,20,37,18,0,55
BUDELE,VL,153,5,2,0,7,35,15,0,50
TITEŞTI,VL,470,18,7,0,25,81,19,0,100
BRATOVEŞTI,VL,145,9,5,0,14,52,26,0,78
TOMŞANI,VL,964,25,6,0,31,236,24,0,260
"FOLEŞTII DE SUS",VL,957,12,5,0,17,125,26,0,151
"FOLEŞTII DE JOS",VL,666,16,13,0,29,98,35,0,133
BOGDĂNEŞTI,VL,592,22,4,0,26,129,18,0,147
VAIDEENI,VL,2126,99,13,0,112,616,62,0,678
"IZVORU RECE",VL,664,20,3,0,23,187,27,0,214
MARIŢA,VL,464,11,11,0,22,71,37,0,108
DELURENI,VL,421,8,7,0,15,26,16,0,42
"VALEA MARE",VL,517,15,4,0,19,66,12,0,78
BĂTĂŞANI,VL,408,8,9,0,17,93,14,0,107
MĂRGINENI,VL,311,9,9,0,18,70,25,0,95
DRĂGANU,VL,437,6,6,0,12,62,19,0,81
VLĂDEŞTI,VL,1528,47,3,0,50,260,46,0,306
PRIPORU,VL,1152,34,4,0,38,153,16,0,169
VOICEŞTI,VL,1267,31,3,0,34,93,14,0,107
VOINEASA,VL,711,16,12,0,28,88,28,0,116
VOINEŞIŢA,VL,617,19,9,0,28,78,22,0,100
ZĂTRENI,VL,549,6,0,0,6,101,16,0,117
STANOMIRU,VL,379,10,2,0,12,42,10,0,52
VĂLENI,VL,370,12,5,0,17,61,20,0,81
"DEALU VĂLENI",VL,220,2,12,0,14,33,30,0,63
SĂŞCIOARA,VL,332,4,7,0,11,60,30,0,90
FOCŞANI,VN,76455,4091,371,351,4813,12570,1236,364,14170
MÎNDREŞTI-MUNTENI,VN,1365,38,1,158,197,187,9,158,354
ADJUD,VN,14036,480,115,0,595,2080,244,43,2367
BURCIOAIA,VN,452,16,2,0,18,129,8,0,137
ŞIŞCANI,VN,698,10,3,0,13,100,13,0,113
"ADJUDU VECHI",VN,1380,35,3,0,38,233,20,0,253
MĂRĂŞEŞTI,VN,8418,205,15,0,220,1278,70,1,1349
HARET,VN,491,4,6,0,10,52,9,0,61
PĂDURENI,VN,423,35,6,0,41,108,22,0,130
CĂLIMĂNEŞTI,VN,449,14,0,0,14,101,4,0,105
TIŞIŢA,VN,225,12,0,0,12,45,6,0,51
ODOBEŞTI,VN,5760,227,39,0,266,1181,120,1,1302
UNIREA,VN,2123,45,8,0,53,353,45,0,398
PANCIU,VN,4937,211,31,0,242,877,119,21,1017
"SATU NOU",VN,837,26,1,0,27,179,23,0,202
"CRUCEA DE JOS",VN,389,15,7,0,22,89,18,0,107
DUMBRAVA,VN,402,15,0,0,15,77,7,0,84
"CRUCEA DE SUS",VN,724,43,4,0,47,171,14,0,185
NEICU,VN,543,26,7,0,33,104,13,0,117
"ANDREIAŞU DE JOS",VN,476,13,4,0,17,191,31,0,222
RĂCHITAŞU,VN,574,11,3,0,14,186,5,0,191
"ANDREIAŞU DE SUS",VN,393,10,0,0,10,144,7,0,151
BĂLEŞTI,VN,1575,67,9,0,76,355,49,0,404
BÂRSEŞTI,VN,1196,40,4,17,61,426,24,48,498
BILIEŞTI,VN,2067,83,17,7,107,511,79,17,607
BOGHEŞTI,VN,679,11,2,0,13,87,22,0,109
PRISECANI,VN,427,12,1,0,13,117,31,0,148
IUGANI,VN,125,4,4,0,8,50,19,0,69
BOLOTEŞTI,VN,608,18,9,0,27,123,41,0,164
PUTNA,VN,525,12,2,0,14,74,18,1,93
IVĂNCEŞTI,VN,368,3,6,0,9,49,9,0,58
GĂGEŞTI,VN,1765,20,5,0,25,307,47,0,354
"VITĂNEŞTII DE SUB MĂGURĂ",VN,595,17,2,0,19,119,27,0,146
BORDEŞTI,VN,1017,26,2,0,28,145,13,0,158
"BORDEŞTII DE JOS",VN,416,21,10,0,31,140,33,0,173
BROŞTENI,VN,1354,41,13,0,54,330,34,0,364
ARVA,VN,514,9,3,0,12,87,5,0,92
CHIOJDENI,VN,796,6,0,0,6,110,11,0,121
CĂTĂUŢI,VN,288,4,0,0,4,50,5,0,55
LUNCILE,VN,740,17,2,0,19,88,6,0,94
CIORĂŞTI,VN,711,34,7,0,41,100,24,0,124
CODREŞTI,VN,170,6,6,0,12,34,19,0,53
MIHĂLCENI,VN,563,20,2,0,22,84,20,0,104
"SALCIA NOUĂ",VN,339,60,11,0,71,90,22,0,112
"SALCIA VECHE",VN,235,26,1,0,27,52,8,0,60
"SATU NOU",VN,206,10,4,0,14,15,7,0,22
SPĂTĂREASA,VN,164,16,2,0,18,39,8,0,47
CÎMPINEANCA,VN,3478,133,13,0,146,618,54,0,672
CÎMPURI,VN,1725,47,17,0,64,453,29,4,486
"ROTILEŞTII MICI",VN,534,13,4,0,17,130,19,0,149
FETEŞTI,VN,764,10,8,0,18,141,26,0,167
CÎRLIGELE,VN,1061,31,9,0,40,172,40,0,212
BLIDARI,VN,465,13,13,0,26,72,29,0,101
BONŢEŞTI,VN,383,12,9,0,21,81,19,0,100
DĂLHĂUŢI,VN,560,27,44,0,71,88,52,0,140
ŞERBĂNEŞTI,VN,346,15,5,0,20,109,30,0,139
BUDA,VN,413,18,2,0,20,88,14,0,102
RĂDĂCINEŞTI,VN,355,16,6,0,22,89,25,0,114
OCHEŞEŞTI,VN,273,13,0,0,13,100,7,0,107
COTEŞTI,VN,1583,46,9,0,55,245,61,0,306
BUDEŞTI,VN,1511,43,9,0,52,217,37,0,254
"VALEA COTEŞTI",VN,574,5,2,0,7,80,15,0,95
"GOLEŞTII DE SUS",VN,346,23,2,0,25,106,13,0,119
DUMBRĂVENI,VN,2534,49,8,0,57,356,42,0,398
CÎNDEŞTI,VN,1153,26,5,0,31,195,45,1,241
DUMITREŞTI,VN,622,21,12,0,33,155,32,0,187
"DUMITREŞTII DE SUS",VN,225,6,3,0,9,75,11,0,86
MOTNĂU,VN,286,13,0,0,13,81,6,0,87
TRESTIA,VN,134,6,0,0,6,38,6,0,44
TINOASA,VN,142,4,0,0,4,59,1,0,60
LĂSTUNI,VN,272,12,2,0,14,88,8,0,96
POIENIŢA,VN,189,7,2,0,9,57,6,0,63
DUMITREŞTII-FAŢĂ,VN,175,17,9,4,30,76,15,4,95
"BICEŞTII DE SUS",VN,611,15,3,0,18,220,25,0,245
GĂLOIEŞTI,VN,470,12,2,0,14,129,15,0,144
"BICEŞTII DE JOS",VN,536,44,5,0,49,148,13,0,161
FITIONEŞTI,VN,1260,24,4,0,28,244,40,0,284
GHIMICEŞTI,VN,338,9,6,0,15,75,30,0,105
MĂNĂSTIOARA,VN,618,13,9,0,22,104,26,0,130
GAROAFA,VN,1591,39,4,0,43,326,47,0,373
BIZIGHEŞTI,VN,596,24,3,0,27,126,13,0,139
DOAGA,VN,373,9,5,0,14,102,26,0,128
CIUŞLEA,VN,1305,86,25,0,111,242,54,0,296
GOLEŞTI,VN,3266,127,12,0,139,611,57,0,668
CEARDAC,VN,556,21,0,0,21,90,7,0,97
GOLOGANU,VN,2639,51,10,0,61,368,33,0,401
GUGEŞTI,VN,5050,159,13,0,172,821,52,0,873
OREAVU,VN,444,21,6,0,27,82,20,0,102
"GURA CALIŢEI",VN,2143,45,6,0,51,385,39,0,424
HOMOCEA,VN,4486,83,14,0,97,957,51,0,1008
LESPEZI,VN,1047,13,5,0,18,221,22,0,243
COSTIŞA,VN,295,5,0,0,5,67,19,0,86
JARIŞTEA,VN,2381,45,13,0,58,339,84,0,423
VĂRSĂTURA,VN,470,21,0,0,21,70,20,0,90
PĂDURENI,VN,393,16,10,0,26,104,30,0,134
SCÎNTEIA,VN,170,5,3,0,8,43,18,0,61
JITIA,VN,797,20,0,0,20,180,16,1,197
"JITIA DE JOS",VN,328,8,5,0,13,132,9,0,141
"DEALU SĂRII",VN,153,16,0,0,16,73,14,0,87
MĂICĂNEŞTI,VN,2627,131,19,0,150,577,84,9,670
RÎMNICENI,VN,1279,68,6,0,74,412,37,0,449
MERA,VN,1620,20,2,0,22,310,39,0,349
VULCĂNEASA,VN,1599,22,4,0,26,363,24,0,387
MILCOVUL,VN,2206,65,12,0,77,454,55,6,515
LĂMOTEŞTI,VN,861,37,8,0,45,173,20,7,200
DIOCHEŢIREDIU,VN,580,12,0,0,12,200,20,0,220
MOVILIŢA,VN,1798,39,10,0,49,388,56,0,444
TROTUŞANU,VN,380,16,5,0,21,81,16,0,97
FRECĂŢEI,VN,408,3,0,0,3,79,12,0,91
NĂNEŞTI,VN,1077,17,15,0,32,117,42,0,159
"CĂLIENII VECHI",VN,585,20,8,0,28,94,31,0,125
"CĂLIENII NOI",VN,272,6,6,0,12,49,24,0,73
NĂRUJA,VN,1004,33,11,0,44,442,38,22,502
"PODU NĂRUJEI",VN,540,24,2,0,26,186,23,6,215
NEGRILEŞTI,VN,1428,61,7,35,103,362,18,40,420
NEREJU,VN,1408,56,7,0,63,469,28,0,497
"NEREJU MIC",VN,2053,66,3,0,69,765,37,0,802
VETREŞTI-HERĂSTRĂU,VN,837,21,4,49,74,197,11,49,257
OBREJIŢA,VN,1284,24,0,0,24,170,12,0,182
PALTIN,VN,1590,61,19,0,80,557,49,0,606
PĂULEŞTI,VN,1056,52,5,0,57,365,20,1,386
HĂULIŞCA,VN,556,29,12,0,41,201,20,0,221
PĂUNEŞTI,VN,4617,48,16,0,64,662,102,1,765
VIIŞOARA,VN,810,14,2,0,16,143,11,0,154
PLOSCUŢENI,VN,2129,54,5,0,59,358,27,6,391
ARGEA,VN,339,12,0,0,12,103,6,0,109
"POIANA CRISTEI",VN,946,33,2,0,35,215,10,0,225
"PODU LACULUI",VN,529,21,4,0,25,190,13,0,203
MAHRIU,VN,317,9,0,0,9,117,9,0,126
PETREANU,VN,123,9,4,0,13,41,8,0,49
TÎRÎTU,VN,232,25,2,0,27,96,4,0,100
POPEŞTI,VN,2051,32,4,0,36,228,26,0,254
TERCHEŞTI,VN,505,8,1,0,9,29,10,0,39
PUFEŞTI,VN,1318,31,2,0,33,162,16,0,178
CIORANI,VN,817,18,6,0,24,137,19,0,156
DOMNEŞTI-TÎRG,VN,1233,25,2,0,27,161,13,0,174
RĂCOASA,VN,916,24,4,0,28,203,28,0,231
GOGOIU,VN,179,5,0,0,5,52,10,0,62
MĂRĂŞTI,VN,434,9,4,0,13,117,15,0,132
VARNIŢA,VN,448,15,4,0,19,99,14,0,113
VERDEA,VN,588,11,1,0,12,225,29,0,254
RĂSTOACA,VN,2106,62,3,0,65,399,19,43,461
ŞINDRILARI,VN,985,24,4,0,28,344,19,0,363
REGHIU,VN,532,13,4,0,17,142,20,0,162
RĂIUŢI,VN,286,18,1,0,19,120,12,0,132
RUGINEŞTI,VN,1579,32,8,15,55,332,55,19,406
ANGHELEŞTI,VN,1017,38,5,0,43,292,33,6,331
COPĂCEŞTI,VN,588,13,2,0,15,154,17,0,171
VĂLENI,VN,256,16,2,0,18,69,11,5,85
SIHLEA,VN,1893,61,11,0,72,336,38,0,374
CĂIATA,VN,565,14,9,0,23,77,23,0,100
BOGZA,VN,743,58,4,0,62,220,45,0,265
VOETIN,VN,902,30,7,0,37,138,27,0,165
"SLOBOZIA BRADULUI",VN,2467,137,14,0,151,743,48,0,791
COROTENI,VN,778,11,7,0,18,132,19,0,151
CORNETU,VN,1039,69,7,0,76,309,16,0,325
"SLOBOZIA CIORĂŞTI",VN,1110,65,23,0,88,296,59,19,374
JILIŞTE,VN,569,18,6,0,24,177,21,16,214
DRAGOSLOVENI,VN,1078,33,10,0,43,241,40,0,281
RUCĂRENI,VN,777,35,3,0,38,187,29,0,216
SPULBER,VN,1010,29,1,0,30,425,18,0,443
STRĂOANE,VN,1908,61,12,0,73,407,62,0,469
REPEDEA,VN,286,14,4,0,18,81,5,0,86
MUNCELU,VN,792,26,5,0,31,183,39,0,222
SURAIA,VN,4929,100,9,31,140,540,46,34,620
TĂNĂSOAIA,VN,1150,64,10,35,109,343,68,37,448
TĂTĂRANU,VN,1190,32,2,0,34,194,17,1,212
MĂRTINEŞTI,VN,561,18,11,0,29,92,30,0,122
VÎJÎITOAREA,VN,192,34,13,0,47,77,22,0,99
"BORDEASCA VECHE",VN,1523,59,19,0,78,260,63,0,323
"BORDEASCA NOUĂ",VN,347,17,6,0,23,66,20,0,86
TÂMBOEŞTI,VN,1049,14,3,0,17,54,27,0,81
SLIMNIC,VN,1191,47,3,0,50,194,22,0,216
TRESTIENI,VN,141,7,3,0,10,17,5,0,22
TULNICI,VN,2354,92,6,0,98,589,31,0,620
COZA,VN,668,30,6,0,36,255,19,0,274
LEPŞA,VN,367,9,26,0,35,82,91,0,173
ŢIFEŞTI,VN,857,7,0,0,7,88,19,0,107
BĂTINEŞTI,VN,1302,35,8,0,43,233,30,0,263
CLIPICEŞTI,VN,685,16,0,0,16,73,8,0,81
OLEŞEŞTI,VN,740,18,2,0,20,85,20,0,105
SÎRBI,VN,638,22,6,0,28,116,26,0,142
URECHEŞTI,VN,2288,48,17,0,65,299,60,0,359
"VALEA SĂRII",VN,1664,77,7,0,84,540,36,0,576
VIDRA,VN,1458,70,14,21,105,316,48,21,385
VOLOŞCANI,VN,293,4,3,0,7,76,11,0,87
IREŞTI,VN,755,16,7,0,23,185,34,0,219
ŞERBEŞTI,VN,475,20,5,0,25,103,36,0,139
BURCA,VN,1350,27,10,0,37,222,26,0,248
SCAFARI,VN,363,16,4,0,20,143,22,0,165
TICHIRIŞ,VN,645,17,5,0,22,155,9,0,164
VIIŞOARA,VN,575,14,2,0,16,185,9,0,194
VINTILEASCA,VN,631,41,5,0,46,269,40,0,309
NECULELE,VN,382,28,9,0,37,140,26,2,168
BAHNELE,VN,466,19,3,0,22,204,14,0,218
"DUPĂ MĂGURA",VN,75,6,0,0,6,25,5,0,30
"POIANA STOICHII",VN,56,4,2,0,6,29,8,0,37
"VIZANTEA RĂZĂŞEASCĂ",VN,636,46,9,0,55,222,27,24,273
"VIZANTEA MĂNĂSTIREASCĂ",VN,1426,47,4,30,81,313,19,30,362
"PISCU RADULUI",VN,355,5,8,0,13,74,11,0,85
MESTEACĂNU,VN,304,7,1,0,8,102,7,0,109
LIVEZILE,VN,578,13,1,0,14,129,21,0,150
VÎNĂTORI,VN,1135,33,9,0,42,191,38,0,229
JORĂŞTI,VN,1288,35,2,0,37,273,26,0,299
PETREŞTI,VN,1205,35,4,0,39,218,37,0,255
"MIRCEŞTII NOI",VN,751,17,5,0,22,148,30,0,178
"MIRCEŞTII VECHI",VN,252,14,2,0,16,80,19,0,99
"BALTA RAŢEI",VN,239,4,3,0,7,34,13,0,47
RĂDULEŞTI,VN,746,21,6,0,27,117,22,0,139
VÎRTEŞCOIU,VN,1270,32,5,0,37,239,28,0,267
FARAOANELE,VN,1024,31,9,0,40,250,28,0,278
BECIU,VN,346,11,5,0,16,83,30,0,113
RÎMNICEANCA,VN,228,13,1,0,14,47,13,0,60
VRÎNCIOAIA,VN,502,44,0,0,44,191,5,9,205
POIANA,VN,573,13,4,0,17,175,22,19,216
SPINEŞTI,VN,626,10,1,0,11,151,10,24,185
MUNCEI,VN,582,12,3,0,15,183,14,23,220
VULTURU,VN,3801,85,14,0,99,512,60,0,572
BOŢÎRLĂU,VN,1224,34,3,0,37,175,25,0,200
HÎNGULEŞTI,VN,973,74,13,0,87,305,45,0,350
MALURI,VN,468,11,7,0,18,60,31,0,91
"VADU ROŞCA",VN,588,35,9,0,44,145,24,0,169
VASLUI,VS,110653,2687,235,15,2937,9910,659,126,10695
BÎRLAD,VS,59356,2652,174,76,2902,9143,494,80,9717
HUŞI,VS,27521,892,129,41,1062,3684,297,42,4023
MURGENI,VS,2853,148,10,0,158,438,32,0,470
CÂRJA,VS,797,23,14,0,37,126,46,0,172
FLORENI,VS,538,8,4,0,12,97,17,0,114
LĂŢEŞTI,VS,258,10,3,0,13,50,10,0,60
RAIU,VS,535,21,0,0,21,103,9,0,112
SĂRĂŢENI,VS,297,8,5,0,13,31,6,0,37
SCHINENI,VS,388,18,4,0,22,88,15,0,103
NEGREŞTI,VS,5878,207,16,0,223,1151,54,0,1205
"VALEA MARE",VS,680,21,5,0,26,126,10,0,136
POIANA,VS,218,10,6,0,16,50,17,0,67
CIOATELE,VS,286,8,5,0,13,113,7,2,122
PARPANIŢA,VS,471,48,6,0,54,190,30,0,220
GLODENI,VS,224,21,4,0,25,64,14,0,78
CĂZĂNEŞTI,VS,356,11,1,0,12,94,10,0,104
ALBEŞTI,VS,830,21,4,0,25,143,29,0,172
CORNI-ALBEŞTI,VS,994,26,3,0,29,183,30,0,213
CRASNA,VS,443,5,1,0,6,81,12,0,93
"GURA ALBEŞTI",VS,116,11,2,0,13,25,11,0,36
"ALEXANDRU VLAHUŢĂ",VS,645,26,30,0,56,86,84,0,170
GHICANI,VS,139,7,3,0,10,24,6,0,30
BUDA,VS,219,7,0,0,7,30,5,0,35
MORĂRENI,VS,198,16,3,0,19,53,4,0,57
ARSURA,VS,528,9,3,0,12,81,17,0,98
FUNDĂTURA,VS,329,13,3,0,16,70,12,0,82
PÎHNEŞTI,VS,345,10,7,0,17,94,25,0,119
"MIHAIL KOGĂLNICEANU",VS,80,4,9,0,13,18,21,0,39
"GARA BANCA",VS,1063,15,0,0,15,186,19,0,205
BANCA,VS,839,23,2,0,25,159,19,0,178
GHERMĂNEŞTI,VS,383,10,2,0,12,97,15,0,112
STOIŞEŞTI,VS,482,21,4,0,25,139,20,0,159
ŢIFU,VS,321,35,6,0,41,114,16,0,130
"1 DECEMBRIE",VS,347,20,7,0,27,158,47,0,205
MITOC,VS,297,22,0,0,22,87,8,0,95
SÎRBI,VS,326,19,5,0,24,60,16,0,76
STRÎMTURA-MITOC,VS,165,12,0,0,12,43,3,0,46
MICLEŞTI,VS,194,26,7,0,33,65,13,0,78
BĂCANI,VS,1084,27,15,0,42,218,30,0,248
BĂLTĂŢENI,VS,362,21,4,0,25,107,17,0,124
DRUJEŞTI,VS,344,24,4,0,28,105,19,0,124
SUSENI,VS,336,6,0,0,6,79,10,0,89
VULPĂŞENI,VS,153,8,3,0,11,45,11,0,56
BĂCEŞTI,VS,1707,29,7,24,60,245,20,24,289
ARMĂŞENI,VS,318,9,0,0,9,97,12,0,109
BĂBUŞA,VS,340,6,6,0,12,86,13,0,99
PĂLTINIŞ,VS,237,6,2,0,8,62,6,0,68
"ŢIBĂNEŞTII BUHLII",VS,171,5,5,0,10,35,12,0,47
VOVRIEŞTI,VS,253,9,1,0,10,64,9,0,73
BĂLTENI,VS,784,26,3,0,29,178,30,0,208
BĂLTENI-DEAL,VS,381,16,6,0,22,78,17,0,95
CHETREŞTI,VS,103,7,7,0,14,53,16,0,69
BEREZENI,VS,1876,44,12,0,56,298,35,0,333
MUŞATA,VS,365,13,2,0,15,71,9,0,80
RÎNCENI,VS,446,10,2,0,12,112,15,0,127
STUHULEŢ,VS,182,10,4,0,14,47,12,0,59
"SATU NOU",VS,1150,36,2,0,38,266,14,0,280
BLĂGEŞTI,VS,834,9,1,0,10,71,9,0,80
IGEŞTI,VS,201,3,1,0,4,25,11,0,36
SIPENI,VS,71,2,4,0,6,17,13,0,30
BOGDANA,VS,454,25,1,0,26,88,11,0,99
SUCEVENI,VS,158,5,0,0,5,14,6,0,20
GĂVANU,VS,94,8,5,0,13,33,12,0,45
VERDEŞ,VS,155,12,4,0,16,41,14,0,55
"LACU BABEI",VS,334,14,0,0,14,96,6,0,102
BOGDĂNEŞTI,VS,790,19,7,0,26,185,27,0,212
BUDA,VS,283,24,7,0,31,157,16,0,173
VIŞINARI,VS,157,12,2,0,14,72,14,0,86
ULEA,VS,269,9,7,0,16,61,14,0,75
UNŢEŞTI,VS,792,23,3,0,26,184,15,0,199
HOROIATA,VS,119,3,3,0,6,39,13,0,52
BOGDĂNIŢA,VS,150,8,9,0,17,39,18,0,57
COROIEŞTI,VS,351,21,2,0,23,62,10,0,72
TUNSEŞTI,VS,205,15,4,0,19,45,5,0,50
CEPEŞTI,VS,437,30,3,0,33,142,30,5,177
BOŢEŞTI,VS,808,19,4,0,23,141,20,0,161
GUGEŞTI,VS,799,35,6,0,41,212,27,0,239
AVEREŞTI,VS,232,25,2,0,27,65,7,0,72
BUNEŞTI,VS,982,21,1,0,22,206,9,0,215
PLOPI,VS,380,17,14,0,31,72,25,0,97
ARMĂŞENI,VS,285,14,1,0,15,54,8,0,62
"PODU OPRII",VS,196,8,2,0,10,39,17,0,56
CIOCANI,VS,904,17,1,0,18,108,18,0,126
CRÂNG,VS,358,6,5,0,11,43,10,0,53
CODĂEŞTI,VS,1709,52,8,0,60,234,24,0,258
PRIBEŞTI,VS,975,18,3,0,21,94,14,0,108
"REDIU GALIAN",VS,454,6,4,0,10,87,10,0,97
GHERGHELEU,VS,320,11,7,0,18,54,10,0,64
COROIEŞTI,VS,729,37,0,0,37,263,13,0,276
CHILIENI,VS,211,19,6,0,25,66,14,0,80
MIRENI,VS,382,65,2,0,67,200,20,0,220
HREASCA,VS,302,12,3,0,15,108,9,0,117
COSTEŞTI,VS,1452,26,29,0,55,309,66,0,375
PUNTIŞENI,VS,234,17,3,0,20,48,13,0,61
CHIŢCANI,VS,256,3,0,0,3,27,7,0,34
DINGA,VS,107,4,6,0,10,29,17,0,46
RĂDEŞTI,VS,117,4,2,0,6,28,10,0,38
PÎRVEŞTI,VS,78,7,1,0,8,19,5,0,24
BĂLEŞTI,VS,598,25,3,0,28,172,23,0,195
FÂSTÂCI,VS,875,53,3,0,56,280,29,0,309
COZMEŞTI,VS,256,32,8,0,40,78,16,0,94
CREŢEŞTI,VS,488,14,3,0,17,81,11,0,92
"CREŢEŞTII DE SUS",VS,491,15,7,0,22,115,29,0,144
"SATU NOU",VS,252,14,5,0,19,57,13,0,70
BUDEŞTI,VS,162,17,3,0,20,41,7,0,48
DĂNEŞTI,VS,443,24,4,0,28,88,13,0,101
"EMIL RACOVIŢĂ",VS,670,19,8,0,27,93,14,0,107
BEREASA,VS,311,30,7,0,37,88,13,0,101
TĂTĂRĂNI,VS,165,17,2,0,19,43,16,0,59
DELENI,VS,1392,38,12,0,50,236,71,4,311
BULBOACA,VS,515,26,8,0,34,102,18,0,120
DELEŞTI,VS,605,14,5,0,19,136,21,0,157
ALBEŞTI,VS,157,14,4,0,18,59,9,0,68
FUNDĂTURA,VS,332,20,0,0,20,115,17,0,132
HÎRSOVA,VS,392,25,7,0,32,137,22,0,159
MÎNĂSTIREA,VS,147,16,4,0,20,68,10,0,78
RĂDUIEŞTI,VS,172,7,0,0,7,35,6,0,41
HURDUGI,VS,513,46,8,0,54,159,19,0,178
GRUMEZOAIA,VS,325,23,9,0,32,99,30,0,129
GUŞIŢEI,VS,616,17,3,0,20,137,8,0,145
PLOTONEŞTI,VS,264,16,1,0,17,62,10,0,72
URLAŢI,VS,199,13,3,0,16,49,7,0,56
DODEŞTI,VS,1155,19,7,0,26,393,39,47,479
URDEŞTI,VS,197,10,1,0,11,49,16,4,69
DRAGOMIREŞTI,VS,450,15,0,0,15,75,43,0,118
"POIANA PIETREI",VS,235,9,2,0,11,52,5,0,57
DOAGELE,VS,834,7,0,0,7,54,9,0,63
VLADIA,VS,384,6,0,0,6,47,13,0,60
BELZENI,VS,204,8,2,0,10,60,13,0,73
BĂBUŢA,VS,129,7,0,0,7,47,6,0,53
RĂDENI,VS,927,16,7,0,23,205,28,0,233
TULEŞTI,VS,144,8,2,0,10,36,18,0,54
POPEŞTI,VS,309,12,0,0,12,55,3,0,58
GHERMĂNEŞTI,VS,1638,83,2,0,85,378,22,0,400
DRÎNCENI,VS,464,13,2,0,15,46,12,0,58
RÎŞEŞTI,VS,1676,41,10,0,51,336,35,0,371
EPURENI,VS,1211,22,7,0,29,144,25,0,169
DUDA,VS,980,28,11,0,39,200,30,0,230
"VALEA GRECULUI",VS,1306,8,0,0,8,141,4,0,145
BOBEŞTI,VS,110,4,0,0,4,24,10,0,34
DUMEŞTI,VS,1791,35,9,0,44,231,39,0,270
"DUMEŞTII VECHI",VS,348,15,3,0,18,82,10,0,92
"VALEA MARE",VS,700,13,2,0,15,131,8,0,139
EPURENI,VS,777,19,7,0,26,126,23,0,149
BURSUCI,VS,734,31,4,0,35,210,17,0,227
BÎRLĂLEŞTI,VS,573,11,1,0,12,153,15,0,168
HORGA,VS,319,30,14,0,44,123,18,4,145
FĂLCIU,VS,2108,35,11,0,46,262,38,0,300
BOGDĂNEŞTI,VS,477,6,0,0,6,39,6,0,45
RÎNZEŞTI,VS,845,39,7,0,46,189,27,12,228
BOZIA,VS,331,11,2,0,13,55,14,0,69
COPĂCEANA,VS,461,20,7,0,27,115,18,0,133
"ODAIA BOGDANA",VS,258,6,9,0,15,43,14,0,57
FEREŞTI,VS,1653,40,1,0,41,340,27,2,369
FRUNTIŞENI,VS,760,36,4,0,40,230,11,0,241
GRĂJDENI,VS,637,35,8,0,43,219,26,0,245
GĂGEŞTI,VS,380,18,4,0,22,70,10,0,80
GIURCANI,VS,463,22,19,0,41,77,33,17,127
PEICANI,VS,429,18,2,0,20,97,15,0,112
TUPILAŢI,VS,255,7,4,0,11,82,16,0,98
GHERGHEŞTI,VS,935,13,3,0,16,219,24,0,243
LUNCA,VS,386,7,0,0,7,110,8,0,118
CORODEŞTI,VS,177,7,6,0,13,40,16,0,56
CHETROSU,VS,405,7,3,0,10,79,11,0,90
DRĂXENI,VS,121,5,5,0,10,38,8,0,46
GÎRCENI,VS,729,34,13,0,47,202,42,0,244
DUMBRĂVENI,VS,173,14,6,0,20,48,23,0,71
TROHAN,VS,182,13,0,0,13,58,16,0,74
RACOVA,VS,155,9,1,0,10,40,4,0,44
RACOVIŢA,VS,176,13,1,0,14,75,7,0,82
SLOBOZIA,VS,346,9,3,0,12,144,9,0,153
GRIVIŢA,VS,1310,23,8,0,31,224,36,0,260
TRESTIANA,VS,1131,19,0,0,19,170,22,0,192
"ODAIA BURSUCANI",VS,437,16,3,0,19,151,29,0,180
HOCENI,VS,425,16,3,0,19,81,11,0,92
BARBOŞI,VS,556,29,1,0,30,137,13,0,150
DELENI,VS,358,15,4,0,19,87,20,0,107
OŢELENI,VS,416,22,3,0,25,119,21,0,140
TOMŞA,VS,348,8,3,0,11,75,30,0,105
IANA,VS,917,23,2,0,25,210,25,0,235
HĂLĂREŞTI,VS,814,38,2,0,40,221,16,0,237
SILIŞTEA,VS,771,12,5,0,17,305,12,0,317
RECEA,VS,378,13,4,0,17,96,6,0,102
VADURILE,VS,255,20,6,0,26,61,9,0,70
IBĂNEŞTI,VS,533,86,5,0,91,318,28,0,346
MÎNZAŢI,VS,519,33,5,0,38,180,13,0,193
"PUŢU OLARULUI",VS,110,4,3,0,7,32,7,0,39
IVĂNEŞTI,VS,994,33,4,0,37,197,45,0,242
BROŞTENI,VS,463,25,7,0,32,101,16,0,117
"VALEA MARE",VS,409,4,2,0,6,56,9,0,65
COŞCA,VS,267,7,3,0,10,47,15,0,62
COŞEŞTI,VS,294,15,2,0,17,58,14,0,72
"VALEA OANEI",VS,228,7,3,0,10,49,14,0,63
URSOAIA,VS,742,20,9,0,29,144,38,0,182
IVEŞTI,VS,2188,39,6,0,45,445,38,0,483
LAZA,VS,1474,33,0,0,33,298,18,0,316
SAUCA,VS,867,15,2,0,17,161,16,0,177
RÎŞNIŢA,VS,239,4,5,0,9,53,14,0,67
LIPOVĂŢ,VS,1271,37,7,0,44,360,37,1,398
CORBU,VS,450,26,3,0,29,113,14,1,128
CHIŢOC,VS,827,43,6,0,49,217,32,0,249
CĂPUŞNENI,VS,202,12,7,0,19,73,11,0,84
"FUNDU VĂII",VS,456,15,5,0,20,146,8,0,154
"LUNCA BANULUI",VS,1655,39,2,0,41,350,24,0,374
OŢETOAIA,VS,682,30,4,0,34,172,14,0,186
"LUNCA VECHE",VS,76,6,4,0,10,23,5,0,28
FOCŞA,VS,154,7,6,0,13,35,8,0,43
BROSCOŞEŞTI,VS,400,9,3,0,12,78,12,0,90
MĂLUŞTENI,VS,504,9,3,0,12,98,12,0,110
ŢUŢCANI,VS,437,12,3,0,15,84,14,0,98
MÎNĂSTIREA,VS,83,4,2,0,6,21,9,0,30
GHIREASCA,VS,155,0,0,0,0,32,13,0,45
LUPEŞTI,VS,345,4,1,0,5,23,5,0,28
MÎNZĂTEŞTI,VS,278,9,2,0,11,51,10,0,61
MICLEŞTI,VS,786,50,6,0,56,168,36,0,204
CHIRCEŞTI,VS,940,46,10,0,56,235,41,0,276
POPEŞTI,VS,366,32,3,0,35,104,16,0,120
"MUNTENII DE JOS",VS,1830,52,1,130,183,257,13,155,425
MÎNJEŞTI,VS,649,24,6,126,156,149,33,126,308
BĂCĂOANI,VS,1048,14,11,169,194,164,29,212,405
"MUNTENII DE SUS",VS,1210,18,0,0,18,253,14,0,267
"SATU NOU",VS,2146,39,3,0,42,451,12,1,464
OLTENEŞTI,VS,394,16,7,0,23,86,21,0,107
ZGURA,VS,69,9,4,0,13,26,8,0,34
CURTENI,VS,165,15,5,0,20,31,9,0,40
VINEŢEŞTI,VS,528,24,4,0,28,116,18,0,134
TÎRZII,VS,868,59,4,0,63,293,41,0,334
PÎHNA,VS,121,29,7,0,36,58,11,0,69
OŞEŞTI,VS,1016,26,3,0,29,181,20,0,201
BUDA,VS,1092,15,1,0,16,289,20,5,314
PĂDURENI,VS,251,7,0,0,7,65,3,0,68
PĂDURENI,VS,1014,28,0,0,28,199,21,0,220
RUSCA,VS,535,11,6,0,17,59,14,0,73
DAVIDEŞTI,VS,414,16,4,0,20,103,16,0,119
IVĂNEŞTI,VS,346,11,5,0,16,109,24,0,133
VĂLENI,VS,871,37,9,0,46,198,27,0,225
PERIENI,VS,2919,46,12,0,58,359,46,0,405
BORODEŞTI,VS,216,10,7,0,17,88,19,0,107
POCHIDIA,VS,367,18,19,0,37,109,25,0,134
SĂLCENI,VS,784,35,2,0,37,250,12,0,262
POGANA,VS,641,30,17,0,47,125,36,2,163
TOMEŞTI,VS,728,9,0,0,9,123,8,0,131
BOGEŞTI,VS,565,10,4,27,41,90,19,27,136
MĂSCUREI,VS,551,23,0,0,23,107,6,0,113
POGONEŞTI,VS,1232,32,1,0,33,277,27,0,304
POLOCIN,VS,160,7,4,0,11,40,21,0,61
FLOREŞTI,VS,424,15,5,0,20,70,16,0,86
POIENEŞTI,VS,716,11,2,0,13,114,13,0,127
OPRIŞIŢA,VS,691,27,0,0,27,146,0,0,146
FRASINU,VS,293,4,5,0,9,46,7,0,53
POIENEŞTI-DEAL,VS,93,3,7,0,10,20,9,0,29
"FUNDU VĂII",VS,67,6,5,0,11,23,18,0,41
PUIEŞTI,VS,1151,28,2,0,30,198,22,0,220
IEZER,VS,231,2,4,0,6,41,9,0,50
GÎLŢEŞTI,VS,114,6,0,0,6,41,6,0,47
RUŞI,VS,301,8,2,0,10,60,18,0,78
FÎNTÎNELE,VS,90,11,12,0,23,47,21,0,68
CĂLIMĂNEŞTI,VS,278,18,3,0,21,94,11,0,105
FULGU,VS,120,12,11,0,23,39,11,0,50
LĂLEŞTI,VS,377,23,0,0,23,125,11,0,136
CRISTEŞTI,VS,361,7,3,0,10,86,10,0,96
CETĂŢUIA,VS,309,11,2,0,13,45,8,0,53
ROTARI,VS,83,9,2,0,11,29,8,0,37
BĂRTĂLUŞ-MOCANI,VS,209,5,5,0,10,44,14,0,58
PUNGEŞTI,VS,765,24,3,0,27,170,19,0,189
STEJARU,VS,190,10,1,0,11,52,3,0,55
SILIŞTEA,VS,203,5,0,0,5,56,3,0,59
ARMĂŞOAIA,VS,446,17,2,0,19,96,13,0,109
TOPORĂŞTI,VS,521,25,3,0,28,133,19,0,152
CURSEŞTI-DEAL,VS,173,7,2,0,9,53,6,0,59
CURSEŞTI-VALE,VS,207,4,2,0,6,41,17,0,58
PUŞCAŞI,VS,2116,59,9,0,68,375,19,0,394
"POIANA LUI ALEXA",VS,263,18,4,0,22,109,28,0,137
TEIŞORU,VS,415,29,4,0,33,97,9,0,106
"VALEA TÂRGULUI",VS,131,9,0,0,9,47,25,0,72
RAFAILA,VS,1476,19,0,0,19,247,13,0,260
REBRICEA,VS,448,5,3,0,8,79,14,0,93
DRAXENI,VS,659,97,7,0,104,322,37,0,359
SASOVA,VS,240,18,8,0,26,83,13,0,96
"TUFEŞTII DE JOS",VS,315,31,9,0,40,137,13,0,150
BOLAŢI,VS,154,56,20,0,76,89,29,0,118
CRĂCIUNEŞTI,VS,239,16,3,0,19,75,16,0,91
TATOMIREŞTI,VS,252,10,4,0,14,45,6,0,51
"RATEŞU CUZEI",VS,440,18,2,0,20,74,12,0,86
ROŞIEŞTI,VS,951,30,7,0,37,235,39,0,274
"VALEA LUI DARIE",VS,477,37,5,0,42,138,18,0,156
IDRICI,VS,329,13,7,0,20,62,29,0,91
"GURA IDRICI",VS,362,10,5,0,15,55,12,0,67
"GARA ROŞIEŞTI",VS,317,15,1,0,16,66,14,0,80
REDIU,VS,142,5,6,0,11,31,11,0,42
SOLEŞTI,VS,928,30,13,0,43,202,25,0,227
BOUŞORI,VS,212,11,3,0,14,65,19,0,84
IAZ,VS,284,13,2,0,15,117,3,0,120
"SATU NOU",VS,308,19,2,0,21,122,11,0,133
ŞERBOTEŞTI,VS,615,16,0,0,16,133,16,0,149
ŞTIOBORĂNI,VS,292,15,3,0,18,49,13,0,62
"VALEA SILIŞTEI",VS,238,17,6,0,23,73,18,0,91
STĂNILEŞTI,VS,2292,47,2,0,49,331,32,0,363
BOGDANA-VOLOSENI,VS,126,5,6,0,11,20,10,0,30
"BUDU CANTEMIR",VS,225,6,0,0,6,48,0,0,48
CHERSĂCOSU,VS,415,9,4,0,13,63,7,0,70
"GURA VĂII",VS,377,22,4,0,26,62,7,0,69
POGĂNEŞTI,VS,886,49,13,0,62,264,32,0,296
"ŞTEFAN CEL MARE",VS,602,28,4,0,32,204,43,0,247
BÎRZEŞTI,VS,1003,32,1,0,33,253,16,0,269
MĂRĂŞENI,VS,731,15,6,0,21,223,41,0,264
BRĂHĂŞOAIA,VS,429,19,3,0,22,153,37,0,190
ŞULETEA,VS,930,29,0,0,29,185,15,0,200
FEDEŞTI,VS,484,13,0,0,13,108,21,0,129
JIGĂLIA,VS,187,13,1,0,14,34,12,0,46
RĂŞCANI,VS,201,3,5,0,8,74,19,0,93
TANACU,VS,1306,49,16,0,65,288,70,0,358
BENEŞTI,VS,283,14,10,0,24,102,24,0,126
TĂCUTA,VS,670,32,4,0,36,137,17,0,154
DUMASCA,VS,243,4,6,0,10,31,12,0,43
MIRCEŞTI,VS,211,2,4,0,6,38,13,0,51
FOCŞEAŞCA,VS,624,11,0,0,11,78,17,0,95
PROTOPOPEŞTI,VS,685,17,3,0,20,97,10,0,107
LEOŞTI,VS,261,16,2,0,18,57,15,0,72
TĂTĂRĂNI,VS,614,14,6,0,20,89,22,0,111
BĂLŢAŢI,VS,469,22,4,0,26,63,13,0,76
STROIEŞTI,VS,287,12,7,0,19,31,19,0,50
SILIŞTEA,VS,291,11,7,0,18,77,21,0,98
TODIREŞTI,VS,764,17,4,0,21,118,14,0,132
COTIC,VS,244,11,4,0,15,93,19,0,112
DRĂGEŞTI,VS,299,11,0,0,11,107,11,0,118
HUC,VS,472,14,4,0,18,150,18,0,168
PLOPOASA,VS,190,14,4,0,18,76,14,0,90
SOFRONEŞTI,VS,121,7,1,0,8,44,4,0,48
"VALEA POPII",VS,94,16,5,0,21,41,12,0,53
VIIŞOARA,VS,95,2,0,0,2,21,6,0,27
TUTOVA,VS,1104,54,10,0,64,254,43,0,297
BĂDEANA,VS,1144,29,5,0,34,181,17,0,198
CRIVEŞTI,VS,369,16,9,0,25,59,17,0,76
CIORTOLOM,VS,143,7,5,0,12,47,9,0,56
COROIU,VS,160,14,12,0,26,40,14,0,54
VIZURENI,VS,141,4,6,0,10,28,12,0,40
VĂLENI,VS,2736,46,0,0,46,264,9,0,273
"MOARA DOMNEASCĂ",VS,1313,23,0,0,23,219,12,0,231
VETRIŞOAIA,VS,2409,41,4,0,45,362,36,0,398
BUMBĂTA,VS,100,18,3,0,21,48,17,0,65
VIIŞOARA,VS,963,35,10,0,45,175,38,33,246
"HALTA DODEŞTI",VS,166,9,8,0,17,43,24,4,71
VĂLENI,VS,108,15,5,0,20,53,22,0,75
VILTOTEŞTI,VS,163,13,4,0,17,52,17,16,85
VINDEREI,VS,770,37,4,0,41,185,44,0,229
BRĂDEŞTI,VS,454,15,4,0,19,101,14,0,115
DOCANI,VS,495,10,3,0,13,102,21,0,123
DOCĂNEASA,VS,390,8,1,0,9,44,9,0,53
OBÎRŞENI,VS,739,28,5,0,33,216,35,0,251
"VALEA LUNGĂ",VS,394,20,5,0,25,116,22,0,138
VOINEŞTI,VS,310,3,0,0,3,51,5,0,56
AVRĂMEŞTI,VS,526,6,0,0,6,70,15,0,85
MĂRĂŞEŞTI,VS,172,11,4,0,15,42,14,0,56
BĂNCEŞTI,VS,151,5,0,0,5,47,16,0,63
STÎNCĂŞENI,VS,161,5,2,0,7,66,12,0,78
GÎRDEŞTI,VS,483,42,0,0,42,148,6,0,154
OBÎRŞENI,VS,283,6,0,0,6,49,5,0,54
"OBÎRŞENII LINGURARI",VS,656,2,0,0,2,111,6,0,117
VULTUREŞTI,VS,833,31,5,0,36,186,31,0,217
BUHĂIEŞTI,VS,638,26,6,0,32,122,24,0,146
VOINEŞTI,VS,291,13,4,0,17,81,16,0,97
VUTCANI,VS,1124,34,7,0,41,257,42,24,323
MĂLĂIEŞTI,VS,255,16,4,0,20,66,10,36,112
"POŞTA ELAN",VS,128,11,0,0,11,53,12,4,69
ZĂPODENI,VS,1190,40,7,0,47,357,56,13,426
CIOFENI,VS,114,17,4,0,21,38,8,3,49
PORTARI,VS,503,20,2,0,22,123,18,0,141
DELEA,VS,167,9,3,0,12,27,7,0,34
TELEJNA,VS,304,13,2,0,15,68,12,0,80
BUTUCĂRIA,VS,122,8,6,0,14,35,12,0,47
DOBROSLOVEŞTI,VS,305,27,8,0,35,97,13,0,110
UNCEŞTI,VS,289,13,4,0,17,141,13,0,154
ZORLENI,VS,4215,87,15,0,102,498,53,0,551
"DEALU MARE",VS,207,8,6,0,14,37,10,0,47
SIMILA,VS,1051,40,9,0,49,162,44,0,206
POPENI,VS,2196,66,26,0,92,384,50,0,434
