siruta,"nr sectie","nume sectie",localitate,county,"pe lista",LP_06_10,LS_06_10,UM_06_10,LT_06_10,LP_06_13,LS_06_13,UM_06_13,LT_06_13,LP_06_16,LS_06_16,UM_06_16,LT_06_16,LP_06_19,LS_06_19,UM_06_19,LT_06_19,LP_06_21,LS_06_21,UM_06_21,LT_06_21
1026,1,"CENTRUL DE ZI PENTRU PERSOANE VÂRSTNICE","ALBA IULIA",AB,1593,25,5,0,30,63,9,0,72,80,10,0,90,103,12,0,115,111,12,0,123
1026,2,"ŞCOALA GIMNAZIALĂ „VASILE GOLDIŞ”","ALBA IULIA",AB,1056,9,0,0,9,39,9,0,48,48,10,0,58,56,10,0,66,67,12,0,79
1026,3,"ŞCOALA GIMNAZIALĂ „VASILE GOLDIŞ”","ALBA IULIA",AB,1402,9,6,0,15,33,7,0,40,52,13,0,65,74,16,0,90,83,17,0,100
1026,4,"ŞCOALĂ GIMNAZIALĂ „AVRAM IANCU”","ALBA IULIA",AB,1337,9,0,0,9,26,0,0,26,43,4,0,47,56,4,0,60,61,4,0,65
1026,5,"ŞCOALĂ GIMNAZIALĂ „AVRAM IANCU”","ALBA IULIA",AB,916,20,2,0,22,38,6,0,44,60,8,0,68,67,10,0,77,75,11,0,86
1026,6,"CASA DE CULTURĂ A STUDENŢILOR","ALBA IULIA",AB,625,6,4,0,10,15,4,0,19,17,8,0,25,28,9,0,37,33,9,0,42
1026,7,"COLEGIUL ECONOMIC”DIONISIE POP MARŢIAN”","ALBA IULIA",AB,1311,20,1,0,21,42,1,0,43,74,5,0,79,97,6,0,103,103,9,0,112
1026,8,"COLEGIUL NAŢIONAL „HOREA CLOŞCA ŞI CRIŞAN”","ALBA IULIA",AB,1060,16,3,0,19,49,3,0,52,83,7,0,90,103,9,0,112,114,9,0,123
1026,9,"COLEGIUL NAŢIONAL „HOREA CLOŞCA ŞI CRIŞAN”","ALBA IULIA",AB,1691,13,0,0,13,32,1,0,33,71,7,0,78,100,14,0,114,118,15,0,133
1026,10,"COLEGIUL NAŢIONAL „HOREA CLOŞCA ŞI CRIŞAN”","ALBA IULIA",AB,1465,10,4,0,14,29,10,0,39,49,29,0,78,93,46,0,139,102,52,0,154
1026,11,"COLEGIUL NAŢIONAL „HOREA CLOŞCA ŞI CRIŞAN”","ALBA IULIA",AB,1027,3,1,0,4,22,3,0,25,46,3,0,49,55,12,0,67,61,14,0,75
1026,12,"COLEGIUL TEHNIC ""APULUM""","ALBA IULIA",AB,1226,15,0,0,15,27,2,0,29,33,3,0,36,52,4,0,56,58,4,0,62
1026,13,"COLEGIUL TEHNIC „APULUM”","ALBA IULIA",AB,1018,8,6,0,14,15,8,0,23,35,8,0,43,52,8,0,60,60,8,0,68
1026,14,"COLEGIUL TEHNIC „APULUM”","ALBA IULIA",AB,1101,9,0,0,9,25,0,0,25,42,0,0,42,63,0,0,63,73,0,0,73
1026,15,"GRĂDINIŢA CU PROGRAM PRELUNGIT NR.9","ALBA IULIA",AB,1398,8,4,0,12,32,14,0,46,43,28,0,71,68,41,0,109,80,44,0,124
1026,16,"SEMINARUL TEOLOGIC ORTODOX „SFÂNTUL SIMION ŞTEFAN“","ALBA IULIA",AB,1345,3,0,0,3,32,9,0,41,44,16,53,113,72,19,53,144,83,20,53,156
1026,17,"ŞCOALA GIMNAZIALĂ„ION AGÂRBICEANU”","ALBA IULIA",AB,957,15,3,0,18,38,4,0,42,53,6,0,59,79,8,0,87,94,11,0,105
1026,18,"ŞCOALA GIMNAZIALĂ„ION AGÂRBICEANU”","ALBA IULIA",AB,916,10,1,0,11,40,6,0,46,54,7,0,61,70,8,0,78,77,8,0,85
1026,19,"GRĂDINIŢA CU PROGRAM PRELUNGIT NR.11","ALBA IULIA",AB,1334,14,0,0,14,40,2,0,42,57,6,0,63,69,14,0,83,77,15,0,92
1026,20,"GRĂDINIŢA CU PROGRAM PRELUNGIT STEP BY STEP NR.12","ALBA IULIA",AB,1089,9,1,0,10,42,3,0,45,65,3,0,68,84,4,0,88,91,5,0,96
1026,21,"GRĂDINIŢA CU PROGRAM PRELUNGIT STEP BY STEP NR.12","ALBA IULIA",AB,1097,14,2,0,16,39,3,0,42,65,4,0,69,99,8,0,107,103,8,0,111
1026,22,"ŞCOALA GIMNAZIALĂ „MIHAI EMINESCU”","ALBA IULIA",AB,1276,15,6,0,21,60,16,0,76,84,21,0,105,99,23,0,122,116,29,0,145
1026,23,"ŞCOALA GIMNAZIALĂ „MIHAI EMINESCU”","ALBA IULIA",AB,1648,15,0,0,15,40,7,0,47,54,7,0,61,84,9,0,93,90,9,0,99
1026,24,"GRĂDINIŢA CU PROGRAM PRELUNGIT NR.13","ALBA IULIA",AB,1119,26,4,0,30,49,6,0,55,72,9,0,81,86,10,0,96,99,12,0,111
1026,25,"GRĂDINIŢA CU PROGRAM PRELUNGIT NR.13","ALBA IULIA",AB,1254,9,0,0,9,49,1,0,50,65,3,0,68,89,7,0,96,95,7,0,102
1026,26,"LICEUL CU PROGRAM SPORTIV","ALBA IULIA",AB,1415,6,0,0,6,26,4,0,30,39,13,0,52,57,15,0,72,66,17,0,83
1026,27,"LICEUL CU PROGRAM SPORTIV","ALBA IULIA",AB,1388,15,0,0,15,38,2,0,40,56,4,0,60,91,6,0,97,106,7,0,113
1026,28,"LICEUL CU PROGRAM SPORTIV","ALBA IULIA",AB,1395,26,3,0,29,69,4,0,73,104,5,0,109,124,6,0,130,145,8,0,153
1026,29,"LICEUL CU PROGRAM SPORTIV","ALBA IULIA",AB,1103,7,4,0,11,24,4,0,28,33,4,0,37,49,4,0,53,52,4,0,56
1026,30,"BAZIN OLIMPIC","ALBA IULIA",AB,1181,13,0,0,13,35,7,0,42,50,8,0,58,61,8,0,69,63,8,0,71
1026,31,"BAZIN OLIMPIC","ALBA IULIA",AB,1429,3,6,0,9,14,6,0,20,27,7,0,34,39,11,0,50,48,13,0,61
1026,32,"STADION MUNICIPAL „CETATE”","ALBA IULIA",AB,1430,11,2,0,13,38,3,0,41,54,3,0,57,78,8,0,86,89,11,0,100
1026,33,"GRADINITA CU PROGRAM NORMAL NR. 10","ALBA IULIA",AB,1773,10,6,0,16,25,6,0,31,44,6,0,50,63,8,0,71,69,9,0,78
1026,34,"GRĂDINIŢA CU PROGRAM NORMAL NR. 10","ALBA IULIA",AB,1487,8,6,0,14,27,7,0,34,41,7,0,48,62,11,0,73,69,11,0,80
1026,35,"COLEGIUL TEHNIC „DORIN PAVEL” SCOALA GENERALA NR. 9","ALBA IULIA",AB,1456,9,2,0,11,32,5,0,37,60,6,0,66,91,6,0,97,94,9,0,103
1026,36,"COLEGIUL TEHNIC „DORIN PAVEL”","ALBA IULIA",AB,1102,6,3,0,9,20,4,0,24,29,8,0,37,57,16,0,73,65,16,0,81
1026,37,"GRĂDINIŢA CU PROGRAM PRELUNGIT NR.16","ALBA IULIA",AB,1605,11,4,0,15,24,8,0,32,35,10,0,45,58,15,0,73,73,17,0,90
1026,38,"COLEGIUL TEHNIC „ALEXANDRU DOMSA”","ALBA IULIA",AB,1075,12,1,0,13,23,1,0,24,32,1,0,33,40,1,0,41,45,1,0,46
1026,39,"COLEGIUL TEHNIC „ALEXANDRU DOMSA”","ALBA IULIA",AB,1633,8,4,0,12,22,4,0,26,49,5,0,54,70,5,0,75,80,5,0,85
1026,40,"COLEGIUL TEHNIC „ALEXANDRU DOMSA”","ALBA IULIA",AB,1390,9,6,0,15,18,7,0,25,33,8,0,41,51,9,0,60,59,9,0,68
1026,41,"SC FLORIDA IMPEXSRL","ALBA IULIA",AB,1782,8,2,0,10,32,4,0,36,50,9,0,59,84,11,0,95,97,14,0,111
1026,42,"GRĂDINIŢA CU PROGRAM NORMAL NR.5PARTOŞ","ALBA IULIA",AB,815,6,0,0,6,23,0,0,23,43,4,0,47,62,6,0,68,68,7,0,75
1026,43,"CĂMINUL PENTRU PERSOANE VÂRSTNICE","ALBA IULIA",AB,996,16,0,0,16,41,1,0,42,55,3,0,58,90,3,0,93,101,4,0,105
1035,44,"GRĂDINIŢA CU PROGRAM NORMAL BĂRĂBANŢ",BĂRĂBANŢ,AB,1028,7,0,0,7,18,3,0,21,34,3,0,37,54,3,0,57,59,3,0,62
1035,45,"GRĂDINIŢA CU PROGRAM NORMAL BĂRĂBANŢ",BĂRĂBANŢ,AB,1231,14,3,0,17,33,5,0,38,41,5,0,46,52,6,0,58,55,6,0,61
1044,46,"ŞCOALA GIMNAZIALĂ MICEŞTI - SALA DE SPORT",MICEŞTI,AB,1016,11,2,0,13,20,2,0,22,32,3,0,35,40,3,0,43,52,3,0,55
1044,47,"ŞCOALA GIMNAZIALĂ MICEŞTI",MICEŞTI,AB,1247,11,3,0,14,27,4,0,31,38,4,0,42,54,5,0,59,62,5,0,67
1053,48,"CĂMINUL CULTURAL OARDA DE JOS",OARDA,AB,1270,10,0,0,10,34,0,0,34,49,0,0,49,72,0,0,72,83,2,0,85
1053,49,"GRĂDINIŢA CU PROGRAM NORMAL OARDA DE SUS",OARDA,AB,718,7,1,0,8,18,1,0,19,32,3,0,35,44,8,0,52,49,9,0,58
1062,50,"ŞCOALA PRIMARĂ PÂCLIŞA",PÎCLIŞA,AB,865,5,0,0,5,11,2,0,13,14,2,0,16,25,3,0,28,35,3,0,38
1222,51,"ȘCOALA GIMNAZIALĂ ”OVIDIU HULEA” AIUD",AIUD,AB,1425,23,5,0,28,48,5,0,53,59,5,0,64,76,6,0,82,93,7,0,100
1222,52,"GRĂDINIŢA CU PROGRAM PRELUNGIT ""PRIMII PAŞI"" AIUD",AIUD,AB,956,9,0,0,9,20,1,181,202,27,1,181,209,41,2,181,224,45,4,181,230
1222,53,"GRĂDINIŢA CU PROGRAM PRELUNGIT ""PRIMII PAŞI"" AIUD",AIUD,AB,1060,3,0,0,3,22,1,188,211,28,1,188,217,58,1,188,247,61,2,188,251
1222,54,"CREŞA AIUD",AIUD,AB,1318,19,5,0,24,38,6,0,44,55,8,0,63,75,10,0,85,82,11,0,93
1222,55,"GRĂDINIŢA CU PROGRAM PRELUNGIT NR. 2 AIUD",AIUD,AB,1325,10,3,0,13,44,4,0,48,47,5,0,52,62,5,0,67,71,5,0,76
1222,56,"ŞCOALA GIMNAZIALĂ “AXENTE SEVER” AIUD",AIUD,AB,1264,2,0,0,2,19,1,0,20,35,1,0,36,42,1,0,43,45,1,0,46
1222,57,"ŞCOALA GIMNAZIALĂ “AXENTE SEVER” AIUD",AIUD,AB,1220,20,0,0,20,41,0,0,41,50,0,0,50,62,1,0,63,75,1,0,76
1222,58,"ŞCOALA GIMNAZIALĂ “AXENTE SEVER” AIUD",AIUD,AB,1160,21,3,0,24,45,3,0,48,64,3,0,67,74,5,0,79,85,5,0,90
1222,59,"COLEGIUL NAŢIONAL “TITU MAIORESCU“ AIUD",AIUD,AB,1439,7,0,0,7,23,2,0,25,28,3,0,31,36,3,0,39,43,3,0,46
1222,60,"COLEGIUL TEHNIC AIUD",AIUD,AB,801,6,0,0,6,17,6,0,23,21,6,0,27,29,6,0,35,30,6,0,36
1222,61,"COLEGIUL TEHNIC AIUD",AIUD,AB,727,3,0,0,3,14,4,0,18,22,4,0,26,26,4,0,30,28,4,0,32
1222,62,"FOSTA GRĂDINIŢĂ NR. 1 AIUD",AIUD,AB,1466,6,1,0,7,29,1,0,30,37,3,0,40,61,7,0,68,78,7,0,85
1222,63,"ŞCOALA GIMNAZIALĂ “OVIDIU HULEA” AIUD",AIUD,AB,1038,11,7,0,18,14,8,0,22,20,8,0,28,26,10,0,36,31,10,0,41
1222,64,"ŞCOALA GIMNAZIALĂ “OVIDIU HULEA” AIUD",AIUD,AB,1198,5,0,0,5,16,2,0,18,26,4,0,30,39,6,0,45,51,6,0,57
1231,65,"ŞCOALA GIMNAZIALĂ ""LIVIU REBREANU"" AIUDUL DE SUS","AIUDUL DE SUS",AB,921,8,0,0,8,16,0,0,16,23,0,0,23,40,0,0,40,44,0,0,44
1231,66,"ŞCOALA GIMNAZIALĂ ""LIVIU REBREANU"" AIUDUL DE SUS","AIUDUL DE SUS",AB,1111,9,0,0,9,24,0,1,25,34,2,1,37,51,3,1,55,57,4,1,62
1277,67,"LICEUL TEHNOLOGIC AGRICOL ""ALEXANDRU BORZA"" CIUMBRUD",CIUMBRUD,AB,1074,3,4,0,7,8,4,0,12,16,4,0,20,23,5,0,28,27,5,0,32
1240,68,"FOSTA ŞCOALĂ GENERALĂ GÎMBAŞ",GÎMBAŞ,AB,414,2,3,0,5,3,4,0,7,5,4,0,9,6,4,0,10,6,4,0,10
1286,69,"ŞCOALA PRIMARĂ GÎRBOVA DE JOS","GÎRBOVA DE JOS",AB,418,4,0,0,4,7,0,0,7,9,2,0,11,10,2,0,12,15,2,0,17
1295,70,"FOSTA ŞCOALĂ GENERALĂ GÎRBOVA DE SUS","GÎRBOVA DE SUS",AB,233,2,0,0,2,3,1,0,4,3,2,0,5,5,2,0,7,8,2,0,10
1302,71,"FOSTA ŞCOALĂ GENERALĂ GÎRBOVIŢA",GÎRBOVIŢA,AB,99,0,0,0,0,1,0,0,1,1,0,0,1,1,0,0,1,1,3,0,4
1259,72,"GRĂDINIŢA CU PROGRAM NORMAL MĂGINA",MĂGINA,AB,464,3,2,0,5,11,2,0,13,13,4,0,17,20,4,0,24,24,5,0,29
1268,73,"CĂMINUL CULTURAL PĂGIDA",PĂGIDA,AB,93,0,2,0,2,0,2,0,2,0,4,0,4,1,4,0,5,1,4,0,5
1311,74,"SALA DE FESTIVITĂŢI DIN SÎNCRAI",SÎNCRAI,AB,572,1,0,0,1,8,0,0,8,20,3,0,23,23,3,0,26,23,7,0,30
1357,75,"PIAŢA AGROALIMENTARĂ",BLAJ,AB,1012,8,5,0,13,16,6,0,22,28,6,0,34,58,7,0,65,58,7,0,65
1357,76,"PIAŢA AGROALIMENTARĂ",BLAJ,AB,621,5,1,0,6,23,1,0,24,28,2,0,30,43,4,0,47,47,4,0,51
1357,77,"BAZA DE AGREMENT A MUNICIPIULUI BLAJ",BLAJ,AB,685,0,3,0,3,0,3,0,3,0,3,0,3,0,3,0,3,0,3,0,3
1357,78,"GRADINIŢA CU PROGRAM PRELUNGIT ""LUMEA COPIILOR""",BLAJ,AB,1264,5,2,0,7,25,3,0,28,38,3,0,41,52,3,0,55,61,3,0,64
1357,79,"ŞCOALA GIMNAZIALĂ ""TOMA COCIŞIU"" BLAJ",BLAJ,AB,1246,7,0,0,7,28,2,0,30,42,2,0,44,56,2,0,58,62,3,0,65
1357,80,"CENTRUL CULTURAL ""IACOB MUREŞIANU’’",BLAJ,AB,853,5,1,0,6,23,6,0,29,32,12,0,44,40,12,0,52,45,12,0,57
1357,81,"LICEUL TEHNOLOGIC ""ŞTEFAN MANCIULEA"" BLAJ",BLAJ,AB,631,2,0,0,2,12,4,0,16,16,4,0,20,22,7,0,29,23,7,0,30
1357,82,"SERVICIUL PUBLIC DE ASISTENŢĂ SOCIALĂ BLAJ",BLAJ,AB,511,1,2,0,3,4,6,0,10,8,12,0,20,18,12,0,30,24,12,0,36
1357,83,"ASOCIAŢIA JUDEŢEANĂ A VÂNĂTORILOR SI PESCARILOR SPORTIVI ALBA - CLUBUL BLAJ",BLAJ,AB,343,0,1,0,1,1,1,0,2,5,1,0,6,7,1,0,8,9,2,0,11
1357,84,"LICEUL TEHNOLOGIC ""TIMOTEI CIPARIU""",BLAJ,AB,1468,27,1,0,28,37,1,0,38,42,2,0,44,57,3,0,60,70,5,0,75
1357,85,"COLEGIUL NAŢIONAL ""INOCHENTIE MICU CLAIN’’",BLAJ,AB,1366,8,2,0,10,21,3,0,24,31,7,0,38,44,9,0,53,50,10,0,60
1357,86,"ŞCOALA GIMNAZIALĂ ""PETRU PAVEL ARON"" BLAJ",BLAJ,AB,1599,6,2,0,8,22,2,0,24,35,2,0,37,45,5,0,50,58,9,0,67
1357,87,"ŞCOALA GIMNAZIALĂ ""ION MICU MOLDOVAN"" BLAJ",BLAJ,AB,1434,3,0,0,3,15,0,0,15,24,0,0,24,31,0,0,31,33,0,0,33
1357,88,"GRĂDINIŢA CU PROGRAM NORMAL ""IZVOARELE"" BLAJ",BLAJ,AB,1329,7,3,0,10,23,5,0,28,32,5,0,37,52,6,0,58,52,6,0,58
1428,89,"ŞCOALA GIMNAZIALĂ ""AXENTE SEVER"" MĂNĂRADE",MĂNĂRADE,AB,900,7,6,0,13,8,6,0,14,9,6,0,15,12,7,0,19,17,7,0,24
1393,90,"ŞCOALA PRIMARĂ PETRISAT",PETRISAT,AB,480,0,0,0,0,0,0,0,0,1,0,0,1,3,0,0,3,5,0,0,5
1400,91,"ŞCOALA GIMNAZIALĂ ""SIMION BĂRNUŢIU"" TIUR",TIUR,AB,1301,9,0,0,9,15,0,0,15,25,0,0,25,36,0,0,36,41,0,0,41
1883,92,"SERVICIUL PUBLIC DE ADMINISTRARE A PATRIMONIULUI SEBEŞ",SEBEŞ,AB,1633,16,0,0,16,32,3,0,35,75,4,0,79,93,7,0,100,113,7,0,120
1883,93,"LICEUL TEHNOLOGIC SEBEŞ",SEBEŞ,AB,1400,2,0,0,2,6,3,0,9,7,5,0,12,7,5,0,12,7,5,0,12
1883,94,"LICEUL TEHNOLOGIC SEBEŞ",SEBEŞ,AB,1622,16,0,0,16,43,3,0,46,65,5,0,70,89,5,0,94,102,5,0,107
1883,95,"LICEUL TEHNOLOGIC SEBEŞ",SEBEŞ,AB,1035,7,0,0,7,29,0,0,29,44,0,0,44,57,0,0,57,73,0,0,73
1883,96,"LICEUL TEHNOLOGIC SEBEŞ",SEBEŞ,AB,981,3,5,0,8,23,5,0,28,28,5,0,33,34,8,0,42,34,9,0,43
1883,97,"LICEUL CU PROGRAM SPORTIV SEBEŞ",SEBEŞ,AB,1549,24,1,0,25,59,1,0,60,71,4,0,75,101,5,0,106,115,5,0,120
1883,98,"LICEUL CU PROGRAM SPORTIV SEBEŞ",SEBEŞ,AB,1517,11,1,0,12,34,2,0,36,42,2,0,44,59,4,0,63,68,7,0,75
1883,99,"LICEUL CU PROGRAM SPORTIV SEBEŞ",SEBEŞ,AB,1433,6,2,0,8,22,6,0,28,27,6,0,33,50,8,0,58,56,8,0,64
1883,100,"ŞCOALA GIMNAZIALĂNR. 2 SEBEŞ",SEBEŞ,AB,1415,5,2,0,7,34,3,0,37,45,5,0,50,58,7,0,65,65,7,4,76
1883,101,"COLEGIUL NAŢIONAL ""LUCIAN BLAGA"" SEBEŞ",SEBEŞ,AB,1306,15,3,0,18,21,7,0,28,57,11,0,68,83,11,0,94,96,11,0,107
1883,102,"COLEGIUL NAŢIONAL ""LUCIAN BLAGA"" SEBEŞ",SEBEŞ,AB,1345,10,4,0,14,19,5,0,24,30,6,0,36,41,6,0,47,43,6,0,49
1883,103,"ŞCOALA GIMNAZIALĂ ""MIHAIL KOGĂLNICEANU"" SEBEŞ",SEBEŞ,AB,1151,5,5,0,10,21,6,0,27,29,6,0,35,51,12,0,63,57,12,0,69
1883,104,"ŞCOALA GIMNAZIALĂ ""MIHAIL KOGĂLNICEANU"" SEBEŞ",SEBEŞ,AB,1083,8,3,0,11,14,3,0,17,24,5,0,29,36,5,0,41,45,5,0,50
1883,105,"ŞCOALA GIMNAZIALĂ ""MIHAIL KOGĂLNICEANU"" SEBEŞ",SEBEŞ,AB,1156,12,0,0,12,27,0,0,27,33,0,0,33,48,3,0,51,50,3,0,53
1883,106,"ŞCOALA GIMNAZIALĂ ""MIHAIL KOGĂLNICEANU"" SEBEŞ",SEBEŞ,AB,1115,10,0,0,10,23,1,0,24,41,2,0,43,55,2,0,57,57,2,0,59
1892,107,"ŞCOALA GIMNAZIALĂ LANCRĂM",LANCRĂM,AB,1416,17,2,0,19,39,3,0,42,51,3,0,54,69,4,0,73,78,5,0,83
1909,108,"ŞCOALA GIMNAZIALĂ PETREŞTI",PETREŞTI,AB,1419,15,0,0,15,37,3,0,40,66,6,0,72,89,6,0,95,105,6,0,111
1909,109,"ŞCOALA GIMNAZIALĂ PETREŞTI",PETREŞTI,AB,1402,8,0,0,8,21,0,0,21,30,2,0,32,56,2,0,58,62,3,0,65
1909,110,"ŞCOALA GIMNAZIALĂ PETREŞTI",PETREŞTI,AB,1412,6,1,0,7,16,1,0,17,25,2,0,27,35,2,0,37,41,3,0,44
1918,111,"ŞCOALA GIMNAZIALĂRĂHĂU",RĂHĂU,AB,850,5,0,0,5,10,2,0,12,13,2,0,15,17,2,0,19,17,2,0,19
1160,112,"ŞCOALA GIMNAZIALĂ ,,AVRAM IANCU'' ABRUD",ABRUD,AB,1151,13,3,0,16,25,4,0,29,30,6,0,36,37,9,0,46,37,10,0,47
1160,113,"ŞCOALA GIMNAZIALĂ ""AVRAM IANCU"" GRADINIȚA CU PROGRAM NORMAL NR. 1 ABRUD",ABRUD,AB,1102,6,0,0,6,27,0,0,27,34,0,0,34,43,1,0,44,48,2,0,50
1160,114,"ȘCOALA GIMNAZIALĂ ""AVRAM IANCU""GRĂDINIŢA CU PROGRAM PRELUNGIT NR.1 ABRUD",ABRUD,AB,1322,14,0,0,14,30,1,0,31,41,1,0,42,63,1,0,64,66,1,0,67
1160,115,"LICEUL ,,HOREA, CLOŞCA ŞI CRIŞAN"" ABRUD",ABRUD,AB,1091,6,4,0,10,15,5,0,20,23,8,0,31,33,11,0,44,39,12,0,51
2924,116,"ŞCOALA GENERALĂ CU CLASELE I-VIII","BAIA DE ARIEŞ",AB,914,6,0,0,6,16,0,17,33,19,1,17,37,20,2,17,39,21,2,17,40
2924,117,"ŞCOALA GENERALĂ CU CLASELE I-VIII","BAIA DE ARIEŞ",AB,881,12,0,0,12,29,2,0,31,34,2,0,36,48,2,0,50,50,3,0,53
2924,118,"LICEUL ""DR. LAZĂR CHIRILĂ""","BAIA DE ARIEŞ",AB,644,4,4,0,8,9,7,0,16,14,7,0,21,16,7,0,23,23,7,0,30
2933,119,"ŞCOALA PRIMARĂ BRĂZEŞTI",BRĂZEŞTI,AB,212,2,0,0,2,4,0,0,4,5,0,0,5,8,1,0,9,8,1,0,9
2942,120,"CĂMINUL CULTURAL CIOARA DE SUS","CIOARA DE SUS",AB,191,3,0,0,3,4,0,0,4,5,3,0,8,6,3,0,9,7,3,0,10
2951,121,"CĂMINUL CULTURAL MUNCELU",MUNCELU,AB,304,1,2,0,3,2,2,0,4,4,5,0,9,10,5,0,15,10,5,0,15
2960,122,"CĂMINUL CULTURAL SARTĂŞ",SARTĂŞ,AB,320,4,0,0,4,6,0,0,6,7,0,0,7,10,0,0,10,10,0,0,10
1464,123,"PRIMĂRIA ORAŞULUI CÎMPENI",CÎMPENI,AB,1263,18,0,0,18,45,19,0,64,69,28,0,97,85,32,0,117,94,36,0,130
1464,124,"ŞCOALA GIMNAZIALĂ CÎMPENI",CÎMPENI,AB,897,10,0,0,10,22,3,0,25,35,5,0,40,45,5,0,50,57,6,0,63
1464,125,"ȘCOALA GIMNAZIALĂ CÎMPENI",CÎMPENI,AB,845,12,5,0,17,22,6,0,28,39,6,0,45,51,7,0,58,65,9,0,74
1464,126,"COLEGIUL NAŢIONAL ”AVRAM IANCU” CÎMPENI",CÎMPENI,AB,899,21,1,0,22,34,4,0,38,42,6,0,48,86,8,41,135,97,8,41,146
1464,127,"COLEGIUL NAŢIONAL ”AVRAM IANCU” CÎMPENI",CÎMPENI,AB,879,7,0,0,7,38,0,0,38,47,3,0,50,59,4,0,63,78,6,0,84
1464,128,"ŞCOALA PRIMARĂ VÎRŞI",CÎMPENI,AB,559,4,4,0,8,8,5,0,13,12,6,0,18,18,7,0,25,23,7,0,30
1507,129,"ŞCOALAPRIMARĂ CERTEGE",CERTEGE,AB,384,5,0,0,5,15,0,0,15,24,0,0,24,36,0,0,36,40,0,0,40
1598,130,"ŞCOALA PRIMARĂ MIHOEŞTI",MIHOEŞTI,AB,274,4,3,0,7,10,5,0,15,15,5,0,20,17,5,0,22,18,5,0,23
1650,131,"ŞCOALA PRIMARĂ VALEA BISTRII","VALEA BISTRII",AB,378,4,4,0,8,9,4,0,13,24,5,0,29,26,5,0,31,28,5,0,33
1703,132,"ŞCOALA GIMNAZIALĂ NR. 3 - CUGIR",CUGIR,AB,1081,15,3,0,18,44,5,0,49,57,6,0,63,69,6,0,75,80,6,0,86
1703,133,"ŞCOALA GIMNAZIALĂ NR. 3 - CUGIR",CUGIR,AB,1419,20,1,0,21,47,3,0,50,63,4,0,67,83,4,0,87,92,4,0,96
1703,134,"ŞCOALA GIMNAZIALĂ NR. 3 - CUGIR",CUGIR,AB,1278,16,1,0,17,40,2,0,42,59,4,0,63,73,7,0,80,76,7,0,83
1703,135,"ŞCOALA GIMNAZIALĂ NR. 3 - CUGIR",CUGIR,AB,1153,17,3,0,20,45,5,0,50,55,5,0,60,66,5,0,71,69,5,0,74
1703,136,"GRĂDINIŢA CU PROGRAM NORMAL NR. 5 - CUGIR",CUGIR,AB,1049,16,5,0,21,34,5,0,39,49,6,0,55,58,6,0,64,63,6,0,69
1703,137,"COLEGIUL NAŢIONAL ""DAVID PRODAN"" CUGIR",CUGIR,AB,1106,11,3,0,14,26,3,0,29,38,3,0,41,56,3,0,59,56,6,0,62
1703,138,"COLEGIUL NAŢIONAL ""DAVID PRODAN"" CUGIR",CUGIR,AB,1079,15,0,0,15,30,0,0,30,42,5,0,47,63,5,0,68,70,5,0,75
1703,139,"ŞCOALA GIMNAZIALĂ ""SINGIDAVA"" CUGIR",CUGIR,AB,1215,11,0,0,11,36,0,0,36,47,0,0,47,59,0,0,59,63,0,0,63
1703,140,"ŞCOALA GIMNAZIALĂ ""SINGIDAVA"" CUGIR",CUGIR,AB,1387,20,0,0,20,49,2,0,51,63,4,0,67,84,6,0,90,94,6,0,100
1703,141,"ŞCOALA GIMNAZIALĂ ""SINGIDAVA"" CUGIR",CUGIR,AB,1154,3,2,0,5,11,2,0,13,17,2,0,19,24,4,0,28,26,4,0,30
1703,142,"GRĂDINIŢA CU PROGRAM NORMAL ""VOINICEL"" CUGIR",CUGIR,AB,1246,21,0,0,21,48,0,0,48,69,0,0,69,83,6,0,89,84,6,0,90
1703,143,"COLEGIUL TEHNIC ""I.D.LĂZĂRESCU"" CUGIR",CUGIR,AB,1072,7,0,0,7,21,0,0,21,35,0,0,35,41,0,0,41,57,0,0,57
1703,144,"CASA DE CULTURĂ A ORAŞULUI CUGIR",CUGIR,AB,1322,8,5,0,13,29,5,0,34,48,8,0,56,68,11,0,79,69,13,0,82
1703,145,"GRĂDINIŢA CU PROGRAM NORMAL NR. 2 - CUGIR",CUGIR,AB,1215,6,3,0,9,11,4,0,15,21,4,0,25,27,4,0,31,30,5,0,35
1703,146,"ŞCOALA GIMNAZIALĂ ""IOSIF PERVAIN"" CUGIR",CUGIR,AB,1094,12,0,0,12,22,0,0,22,32,0,0,32,45,6,0,51,52,6,0,58
1703,147,"ŞCOALA GIMNAZIALĂ ""IOSIF PERVAIN"" CUGIR",CUGIR,AB,1134,8,0,0,8,31,0,0,31,42,0,0,42,56,2,0,58,62,2,0,64
1703,148,"GRĂDINIŢA CU PROGRAM NORMAL NR. 1 - CUGIR",CUGIR,AB,1155,7,2,0,9,17,2,0,19,24,4,0,28,38,4,0,42,42,4,0,46
1721,149,"ŞCOALA PRIMARĂ - BUCURU",BUCURU,AB,104,0,0,0,0,0,0,0,0,0,0,0,0,0,0,0,0,0,2,0,2
1730,150,"ŞCOALA PRIMARĂ - CĂLENE",CĂLENE,AB,48,0,5,0,5,0,5,0,5,4,5,0,9,4,5,0,9,5,5,0,10
1767,151,"ŞCOALA PRIMARĂ - MUGEŞTI",MUGEŞTI,AB,93,0,0,0,0,0,0,0,0,0,2,0,2,0,3,0,3,0,4,0,4
1776,152,"ŞCOALA GIMNAZIALĂ ""IOAN MIHU"" VINEREA",VINEREA,AB,1062,5,0,0,5,13,1,0,14,13,2,0,15,19,4,0,23,26,5,0,31
1776,153,"ŞCOALA GIMNAZIALĂ ""IOAN MIHU"" VINEREA",VINEREA,AB,909,9,0,0,9,16,0,0,16,23,6,0,29,34,6,0,40,43,6,0,49
1801,154,"GRĂDINIŢA CU PROGRAM NORMALNR. 5","OCNA MUREŞ",AB,1398,7,0,0,7,23,0,0,23,34,0,0,34,60,0,0,60,62,0,0,62
1801,155,"ȘCOALA GIMNAZIALĂ""LUCIAN BLAGA""","OCNA MUREŞ",AB,1160,7,0,0,7,24,0,0,24,40,0,0,40,53,0,0,53,61,1,0,62
1801,156,"CASA DE CULTURĂ""ION SÂNGEREANU""","OCNA MUREŞ",AB,1260,9,0,0,9,21,6,0,27,27,8,0,35,41,10,0,51,49,10,0,59
1801,157,"DIRECŢIA SANITAR-VETERINARĂ ŞI PENTRU SIGURANŢA ALIMENTELOR OCNA MUREŞ","OCNA MUREŞ",AB,1118,3,4,0,7,9,5,0,14,16,5,0,21,28,6,0,34,29,6,0,35
1801,158,"LICEUL TEORETIC ""PETRU MAIOR""","OCNA MUREŞ",AB,1363,5,0,0,5,16,0,0,16,24,1,0,25,42,1,0,43,46,1,0,47
1801,159,"GRĂDINIŢA CU PROGRAM NORMAL NR. 3","OCNA MUREŞ",AB,1489,7,0,0,7,20,0,0,20,38,2,0,40,51,2,0,53,55,5,0,60
1810,160,"ŞCOALA PRIMARĂUIOARA DE JOS","UIOARA DE JOS",AB,902,5,1,0,6,15,2,0,17,22,4,0,26,29,5,0,34,31,6,0,37
1829,161,"GRĂDINIŢA CU PROGRAM NORMAL NR. 6 UIOARA DE SUS","UIOARA DE SUS",AB,1392,4,0,0,4,12,0,0,12,16,0,0,16,22,0,0,22,22,0,0,22
1838,162,"ŞCOALA GENERALĂ CISTEIU DE MUREŞ","CISTEIU DE MUREŞ",AB,542,2,0,0,2,3,0,0,3,5,0,0,5,7,0,0,7,9,1,0,10
1847,163,"GRĂDINIŢA CU PROGRAM NORMAL MICOŞLACA",MICOŞLACA,AB,245,0,0,0,0,0,0,0,0,0,0,0,0,1,2,0,3,1,2,0,3
1856,164,"CĂMINUL CULTURAL RĂZBOIENI-CETATE",RĂZBOIENI-CETATE,AB,1104,11,2,0,13,22,4,0,26,26,4,0,30,35,4,0,39,40,6,0,46
8103,165,"CASA DE CULTURĂ TEIUŞ",TEIUŞ,AB,1551,22,3,0,25,38,5,0,43,45,5,0,50,57,5,0,62,57,5,0,62
8103,166,"ŞCOALA GIMNAZIALĂ TEIUŞ",TEIUŞ,AB,1355,7,3,0,10,17,5,0,22,22,8,0,30,32,8,0,40,32,8,0,40
8103,167,"LICEUL TEORETIC TEIUŞ",TEIUŞ,AB,1507,13,0,0,13,39,0,0,39,49,0,0,49,69,2,0,71,78,4,0,82
8103,168,"GARA CFR TEIUŞ",TEIUŞ,AB,1039,4,10,0,14,13,12,0,25,17,12,0,29,31,15,0,46,35,15,0,50
8112,169,"ŞCOALA PRIMARĂ BELDIU",BELDIU,AB,201,0,1,0,1,1,1,0,2,5,1,0,6,5,1,0,6,5,1,0,6
8149,170,"ŞCOALA PRIMARĂ PEŢELCA",PEŢELCA,AB,122,1,0,0,1,1,0,0,1,3,0,0,3,3,0,0,3,3,0,0,3
8121,171,"CĂMIN CULTURAL CĂPUD",CĂPUD,AB,264,3,0,0,3,4,0,0,4,5,0,0,5,14,4,0,18,22,5,0,27
1945,172,"ŞCOALA GIMNAZIALĂ„ AVRAM IANCU” ZLATNA",ZLATNA,AB,1218,13,1,0,14,44,7,0,51,56,8,0,64,65,9,0,74,67,10,0,77
1945,173,"ŞCOALA GIMNAZIALĂ„ AVRAM IANCU” ZLATNA",ZLATNA,AB,960,15,1,0,16,31,1,0,32,34,1,0,35,35,1,0,36,41,1,0,42
1945,174,"LICEUL CORNELIU MEDREA ZLATNA",ZLATNA,AB,1359,16,0,0,16,34,0,0,34,44,2,0,46,56,2,0,58,63,4,0,67
2005,175,"ŞCOALA GIMNAZIALĂ "" SAVA ALBESCU "" SAT FENEŞ",FENEŞ,AB,765,4,0,0,4,11,2,0,13,14,2,0,16,20,4,0,24,26,5,0,31
2014,176,"ŞCOALA PRIMARĂ , SAT GALAŢI",GALAŢI,AB,311,2,0,0,2,4,0,0,4,4,1,0,5,5,1,0,6,5,1,0,6
2023,177,"CĂMIN CULTURAL, SAT IZVORUL AMPOIULUI","IZVORU AMPOIULUI",AB,419,1,0,0,1,2,0,0,2,2,0,0,2,4,0,0,4,5,0,0,5
2032,178,"ŞCOALA PRIMARĂ , SAT PĂTRÂNGENI",PĂTRÎNGENI,AB,508,2,0,0,2,5,0,0,5,9,0,0,9,11,1,0,12,17,2,0,19
2041,179,"ŞCOALA PRIMARĂ , SAT PIRITA",PIRITA,AB,369,0,0,0,0,0,0,0,0,0,0,0,0,7,1,0,8,10,1,0,11
2103,180,"ŞCOALA PRIMARĂ , SAT TRÎMPOIELE",TRÎMPOIELE,AB,338,1,0,0,1,8,1,0,9,15,1,0,16,17,1,0,18,19,1,0,20
2112,181,"ŞCOALA PRIMARĂ , SAT VALEA MICĂ","VALEA MICĂ",AB,342,5,0,0,5,15,0,0,15,21,0,0,21,31,2,0,33,34,6,0,40
2121,182,"CĂMIN CULTURAL, SAT VÎLTORI",VÎLTORI,AB,178,0,0,0,0,2,0,0,2,5,0,0,5,9,0,0,9,10,0,0,10
2149,183,"CĂMINUL CULTURAL ALBAC",ALBAC,AB,751,5,5,0,10,10,9,0,19,31,13,0,44,40,35,0,75,48,60,0,108
2176,184,"ŞCOALA PRIMARĂ CIONEŞTI",CIONEŞTI,AB,541,0,1,0,1,1,1,0,2,5,2,0,7,5,2,0,7,9,7,0,16
2185,185,"ŞCOALA PRIMARĂ COSTEŞTI",COSTEŞTI,AB,86,0,0,0,0,0,0,0,0,1,2,0,3,2,2,0,4,2,2,0,4
2247,186,"ŞCOALA PRIMARĂ POTIONCI",POTIONCI,AB,68,1,0,0,1,7,0,0,7,11,1,0,12,11,3,0,14,11,3,0,14
2256,187,"ŞCOALA PRIMARĂ ROGOZ",ROGOZ,AB,242,1,0,0,1,11,10,0,21,18,10,0,28,24,10,0,34,29,10,0,39
2318,188,"PRIMARIA COMUNEI ALMSU MARE","ALMAŞU MARE",AB,318,4,0,0,4,9,0,0,9,12,0,0,12,17,0,0,17,20,0,0,20
2318,189,"SCOALA PRIMARA ALMASU MARE - SUSENI","ALMAŞU MARE",AB,217,0,0,0,0,4,0,0,4,8,0,0,8,9,0,0,9,11,0,0,11
2327,190,"ŞCOALA PRIMARA ALMAŞU DE MIJLOC","ALMAŞU DE MIJLOC",AB,127,0,0,0,0,3,0,0,3,5,1,0,6,5,2,0,7,6,2,0,8
2354,191,"ŞCOALA PRIMARA CIB",CIB,AB,240,0,0,0,0,0,0,0,0,1,0,0,1,1,0,0,1,1,0,0,1
2363,192,"ŞCOALA PRIMARA GLOD",GLOD,AB,154,0,0,0,0,3,3,0,6,4,3,0,7,7,4,0,11,7,4,0,11
2390,193,"GRUP ȘCOLAR DE TURISM ARIEȘENI",ARIEŞENI,AB,587,0,0,0,0,5,4,0,9,6,4,0,10,14,7,0,21,22,13,0,35
2390,194,"GRUP ȘCOLAR DE TURISM ARIEȘENI",ARIEŞENI,AB,537,6,0,0,6,8,0,0,8,9,0,0,9,11,5,0,16,11,8,0,19
2425,195,"ȘCOALAPRIMARĂ CASA DE PIATRĂ","CASA DE PIATRĂ",AB,90,0,0,0,0,0,0,0,0,0,0,0,0,0,0,0,0,1,0,0,1
2434,196,"ȘCOALA PRIMARĂ COBLEȘ",COBLEŞ,AB,199,4,0,0,4,8,0,0,8,11,1,0,12,12,2,0,14,12,2,0,14
2586,197,"ŞCOALA GIMNAZIALĂAVRAM IANCU","AVRAM IANCU",AB,624,1,0,0,1,7,3,0,10,7,6,0,13,7,6,0,13,15,7,0,22
2853,198,"ŞCOALA PRIMARĂ I-IV TÎRSA",TÎRSA,AB,628,1,0,0,1,5,0,0,5,7,0,0,7,7,0,0,7,7,2,0,9
3011,199,"CLĂDIRE CĂMIN CULTURAL HENIG",HENIG,AB,236,2,0,0,2,6,0,0,6,9,1,0,10,11,1,0,12,12,2,0,14
2997,200,"CLĂDIRE CĂMIN CULTURAL BERGHIN",BERGHIN,AB,707,9,2,0,11,16,4,0,20,28,4,0,32,43,6,0,49,44,7,0,51
3002,201,"CLĂDIRE CĂMIN CULTURAL GHIRBOM",GHIRBOM,AB,425,3,0,0,3,5,0,0,5,7,2,0,9,15,2,0,17,17,3,0,20
3020,202,"CLĂDIRE CĂMIN CULTURAL STRAJA",STRAJA,AB,292,5,2,0,7,8,2,0,10,12,4,0,16,14,4,0,18,15,4,0,19
3048,203,"ŞCOALA GIMNAZIALĂ "" NICODIM GANEA""BISTRA",BISTRA,AB,810,5,0,0,5,7,0,0,7,10,0,0,10,18,2,0,20,18,2,0,20
3048,204,"ŞCOALA GIMNAZIALĂ ""NICODIM GANEA""BISTRA",BISTRA,AB,1031,3,0,0,3,11,0,0,11,14,0,0,14,17,0,0,17,24,0,0,24
3048,205,"ŞCOALA GIMNAZIALĂ ""NICODIM GANEA""BISTRA",BISTRA,AB,836,3,0,0,3,6,0,0,6,11,0,0,11,11,0,0,11,12,0,0,12
3100,206,"ŞCOALA PRIMARĂ CIULDEŞTI - COMUNA BISTRA",CIULDEŞTI,AB,626,2,3,0,5,5,4,0,9,7,5,0,12,8,5,0,13,8,5,0,13
3164,207,"ŞCOALA GIMNAZIALĂ GÎRDE I - COMUNA BISTRA",GÎRDE,AB,654,4,2,0,6,5,2,0,7,10,3,0,13,13,3,0,16,14,3,0,17
3404,208,"PRIMARIA COMUNEI BLANDIANA",BLANDIANA,AB,470,1,1,0,2,3,4,0,7,4,5,0,9,6,6,0,12,6,6,0,12
3413,209,"ŞCOALA PRIMARĂ ACMARIU",ACMARIU,AB,293,0,5,0,5,2,6,0,8,4,7,0,11,8,10,0,18,8,10,0,18
3440,210,"ŞCOALA CU CLASELE I-IV RĂCĂTĂU",RĂCĂTĂU,AB,27,1,0,0,1,1,0,0,1,1,0,0,1,1,0,0,1,1,0,0,1
4204,211,"CĂMINUL CULTURAL BUCERDEA GRÂNOASĂ","BUCERDEA GRÂNOASĂ",AB,1066,3,0,0,3,10,0,0,10,11,0,0,11,19,0,0,19,21,0,0,21
4204,212,"ŞCOALA GIMNAZIALĂ IOAN MAIORESCU BUCERDEA GRANOASĂ","BUCERDEA GRÂNOASĂ",AB,780,0,0,0,0,0,0,0,0,0,0,0,0,4,0,0,4,4,0,0,4
3510,213,"ŞCOALA PRIMARĂ CIUCULEŞTI",CIUCULEŞTI,AB,361,4,0,0,4,4,0,0,4,9,0,0,9,13,0,0,13,14,3,0,17
3495,214,"ŞCOALA PRIMARĂ BUCIUM-SAT",BUCIUM-SAT,AB,416,1,0,0,1,5,0,0,5,10,0,0,10,19,1,0,20,20,1,0,21
3501,215,"ŞCOALA PRIMARĂ CERBU",CERBU,AB,272,0,0,0,0,1,0,0,1,5,0,0,5,8,0,0,8,9,0,0,9
3663,216,"ŞCOALA PRIMARĂ POIENI",POIENI,AB,275,6,0,0,6,13,0,0,13,20,1,0,21,21,1,0,22,21,1,0,22
3770,217,"PRIMĂRIA CENADE",CENADE,AB,759,3,1,0,4,8,1,1,10,8,2,1,11,9,2,1,12,12,2,1,15
3814,218,"ŞCOALA GIMNAZIALĂ ""ARONCOTRUŞ"" CERGĂU MARE","CERGĂU MARE",AB,813,5,2,0,7,8,2,0,10,10,2,0,12,12,2,0,14,13,2,0,15
3823,219,"GRĂDINIȚA CU PROGRAM NORMAL CERGĂU MIC","CERGĂU MIC",AB,259,3,0,0,3,4,1,0,5,13,1,0,14,20,1,0,21,22,2,0,24
3832,220,"CLĂDIRE CĂMIN CULTURAL LUPU",LUPU,AB,206,4,4,0,8,7,5,0,12,11,6,0,17,16,8,0,24,20,9,0,29
3850,221,"CĂMINUL CULTURAL",CERU-BĂCĂINŢI,AB,213,4,0,0,4,4,1,0,5,5,1,0,6,9,1,0,10,9,1,0,10
3967,222,"CĂMIN CULTURAL","CETATEA DE BALTĂ",AB,603,11,0,0,11,18,0,0,18,20,1,0,21,22,1,0,23,22,1,0,23
3967,223,"CĂMIN CULTURAL","CETATEA DE BALTĂ",AB,878,7,0,0,7,11,0,0,11,14,0,0,14,20,0,0,20,22,0,0,22
3976,224,"SCOALA GENERALACRĂCIUNELU DE SUS","CRACIUNELU DE SUS",AB,83,1,2,0,3,3,2,0,5,8,4,0,12,11,4,0,15,13,6,0,19
3985,225,"SCOALA GENERALA SÎNTĂMĂRIE",SÎNTĂMĂRIE,AB,243,2,0,0,2,3,0,0,3,3,0,0,3,5,0,0,5,5,0,0,5
3994,226,"CĂMIN CULTURAL TĂTÎRLAUA SALANR.1",TĂTÎRLAUA,AB,619,4,0,0,4,8,0,0,8,9,1,0,10,18,2,0,20,18,2,0,20
1080,227,"ŞCOALĂ GIMNAZIALĂ CIUGUD",CIUGUD,AB,480,6,0,0,6,14,3,0,17,19,8,0,27,25,11,0,36,29,12,0,41
1099,228,"CĂMIN CULTURAL DRÎMBAR",DRÎMBAR,AB,327,1,1,0,2,3,1,0,4,7,1,0,8,17,2,0,19,17,2,0,19
1115,229,"CĂMIN CULTURAL HĂPRIA",HĂPRIA,AB,488,10,0,0,10,28,6,0,34,40,6,0,46,61,9,0,70,73,9,0,82
1106,230,"CĂMIN CULTURAL LIMBA",LIMBA,AB,321,5,1,0,6,23,1,0,24,32,5,0,37,41,6,0,47,41,6,0,47
1124,231,"CĂMIN CULTURAL ȘEUȘA",ŞEUŞA,AB,636,2,2,13,17,17,3,15,35,28,4,15,47,51,6,15,72,69,6,15,90
1133,232,"CĂMIN CULTURAL TELEAC",TELEAC,AB,335,9,1,0,10,16,3,0,19,27,4,0,31,35,5,0,40,44,7,0,51
4053,233,"ŞCOALA PRIMARĂ BUNINGINEA",BUNINGINEA,AB,371,1,1,0,2,10,1,0,11,12,4,0,16,17,4,0,21,19,4,0,23
4017,234,"PRIMĂRIA COMUNEI CIURULEASA",CIURULEASA,AB,596,4,2,0,6,10,6,0,16,17,7,0,24,22,8,0,30,24,9,0,33
4115,235,"PRIMĂRIA COMUNEI CÎLNIC",CÎLNIC,AB,1127,13,0,0,13,20,1,0,21,29,1,0,30,49,1,0,50,54,2,0,56
4133,236,"ŞCOALA PRIMARĂ DEAL",DEAL,AB,311,5,0,0,5,10,2,0,12,17,9,0,26,28,9,0,37,33,9,0,42
4197,237,"PRIMĂRIACOMUNEICRĂCIUNELU DE JOS","CRĂCIUNELU DE JOS",AB,876,6,5,0,11,16,6,0,22,19,6,0,25,24,6,0,30,24,6,0,30
4197,238,"ŞCOALA GIMNAZIALĂ - CRĂCIUNELU DE JOS","CRĂCIUNELU DE JOS",AB,854,5,0,0,5,11,3,0,14,14,3,0,17,19,3,0,22,21,4,0,25
4151,239,"BIBLIOTECA COMUNALĂ",CRICĂU,AB,1106,8,1,0,9,21,2,0,23,34,2,0,36,49,4,0,53,53,4,0,57
4160,240,"ȘCOALA PRIMARĂ CRAIVA",CRAIVA,AB,297,4,0,0,4,8,1,0,9,13,1,0,14,18,1,0,19,20,1,0,21
4179,241,"SALA DE ÎNTRUNIRI",TIBRU,AB,324,3,0,0,3,5,0,0,5,7,1,0,8,8,1,0,9,10,1,0,11
4124,242,"ŞCOALA GIMNAZIALĂ ,,SEPTIMIU ALBINI""",CUT,AB,1062,7,0,0,7,13,0,0,13,18,1,0,19,25,1,0,26,30,1,0,31
4259,243,"PRIMĂRIA DAIA ROMÂNĂ","DAIA ROMÂNĂ",AB,1060,9,0,0,9,19,2,0,21,26,2,0,28,31,2,0,33,31,2,0,33
4259,244,"PRIMĂRIA DAIA ROMÂNĂ","DAIA ROMÂNĂ",AB,1511,9,1,0,10,24,1,0,25,37,4,0,41,45,10,0,55,51,10,0,61
4277,245,"ŞCOALA GIMNAZIALĂ DOŞTAT",DOŞTAT,AB,402,3,0,0,3,7,1,0,8,12,2,0,14,13,2,0,15,14,2,0,16
4286,246,"ŞCOALA PRIMARĂ BOZ",BOZ,AB,368,3,1,0,4,5,3,0,8,10,3,0,13,15,3,0,18,17,4,0,21
4311,247,"GRĂDINIŢA CU PROGRAM NORMAL FĂRĂU",FĂRĂU,AB,478,3,2,0,5,9,3,0,12,12,3,0,15,19,7,0,26,23,9,0,32
4320,248,"GRĂDINIŢA CU PROGRAM NORMAL HERIA",HERIA,AB,219,4,0,0,4,6,2,0,8,11,2,0,13,12,2,0,14,13,2,0,15
4348,249,"ŞCOALA PRIMARĂ SÎNBENEDIC",SÎNBENEDIC,AB,200,1,0,0,1,1,0,0,1,3,2,0,5,3,5,0,8,3,5,0,8
4339,250,"ŞCOALA PRIMARĂ MEDVEŞ",MEDVEŞ,AB,147,1,3,0,4,1,3,0,4,1,3,0,4,2,3,0,5,2,3,0,5
4357,251,"CLĂDIRE ,, PUNCT DE INFORMARE,,",ŞILEA,AB,252,5,0,0,5,7,0,0,7,9,0,0,9,10,0,0,10,10,0,0,10
4375,252,"CĂMINUL CULTURAL GALDA DE JOS","GALDA DE JOS",AB,1566,9,1,0,10,18,2,0,20,38,4,0,42,50,5,0,55,53,5,0,58
4384,253,"ŞCOALAGIMNAZIALĂ BENIC",BENIC,AB,431,0,0,0,0,5,2,0,7,6,2,0,8,8,2,0,10,10,2,0,12
4393,254,"ŞCOALAPRIMARĂ CETEA",CETEA,AB,360,0,0,0,0,2,1,0,3,4,3,0,7,8,7,0,15,8,7,0,15
4400,255,"ŞCOALA PRIMARĂGALDA DE SUS","GALDA DE SUS",AB,342,7,0,0,7,11,1,0,12,16,3,0,19,21,9,0,30,21,10,0,31
4437,256,SALADEFESTIVITĂŢIMESENTEA,MESENTEA,AB,198,2,3,0,5,3,3,0,6,3,3,0,6,6,6,0,12,6,6,0,12
4446,257,"CĂMINUL CULTURAL OIEJDEA",OIEJDEA,AB,717,1,1,0,2,4,1,0,5,7,2,0,9,10,2,0,12,11,3,0,14
4455,258,"CLĂDIRE ADMINISTRATIVĂ(FOSTĂ ŞCOALA GENERALĂ POIANA GALDEI)","POIANA GALDEI",AB,129,1,0,0,1,3,0,0,3,3,0,0,3,3,0,0,3,4,0,0,4
4491,259,"PRIMĂRIA COMUNEI GÎRBOVA",GÎRBOVA,AB,1178,6,3,0,9,11,5,0,16,14,5,0,19,27,5,0,32,38,5,0,43
4507,260,"PRIMĂRIA COMUNEI GÎRBOVA (CLĂDIREA FOSTULUI CAP)",CĂRPINIŞ,AB,206,7,0,0,7,11,1,0,12,11,1,0,12,14,8,0,22,14,10,0,24
4516,261,"PRIMĂRIA COMUNEI GÎRBOVA (CLĂDIREA FOSTULUI CAP)",RECIU,AB,267,0,0,0,0,3,0,0,3,4,2,0,6,12,3,0,15,19,5,0,24
4534,262,"ŞCOALA GIMNAZIALĂ ""EMIL RACOVIŢĂ"" GÎRDA DE SUS","GÎRDA DE SUS",AB,829,3,0,0,3,18,1,0,19,25,4,0,29,31,4,0,35,39,4,0,43
4543,263,"ŞCOALA PRIMARĂBIHARIA",BIHARIA,AB,131,0,0,0,0,0,0,0,0,1,0,0,1,1,0,0,1,1,0,0,1
4589,264,"ŞCOALA GIMNAZIALĂ GHEŢARI",GHEŢARI,AB,426,0,0,0,0,0,0,0,0,1,0,0,1,1,0,0,1,1,0,0,1
4712,265,"CĂMIN CULTURAL HOPÎRTA",HOPÎRTA,AB,231,3,1,0,4,13,4,0,17,15,5,0,20,16,5,0,21,18,5,0,23
4721,266,"CĂMIN CULTURAL SILIVAŞ",SILIVAŞ,AB,219,2,2,0,4,9,2,0,11,10,2,0,12,12,2,0,14,12,2,0,14
4730,267,"CĂMIN CULTURAL ŞPĂLNACA",ŞPĂLNACA,AB,160,4,0,0,4,6,2,0,8,7,2,0,9,10,3,0,13,12,7,0,19
4749,268,"CĂMIN CULTURAL TURDAŞ",TURDAŞ,AB,142,4,1,0,5,7,1,0,8,7,4,0,11,8,7,0,15,8,7,0,15
4758,269,"CĂMIN CULTURAL VAMA SEACĂ","VAMA SEACĂ",AB,149,2,0,0,2,3,3,0,6,4,4,0,8,4,4,0,8,7,4,0,11
4776,270,"ȘCOALA GIMNAZIALĂHOREA",HOREA,AB,628,4,0,0,4,13,0,0,13,16,2,0,18,20,2,0,22,20,2,0,22
4801,271,"ȘCOALA PRIMARĂ TRIFEȘTI",DÎRLEŞTI,AB,391,3,0,5,8,8,2,8,18,8,2,8,18,18,3,8,29,29,4,8,41
4829,272,"ȘCOALA PRIMARĂ GIURGIUȚ",GIURGIUŢ,AB,123,0,0,0,0,0,0,0,0,0,0,0,0,0,1,0,1,0,2,0,2
4847,273,"CĂMIN CULTURAL MĂTIȘEȘTI",MĂTIŞEŞTI,AB,356,0,0,0,0,0,1,0,1,2,1,0,3,8,1,0,9,8,1,0,9
4865,274,"ȘCOALA PRIMARĂ PĂTRUȘEȘTI",PĂTRUŞEŞTI,AB,133,0,1,0,1,2,1,0,3,3,1,0,4,6,4,0,10,9,4,0,13
4883,275,"ȘCOALA PRIMARĂ PRELUCA",PRELUCA,AB,61,2,1,0,3,8,1,0,9,10,1,0,11,10,1,0,11,11,3,0,14
4936,276,"PRIMĂRIA COMUNEI IGHIU",IGHIU,AB,1154,31,3,0,34,41,4,0,45,62,5,0,67,78,7,0,85,87,8,0,95
4945,277,"ȘCOALA PRIMARĂ BUCERDEA VINOASĂ","BUCERDEA VINOASĂ",AB,753,8,2,0,10,13,2,0,15,17,4,0,21,22,5,0,27,25,5,0,30
4954,278,"ȘCOALA GIMNAZIALĂ IGHIEL",IGHIEL,AB,821,9,2,0,11,12,2,0,14,21,2,0,23,41,2,0,43,58,2,0,60
4963,279,"ŞCOALA GIMNAZIALĂ ŞARD",ŞARD,AB,925,10,1,0,11,17,6,0,23,18,6,0,24,22,6,0,28,28,6,0,34
4963,280,"ŞCOALA GIMNAZIALĂ ŞARD",ŞARD,AB,1076,2,0,0,2,4,1,0,5,8,3,0,11,21,4,0,25,23,4,0,27
4972,281,"ȘCOALĂ GIMNAZIALĂȚELNA",ŢELNA,AB,886,8,0,0,8,12,0,0,12,12,0,0,12,21,0,0,21,25,0,0,25
4990,282,"ȘCOALA GIMNAZIALĂÎNTREGALDE",ÎNTREGALDE,AB,234,1,0,0,1,3,0,0,3,4,0,0,4,4,0,0,4,6,0,0,6
5005,283,"ȘCOALA CU CLASELE I-IV DEALUGEOAGIULUI","DEALU GEOAGIULUI",AB,87,0,0,0,0,3,2,0,5,5,2,0,7,5,2,0,7,5,2,0,7
5014,284,"ȘCOALA CU CLASELE I-IVGHIONCANI",GHIONCANI,AB,58,1,0,0,1,1,1,0,2,1,1,0,2,1,4,0,5,1,4,0,5
5069,285,"CĂMINUL CULTURAL NECRILEȘTI",NECRILEŞTI,AB,145,0,0,0,0,1,1,0,2,2,2,0,4,5,2,0,7,5,3,0,8
5112,286,"CĂMINUL CULTURAL JIDVEI",JIDVEI,AB,1098,6,1,0,7,7,1,0,8,8,1,0,9,12,1,0,13,14,1,0,15
5121,287,"ŞCOALA GIMNAZIALĂBĂLCACIU",BĂLCACIU,AB,1107,6,0,0,6,8,0,0,8,12,0,0,12,17,2,0,19,19,2,0,21
5130,288,"CĂMINUL CULTURAL CĂPÎLNA DE JOS","CĂPÎLNA DE JOS",AB,648,0,0,0,0,4,0,0,4,11,0,0,11,25,0,0,25,30,1,0,31
5149,289,"ȘCOALAGENERALĂ FEISA",FEISA,AB,659,10,2,0,12,14,3,0,17,15,3,0,18,24,6,0,30,24,6,0,30
5158,290,"CĂMINUL CULTURAL VESEUŞ",VESEUŞ,AB,750,6,1,0,7,9,1,0,10,13,1,0,14,16,2,0,18,17,2,0,19
5176,291,"ȘCOALA GIMNAZIALĂ LIVEZILE",LIVEZILE,AB,597,9,0,0,9,23,2,0,25,25,5,0,30,36,8,0,44,43,11,0,54
5194,292,"CĂMIN CULTURAL","POIANA AIUDULUI",AB,276,3,0,0,3,9,0,0,9,14,0,0,14,19,0,0,19,21,1,0,22
5185,293,"CĂMIN CULTURAL IZVOARELE",IZVOARELE,AB,106,0,6,0,6,9,8,0,17,24,18,0,42,29,23,0,52,30,27,0,57
5201,294,"CĂMIN CULTURAL VĂLIȘOARA",VĂLIŞOARA,AB,116,0,0,0,0,1,1,0,2,1,1,0,2,4,4,0,8,5,6,0,11
5229,295,"PRIMĂRIA LOPADEA NOUĂ","LOPADEA NOUĂ",AB,820,2,0,0,2,2,1,0,3,4,1,0,5,4,2,0,6,4,2,0,6
5238,296,CĂMINCULTURAL,ASINIP,AB,87,0,0,0,0,0,0,0,0,1,1,0,2,2,1,0,3,2,1,0,3
5256,297,"CLĂDIRE ANEXĂ PRIMĂRIA LOPADEA NOUĂ",BĂGĂU,AB,438,9,1,0,10,13,1,0,14,15,1,0,16,22,1,0,23,22,1,0,23
5247,298,"ȘCOALA PRIMARĂ BEȚA",BEŢA,AB,312,1,1,0,2,2,1,0,3,2,2,0,4,3,2,0,5,3,3,0,6
5274,299,"CLĂDIRE ANEXĂ PRIMĂRIA LOPADEA NOUĂ",CIUGUZEL,AB,549,2,0,0,2,11,2,0,13,11,4,0,15,23,7,0,30,25,10,0,35
5292,300,"CLĂDIRE ANEXĂ PRIMĂRIA LOPADEA NOUĂ",ODVEREM,AB,46,1,1,0,2,2,1,0,3,2,2,0,4,3,5,0,8,3,7,0,10
5318,301,"ŞCOALA GIMNAZIALĂ ""SIMION LAZĂR"" LUNCA MUREŞULUI, NR. 241A","LUNCA MUREŞULUI",AB,803,7,1,0,8,7,4,0,11,9,5,0,14,12,5,0,17,14,7,0,21
5318,302,"ŞCOALA GIMNAZIALĂ ""SIMION LAZĂR"" LUNCA MUREŞULUI, NR. 241A","LUNCA MUREŞULUI",AB,879,4,0,0,4,9,0,0,9,12,1,0,13,14,1,0,15,14,1,0,15
5327,303,"ŞCOALA PRIMARĂGURA ARIEŞULUI, NR. 84","GURA ARIEŞULUI",AB,388,7,1,0,8,18,1,0,19,27,1,0,28,39,2,0,41,39,2,0,41
5345,304,"CĂMINUL CULTURAL LUPȘA",LUPŞA,AB,692,9,4,0,13,14,4,0,18,36,7,0,43,39,7,0,46,40,7,0,47
5407,305,"ŞCOALA PRIMARĂ HĂDĂRĂU",HĂDĂRĂU,AB,313,2,6,0,8,3,6,0,9,8,8,0,16,8,8,0,16,8,8,0,16
5531,306,"ŞCOALA PRIMARĂ VALEA LUPȘII","VALEA LUPŞII",AB,734,6,0,0,6,9,0,0,9,12,0,0,12,20,3,0,23,26,5,0,31
5461,307,"SEDIUL FOSTEI PRIMĂRII MUȘCA",MUŞCA,AB,960,7,0,0,7,13,0,0,13,19,0,0,19,31,2,0,33,38,2,0,40
5611,308,"ŞCOALA CU CLASELE I-IV","LUNCA AMPOIŢEI",AB,212,0,0,0,0,0,2,0,2,0,2,0,2,2,2,0,4,4,5,0,9
5666,309,"ŞCOALA PRIMARĂ PRESACA AMPOIULUI","PRESACA AMPOIULUI",AB,294,2,0,0,2,3,0,0,3,9,0,0,9,12,0,0,12,12,0,0,12
5586,310,"ŞCOALA GIMNAZIALĂ METEŞ",METEŞ,AB,532,1,3,0,4,8,5,0,13,11,6,0,17,19,6,0,25,23,9,0,32
5595,311,"ŞCOALA GIMNAZIALĂ AMPOIŢA",AMPOIŢA,AB,588,6,3,0,9,9,3,0,12,14,3,0,17,21,3,0,24,24,5,0,29
5684,312,"ŞCOALA PRIMARĂ ""DIONISIU POPOVICIU"" TĂUŢI",TĂUŢI,AB,545,5,0,0,5,7,0,0,7,9,0,0,9,10,1,0,11,11,1,0,12
5648,313,"CĂMINUL CULTURAL POIANA AMPOIULUI","POIANA AMPOIULUI",AB,220,7,1,0,8,7,6,0,13,10,6,0,16,14,6,0,20,14,6,0,20
5719,314,"ŞCOALA GIMNAZIALĂ ""ION BREAZU"" MIHALŢ",MIHALŢ,AB,1031,3,1,0,4,7,2,0,9,10,4,0,14,16,4,0,20,20,5,0,25
5719,315,"ŞCOALA GIMNAZIALĂ ""ION BREAZU"" MIHALŢ",MIHALŢ,AB,830,11,0,0,11,15,0,0,15,18,1,0,19,25,1,0,26,29,1,0,30
5728,316,"ŞCOALA PRIMARĂ CISTEI",CISTEI,AB,466,0,0,0,0,5,0,0,5,9,0,0,9,13,0,0,13,14,1,0,15
5737,317,"ŞCOALA PRIMARĂ OBREJA",OBREJA,AB,470,2,0,0,2,7,0,0,7,9,2,0,11,14,7,0,21,15,9,0,24
5764,318,"GRĂDINIŢA CU PROGRAM NORMAL - MIRĂSLĂU",MIRĂSLĂU,AB,718,4,0,0,4,6,1,0,7,6,1,0,7,17,1,0,18,20,3,0,23
5773,319,"ŞCOALA PRIMARĂ - CICĂU",CICĂU,AB,104,1,0,0,1,2,0,0,2,2,0,0,2,2,0,0,2,2,0,0,2
5782,320,"ŞCOALA PRIMARĂ - DECEA",DECEA,AB,635,2,0,0,2,5,1,0,6,5,3,0,8,10,4,0,14,10,4,0,14
5791,321,"ŞCOALA PRIMARĂ - LOPADEA VECHE","LOPADEA VECHE",AB,229,0,0,0,0,3,0,0,3,7,1,0,8,8,1,0,9,8,1,0,9
5808,322,"ŞCOALA PRIMARĂ - ORMENIŞ",ORMENIŞ,AB,65,3,2,0,5,4,3,0,7,5,5,0,10,7,6,0,13,7,7,0,14
5835,323,"CONSILIUL LOCAL AL COMUNEI MOGOŞ",MOGOŞ,AB,512,7,0,0,7,9,0,0,9,11,0,0,11,12,3,0,15,15,3,0,18
5906,324,"ŞCOALA CU CLASELEI-IV, SAT BUTEŞTI",BUTEŞTI,AB,59,2,0,0,2,2,0,0,2,4,0,0,4,4,0,0,4,4,0,0,4
5997,325,"REFUGIU TURISTIC VALEA BARNII","VALEA BARNII",AB,148,1,0,0,1,3,1,0,4,4,2,0,6,5,4,0,9,5,5,0,10
6057,326,"PRIMĂRIA NOSLAC",NOŞLAC,AB,977,3,1,0,4,8,6,0,14,12,6,0,18,25,8,0,33,26,10,0,36
6084,327,"ŞCOALA GENERALĂ GĂBUD",GĂBUD,AB,211,1,0,0,1,2,1,0,3,2,2,0,4,2,2,0,4,2,2,0,4
6093,328,"ŞCOALA GENERALĂSTÎNA DE MUREŞ","STÂNA DE MUREŞ",AB,317,1,2,0,3,7,2,0,9,10,4,0,14,11,4,0,15,11,4,0,15
6128,329,"INTERNAT ŞCOLAR -OCOLIŞ",OCOLIŞ,AB,268,6,2,0,8,8,2,0,10,9,2,0,11,11,2,0,13,11,3,0,14
6137,330,"TABĂRA DE CREAȚIE SI ODIHNĂ ”AVRAM IANCU”","LUNCA LARGĂ",AB,51,2,0,0,2,2,0,0,2,3,0,0,3,3,0,0,3,5,2,0,7
6146,331,"ȘCOALA PRIMARĂ - RUNC",RUNC,AB,123,0,0,0,0,1,0,0,1,1,0,0,1,1,0,0,1,1,0,0,1
6155,332,"ȘCOALA PRIMARĂ - VIDOLM",VIDOLM,AB,57,0,0,0,0,1,0,0,1,1,0,0,1,3,0,0,3,3,0,0,3
6173,333,"CONSILIUL LOCAL OHABA",OHABA,AB,361,3,1,0,4,8,2,0,10,11,2,0,13,15,7,0,22,18,9,0,27
6182,334,"CLĂDIRE ADMINISTRATIVĂ COLIBI (FOSTA ŞCOALĂ GENERALĂ)",COLIBI,AB,30,3,1,0,4,3,1,0,4,3,1,0,4,3,1,0,4,3,1,0,4
6208,335,"FOSTUL SEDIUC.A.P.",SECĂŞEL,AB,157,4,3,0,7,5,3,0,8,5,3,0,8,5,4,0,9,5,6,0,11
6226,336,"ŞCOALA GIMNAZIALĂ PIANU DE SUS","PIANU DE SUS",AB,1381,15,0,0,15,17,5,0,22,23,5,0,28,29,7,0,36,39,8,0,47
6235,337,"ŞCOALA GIMNAZIALĂ""AUGUSTIN BENA""PIANU DE JOS","PIANU DE JOS",AB,1100,1,0,0,1,12,4,0,16,15,4,0,19,23,4,0,27,23,6,0,29
6244,338,"CLĂDIRE ADMINISTRATIVĂ (FOSTA ŞCOALĂ GENERALĂ CU CLASELE I-IV) PLAIURI",PLAIURI,AB,41,0,0,0,0,0,0,0,0,0,0,0,0,0,0,0,0,0,0,0,0
6253,339,"ŞCOALA PRIMARĂ ""GHEORGHE PAVELESCU"" PURCĂREŢI",PURCĂREŢI,AB,215,2,0,0,2,2,0,0,2,3,2,0,5,7,2,0,9,10,2,0,12
6262,340,"ŞCOALA GIMNAZIALĂ STRUNGARI",STRUNGARI,AB,202,2,1,0,3,17,3,0,20,32,3,0,35,36,3,0,39,36,7,0,43
6280,341,"CĂMINUL CULTURAL SAT POIANA VADULUI","POIANA VADULUI",AB,872,8,2,0,10,18,3,0,21,32,3,0,35,39,3,0,42,45,3,0,48
6404,342,"PRIMARIA COMUNEI PONOR",PONOR,AB,347,0,0,0,0,4,0,0,4,13,1,5,19,19,1,5,25,21,2,5,28
6422,343,"CAMINUL CULTURAL GEOGEL",GEOGEL,AB,188,0,0,0,0,5,6,0,11,7,6,0,13,8,7,0,15,9,7,0,16
6477,344,"CĂMINUL CULTURAL","POŞAGA DE JOS",AB,366,8,2,0,10,10,2,0,12,12,2,0,14,12,2,0,14,16,3,0,19
6501,345,"ȘCOALA CU CLASELE I-IV - LUNCA",LUNCA,AB,122,2,0,0,2,2,0,0,2,2,0,0,2,2,0,0,2,2,4,0,6
6510,346,"ȘCOALA CU CLASELE I-IV - ORĂȘTI",ORĂŞTI,AB,107,0,0,0,0,1,0,0,1,1,0,0,1,4,1,0,5,4,1,0,5
6529,347,"ŞCOALA PRIMARĂ - POȘAGA DE SUS","POŞAGA DE SUS",AB,145,1,0,0,1,1,0,0,1,1,0,0,1,1,0,0,1,1,0,0,1
6538,348,"ȘCOALA PRIMARĂ - SAGAGEA",SAGAGEA,AB,175,0,0,0,0,2,3,0,5,5,3,0,8,6,3,0,9,6,3,0,9
6556,349,"CĂMIN CULTURAL RĂDEŞTI",RĂDEŞTI,AB,575,7,3,0,10,8,3,0,11,15,5,0,20,21,5,0,26,29,7,0,36
6565,350,"ŞCOALA PRIMARĂ LEORINŢ",LEORINŢ,AB,252,1,0,0,1,1,0,0,1,3,0,0,3,6,0,0,6,6,0,0,6
6574,351,"ŞCOALA PRIMARĂ MEŞCREAC",MEŞCREAC,AB,251,0,0,0,0,1,0,0,1,3,0,0,3,4,0,0,4,4,0,0,4
6609,352,"CĂMINUL CULTURAL RIMETEA",RIMETEA,AB,472,0,0,0,0,1,1,0,2,14,6,0,20,14,6,0,20,16,6,0,22
6618,353,"ŞCOALA PRIMARA COLŢEŞTI",COLŢEŞTI,AB,441,0,0,0,0,0,0,0,0,0,0,0,0,0,0,0,0,3,2,0,5
6636,354,"PRIMĂRIA COMUNEI RÎMEŢ",RÎMEŢ,AB,178,3,1,0,4,3,2,0,5,9,2,0,11,10,5,0,15,11,5,0,16
6654,355,"FOSTA ŞCOALĂ CU CLASELE I-IV BRĂDEȘTI",BRĂDEŞTI,AB,93,0,0,0,0,1,0,0,1,7,1,0,8,10,11,0,21,10,11,0,21
6716,356,"FOSTA ŞCOALĂ CU CLASELE I-IV VALEA INZELULUI","VALEA INZELULUI",AB,74,0,0,0,0,0,0,0,0,2,2,0,4,5,2,0,7,5,2,0,7
6725,357,"FOSTA ŞCOALĂCU CLASELE I-IV VALEA MĂNĂSTIRII","VALEA MĂNĂSTIRII",AB,138,4,0,0,4,22,6,0,28,43,37,0,80,50,66,0,116,52,90,0,142
6967,358,"CĂMIN CULTURAL",UNGUREI,AB,266,3,2,0,5,5,3,0,8,5,3,0,8,6,3,0,9,6,3,0,9
6949,359,"PRIMĂRIA ROŞIA DE SECAŞ","ROŞIA DE SECAŞ",AB,582,3,0,0,3,11,0,0,11,19,2,0,21,26,2,0,28,26,3,0,29
6958,360,"FOSTUL SEDIU CAP",TĂU,AB,369,3,4,0,7,10,5,0,15,18,5,0,23,20,7,0,27,21,7,0,28
6814,361,"ŞCOALA CU CLASELE I-IV - GURA ROȘIEI",CĂRPINIŞ,AB,626,5,0,0,5,15,1,0,16,23,1,0,24,30,1,0,31,38,1,0,39
6921,362,"ŞCOALA CU CLASELE I-IV - VÎRTOP",VÎRTOP,AB,182,0,0,0,0,0,0,0,0,3,2,0,5,3,2,0,5,4,2,0,6
6770,363,"PRIMARIA COMUNEI ROȘIA MONTANĂ","ROŞIA MONTANĂ",AB,700,0,0,0,0,8,2,0,10,10,2,0,12,17,5,0,22,17,5,0,22
6814,364,"LOCUINȚE SOCIALE - CĂRPINIȘ",CĂRPINIŞ,AB,677,3,2,0,5,10,6,0,16,16,6,0,22,22,6,0,28,25,6,0,31
6832,365,"ȘCOALA CU CLASELE I-IV - CORNA",CORNA,AB,133,0,0,0,0,2,0,0,2,4,0,0,4,9,0,0,9,9,0,0,9
6985,366,"ŞCOALA PRIMARĂ SĂLCIUA DE JOS","SĂLCIUA DE JOS",AB,704,7,1,0,8,16,1,0,17,21,3,0,24,26,5,0,31,28,6,0,34
7017,367,"ŞCOALA GIMNAZIALĂ ""SIMION PANTEA"" SĂLCIUA","SĂLCIUA DE SUS",AB,591,5,0,0,5,10,0,0,10,10,0,0,10,12,0,0,12,15,0,0,15
7053,368,"ȘCOALA GIMNAZIALĂ ""DAVID PRODAN"" SĂLIȘTEA",SĂLIŞTEA,AB,1041,9,0,0,9,20,1,0,21,35,3,0,38,44,4,0,48,55,6,0,61
7062,369,"ŞCOALA PRIMARĂ MĂRGINENI",MĂRGINENI,AB,49,0,0,0,0,10,4,0,14,13,5,0,18,13,5,0,18,13,5,0,18
7071,370,"ŞCOALA PRIMARĂ SĂLIŞTEA-DEAL",SĂLIŞTEA-DEAL,AB,236,1,1,0,2,5,2,0,7,7,2,0,9,10,3,0,13,10,3,0,13
7080,371,"ŞCOALA PRIMARĂ TĂRTĂRIA",TĂRTĂRIA,AB,570,0,0,0,0,4,0,0,4,5,0,0,5,11,1,0,12,11,1,0,12
7115,372,"ȘCOALA PRIMARĂ CĂPÎLNA",CĂPÎLNA,AB,698,16,3,0,19,36,5,0,41,48,5,0,53,66,8,0,74,71,8,0,79
7106,373,"ȘCOALA GIMNAZIALĂ SĂSCIORI",SĂSCIORI,AB,1338,8,1,0,9,14,1,0,15,24,2,0,26,32,4,0,36,35,4,0,39
7133,374,"ȘCOALA PRIMARĂ LAZ",LAZ,AB,349,2,0,0,2,7,4,0,11,13,4,0,17,16,4,0,20,18,4,0,22
7179,375,"ȘCOALA PRIMARĂ SEBEȘEL",SEBEŞEL,AB,1026,6,2,0,8,16,2,0,18,27,4,0,31,38,11,0,49,45,11,0,56
7142,376,"ȘCOALA GIMNAZIALĂ LOMAN",LOMAN,AB,677,6,1,0,7,13,2,0,15,16,2,0,18,25,2,0,27,26,2,0,28
7160,377,"ȘCOALA GIMNAZIALĂ RĂCHITA",RĂCHITA,AB,728,0,0,0,0,5,0,0,5,7,0,0,7,12,0,0,12,15,0,0,15
7204,378,"CĂMINUL CULTURAL SCĂRIȘOARA",SCĂRIŞOARA,AB,596,9,1,0,10,11,1,0,12,12,1,0,13,13,1,0,14,13,1,0,14
7286,380,"ŞCOALA PRIMARĂ NEGEȘTI",NEGEŞTI,AB,154,0,0,0,0,1,0,0,1,1,0,0,1,1,0,0,1,1,0,0,1
7302,381,"ŞCOALA PRIMARĂ RUNC",RUNC,AB,144,0,0,0,0,1,1,0,2,1,2,0,3,3,2,0,5,3,4,0,7
7311,382,"ŞCOALA PRIMARĂ SFOARTEA",SFOARTEA,AB,68,0,3,0,3,0,3,0,3,1,4,0,5,1,5,0,6,1,5,0,6
7320,383,"ŞCOALA PRIMARĂ ȘTIULEȚI",ŞTIULEŢI,AB,118,0,0,0,0,1,0,0,1,2,0,0,2,7,0,0,7,8,0,0,8
7259,384,"ŞCOALA GIMNAZIALĂ LĂZEȘTI",LĂZEŞTI,AB,212,3,0,0,3,14,0,0,14,21,0,0,21,25,0,0,25,29,1,0,30
7357,385,"ȘCOALA GIMNAZIALĂ ION POP RETEGANUL",SÎNCEL,AB,1318,2,2,0,4,12,2,0,14,22,3,0,25,23,4,0,27,28,5,0,33
7366,386,"ŞCOALA PRIMARĂ ICLOD",ICLOD,AB,309,1,4,0,5,2,4,0,6,2,4,0,6,4,6,0,10,5,6,0,11
7375,387,"ŞCOALA PRIMARĂ PĂNADE",PĂNADE,AB,527,2,0,0,2,8,2,0,10,11,2,0,13,22,2,0,24,24,3,0,27
7400,388,"CLĂDIRE VESTIAR - BAZA SPORTIVĂ COȘLARIU",COŞLARIU,AB,357,1,3,0,4,2,4,0,6,4,4,0,8,12,5,0,17,12,5,0,17
7437,389,"ŞCOALA PRIMARĂ TOTOI",TOTOI,AB,437,3,4,0,7,10,4,0,14,11,5,0,16,19,6,0,25,21,7,0,28
7393,390,"PRIMĂRIA COMUNEI SÎNTIMBRU",SÎNTIMBRU,AB,1177,8,2,0,10,20,3,0,23,34,5,0,39,50,6,0,56,55,6,0,61
7419,391,"CENTRU DE ZI PERSOANE VĂRSTNICE",DUMITRA,AB,70,0,0,0,0,1,2,0,3,3,2,0,5,3,3,0,6,4,3,0,7
7428,392,"CĂMINUL CULTURAL ""EUGEN CURTA"" GALTIU",GALTIU,AB,407,2,0,0,2,10,4,0,14,16,4,0,20,17,6,0,23,18,9,0,27
7669,393,"ȘCOALA PRIMARĂPELEŞ",PELEŞ,AB,358,0,2,0,2,1,3,0,4,3,3,0,6,6,4,0,10,9,5,0,14
7678,394,"ŞCOALA PRIMARĂPOIANA",POIANA,AB,133,1,1,0,2,2,1,0,3,3,1,0,4,6,1,0,7,6,1,0,7
7455,395,"CĂMINUL CULTURAL SOHODOL",SOHODOL,AB,815,6,1,0,7,8,1,0,9,18,1,0,19,23,2,0,25,24,3,0,27
7570,396,"SC HIDROCONSTRUCȚIA SA SEBEȘ PUNCT DE LUCRU SAT LAZURI",LAZURI,AB,185,0,1,0,1,0,2,0,2,3,4,0,7,3,4,0,7,4,4,0,8
7776,397,"ŞCOALA GIMNAZIALĂ STREMŢ",STREMŢ,AB,1160,4,0,0,4,19,3,0,22,35,7,0,42,52,11,0,63,57,13,0,70
7794,398,"ŞCOALA GIMNAZIALA ""VASILE BOLOGA"" GEOAGIU DE SUS","GEOAGIU DE SUS",AB,643,5,0,0,5,7,2,0,9,14,3,0,17,19,5,0,24,24,6,0,30
7801,399,"ŞCOALA PRIMARA GEOMAL",GEOMAL,AB,271,0,1,0,1,0,4,0,4,0,4,0,4,6,4,0,10,8,8,0,16
7829,400,"GRĂDINIȚA CU PROGRAM NORMAL ȘIBOT",ŞIBOT,AB,1174,2,0,0,2,9,1,0,10,11,1,0,12,16,1,0,17,19,1,0,20
7838,401,"CĂMINUL CULTURAL BALOMIR","BALOMIRU DE CÎMP",AB,527,12,1,0,13,15,1,0,16,18,4,0,22,24,6,0,30,28,7,0,35
7847,402,"ŞCOALA PRIMARĂ BĂCĂINŢI",BĂCĂINŢI,AB,227,0,0,0,0,1,1,0,2,4,2,0,6,6,2,0,8,7,2,0,9
7856,403,"CLĂDIRE ADMINISTRATIVĂ SĂRĂCSĂU (FOSTA ŞCOALĂ GENERALĂ)",SĂRĂCSĂU,AB,161,2,2,0,4,3,2,0,5,5,2,0,7,5,2,0,7,7,2,0,9
7918,404,"CLĂDIRE ADMINISTRATIVĂ (FOSTA ŞCOALĂ CU CLASELE I-IV LUNCA TÎRNAVEI)","LUNCA TÎRNAVEI",AB,343,1,0,0,1,1,0,0,1,1,0,0,1,3,2,0,5,3,3,0,6
7874,405,"ŞCOALA GIMNAZIALĂ ŞONA",ŞONA,AB,1052,5,0,0,5,9,1,0,10,16,1,0,17,18,1,0,19,18,2,0,20
7883,406,"CĂMINUL CULTURAL ALECUŞ",ALECUŞ,AB,91,1,6,0,7,1,6,0,7,2,9,0,11,2,10,0,12,3,11,0,14
7892,407,"SALA MULTIFUNCȚIONALĂBIIA",BIIA,AB,969,2,3,0,5,5,3,0,8,6,8,0,14,10,8,0,18,14,9,0,23
7927,408,"ȘCOALA GIMNAZIALĂSÎNMICLĂUŞ",SÎNMICLĂUŞ,AB,1154,1,0,0,1,2,0,0,2,2,0,0,2,8,2,0,10,9,3,0,12
7954,409,"PRIMĂRIA COMUNEI ŞPRING",ŞPRING,AB,579,5,0,0,5,7,0,0,7,12,1,0,13,20,5,0,25,21,5,0,26
7981,410,"ŞCOALA GIMNAZIALĂ CUNŢA",CUNŢA,AB,474,6,0,0,6,8,7,0,15,10,9,0,19,14,9,0,23,20,9,0,29
7990,411,"ŞCOALA PRIMARĂ DRAŞOV",DRAŞOV,AB,434,4,0,0,4,6,3,0,9,11,5,0,16,13,5,0,18,15,5,0,20
8005,412,"SEDIU ADMINISTRATIV VINGARD - COMUNA ŞPRING",VINGARD,AB,574,5,1,0,6,12,5,0,17,12,5,0,17,16,5,0,21,17,5,0,22
8050,413,"CLĂDIRE ADMINISTRATIVĂ (FOSTĂ ŞCOALA GENERALĂ DOBRA)",DOBRA,AB,451,1,0,0,1,12,1,0,13,20,1,0,21,33,1,0,34,37,1,0,38
8078,414,"ŞCOALA PRIMARĂ MĂRTINIE",MĂRTINIE,AB,450,0,0,0,0,5,0,0,5,5,1,0,6,8,1,0,9,8,3,0,11
8023,415,"PRIMĂRIA COMUNEI ŞUGAG",ŞUGAG,AB,1430,7,0,0,7,9,2,0,11,22,14,0,36,28,15,0,43,37,16,0,53
8167,416,"ŞCOALA GIMNAZIALĂ ""AVRAM IANCU"" UNIREA",UNIREA,AB,972,0,1,0,1,10,2,0,12,15,3,0,18,22,3,0,25,24,3,0,27
8167,417,"ŞCOALA GIMNAZIALĂ ""AVRAM IANCU"" UNIREA",UNIREA,AB,817,1,0,0,1,6,8,0,14,7,10,0,17,11,11,0,22,13,11,0,24
8167,418,"ŞCOALA GIMNAZIALĂ ""GHEORGHE MAIER"" UNIREA",UNIREA,AB,1164,13,0,0,13,19,2,0,21,31,2,0,33,38,4,0,42,40,4,0,44
8176,419,"ŞCOALA PRIMARĂ CIUGUDU DE JOS","CIUGUDU DE JOS",AB,281,0,0,0,0,7,0,0,7,9,0,0,9,14,1,0,15,14,1,0,15
8185,420,"ŞCOALA PRIMARĂ CIUGUDU DE SUS","CIUGUDU DE SUS",AB,118,2,4,0,6,3,5,0,8,4,5,0,9,4,5,0,9,4,5,0,9
8194,421,"ŞCOALA PRIMARĂ DUMBRAVA",DUMBRAVA,AB,278,1,5,0,6,39,16,0,55,39,18,0,57,39,18,31,88,39,19,31,89
8201,422,"ŞCOALA PRIMARĂ INOC",INOC,AB,163,2,7,0,9,2,7,0,9,2,7,0,9,4,8,0,12,7,9,0,16
8210,423,"ŞCOALA PRIMARĂ MĂHĂCENI",MĂHĂCENI,AB,229,0,1,0,1,2,2,0,4,11,3,0,14,14,3,0,17,15,4,0,19
8238,424,CĂMINCULTURAL,"VADU MOŢILOR",AB,1139,10,0,0,10,26,0,0,26,35,2,0,37,37,5,0,42,42,8,0,50
8363,425,"PRIMĂRIA VALEA LUNGĂ","VALEA LUNGĂ",AB,1553,9,1,0,10,15,1,0,16,25,1,0,26,33,1,0,34,42,2,0,44
8372,426,"CASĂ PARTICULARĂ FĂGET",FĂGET,AB,21,0,0,0,0,1,1,0,2,1,1,0,2,1,1,0,2,1,2,0,3
8381,427,"ŞCOALA PRIMARĂ GLOGOVEŢ",GLOGOVEŢ,AB,135,3,3,0,6,3,4,0,7,5,6,0,11,8,7,0,15,8,7,0,15
8390,428,"ŞCOALA PRIMARĂ LODROMAN",LODROMAN,AB,156,2,1,0,3,6,2,0,8,7,2,0,9,15,2,0,17,16,3,0,19
8407,429,"ȘCOALA PRIMARĂLUNCA",LUNCA,AB,374,1,3,0,4,2,4,0,6,2,4,0,6,4,9,0,13,5,10,0,15
8416,430,"CĂMIN CULTURAL TĂUNI",TĂUNI,AB,241,1,0,0,1,5,0,0,5,6,0,0,6,6,1,0,7,6,1,0,7
8434,431,"PRIMĂRIA COMUNEI VIDRA",VIDRA,AB,308,2,0,0,2,4,0,0,4,5,2,0,7,9,4,0,13,9,4,0,13
8568,432,"ŞCOALA PRIMARĂ GOIEŞTI",GOIEŞTI,AB,293,3,3,0,6,6,6,0,12,7,6,0,13,14,6,0,20,17,7,0,24
8728,433,"FOSTUL SEDIU AL PRIMĂRIEI PONOREL",PONOREL,AB,733,5,0,0,5,12,0,0,12,14,0,0,14,16,0,0,16,20,0,0,20
9002,434,"CĂMIN CULTURAL VURPĂR",VURPĂR,AB,860,6,1,0,7,8,1,0,9,13,1,0,14,18,1,0,19,21,1,0,22
8835,435,"CĂMIN CULTURAL VINŢU DE JOS","VINŢU DE JOS",AB,1060,10,0,0,10,25,0,0,25,35,0,0,35,49,0,0,49,54,0,0,54
8835,436,"ŞCOALA GIMNAZIALĂ ""IULIU MANIU"" VINŢU DE JOS","VINŢU DE JOS",AB,1319,11,4,0,15,30,4,0,34,41,7,0,48,51,10,0,61,59,10,0,69
8835,437,"GRĂDINIŢA CU PROGRAM NORMAL SIBIŞENI","VINŢU DE JOS",AB,596,8,0,0,8,17,3,0,20,24,4,0,28,33,5,0,38,40,5,0,45
8906,438,"CASA PAROHIALĂ INURI",INURI,AB,155,0,0,0,0,0,0,0,0,0,0,0,0,1,1,0,2,1,2,0,3
8933,439,"CĂMIN CULTURAL MERETEU",MERETEU,AB,171,2,4,0,6,2,4,0,6,2,4,0,6,2,4,0,6,2,4,0,6
8997,440,"ŞCOALA PRIMARĂ VALEA VINŢULUI","VALEA VINŢULUI",AB,335,0,1,0,1,0,1,0,1,1,1,0,2,3,4,0,7,3,4,0,7
13178,1,"BIBLIOTECA JUDEŢEANĂ ARGEŞ “DINICU GOLESCU”",PITEŞTI,AG,1256,15,0,0,15,55,16,0,71,86,22,0,108,106,38,0,144,117,39,0,156
13178,2,"COLEGIUL ECONOMIC “MARIA TEIULEANU”",PITEŞTI,AG,1151,21,0,0,21,69,4,0,73,86,5,0,91,124,6,0,130,134,9,0,143
13178,3,"ŞCOALA GIMNAZIALĂ “ION PILLAT” ( FOSTĂ ŞCOALĂ NR.3)",PITEŞTI,AG,1047,12,0,0,12,31,5,0,36,38,5,0,43,50,5,0,55,55,6,0,61
13178,4,"COLEGIUL ECONOMIC “MARIA TEIULEANU” (FOST LICEUL TEHNOLOGIC „ION MINCU”)",PITEŞTI,AG,1489,8,2,0,10,34,2,0,36,51,2,0,53,86,4,0,90,94,7,0,101
13178,5,"ŞCOALA GIMNAZIALĂ "" NEGRU VODĂ"" ( FOSTĂ ŞCOALA NR. 12)",PITEŞTI,AG,1775,15,2,0,17,49,3,0,52,87,3,0,90,110,3,0,113,115,4,0,119
13178,6,"ŞCOALA GIMNAZIALĂ "" NEGRU VODĂ"" ( FOSTĂ ŞCOALA NR. 12)",PITEŞTI,AG,1605,5,0,0,5,28,2,0,30,58,2,0,60,73,2,0,75,80,2,0,82
13178,7,"ŞCOALA GIMNAZIALĂ "" NEGRU VODĂ"" ( FOSTĂ ŞCOALA NR. 12)",PITEŞTI,AG,1803,8,0,0,8,30,1,0,31,48,2,0,50,64,2,0,66,73,2,0,75
13178,8,"ŞCOALA GIMNAZIALĂ "" NEGRU VODĂ"" ( FOSTĂ ŞCOALA NR. 12)",PITEŞTI,AG,1882,10,1,0,11,39,1,0,40,63,2,0,65,78,2,0,80,84,3,0,87
13178,9,"GRĂDINIŢACU PROGRAM PRELUNGIT "" MICUL PRINŢ"" (FOSTA GRĂDINIŢACU PROGRAM PRELUNGIT NR. 13",PITEŞTI,AG,2101,13,0,0,13,72,0,0,72,96,2,0,98,110,2,0,112,116,4,0,120
13178,10,"ŞCOALAGIMNAZIALĂ “MIRCEA CELBĂTRAN"" (FOSTĂ ŞCOALANR. 13)",PITEŞTI,AG,1897,9,0,0,9,32,0,0,32,53,0,0,53,75,0,0,75,101,0,0,101
13178,11,"ŞCOALAGIMNAZIALĂ “MIRCEA CELBĂTRAN"" (FOSTĂ ŞCOALANR. 13)",PITEŞTI,AG,1865,18,1,0,19,55,1,0,56,77,1,0,78,117,5,0,122,130,8,0,138
13178,12,"ŞCOALAGIMNAZIALĂ “MIRCEA CELBĂTRAN"" (FOSTĂ ŞCOALANR. 13)",PITEŞTI,AG,1928,11,0,0,11,46,2,0,48,67,2,0,69,100,4,0,104,107,4,0,111
13178,13,"ŞCOALAGIMNAZIALĂ “MIRCEA CELBĂTRAN"" (FOSTĂ ŞCOALANR. 13)",PITEŞTI,AG,1840,15,0,0,15,72,2,0,74,98,2,0,100,139,3,0,142,152,4,0,156
13178,14,"GRĂDINIŢA CU PROGRAM PRELUNGIT ""LUMINIŞUL PĂDURII"" (FOSTĂ GRĂDINIŢĂNR. 6)",PITEŞTI,AG,1429,10,1,0,11,54,2,0,56,86,3,0,89,109,5,0,114,115,5,0,120
13178,15,"GRĂDINIŢA CU PROGRAM PRELUNGIT ""LUMINIŞUL PĂDURII"" (FOSTĂ GRĂDINIŢĂNR. 6)",PITEŞTI,AG,1737,12,0,0,12,65,2,0,67,110,2,0,112,128,2,0,130,135,2,0,137
13178,16,"LICEUL TEHNOLOGIC ""DACIA"" (FOST GRUP ŞCOLAR INDUSTRIAL CONSTRUCŢII MAŞINI)",PITEŞTI,AG,1552,15,0,0,15,57,2,0,59,81,3,0,84,117,5,0,122,121,8,0,129
13178,17,"COLEGIUL NAŢIONAL “ION C. BRĂTIANU”",PITEŞTI,AG,926,7,2,0,9,28,2,0,30,41,6,0,47,50,10,0,60,59,11,0,70
13178,18,"ŞCOALA NR.1 - STRUCTURĂ A ŞCOLII GIMNAZIALE „NICOLAE BĂLCESCU” (FOSTA ŞCOALA GIMNAZIALĂ NR.9)",PITEŞTI,AG,1692,11,1,0,12,68,4,0,72,105,4,0,109,128,4,8,140,142,4,8,154
13178,19,"ŞCOALA NR.1 - STRUCTURĂ A ŞCOLII GIMNAZIALE „NICOLAE BĂLCESCU” (FOSTA ŞCOALA GIMNAZIALĂ NR.9)",PITEŞTI,AG,1661,17,1,0,18,64,1,0,65,97,1,0,98,120,1,0,121,131,1,0,132
13178,20,"UNIVERSITATEA „CONSTANTIN BRÂNCOVEANU” (INTRAREA C)",PITEŞTI,AG,1553,18,3,0,21,33,8,0,41,44,8,0,52,53,8,0,61,60,8,0,68
13178,21,"ŞCOALA GIMNAZIALĂ „ALEXANDRU DAVILA” (INTRAREA B) (FOSTA ŞCOALĂ NR.14)",PITEŞTI,AG,1172,12,5,0,17,47,6,0,53,62,6,0,68,73,12,0,85,79,12,0,91
13178,22,"ŞCOALA GIMNAZIALĂ""NICOLAE BĂLCESCU"" ( FOSTA ŞCOALĂ NR.6)",PITEŞTI,AG,1803,16,2,0,18,39,2,0,41,75,2,0,77,97,3,0,100,103,7,0,110
13178,23,"ŞCOALA GIMNAZIALĂ""NICOLAE BĂLCESCU"" ( FOSTA ŞCOALĂ NR.6)",PITEŞTI,AG,1755,10,0,0,10,26,0,0,26,36,0,0,36,53,0,0,53,59,0,0,59
13178,24,"ŞCOALA GIMNAZIALĂ""NICOLAE BĂLCESCU"" ( FOSTA ŞCOALĂ NR.6)",PITEŞTI,AG,1795,19,4,0,23,50,4,0,54,70,4,0,74,84,4,0,88,94,4,0,98
13178,25,"ŞCOALA GIMNAZIALĂ""NICOLAE BĂLCESCU"" ( FOSTA ŞCOALĂ NR.6)",PITEŞTI,AG,1736,12,0,0,12,35,5,0,40,55,5,0,60,69,5,0,74,69,5,0,74
13178,26,"GRĂDINIŢA CU PROGRAM PRELUNGIT ""ALBĂ CA ZĂPADA"" ( FOSTA GRĂDINIŢĂNR. 10)",PITEŞTI,AG,1873,21,0,0,21,53,1,0,54,80,1,0,81,86,5,0,91,96,5,0,101
13178,27,"ŞCOALA GIMNAZIALĂ“ADRIAN PĂUNESCU” (FOSTĂ ŞCOALA NR. 15 )",PITEŞTI,AG,1793,14,3,0,17,65,4,0,69,99,4,0,103,117,6,0,123,134,9,0,143
13178,28,"ŞCOALA GIMNAZIALĂ“ADRIAN PĂUNESCU” (FOSTĂ ŞCOALA NR. 15 )",PITEŞTI,AG,1848,20,4,0,24,70,5,0,75,91,5,0,96,124,7,0,131,134,7,0,141
13178,29,"GRĂDINIŢA CU PROGRAM NORMAL NR. 11- STRUCTURĂ A GRĂDINIŢEI CU PROGRAMPRELUNGIT „ALBĂ CA ZĂPADA”",PITEŞTI,AG,1839,11,5,0,16,36,5,0,41,65,9,0,74,79,9,0,88,86,9,0,95
13178,30,"S.C.LISA DRAXLMAIERS.A.",PITEŞTI,AG,1896,21,1,0,22,47,1,0,48,75,1,0,76,99,3,0,102,106,4,0,110
13178,31,"S.C.LISA DRAXLMAIERS.A.",PITEŞTI,AG,2009,10,3,0,13,32,3,0,35,52,3,0,55,71,4,0,75,74,4,0,78
13178,32,"LICEUL TEORETIC ""ION CANTACUZINIO""",PITEŞTI,AG,1857,18,0,0,18,43,0,0,43,65,4,0,69,81,6,0,87,88,6,0,94
13178,33,"LICEUL TEORETIC ""ION CANTACUZINIO""",PITEŞTI,AG,1944,20,0,0,20,57,0,0,57,96,0,0,96,113,0,0,113,123,0,0,123
13178,34,"LICEUL TEORETIC "" ION CANTACUZINO""",PITEŞTI,AG,1789,10,0,0,10,59,4,0,63,74,4,0,78,101,4,0,105,105,4,0,109
13178,35,"POLICLINICA SPITALULUI JUDEŢEAN",PITEŞTI,AG,1660,23,1,0,24,53,7,0,60,77,11,0,88,98,12,0,110,104,12,0,116
13178,36,"ŞCOALA GIMNAZIALĂ ""MATEI BASARAB"" ( FOSTA ŞCOALA NR. 19)",PITEŞTI,AG,1695,12,2,0,14,36,2,0,38,58,2,0,60,84,7,0,91,93,8,0,101
13178,37,"ŞCOALA GIMNAZIALĂ ""MATEI BASARAB"" ( FOSTA ŞCOALA NR. 19)",PITEŞTI,AG,2107,23,1,0,24,75,3,0,78,100,5,0,105,130,5,0,135,131,5,0,136
13178,38,"ŞCOALA GIMNAZIALĂ „MATEI BASARAB”(FOSTA ŞCOALĂ NR.19)",PITEŞTI,AG,1726,9,1,0,10,32,2,0,34,55,4,0,59,71,4,0,75,87,4,0,91
13178,39,"UNIVERSITATEA “CONSTANTIN BRÂNCOVEANU”",PITEŞTI,AG,1502,9,1,0,10,33,7,0,40,54,9,0,63,75,9,0,84,79,9,0,88
13178,40,"UNIVERSITATEA ""CONSTANTIN BRÂNCOVEANU""",PITEŞTI,AG,1632,18,0,0,18,40,2,0,42,63,3,0,66,89,3,0,92,95,3,0,98
13178,41,"ŞCOALA GIMNAZIALĂ “ALEXANDRU DAVILA” (FOSTĂ ŞCOALĂ NR.14)",PITEŞTI,AG,1881,18,0,0,18,81,1,0,82,105,2,0,107,146,5,0,151,158,5,0,163
13178,42,"ŞCOALA GIMNAZIALĂ“MARIN PREDA” (FOSTA ŞCOALĂ NR.10)",PITEŞTI,AG,1801,24,0,0,24,79,1,0,80,99,2,0,101,120,2,0,122,128,2,0,130
13178,43,"ŞCOALA GIMNAZIALĂ“MARIN PREDA” (FOSTA ŞCOALĂ NR.10)",PITEŞTI,AG,1479,15,0,0,15,66,1,0,67,80,1,0,81,102,2,2,106,107,2,2,111
13178,44,"ŞCOALA GIMNAZIALĂ“MARIN PREDA” (FOSTA ŞCOALĂ NR.10)",PITEŞTI,AG,1682,25,1,0,26,86,3,0,89,127,6,0,133,149,10,0,159,159,10,0,169
13178,45,"COLEGIUL TEHNIC "" ARMAND CĂLINESCU""",PITEŞTI,AG,742,6,0,8,14,21,0,9,30,31,0,9,40,48,0,9,57,64,1,9,74
13178,46,"COLEGIUL TEHNIC "" ARMAND CĂLINESCU""",PITEŞTI,AG,1403,6,0,0,6,41,1,0,42,78,1,0,79,94,1,0,95,113,5,0,118
13178,47,"ŞCOALA GIMNAZIALĂ “NICOLAE SIMONIDE” (FOSTĂ ŞCOALĂ NR.1)",PITEŞTI,AG,1130,9,1,0,10,57,3,0,60,75,4,0,79,96,5,0,101,104,5,0,109
13178,48,"ŞCOALA GIMNAZIALĂ “NICOLAE SIMONIDE” (FOSTĂ ŞCOALĂ NR.1)",PITEŞTI,AG,1585,14,2,0,16,52,2,0,54,66,2,0,68,86,2,0,88,96,3,0,99
13178,49,"ŞCOALA GIMNAZIALĂ “NICOLAE SIMONIDE” (FOSTĂ ŞCOALĂ NR.1)",PITEŞTI,AG,924,5,0,0,5,35,2,0,37,52,2,0,54,70,2,0,72,71,2,0,73
13178,50,"DIRECŢIA APELOR ARGEŞ-VEDEA",PITEŞTI,AG,1041,4,2,0,6,19,3,0,22,35,3,0,38,51,4,0,55,58,4,0,62
13178,51,"DISPENSARUL NR. 16 (ÎN CLĂDIREA CREŞEI NR. 9)",PITEŞTI,AG,1771,21,1,0,22,84,7,0,91,110,7,0,117,143,8,0,151,147,10,0,157
13178,52,"ŞCOALA GIMNAZIALĂ “NICOLAE IORGA”(FOSTĂ ŞCOALĂ NR.5)",PITEŞTI,AG,1450,15,1,0,16,57,5,0,62,66,9,0,75,80,11,0,91,88,11,0,99
13178,53,"ŞCOALA GIMNAZIALĂ “NICOLAE IORGA”(FOSTĂ ŞCOALĂ NR.5)",PITEŞTI,AG,1083,7,0,0,7,38,0,0,38,57,1,0,58,71,1,0,72,83,1,0,84
13178,54,"ŞCOALA GIMNAZIALĂ ""TUDOR VLADIMIRESCU"" ( FOSTĂ ŞCOALĂ NR.20)",PITEŞTI,AG,1733,15,0,0,15,40,2,0,42,52,4,0,56,71,7,0,78,80,8,0,88
13178,55,"ŞCOALA GIMNAZIALĂ ""TUDOR VLADIMIRESCU"" ( FOSTĂ ŞCOALĂ NR.20)",PITEŞTI,AG,1665,10,0,0,10,28,2,0,30,50,2,0,52,64,3,0,67,80,3,0,83
13178,56,"ŞCOALA GIMNAZIALĂ "" TUDOR VLADIMIRESCU"" ( FOSTĂ ŞCOALĂ NR.20)",PITEŞTI,AG,1820,15,1,0,16,36,3,0,39,71,3,0,74,89,3,0,92,93,4,0,97
13178,57,"ŞCOALA GIMNAZIALĂ "" MIRCEA ELIADE"" ( FOSTĂ ŞCOALĂ NR.18)",PITEŞTI,AG,1710,15,0,0,15,44,1,0,45,71,2,0,73,84,2,0,86,89,2,0,91
13178,58,"ŞCOALA GIMNAZIALĂ "" MIRCEA ELIADE"" ( FOSTĂ ŞCOALĂ NR.18)",PITEŞTI,AG,1707,6,2,0,8,32,3,0,35,48,5,0,53,74,5,0,79,78,5,0,83
13178,59,"ŞCOALA GIMNAZIALĂ "" TUDOR ARGHEZI"" ( FOSTĂ ŞCOALĂ NR.7)",PITEŞTI,AG,1827,12,0,0,12,27,0,0,27,33,0,0,33,52,0,0,52,66,1,0,67
13178,60,"ŞCOALA GIMNAZIALĂ "" TUDOR ARGHEZI"" ( FOSTĂ ŞCOALĂ NR.7)",PITEŞTI,AG,1792,22,1,0,23,57,1,0,58,72,5,0,77,88,8,0,96,89,8,0,97
13178,61,"ŞCOALA GIMNAZIALĂ "" TUDOR ARGHEZI"" ( FOSTĂ ŞCOALĂ NR.7)",PITEŞTI,AG,2024,15,0,0,15,46,4,0,50,72,4,0,76,107,5,0,112,119,5,0,124
13178,62,"ŞCOALA GIMNAZIALĂ "" TUDOR ARGHEZI"" ( FOSTĂ ŞCOALĂ NR.7)",PITEŞTI,AG,1831,20,3,0,23,47,4,0,51,63,4,0,67,98,4,0,102,109,5,0,114
13178,63,"COLEGIUL TEHNIC ""COSTIN D. NENIŢESCU""",PITEŞTI,AG,1598,5,4,0,9,24,5,0,29,35,6,0,41,60,7,0,67,66,8,0,74
13178,64,"COLEGIUL TEHNIC ""COSTIN D. NENIŢESCU""",PITEŞTI,AG,1758,7,0,0,7,32,0,0,32,48,0,0,48,66,0,0,66,69,0,0,69
13178,65,"COLEGIUL TEHNIC ""COSTIN D. NENIŢESCU""",PITEŞTI,AG,1667,15,4,0,19,43,4,0,47,66,7,0,73,87,7,0,94,100,7,0,107
13178,66,"ŞCOALA NR.2 - STRUCTURĂ A ŞCOLII GIMNAZIALE „TUDOR VLADIMIRESCU” (FOSTA ȘCOALĂ NR.8)",PITEŞTI,AG,1813,18,2,0,20,64,5,0,69,86,5,0,91,107,5,0,112,127,10,0,137
13178,67,"CLUBUL PENSIONARILOR",PITEŞTI,AG,1850,16,0,0,16,67,1,0,68,103,8,0,111,143,8,0,151,157,9,0,166
13178,68,"ŞCOALA GIMNAZIALĂ “MIHAI EMINESCU” (FOSTA ŞCOALA NR.11)",PITEŞTI,AG,1527,17,2,0,19,61,5,0,66,97,9,0,106,118,9,0,127,124,9,0,133
13178,69,"ŞCOALA GIMNAZIALĂ “MIHAI EMINESCU” (FOSTA ŞCOALA NR.11)",PITEŞTI,AG,1453,29,2,0,31,78,7,0,85,100,8,0,108,128,9,0,137,135,9,0,144
13178,70,"GRĂDINIŢA CU PROGRAM PRELUNGIT "" FLOARE DE COLŢ"" ( FOSTA GRĂDINIŢĂ NR.5)",PITEŞTI,AG,1191,24,0,0,24,65,1,0,66,97,1,0,98,115,1,0,116,119,1,0,120
13178,71,"UNIVERSITATEA PITEŞTI",PITEŞTI,AG,1765,12,1,0,13,53,2,0,55,80,2,0,82,115,3,0,118,126,3,0,129
13178,72,"COLEGIUL NAŢIONAL “ALEXANDRU ODOBESCU”",PITEŞTI,AG,1907,10,1,0,11,37,2,0,39,69,2,0,71,99,2,0,101,106,2,0,108
13178,73,"COLEGIUL NAŢIONAL “ALEXANDRU ODOBESCU”",PITEŞTI,AG,1768,11,2,0,13,24,3,0,27,51,4,0,55,59,4,0,63,66,4,0,70
13178,74,"GRĂDINIŢA CU PROGRAM PRELUNGIT "" ARMONIA"" ( FOSTA GRĂDINIŢĂ NR.8)",PITEŞTI,AG,1868,13,3,0,16,50,3,0,53,67,3,0,70,77,4,0,81,81,4,0,85
13178,75,"ŞCOALA GIMNAZIALĂ “ION MINULESCU” (FOSTA ŞCOALĂ NR.2)",PITEŞTI,AG,1498,10,5,0,15,41,9,0,50,60,9,0,69,76,9,0,85,81,10,0,91
13178,76,"ŞCOALA GIMNAZIALĂ “ION MINULESCU” (FOSTA ŞCOALĂ NR.2)",PITEŞTI,AG,1696,20,5,0,25,77,7,0,84,102,9,0,111,116,12,0,128,131,13,0,144
13178,77,"COLEGIUL TEHNIC “DIMITRIE DIMA”",PITEŞTI,AG,1612,14,1,0,15,44,2,0,46,68,3,0,71,89,4,0,93,94,4,0,98
13178,78,"COLEGIUL TEHNIC “DIMITRIE DIMA”",PITEŞTI,AG,1856,9,2,0,11,32,6,0,38,50,8,0,58,66,8,0,74,75,9,0,84
13178,79,"ŞCOALA GIMNAZIALĂ "" TUDOR MUŞATESCU"" (FOSTA ŞCOALA NR. 17) (INTRAREA A)",PITEŞTI,AG,1355,4,0,0,4,17,0,0,17,28,0,0,28,52,1,0,53,57,1,0,58
13178,80,"ŞCOALA GIMNAZIALĂ „TUDOR MUŞATESCU” (FOSTĂ ŞCOALĂ NR.17) (INTRAREA B)",PITEŞTI,AG,1346,6,0,0,6,23,0,0,23,33,0,0,33,53,0,0,53,60,0,0,60
13178,81,"LICEUL TEHNOLOGIC "" CONSTANTIN BRÂNCUŞI"" ( FOST LICEU TEHNOLOGIC DEINDUSTRIALIZAREA LEMNULUI)",PITEŞTI,AG,1722,19,2,0,21,57,4,0,61,88,4,0,92,111,5,0,116,123,5,0,128
13178,82,"LICEUL TEHNOLOGIC "" CONSTANTIN BRÂNCUŞI"" ( FOST LICEU TEHNOLOGIC DEINDUSTRIALIZAREA LEMNULUI)",PITEŞTI,AG,1712,16,0,0,16,66,3,0,69,86,3,0,89,116,4,0,120,120,4,0,124
13178,83,"GRĂDINIŢA CU PROGRAM NORMAL ""ISTEŢEL"" ( FOSTA GRĂDINIŢĂ NR.4)",PITEŞTI,AG,1765,11,3,0,14,76,4,0,80,108,4,0,112,125,5,0,130,131,6,0,137
13178,84,"GRĂDINIŢA CU PROGRAM PRELUNGIT "" ARIPI DESCHISE"" ( FOSTA GRĂDINIŢĂ NR.14)",PITEŞTI,AG,1804,16,3,0,19,62,3,0,65,80,5,0,85,97,5,0,102,113,7,0,120
13178,85,"ŞCOALA GIMNAZIALĂ “I. L. CARAGIALE” (FOSTĂ ŞCOALĂ NR.16)",PITEŞTI,AG,1666,14,2,0,16,53,2,0,55,76,4,0,80,90,6,0,96,104,7,0,111
13178,86,"ŞCOALA GIMNAZIALĂ “I. L. CARAGIALE” (FOSTĂ ŞCOALĂ NR.16)",PITEŞTI,AG,1790,26,0,0,26,59,0,0,59,83,0,0,83,96,0,0,96,103,0,0,103
13178,87,"ŞCOALA GIMNAZIALĂ “I. L. CARAGIALE” (FOSTĂ ŞCOALĂ NR.16)",PITEŞTI,AG,1693,11,0,0,11,44,0,0,44,73,0,0,73,99,0,0,99,111,0,0,111
13178,88,"ŞCOALA GIMNAZIALĂ "" TRAIAN"" ( FOSTĂ ŞCOALĂ NR.4)",PITEŞTI,AG,1420,13,0,0,13,49,3,0,52,61,3,0,64,90,3,0,93,103,3,0,106
13178,89,"ŞCOALA GIMNAZIALĂ "" TRAIAN"" ( FOSTĂ ŞCOALĂ NR.4)",PITEŞTI,AG,1677,23,2,0,25,64,10,0,74,102,10,0,112,128,13,0,141,140,13,0,153
13506,90,"ŞCOALA GIMNAZIALĂ ""OPREA IORGULESCU"" - I",CÂMPULUNG,AG,787,9,7,0,16,24,11,0,35,37,16,0,53,44,18,0,62,44,19,0,63
13506,91,"ŞCOALA GIMNAZIALĂ ""OPREA IORGULESCU"" - II",CÂMPULUNG,AG,909,14,4,0,18,41,4,0,45,47,5,0,52,61,7,0,68,63,7,0,70
13506,92,"COLEGIUL TEHNIC",CÂMPULUNG,AG,1195,10,8,0,18,33,10,0,43,47,16,9,72,49,17,9,75,67,18,9,94
13506,93,"BIBLIOTECA GRUI",CÂMPULUNG,AG,1718,7,2,0,9,25,4,0,29,37,4,0,41,59,5,0,64,61,5,0,66
13506,94,"GRĂDINIŢA CU PROGRAM NORMAL NR. 9 - I",CÂMPULUNG,AG,1628,9,0,0,9,33,0,0,33,57,2,0,59,78,2,0,80,91,2,0,93
13506,95,"GRĂDINIŢA CU PROGRAM NORMAL NR. 9 - II",CÂMPULUNG,AG,1481,14,1,0,15,37,4,0,41,45,4,0,49,72,5,0,77,83,5,0,88
13506,96,"GRĂDINIŢA CU PROGRAM NORMAL NR 9 - III",CÂMPULUNG,AG,1508,19,2,0,21,35,2,0,37,55,2,0,57,68,2,0,70,74,2,0,76
13506,97,"ŞCOALA GENERALĂ NR. 5",CÂMPULUNG,AG,1155,3,0,0,3,18,0,0,18,24,3,0,27,29,8,0,37,39,8,0,47
13506,98,"S.C. HIDROELECTRICA S.A.",CÂMPULUNG,AG,932,4,3,0,7,15,3,0,18,31,5,0,36,34,8,0,42,41,8,0,49
13506,99,"ŞCOALA GIMNAZIALĂ ""THEODOR AMAN"" - I",CÂMPULUNG,AG,1460,13,5,0,18,21,6,0,27,37,8,0,45,60,8,0,68,67,8,0,75
13506,100,"ŞCOALA GIMNAZIALĂ ""THEODOR AMAN"" - II",CÂMPULUNG,AG,1133,8,0,0,8,31,0,0,31,47,0,0,47,52,0,0,52,57,0,0,57
13506,101,"ŞCOALA GIMNAZIALĂ ""THEODOR AMAN"" - III",CÂMPULUNG,AG,1340,4,3,0,7,18,3,0,21,29,6,0,35,31,6,0,37,34,6,0,40
13506,102,"GRĂDINIŢA CU PROGRAM PRELUNGIT ""SFÂNTA MARINA"" - I",CÂMPULUNG,AG,1415,10,4,0,14,30,5,0,35,43,5,0,48,59,7,0,66,61,7,0,68
13506,103,"GRĂDINIŢA CU PROGRAM PRELUNGIT ""SFÂNTA MARINA"" - II",CÂMPULUNG,AG,1350,9,0,0,9,30,0,0,30,38,0,0,38,56,0,0,56,56,0,0,56
13506,104,"GRĂDINIŢA CU PROGRAM PRELUNGIT ""SFÂNTA MARINA"" - III",CÂMPULUNG,AG,1657,5,4,0,9,21,6,0,27,35,7,0,42,57,7,1,65,65,7,1,73
13506,105,"GRĂDINIŢA CU PROGRAM NORMAL NR. 8 - I",CÂMPULUNG,AG,1660,12,3,0,15,23,4,0,27,29,4,0,33,41,4,0,45,41,8,0,49
13506,106,"GRĂDINIŢA CU PROGRAM NORMAL NR. 8 - II",CÂMPULUNG,AG,1477,15,1,0,16,51,1,0,52,71,3,0,74,99,4,0,103,104,4,0,108
13506,107,"GRĂDINIŢA VALEA ROMÂNEŞTILOR",CÂMPULUNG,AG,384,2,2,0,4,6,4,0,10,11,4,0,15,16,8,0,24,16,8,0,24
13506,108,"LICEUL TEORETIC ""DAN BARBILIAN""",CÂMPULUNG,AG,1045,16,1,0,17,31,4,0,35,37,6,0,43,48,6,0,54,63,8,0,71
13506,109,"COLEGIUL NAŢIONAL PEDAGOGIC ""CAROL I""",CÂMPULUNG,AG,760,7,0,0,7,12,0,0,12,20,0,0,20,26,1,0,27,29,1,0,30
13506,110,"SERVICIUL ÎNTREŢINERE DRUMURI ŞI STRĂZI",CÂMPULUNG,AG,987,5,0,0,5,16,0,0,16,18,0,0,18,26,1,0,27,28,1,0,29
13506,111,"LICEUL TEHNOLOGIC AUTO",CÂMPULUNG,AG,1242,9,0,0,9,21,0,0,21,25,2,0,27,28,2,0,30,30,2,0,32
13506,112,"ŞCOALA GENERALĂ NR.4 ""APA SĂRATĂ""",CÂMPULUNG,AG,757,2,6,0,8,3,6,0,9,4,7,0,11,5,9,0,14,5,9,0,14
13506,113,"GRĂDINIŢA NR. 1",CÂMPULUNG,AG,537,7,0,0,7,11,0,0,11,17,0,0,17,17,4,0,21,17,4,0,21
13506,114,"COLEGIUL NAŢIONAL ""DINICU GOLESCU""",CÂMPULUNG,AG,1312,12,5,0,17,41,16,0,57,50,20,0,70,58,21,0,79,59,23,0,82
13506,115,"ŞCOALA GIMNAZIALĂ ""C.D. ARICESCU""",CÂMPULUNG,AG,917,8,0,0,8,27,4,0,31,34,8,0,42,41,13,0,54,43,13,0,56
13631,116,"ȘCOALA GIMNAZIALĂ NR.2""REGINA MARIA"" ( I )","CURTEA DE ARGEŞ",AG,1516,6,1,0,7,22,2,0,24,31,3,0,34,44,3,0,47,46,3,0,49
13631,117,"ȘCOALA GIMNAZIALĂNR.2 ""REGINA MARIA""( II )","CURTEA DE ARGEŞ",AG,1220,9,5,0,14,17,7,0,24,24,9,0,33,32,9,0,41,33,9,0,42
13631,118,"ȘCOALA GIMNAZIALĂNR.2 ""REGINA MARIA""( III )","CURTEA DE ARGEŞ",AG,1635,5,1,0,6,30,1,0,31,40,1,0,41,47,1,50,98,59,7,50,116
13631,119,"GRUP ȘCOLAR ""FERDINAND I""","CURTEA DE ARGEŞ",AG,1648,7,0,0,7,15,0,0,15,24,2,0,26,36,2,0,38,42,4,0,46
13631,120,"GRUP ȘCOLAR AGRICOL ""CONSTANTIN DOBRESCU ARGEȘ""( I )","CURTEA DE ARGEŞ",AG,1431,8,2,0,10,31,4,0,35,49,7,0,56,54,8,0,62,61,8,0,69
13631,121,"GRUP ȘCOLAR AGRICOL ""CONSTANTIN DOBRESCU ARGEȘ"" ( II )","CURTEA DE ARGEŞ",AG,1720,10,0,0,10,28,2,0,30,39,2,0,41,51,2,0,53,54,3,0,57
13631,122,"ȘCOALA GIMNAZIALĂNR.6 ""BASARAB I""","CURTEA DE ARGEŞ",AG,1437,5,5,0,10,34,5,0,39,39,5,0,44,60,6,0,66,67,6,0,73
13631,123,"GRUP ȘCOLAR FORESTIER CURTEA DE ARGEȘ( I )","CURTEA DE ARGEŞ",AG,1478,3,1,0,4,21,3,0,24,35,5,0,40,43,7,1,51,49,7,1,57
13631,124,"GRUP ȘCOLAR FORESTIERCURTEA DE ARGEȘ ( II )","CURTEA DE ARGEŞ",AG,1538,8,0,0,8,36,0,0,36,52,2,0,54,62,3,0,65,65,4,0,69
13631,125,"CENTRULDE CULTURĂȘI ARTE "" GEORGE TOPÎRCEANU""( I )","CURTEA DE ARGEŞ",AG,1487,14,0,0,14,42,8,0,50,57,19,0,76,75,21,0,96,81,26,0,107
13631,126,"ȘCOALA GIMNAZIALĂNR.4 "" MIRCEA CEL BATRÂN""","CURTEA DE ARGEŞ",AG,1384,15,5,0,20,61,10,0,71,80,12,0,92,101,13,0,114,106,13,0,119
13631,127,"ȘCOALA GIMNAZIALĂNR.1""CAROLI""","CURTEA DE ARGEŞ",AG,1227,8,2,0,10,26,3,0,29,37,4,0,41,40,4,0,44,40,4,0,44
13631,128,"ȘCOALA GIMNAZIALĂNR.1 ""CAROL I""","CURTEA DE ARGEŞ",AG,1584,7,5,0,12,31,5,0,36,47,5,0,52,53,5,0,58,54,5,0,59
13631,129,"ȘCOALA GENERALĂ NR.5 ""ARMAND CĂLINESCU""(I)","CURTEA DE ARGEŞ",AG,1397,18,5,0,23,28,6,0,34,34,11,0,45,43,14,0,57,52,14,0,66
13631,130,"ȘCOALA GENERALĂ NR 5 ""ARMAND CĂLINESCU""(II)","CURTEA DE ARGEŞ",AG,1080,8,0,0,8,15,0,0,15,25,0,0,25,33,1,0,34,34,1,0,35
13631,131,"ȘCOALA GENERALĂ VALEA SASULUI","CURTEA DE ARGEŞ",AG,872,8,3,0,11,10,3,0,13,17,3,0,20,24,5,0,29,32,6,0,38
13631,132,"GRUP ȘCOLAR AUTO CURTEA DE ARGEȘ","CURTEA DE ARGEŞ",AG,1885,15,0,0,15,29,2,0,31,37,2,0,39,45,3,0,48,45,3,0,48
13631,133,"CENTRUL DE CULTURĂ ȘI ARTE ""GEORGE TOPÎRCEANU""(II)","CURTEA DE ARGEŞ",AG,1496,13,2,0,15,45,4,0,49,59,4,0,63,71,4,0,75,79,4,0,83
13631,134,"ȘCOALA GENERALĂ NR.3 ""SFÂNTUL APOSTOL ANDREI""","CURTEA DE ARGEŞ",AG,1388,4,0,0,4,13,0,0,13,16,2,0,18,23,5,0,28,25,5,0,30
13640,135,"ȘCOALA GENERALĂ NOAPTEȘ",NOAPTEŞ,AG,735,3,0,0,3,12,2,0,14,13,2,0,15,18,3,0,21,18,3,0,21
13677,136,"PRIMĂRIA ORAŞULUI COSTEŞTI",COSTEŞTI,AG,1854,14,4,0,18,28,4,0,32,38,5,0,43,51,5,0,56,65,5,0,70
13677,137,"CASA DE CULTURĂ COSTEŞTI",COSTEŞTI,AG,1770,13,4,0,17,26,4,0,30,38,7,0,45,61,7,0,68,68,11,0,79
13677,138,"LICEUL TEORETIC COSTEŞTI",COSTEŞTI,AG,1627,8,5,0,13,19,6,0,25,27,6,0,33,39,8,16,63,49,8,16,73
13677,139,"ŞCOALA TELEŞTI",COSTEŞTI,AG,789,4,0,0,4,8,0,0,8,14,0,0,14,20,0,0,20,22,0,0,22
13677,140,"ŞCOALA GENERALĂ ZORILE",COSTEŞTI,AG,840,5,4,0,9,7,8,0,15,7,13,0,20,7,18,0,25,8,21,0,29
13686,141,"ŞCOALA GENERALĂ BROŞTENI",BROŞTENI,AG,676,10,1,0,11,12,1,0,13,16,2,0,18,22,4,0,26,23,5,0,28
13711,142,"ŞCOALA GENERALĂ PODU BROŞTENI","PODU BROŞTENI",AG,521,1,4,0,5,3,6,0,9,5,7,0,12,11,12,0,23,12,13,0,25
13702,143,"ŞCOALA GENERALĂ PÎRVU ROŞU","PÎRVU ROŞU",AG,518,3,0,0,3,4,1,0,5,6,2,0,8,7,2,0,9,11,3,0,14
13739,144,"ŞCOALA GENERALĂ STÎRCI",STÎRCI,AG,199,0,0,0,0,2,4,0,6,2,4,0,6,5,4,0,9,10,4,0,14
13310,145,"GRĂDINIŢA ""FLORILE SOARELUI""-INTRARE 1",MIOVENI,AG,1613,7,0,0,7,30,5,0,35,46,6,0,52,56,8,0,64,59,8,0,67
13310,146,"LICEUL TEORETIC ""IULIA ZAMFIRESCU"" - INTRARE C",MIOVENI,AG,1341,11,0,5,16,36,0,6,42,60,11,0,71,70,12,0,82,75,14,0,89
13310,147,"FOSTUL SEDIU ALGRĂDINIȚEI DIN BLOCUL M6",MIOVENI,AG,1618,22,3,0,25,54,4,0,58,74,5,0,79,106,6,0,112,115,6,0,121
13310,148,"GRĂDINIŢA ""FLORILE SOARELUI"" - INTRARE 2",MIOVENI,AG,1564,9,7,0,16,18,8,0,26,24,8,0,32,40,8,0,48,41,8,0,49
13310,149,"DISPENSAR UMAN",MIOVENI,AG,1674,17,0,0,17,50,2,0,52,74,5,0,79,86,5,0,91,93,7,0,100
13310,150,"ŞCOALA GIMNAZIALĂ ""LIVIU REBREANU"" (CĂMIN ȘCOALĂ) - CORP B",MIOVENI,AG,1742,14,2,0,16,39,4,0,43,63,7,0,70,75,10,0,85,78,10,0,88
13310,151,"LICEULTEORETIC ”IULIA ZAMFIRESCU” - INTRARE B",MIOVENI,AG,1544,10,6,0,16,29,8,0,37,41,8,0,49,64,9,0,73,66,9,0,75
13310,152,"ȘCOALA GIMNAZIALĂ LIVIU REBREANU” - INTRARE ELEVI",MIOVENI,AG,1008,4,6,0,10,13,6,0,19,19,6,0,25,23,7,0,30,25,8,0,33
13310,153,"ȘCOALA GIMNAZIALĂ ”LIVIU REBREANU” - INTRARE PROFESORI",MIOVENI,AG,1151,15,4,0,19,36,4,0,40,45,4,0,49,47,6,0,53,51,7,0,58
13310,154,"GRĂDINIŢA ""TIC-PITIC""(CREŞA CĂMIN)",MIOVENI,AG,1142,6,2,0,8,24,5,0,29,42,6,0,48,60,7,0,67,62,11,0,73
13310,155,"FOSTUL SEDIU AL GRĂDINIȚEI DIN BLOCUL F9",MIOVENI,AG,1154,12,0,0,12,36,1,0,37,55,3,0,58,67,3,0,70,76,3,0,79
13310,156,"SC ”CONSTRUCȚII-REPARAȚII MIOVENI„ SRL",MIOVENI,AG,1296,6,2,0,8,40,6,0,46,60,24,0,84,77,25,0,102,86,27,0,113
13310,157,"CASA DE CULTURĂ A SINDICATELOR DACIA",MIOVENI,AG,1411,8,0,0,8,27,0,0,27,38,1,0,39,57,1,0,58,64,1,0,65
13310,158,"FOSTUL SEDIU AL GRĂDINIȚEI DIN BLOCUL T6",MIOVENI,AG,1709,12,0,0,12,25,1,0,26,51,6,0,57,63,8,0,71,72,8,0,80
13310,159,"FOSTUL SEDIU ALGRĂDINIȚEI ”CAMPIONII” DIN BLOCUL T2A",MIOVENI,AG,1304,16,8,0,24,30,10,0,40,42,13,0,55,65,14,0,79,65,14,0,79
13310,160,"GRĂDINIȚA ”CAMPIONII”",MIOVENI,AG,1753,23,9,0,32,30,12,0,42,46,13,0,59,69,16,0,85,71,16,0,87
13310,161,"ȘCOALA GIMNAZIALĂ ”GEORGE TOPÂRCEANU”",MIOVENI,AG,884,6,7,0,13,18,9,0,27,34,13,289,336,44,17,289,350,47,18,289,354
13356,162,"ȘCOALA GIMNAZIALĂ ”MARIN SORESCU” RACOVIȚA",RACOVIŢA,AG,903,15,10,5,30,26,17,9,52,42,32,10,84,52,41,11,104,57,46,11,114
13356,163,"FOSTUL SEDIU ALȘCOLII RACOVIȚA DE SUS",RACOVIŢA,AG,701,7,0,0,7,17,2,0,19,24,3,0,27,35,6,0,41,38,7,0,45
13338,164,"ȘCOALA GIMNAZIALĂ COLIBAȘI",COLIBAŞI,AG,1356,13,0,0,13,29,0,55,84,39,0,55,94,47,1,55,103,51,1,55,107
13338,165,"CĂMINUL CULTURAL COLIBAȘI",COLIBAŞI,AG,648,3,1,0,4,18,4,0,22,23,4,0,27,32,5,7,44,34,5,7,46
13329,166,"FOSTUL SEDIU AL ȘCOLII CLUCEREASA",CLUCEREASA,AG,312,0,0,0,0,4,0,0,4,6,0,0,6,11,1,0,12,11,1,0,12
13347,167,"ȘCOALA PRIMARĂ FĂGETU",FĂGETU,AG,724,9,1,0,10,27,1,0,28,28,1,0,29,55,2,0,57,63,2,0,65
13347,168,"CĂMINUL CULTURAL FĂGETU",FĂGETU,AG,210,3,3,0,6,8,4,0,12,11,4,0,15,17,5,0,22,22,5,0,27
13418,169,"ŞCOALA PRIMARĂ ENCULEŞTI",ENCULEŞTI,AG,470,0,1,0,1,4,1,0,5,5,2,0,7,10,2,0,12,13,2,0,15
13454,170,"ȘCOALA GENERALĂ ""CONSTANTIN BRÂNCOVEANU""","VALEA MARE-PODGORIA",AG,1229,2,0,0,2,5,0,0,5,11,3,0,14,16,5,0,21,19,5,0,24
13454,171,"ŞCOALA GENERALĂ ""CONSTANTIN BRÂNCOVEANU"" VALEA MARE","VALEA MARE-PODGORIA",AG,1690,13,4,0,17,39,8,0,47,61,10,0,71,72,11,0,83,76,11,0,87
13454,172,"NIDEC MOTOR CORPORATION ROMANIA S.A.","VALEA MARE-PODGORIA",AG,1797,11,3,0,14,28,6,0,34,45,13,0,58,65,22,0,87,71,24,0,95
13445,173,"LICEUL TEHNOLOGIC ""DINU BRĂTIANU""","ŞTEFĂNEŞTII NOI",AG,1677,19,1,0,20,48,5,0,53,71,7,0,78,91,15,0,106,99,17,0,116
13445,174,"LICEUL TEHNOLOGIC ""DINU BRĂTIANU""","ŞTEFĂNEŞTII NOI",AG,1359,17,3,0,20,36,4,0,40,50,7,0,57,68,10,0,78,73,10,0,83
13436,175,"ŞCOALA GENERALĂ NR.1 ŞTEFĂNEŞTI, CORP C (GRĂDINIŢĂ)",IZVORANI,AG,969,4,3,0,7,7,7,0,14,10,10,0,20,14,11,0,25,17,11,0,28
13409,176,"CASA DE CULTURĂ ŞTEFĂNEŞTI",ŞTEFĂNEŞTI,AG,1071,5,2,0,7,16,4,0,20,21,8,0,29,29,11,0,40,34,11,0,45
13409,177,"ŞCOALA PRIMARĂ ŞTEFĂNEŞTI",ŞTEFĂNEŞTI,AG,1393,1,0,0,1,7,0,0,7,16,0,0,16,31,5,0,36,34,5,0,39
13427,178,"ŞCOALA ""RADU GOLESCU"" GOLEȘTI",GOLEŞTI,AG,1035,3,0,0,3,10,1,0,11,29,4,0,33,42,4,0,46,45,4,0,49
13766,179,"ŞCOALA PRIMARĂ GOLEŞTII-BADII",TOPOLOVENI,AG,840,9,0,0,9,17,1,0,18,27,2,0,29,38,2,0,40,38,2,0,40
13766,180,"LICEUL TEORETIC ,,ION MIHALACHE’’ TOPOLOVENI",TOPOLOVENI,AG,1028,8,4,0,12,20,12,0,32,34,15,0,49,52,17,0,69,59,19,0,78
13766,181,"LICEUL TEORETIC ,,ION MIHALACHE’’ TOPOLOVENI",TOPOLOVENI,AG,879,10,1,0,11,29,5,0,34,46,9,0,55,52,9,0,61,54,9,0,63
13766,182,"CENTRUL DE ZI TOPOLOVENI",TOPOLOVENI,AG,656,3,0,0,3,12,0,0,12,23,0,0,23,26,0,0,26,31,0,0,31
13766,183,"ŞCOALA GIMNAZIALĂ ""NICOLAE CRISTESCU"" TOPOLOVENI",TOPOLOVENI,AG,860,6,1,0,7,15,1,0,16,32,6,0,38,43,8,0,51,48,8,0,56
13766,184,"ŞCOALA GIMNAZIALĂ ""NICOLAE CRISTESCU"" TOPOLOVENI",TOPOLOVENI,AG,964,3,0,0,3,13,0,0,13,20,0,0,20,29,0,0,29,29,0,0,29
13766,185,"ŞCOALA GIMNAZIALĂ "" NICOLAE CRISTESCU"" SALA DE SPORT",TOPOLOVENI,AG,1073,10,0,0,10,18,0,0,18,23,3,0,26,36,4,0,40,41,5,0,46
13766,186,"ŞCOALA PRIMARĂ INURI",TOPOLOVENI,AG,240,0,1,0,1,0,1,0,1,3,2,0,5,7,3,0,10,8,3,0,11
13766,187,"ŞCOALAPRIMARĂ ŢIGĂNEŞTI- LINIE",TOPOLOVENI,AG,611,6,4,0,10,9,6,0,15,15,6,0,21,23,6,0,29,23,6,0,29
13800,188,"ŞCOALA GENERALĂ ŢIGĂNEŞTI - CENTRU",ŢIGĂNEŞTI,AG,690,5,4,0,9,12,4,0,16,21,5,0,26,28,5,0,33,28,7,0,35
13828,189,"CASA DE CULTURĂ ALBEŞTII DE ARGEŞ","ALBEŞTII PAMÎNTENI",AG,1566,9,3,0,12,16,6,0,22,24,9,0,33,32,9,0,41,38,19,0,57
13837,190,"ŞCOALA PRIMARĂ ALBEŞTII -UNGURENI","ALBEŞTII UNGURENI",AG,1267,2,0,0,2,4,0,0,4,7,0,0,7,10,0,0,10,10,0,0,10
13837,191,"ŞCOALAPRIMARĂ ALBEŞTII-UNGURENI","ALBEŞTII UNGURENI",AG,746,1,0,0,1,2,0,0,2,3,2,0,5,3,2,0,5,3,2,0,5
13846,192,"ŞCOALA PRIMARĂBRĂTEŞTI",BRĂTEŞTI,AG,614,1,0,0,1,1,0,0,1,2,2,0,4,8,2,0,10,9,2,0,11
13864,193,"SCOALA PRIMARĂ DOBROŢU",DOBROTU,AG,830,0,0,0,0,12,2,0,14,12,3,0,15,13,4,0,17,17,8,0,25
13917,194,"ŞCOALA GIMNAZIALĂ NR.1 ALBEȘTII DE MUSCEL, STRADA MAGISTRAT SORIN MOISESCU NR.360",ALBEŞTI,AG,938,4,0,0,4,6,0,0,6,9,1,0,10,13,2,0,15,27,3,0,30
13926,195,"ŞCOALA GENERALĂ I-IV CÂNDEȘTI, STRADA MAGISTRAT SORIN MOISESCU, NR.182",CÎNDEŞTI,AG,355,1,3,0,4,3,8,0,11,3,8,0,11,6,11,0,17,9,11,0,20
13944,196,"CĂMIN CULTURAL ALBOTA",ALBOTA,AG,1875,7,0,0,7,37,0,0,37,48,1,0,49,64,5,0,69,75,6,0,81
13980,197,"ŞCOALA GIMNAZIALĂ MAREŞ",MAREŞ,AG,873,3,2,0,5,5,4,0,9,8,6,0,14,12,7,0,19,15,7,0,22
13953,198,"ŞCOALA PRIMARĂ CERBU",CERBU,AG,634,7,4,0,11,10,6,0,16,15,7,0,22,27,12,0,39,28,13,0,41
14003,199,"ŞCOALA GIMNAZIALĂ BROŞTENI - ANINOASA, CORP B",ANINOASA,AG,1224,14,1,0,15,22,2,0,24,31,5,0,36,32,8,0,40,35,9,0,44
14030,200,"CĂMIN CULTURALVALEA SILIŞTII","VALEA SILIŞTII",AG,521,3,3,0,6,3,3,0,6,3,3,0,6,5,4,0,9,6,6,0,12
14021,201,"ŞCOALA GIMNAZIALĂ SLĂNIC",SLĂNIC,AG,919,8,2,0,10,11,3,0,14,18,4,0,22,19,4,0,23,19,4,0,23
14067,202,"CĂMINUL CULTURAL AREFU",AREFU,AG,1075,3,0,0,3,8,1,0,9,14,1,0,15,22,7,0,29,24,7,0,31
14058,203,"ŞCOALA GIMNAZIALĂ GEORGE STEPHĂNESCU","CĂPĂŢÎNENII PĂMÂNTENI",AG,953,5,0,0,5,8,8,0,16,8,12,0,20,14,18,0,32,14,18,0,32
13196,204,"GRĂDINIȚA NR. 1 BASCOV",BASCOV,AG,1171,8,3,0,11,22,3,0,25,37,6,0,43,49,7,0,56,55,7,0,62
13196,205,"ŞCOALA GENERALĂ BASCOV, CLĂDIREA VECHE",BASCOV,AG,1964,7,3,0,10,26,7,0,33,44,8,0,52,62,10,0,72,64,10,0,74
13196,206,"ŞCOALA GENERALĂ BASCOV, CLĂDIREA NOUĂ",BASCOV,AG,1460,14,0,0,14,40,3,0,43,53,6,0,59,65,6,0,71,78,6,0,84
13249,207,"ŞCOALA GENERALĂ SCHIAU",SCHIAU,AG,1451,12,5,0,17,24,5,0,29,37,5,0,42,51,6,0,57,52,6,0,58
13212,208,"ŞCOALA GENERALĂ GLÎMBOCU",GLÎMBOCU,AG,773,8,2,0,10,8,2,0,10,21,3,0,24,28,3,0,31,32,3,0,35
13267,209,"ŞCOALA GENERALĂ VALEA URSULUI","VALEA URSULUI",AG,1558,1,0,0,1,9,0,0,9,13,5,0,18,25,6,0,31,28,9,0,37
13221,210,"ŞCOALA GENERALĂ MICA",MICA,AG,509,6,0,0,6,9,0,0,9,13,0,0,13,19,1,0,20,22,1,0,23
14094,211,"ŞCOALA BĂBANA",BĂBANA,AG,764,5,4,0,9,10,5,0,15,13,5,0,18,17,5,0,22,22,5,0,27
14156,212,"ŞCOALA SLĂTIOARELE",SLĂATIOARELE,AG,675,5,2,0,7,8,5,0,13,13,6,0,19,19,7,0,26,19,7,0,26
14094,213,"BIBLIOTECA COMUNALĂ",BĂBANA,AG,595,3,2,0,5,8,3,0,11,11,5,0,16,16,7,0,23,18,7,0,25
14138,214,"ŞCOALA GROŞI",GROŞI,AG,373,0,3,0,3,3,3,0,6,3,7,0,10,7,9,0,16,8,9,0,17
14174,215,"PRIMĂRIA BĂICULEŞTI",BĂICULEŞTI,AG,1398,5,1,0,6,15,5,0,20,18,5,0,23,26,7,0,33,26,7,0,33
14218,216,"ŞCOALA MĂNICEŞTI",MĂNICEŞTI,AG,625,6,0,0,6,7,0,0,7,10,3,0,13,10,3,0,13,10,3,0,13
14263,217,"CĂMINUL CULTURAL",ZIGONENI,AG,826,3,2,0,5,4,3,0,7,6,3,0,9,14,3,0,17,14,3,0,17
14254,218,"CĂMINUL CULTURAL","VALEA LUI ENACHE",AG,682,0,3,0,3,1,3,0,4,1,3,0,4,2,3,0,5,2,3,0,5
14236,219,"SEDIUL ADMINISTRATIV TUTANA",TUTANA,AG,1526,1,0,0,1,2,0,0,2,11,1,0,12,15,2,0,17,17,4,0,21
14281,220,"CĂMIN CULTURAL BĂLILEŞTI",BĂLILEŞTI,AG,909,8,4,0,12,17,10,0,27,25,10,0,35,27,10,0,37,32,10,0,42
14290,221,"CĂMIN CULTURAL BĂJEŞTI",BĂJEŞTI,AG,858,4,5,0,9,9,8,0,17,11,9,0,20,15,9,0,24,16,9,0,25
14316,222,"CĂMIN CULTURAL POIENIŢA",POIENIŢA,AG,990,1,0,0,1,6,0,0,6,12,1,0,13,15,1,0,16,23,1,0,24
14307,223,"ŞCOALA GOLEŞTI",GOLEŞTI,AG,582,3,3,0,6,9,5,0,14,11,6,0,17,14,6,0,20,16,6,0,22
14370,224,"CĂMIN CULTURAL BELEŢI",BELEŢI,AG,547,3,1,0,4,11,3,0,14,12,3,0,15,15,3,0,18,17,3,0,20
14398,225,"CĂMIN CULTURAL NEGREŞTI",NEGREŞTI,AG,975,7,1,0,8,10,4,0,14,16,5,0,21,16,6,0,22,16,6,0,22
14414,226,"CĂMIN CULTURAL BEREVOEŞTI-PĂMÎNTENI",BEREVOEŞTI,AG,1704,1,0,0,1,9,1,0,10,19,3,0,22,23,5,0,28,23,5,0,28
14432,227,"ŞCOALA GĂMĂCEŞTI",GĂMĂCEŞTI,AG,846,0,0,0,0,0,0,0,0,0,2,0,2,1,2,0,3,1,2,0,3
14423,228,"ŞCOALA BRATIA",BRATIA,AG,155,2,6,0,8,3,8,0,11,3,10,0,13,7,10,0,17,8,10,0,18
14566,229,"ŞCOALA URLUIENI",URLUENI,AG,1030,7,2,0,9,20,4,0,24,21,5,0,26,28,7,0,35,29,7,0,36
14520,230,"ŞCOALA MÎNDRA",MÎNDRA,AG,669,3,0,0,3,6,1,0,7,6,2,0,8,9,3,0,12,9,4,0,13
14469,231,"ŞCOALA BÎRLA",BÎRLA,AG,790,1,7,0,8,5,7,0,12,9,8,0,17,9,8,0,17,11,8,0,19
14539,232,"ŞCOALA MOZĂCENI-VALE",MOZĂCENII-VALE,AG,938,3,0,0,3,3,10,0,13,6,10,0,16,9,10,0,19,9,10,0,19
14487,233,"ŞCOALA BĂDEŞTI",BĂDEŞTI,AG,269,4,3,0,7,5,6,0,11,6,7,0,13,8,7,0,15,11,8,0,19
14593,234,"ŞCOALA BOGAŢI",BOGAŢI,AG,1366,7,2,0,9,17,3,0,20,18,5,0,23,25,8,0,33,31,8,0,39
14655,235,"ŞCOALA GLÎMBOCELU",GLÎMBOCELU,AG,593,0,4,0,4,0,5,0,5,3,5,0,8,10,9,0,19,13,9,0,22
14628,236,ŞCOALACHIŢEŞTI,CHIŢEŞTI,AG,219,0,3,0,3,4,4,0,8,6,5,0,11,7,5,0,12,8,7,0,15
14619,237,"GRĂDINIŢA BUJOI",BUJOI,AG,520,2,4,0,6,4,4,0,8,6,4,0,10,8,4,0,12,11,4,0,15
14664,238,"ŞCOALA SUSENI",SUSENI,AG,816,3,0,0,3,4,0,0,4,10,2,0,12,13,2,0,15,16,2,0,18
14646,239,"ŞCOALA GLÎMBOCEL",GLÎMBOCEL,AG,161,2,4,0,6,3,4,0,7,5,4,0,9,6,5,0,11,6,5,0,11
14682,240,"CĂMIN CULTURAL BOTENI",BOTENI,AG,1511,3,1,0,4,11,1,0,12,12,2,0,14,20,2,0,22,26,2,0,28
14708,241,"ŞCOALA PRIMARĂ LUNCA",LUNCA,AG,505,1,0,0,1,3,0,0,3,6,0,0,6,12,0,0,12,13,0,0,13
14735,242,"CĂMINUL CULTURAL BOȚEȘTI",BOŢEŞTI,AG,687,5,3,0,8,10,9,0,19,14,10,0,24,20,12,0,32,21,15,0,36
14735,243,"ŞCOALA PRIMARĂ MOŞTENI-GRECI",BOŢEŞTI,AG,248,2,1,0,3,5,1,0,6,5,3,0,8,7,5,0,12,7,7,0,14
13285,244,"CĂMINUL CULTURAL BRADU",BRADU,AG,954,3,2,0,5,14,2,0,16,24,2,0,26,41,5,0,46,47,6,0,53
13285,245,"ȘCOALA PRIMARĂ "" MIHAI EMINESCU""",BRADU,AG,809,17,4,0,21,24,4,0,28,34,7,0,41,43,7,0,50,44,7,0,51
13285,246,"GRĂDINIȚA "" SCUFIȚA ROȘIE """,BRADU,AG,1872,15,2,0,17,31,6,0,37,43,6,0,49,67,8,0,75,73,8,0,81
13294,247,"CLĂDIREA ADMINISTRATIVĂ C25 (FOSTA UNITATE MILITARĂ)",GEAMĂNA,AG,1028,7,0,0,7,20,2,0,22,25,6,0,31,33,7,0,40,39,7,0,46
13294,248,"GRĂDINIȚA DE LA ȘCOALA PRIMARĂ GEAMĂNA",GEAMĂNA,AG,2100,6,1,0,7,34,3,0,37,48,4,0,52,69,6,0,75,71,6,0,77
14762,249,"CĂMIN CULTURAL BRĂDULEŢ",BRĂDULEŢ,AG,454,1,1,0,2,8,1,0,9,12,1,0,13,15,2,0,17,15,2,0,17
14806,250,"CĂMINUL CULTURAL GALEŞU",GALEŞU,AG,758,4,0,0,4,10,1,0,11,17,1,0,18,19,27,0,46,21,27,0,48
14780,251,"ŞCOALA PRIMARĂ BRĂDETU",BRĂDETU,AG,296,5,4,0,9,8,16,0,24,9,32,0,41,11,35,0,46,15,38,0,53
14860,252,"ŞCOALA GENERALĂ BUDEASA MARE","BUDEASA MARE",AG,1069,5,5,0,10,8,7,0,15,11,8,0,19,15,9,0,24,20,16,0,36
14879,253,"ŞCOALA GENERALĂ BUDEASA MICĂ","BUDEASA MICĂ",AG,722,3,1,0,4,4,3,0,7,10,3,0,13,15,4,0,19,18,4,0,22
14897,254,"ŞCOALA GENERALĂ GĂLĂŞEŞTI",GĂLĂŞEŞTI,AG,800,5,1,0,6,6,3,0,9,7,3,0,10,9,3,0,12,10,3,0,13
14888,255,"ŞCOALA GENERALĂ CALOTEŞTI",CALOTEŞTI,AG,834,2,0,0,2,7,4,0,11,7,4,0,11,10,7,0,17,10,8,0,18
14931,256,"SCOALA GIMNAZIALA BUGHEA DE JOS","BUGHEA DE JOS",AG,1382,5,0,0,5,16,0,0,16,24,4,0,28,44,4,0,48,63,4,0,67
14931,257,"SCOALA PRIMARA MLACI","BUGHEA DE JOS",AG,560,1,0,0,1,3,1,0,4,5,6,0,11,9,8,0,17,10,8,0,18
14931,258,"SCOALA PRIMARA HULUBESTI","BUGHEA DE JOS",AG,465,4,4,0,8,9,4,0,13,12,4,0,16,13,4,0,17,13,5,0,18
13908,259,"ŞCOALA GIMNAZIALĂ NR. 1 BUGHEA DE SUS","BUGHEA DE SUS",AG,1674,8,1,0,9,17,7,0,24,20,8,0,28,26,8,0,34,30,8,0,38
13908,260,"GRĂDINIŢA GRUI","BUGHEA DE SUS",AG,706,3,0,0,3,8,0,0,8,16,0,0,16,23,0,0,23,23,0,0,23
15037,261,"ȘCOALA GIMNAZIALĂ ŞERBOENI",ŞERBOENI,AG,1205,3,2,0,5,9,3,0,12,14,3,0,17,20,6,0,26,25,7,0,32
15000,262,"GRĂDINIŢA CU PROGRAM NORMAL IONEŞTI",IONEŞTI,AG,621,3,0,0,3,10,3,0,13,13,3,0,16,18,3,1,22,18,3,1,22
15046,263,"ŞCOALA GIMNAZIALĂ TOMŞANCA",TOMŞANCA,AG,307,1,1,0,2,3,1,0,4,9,1,0,10,9,1,0,10,10,4,0,14
14959,264,"ŞCOALA GIMNAZIALĂ VULPEŞTI",VULPEŞTI,AG,840,2,1,0,3,4,1,0,5,5,1,0,6,7,2,0,9,9,2,0,11
14986,265,"ŞCOALA GIMNAZIALĂ CORNĂŢEL",CORNĂŢEL,AG,825,5,2,0,7,6,3,0,9,13,6,0,19,27,6,0,33,27,8,0,35
14977,266,"ȘCOALA GIMNAZIALĂ BUZOEŞTI",BUZOEŞTI,AG,907,1,1,0,2,4,1,0,5,7,3,0,10,11,4,0,15,12,5,0,17
15073,267,"ŞCOALA GIM.,,PROF.UNIV.DR.ION STOIA"" CĂLDĂRARU",CĂLDĂRARU,AG,734,6,2,0,8,8,3,0,11,10,3,0,13,17,4,0,21,17,4,0,21
15091,268,"ŞCOALAGEN CU CLS. I-VIII STRÎMBENI",STRÎMBENI,AG,710,13,5,0,18,18,5,0,23,19,7,0,26,24,8,0,32,25,8,0,33
15082,269,"ŞCOALA PRIMARĂ ,,ÎNV.CONSTANTIN MIHALCEA'' BURDEA",BURDEA,AG,486,2,0,0,2,2,0,0,2,6,1,0,7,7,1,0,8,10,1,0,11
15117,270,"SCOALA GENERALA VRANESTI",VRĂNEŞTI,AG,1604,5,1,0,6,12,1,0,13,23,1,0,24,29,4,0,33,35,4,0,39
15126,271,"SCOALA CALINESTI",CĂLINEŞTI,AG,1666,7,4,0,11,10,7,0,17,20,8,0,28,27,9,0,36,29,9,0,38
15144,272,"SCOALA CIRSTIENI",CÎRSTIENI,AG,1484,6,0,0,6,13,0,0,13,18,0,0,18,26,0,0,26,28,0,0,28
15135,273,"SCOALA CIOCANESTI",CIOCĂNEŞTI,AG,782,6,2,0,8,10,3,0,13,15,3,0,18,24,3,0,27,28,3,0,31
15153,274,"SCOALA GLODU",GLODU,AG,596,1,1,0,2,6,1,0,7,8,1,0,9,15,1,0,16,15,1,0,16
15162,275,"GRĂDINIŢA DRĂGHICEŞTI",GORGANU,AG,860,5,0,0,5,9,2,0,11,15,4,0,19,20,4,0,24,22,4,0,26
15171,276,"SCOALA RADU NEGRU","RADU NEGRU",AG,514,0,0,0,0,0,1,0,1,4,2,0,6,6,5,0,11,6,5,0,11
15206,277,"SCOALA RINCACIOV",URLUCEA,AG,559,3,1,0,4,3,1,0,4,6,1,0,7,11,3,0,14,13,3,0,16
15224,278,"SCOALA VALENI",VĂLENI-PODGORIA,AG,912,4,1,0,5,7,1,0,8,12,1,0,13,14,1,0,15,16,8,0,24
15242,279,"CĂMINUL CULTURAL CĂTEASCA",CĂTEASCA,AG,702,3,2,0,5,5,4,0,9,10,5,0,15,11,5,0,16,11,5,0,16
15304,280,"CĂMINUL CULTURAL SILIŞTEA",SILIŞTEA,AG,405,6,0,0,6,9,1,0,10,10,1,0,11,14,1,0,15,16,2,0,18
15288,281,"CĂMINUL CULTURAL GRUIU",GRUIU,AG,533,3,0,0,3,5,0,0,5,7,1,0,8,9,3,0,12,12,3,0,15
15260,282,"CĂMIN CULTURAL CIREŞU",CIREŞU,AG,583,5,2,0,7,8,2,0,10,16,3,0,19,20,3,0,23,21,5,0,26
15251,283,"CĂMINUL CULTURAL CĂTANELE",CATANELE,AG,794,5,2,0,7,19,4,0,23,30,4,0,34,42,7,0,49,45,7,0,52
15322,284,"CĂMINUL CULTURAL CEPARI","CEPARII PĂMÎNTENI",AG,706,10,3,0,13,15,4,0,19,22,4,0,26,22,5,0,27,22,5,0,27
15331,285,"ŞCOALA CĂRPENIŞ",CĂRPENIŞ,AG,588,4,3,0,7,5,5,0,10,9,5,0,14,9,5,0,14,13,6,0,19
15377,286,"ŞCOALA URLUIEŞTI",URLUIEŞTI,AG,231,6,0,0,6,10,0,0,10,12,0,0,12,13,0,0,13,13,0,0,13
15340,287,"ŞCOALA CEPARI - UNGURENI","CEPARII UNGURENI",AG,287,2,3,0,5,5,4,0,9,6,5,0,11,6,5,0,11,6,5,0,11
15411,288,"CĂMIN CULTURAL CETĂŢENI",CETĂŢENI,AG,909,4,0,0,4,7,2,0,9,14,4,0,18,20,4,0,24,26,4,0,30
15420,289,"GRĂDINIŢA LĂICĂI",LĂICĂI,AG,687,1,0,0,1,3,0,0,3,5,0,0,5,10,4,0,14,12,5,0,17
15439,290,"ŞCOALA I-IV VALEA CETĂŢUIA","VALEA CETĂŢUIA",AG,694,3,4,0,7,5,4,0,9,5,4,0,9,5,4,0,9,5,4,0,9
15457,291,"ŞCOALA GIMNAZIALĂ CICĂNEŞTI",CICĂNEŞTI,AG,1713,2,0,0,2,6,0,0,6,6,0,0,6,9,0,0,9,9,0,0,9
15509,292,"CĂMIN CULTURAL CIOFRÎNGENI",CIOFRÎNGENI,AG,1052,11,0,0,11,14,5,0,19,17,8,0,25,21,8,0,29,23,8,0,31
15527,293,"SCOALA CU CLASELE I-IVLACURILE",LACURILE,AG,533,4,2,0,6,6,2,0,8,6,2,0,8,7,2,0,9,9,4,0,13
15518,294,"CĂMIN CULTURAL BURLUŞI",BURLUŞI,AG,395,3,2,0,5,5,3,0,8,8,3,0,11,9,6,0,15,11,6,0,17
15581,295,"ȘCOALA GIMNAZIALĂ BRĂTIA",BRATIA,AG,347,5,2,0,7,5,2,0,7,8,2,0,10,8,2,0,10,8,2,0,10
15590,296,"ŞCOALA CU CLS. I-IV CIOMĂGEŞTI-SAT",CIOMĂGEŞTI,AG,346,2,1,0,3,4,2,0,6,4,2,0,6,6,6,0,12,6,6,0,12
15616,297,"GRĂDINIȚA DOGARI",DOGARI,AG,207,8,3,0,11,8,3,0,11,13,3,0,16,13,3,0,16,13,3,0,16
15689,298,"ŞCOALĂ GIMNAZIALĂ NR.1 COCU",COCU,AG,509,2,0,0,2,3,0,0,3,5,2,0,7,5,4,0,9,5,4,0,9
15698,299,"ŞCOALĂ PRIMARĂ CRUCIŞOARA",CRUCIŞOARA,AG,252,4,1,0,5,4,6,0,10,6,9,0,15,11,11,0,22,13,11,0,24
15661,300,"ŞCOALĂRICHIŢELE DE JOS","RĂCHIŢELE DE JOS",AG,310,5,1,0,6,6,1,0,7,9,3,0,12,13,4,0,17,14,4,0,18
15732,301,"ŞCOALĂ PRIMARĂ RICHIŢELE DE SUS","RĂCHIŢELE DE SUS",AG,318,0,0,0,0,2,2,0,4,6,4,0,10,8,4,0,12,8,4,0,12
15670,302,"ŞCOALĂ PRIMARĂ BĂRBĂTEŞTI",BĂRBĂTEŞTI,AG,477,1,6,0,7,2,6,0,8,4,6,0,10,8,7,0,15,8,7,0,15
15796,303,"ŞCOALA GIMNAZIALĂ PROF. DR. VASILE VASILESCU","OEŞTII UNGURENI",AG,843,1,0,0,1,7,1,0,8,7,3,0,10,9,4,0,13,9,4,0,13
15796,304,"ŞCOALA GIMNAZIALĂ PROF. DR. VASILE VASILESCU","OEŞTII UNGURENI",AG,1226,0,0,0,0,6,1,0,7,8,1,0,9,10,1,0,11,10,1,0,11
15750,305,"GRĂDINIŢA NR. 1 CORBENI",CORBENI,AG,637,0,0,0,0,0,1,0,1,0,1,0,1,2,1,0,3,3,1,0,4
15750,306,"ŞCOALA GIMNAZIALĂ NR. 1 CORBENI",CORBENI,AG,1349,2,3,0,5,10,4,0,14,13,4,0,17,17,5,0,22,25,7,0,32
15769,307,"ŞCOALA PRIMARĂ BERINDEŞTI",BERINDEŞTI,AG,604,3,1,0,4,3,3,0,6,4,3,0,7,6,4,0,10,6,4,0,10
15849,308,"CĂMIN CULTURAL CORBI",CORBI,AG,1689,17,3,0,20,24,4,0,28,28,9,0,37,33,11,0,44,40,11,0,51
15858,309,"CĂMIN CULTURAL CORBŞORI",CORBŞORI,AG,775,4,3,0,7,5,3,0,8,6,7,0,13,15,9,0,24,15,9,0,24
15894,310,"CĂMIN CULTURAL STĂNEŞTI",STĂNEŞTI,AG,941,7,1,0,8,10,1,0,11,11,1,0,12,16,2,0,18,21,3,0,24
15965,311,"ŞCOALA PETREŞTI",PETREŞTI,AG,717,2,0,0,2,6,0,0,6,11,0,0,11,13,2,0,15,14,2,0,16
15910,312,"CĂMIN CULTURAL COŞEŞTI",COŞEŞTI,AG,861,5,3,0,8,6,4,0,10,6,5,0,11,9,5,0,14,10,5,0,15
15947,313,"CĂMIN CULTURAL LEICEŞTI",LEICEŞTI,AG,1589,2,1,0,3,8,2,0,10,11,2,0,13,19,5,0,24,22,5,0,27
15929,314,"CĂMIN CULTURAL JUPÎNEŞTI",JUPÎNEŞTI,AG,889,2,2,0,4,5,3,0,8,9,4,0,13,11,6,0,17,13,7,0,20
15938,315,"CĂMINUL CULTURAL LĂPUŞANI",LĂPUŞANI,AG,312,1,3,0,4,1,4,0,5,4,4,0,8,4,4,0,8,4,4,0,8
15992,316,"CENTRU DE INFORMARE TURISTICĂ COTMEANA",COTMEANA,AG,806,5,12,0,17,8,16,0,24,11,18,0,29,16,18,0,34,16,18,0,34
16052,317,"ŞCOALA LINTEŞTI",LINTEŞTI,AG,348,0,0,0,0,3,2,0,5,8,3,0,11,11,4,0,15,11,4,0,15
16053,318,"CENTRULINGRIJIRE COPII",URSOAIA,AG,442,0,1,0,1,2,1,0,3,2,3,0,5,4,5,0,9,8,5,0,13
16141,319,"ŞCOALA GIMNAZIALĂ “MIRCEA GHIŢULESCU” CUCA",CUCA,AG,409,6,1,0,7,7,2,0,9,9,2,0,11,14,2,0,16,14,2,0,16
16258,320,"ŞCOALA PRIMARĂ LĂUNELE",TEODOREŞTI,AG,523,2,0,0,2,6,6,0,12,8,8,0,16,11,9,0,20,12,9,0,21
16212,321,"ŞCOALA PRIMARĂ MĂCĂI",MĂCĂI,AG,512,0,0,0,0,5,2,0,7,5,2,0,7,9,4,0,13,11,4,0,15
16178,322,"ŞCOALA PRIMARĂ CÎRCEŞTI",CÎRCEŞTI,AG,257,10,0,0,10,10,2,0,12,12,4,0,16,13,7,0,20,13,7,0,20
16294,323,"ŞCOALA DAVIDEŞTI",DAVIDEŞTI,AG,482,4,0,0,4,10,2,0,12,10,2,0,12,16,6,0,22,19,7,0,26
16310,324,"ŞCOALA VOROVENI",VOROVENI,AG,481,2,0,0,2,3,0,0,3,8,0,0,8,11,2,0,13,11,2,0,13
16301,325,"ŞCOALA CONŢEŞTI NR.1",CONŢEŞTI,AG,671,3,2,0,5,8,2,0,10,9,2,0,11,13,4,0,17,14,4,0,18
16301,326,"ŞCOALA OLTEANCA",CONŢEŞTI,AG,746,5,0,0,5,7,2,0,9,10,2,0,12,21,2,0,23,24,2,0,26
16356,327,"CĂMINUL CULTURAL PODU DÎMBOVIŢEI","PODU DÎMBOVIŢEI",AG,461,2,0,0,2,2,1,0,3,5,1,0,6,7,1,0,8,7,1,0,8
16338,328,"FOSTUL SEDIU AL PRIMĂRIEI DÎMBOVICIOARA",DÎMBOVICIOARA,AG,235,6,3,0,9,11,6,0,17,16,8,0,24,19,8,0,27,21,8,0,29
16347,329,"ŞCOALA CIOCANU",CIOCANU,AG,60,0,2,0,2,1,2,0,3,2,4,0,6,2,6,0,8,2,9,0,11
16392,330,"ŞCOALA PISCANI",PISCANI,AG,764,8,1,0,9,10,2,0,12,15,2,0,17,16,3,0,19,17,3,0,20
16374,331,"ŞCOALA DÎRMĂNEŞTI",DÎRMĂNEŞTI,AG,1051,2,0,0,2,7,0,0,7,11,4,0,15,12,4,0,16,12,4,0,16
16409,332,"ŞCOALA VALEA NANDRII","VALEA NANDRII",AG,586,2,2,0,4,7,2,0,9,8,4,0,12,9,7,0,16,9,8,0,17
16383,333,"CAMINUL CULTURAL NEGRENI",NEGRENI,AG,556,1,0,0,1,13,3,0,16,16,3,0,19,17,3,0,20,18,4,0,22
16436,334,"CĂMIN CULTURAL DOBREŞTI",DOBREŞTI,AG,759,3,1,0,4,7,2,0,9,11,7,0,18,24,16,0,40,24,16,0,40
16445,335,"ŞCOALA GEN. I-IV FUREŞTI",FUREŞTI,AG,709,4,0,0,4,6,1,0,7,7,4,0,11,8,5,0,13,8,5,0,13
16463,336,"CAMINUL CULTURAL""PETRE IONESCU MUSCEL""",DOMNEŞTI,AG,1275,14,0,0,14,28,1,0,29,40,1,0,41,55,5,0,60,57,5,0,62
16463,337,"CAMINUL CULTURAL ""PETRE IONESCU MUSCEL"" -",DOMNEŞTI,AG,1348,12,5,0,17,29,16,0,45,45,21,0,66,61,22,0,83,69,24,0,93
16481,338,"ŞCOALA GIMNAZIALĂ IOSIF CATRINESCU CLS. V-VIII",DRAGOSLAVELE,AG,665,2,7,0,9,3,9,0,12,3,10,0,13,5,10,0,15,8,10,0,18
16481,339,"ŞCOALAPRIMARĂ DRAGOSLAVELE",DRAGOSLAVELE,AG,916,6,0,0,6,18,2,0,20,23,2,0,25,26,2,0,28,27,3,0,30
16490,340,"ŞCOALA VALEA HOTARULUI","VALEA HOTARULUI",AG,507,1,6,0,7,3,6,0,9,4,7,0,11,13,7,0,20,16,7,0,23
16515,341,"CĂMIN CULTURAL DRĂGANU",DRĂGANU-OLTENI,AG,1703,0,3,0,3,7,3,0,10,10,4,0,14,12,4,0,16,12,4,0,16
16560,342,"ȘCOALA GODENI, NR.26",GODENI,AG,1056,11,2,0,13,23,6,0,29,35,7,0,42,42,8,0,50,44,10,0,54
16597,343,"ŞCOALA GIMNAZIALĂ COTEȘTI-GODENI, NR.198",COTEŞTI,AG,1464,6,0,0,6,12,2,0,14,20,2,0,22,26,2,0,28,31,3,0,34
16622,344,"CĂMINUL CULTURAL HÂRSEŞTI",HÎRSEŞTI,AG,1279,3,2,0,5,8,4,0,12,12,7,0,19,19,10,0,29,20,10,0,30
16640,345,ŞCOALAMARTALOGI,MARTALOGI,AG,592,5,3,0,8,5,4,0,9,6,4,0,10,7,4,0,11,8,4,0,12
16668,346,"CĂMIN CULTURAL HÎRTIEŞTI",HÂRTIEŞTI,AG,776,2,0,0,2,5,2,0,7,10,3,0,13,12,5,0,17,12,6,0,18
16686,347,"PRIMĂRIA VECHE HÎRTIEŞTI",DEALU,AG,299,2,0,0,2,2,0,0,2,2,0,0,2,3,0,0,3,3,1,0,4
16711,348,"ŞCOALA LUCIENI",LUCIENI,AG,278,1,0,0,1,1,0,0,1,1,0,0,1,4,2,0,6,4,2,0,6
16702,349,"CENTRUL DE ZI LESPEZI",LESPEZI,AG,369,2,4,0,6,3,4,0,7,6,4,0,10,8,4,0,12,12,4,0,16
16748,350,"ŞCOALA GIMNAZIALĂ ELENA DAVILA PERTICARI",IZVORU,AG,922,7,3,0,10,16,9,0,25,24,10,0,34,30,12,0,42,35,12,0,47
16748,351,"ŞCOALA GIMNAZIALĂ ELENA DAVILA PERTICARI",IZVORU,AG,920,9,0,0,9,14,0,0,14,17,0,0,17,20,0,0,20,22,0,0,22
16766,352,PRIMĂRIE,LEORDENI,AG,1416,7,2,0,9,19,12,0,31,26,15,0,41,32,15,0,47,41,15,0,56
16800,353,"CENTRUL CULTURAL MULTIFUNCȚIONAL BUDIŞTENI",BUDIŞTENI,AG,1066,2,3,0,5,5,3,0,8,13,4,0,17,17,5,0,22,17,5,0,22
16855,354,"ŞCOALA CU CLASELE I-VIII GLÎMBOCATA",GLÎMBOCATA,AG,908,4,4,0,8,6,4,0,10,11,4,0,15,13,4,0,17,15,4,0,19
16828,355,"ŞCOALA CIULNIŢA",CIULNIŢA,AG,929,5,1,0,6,13,1,0,14,13,2,0,15,17,4,0,21,18,6,0,24
16846,356,"ŞCOALA COTU MALULUI","COTU MALULUI",AG,346,2,4,0,6,3,4,0,7,7,4,0,11,19,4,0,23,29,4,0,33
16917,357,"ȘCOALA GIMNAZIALĂ NR.1 LEREȘTI, SAT LEREȘTI",LEREŞTI,AG,1390,12,0,0,12,26,1,0,27,41,2,0,43,67,2,0,69,74,3,0,77
16935,358,"ȘCOALA GIMNAZIALĂ NR.1 LEREȘTI, SAT VOINEȘTI",VOINEŞTI,AG,1370,12,2,0,14,37,11,0,48,56,23,0,79,71,33,0,104,77,34,0,111
16917,359,"CĂMIN CULTURAL LEREȘTI",LEREŞTI,AG,1122,6,4,0,10,20,9,0,29,25,15,0,40,32,16,0,48,33,16,0,49
16953,360,"ŞCOALA GIMNAZIALĂ ""GENERAL CONSTANTIN CRISTESCU"" LUNCA CORBULUI","LUNCA CORBULUI",AG,829,5,1,0,6,10,4,0,14,14,6,0,20,18,9,0,27,18,9,0,27
16953,361,"ŞCOALA SILIŞTENI","LUNCA CORBULUI",AG,222,4,4,0,8,7,5,0,12,9,6,0,15,13,6,0,19,13,7,0,20
16953,362,"ŞCOALA PĂDUREŢI","LUNCA CORBULUI",AG,854,1,1,0,2,4,2,0,6,11,3,0,14,19,11,0,30,21,12,0,33
16953,363,"ŞCOALA MÎRGHIA DE SUS","LUNCA CORBULUI",AG,338,2,1,0,3,4,3,0,7,6,4,0,10,6,4,0,10,6,8,0,14
17058,364,"ŞCOALA MĂLURENI",MĂLURENI,AG,536,8,0,0,8,10,0,0,10,14,1,0,15,17,3,0,20,19,5,0,24
17058,365,"CĂMIN CULTURAL BĂDICENI",MĂLURENI,AG,411,1,2,0,3,5,3,0,8,7,3,0,10,9,3,0,12,11,3,0,14
17085,366,ŞCOALABOHARI,TOPLIŢA,AG,314,1,4,0,5,1,6,0,7,2,6,0,8,6,6,0,12,8,6,0,14
17085,367,"ŞCOALA TOPLIŢA",TOPLIŢA,AG,329,3,2,0,5,4,2,0,6,6,3,0,9,13,3,0,16,13,3,0,16
17094,368,ŞCOALAZĂRNEŞTI,ZĂRNEŞTI,AG,787,8,0,0,8,12,4,0,16,16,4,0,20,21,6,0,27,23,6,0,29
17067,369,"ŞCOALA BUNEŞTI",BUNEŞTI,AG,556,0,0,0,0,2,2,0,4,2,4,0,6,6,4,0,10,7,7,0,14
17076,370,"TABĂRA PĂULEASCA",PĂULEASCA,AG,636,0,0,0,0,2,0,0,2,2,0,0,2,7,3,0,10,7,3,0,10
13374,371,"ŞCOALA GENERALĂ NR.1",MĂRĂCINENI,AG,1200,22,2,0,24,42,5,0,47,58,6,0,64,73,9,0,82,86,9,0,95
13374,372,"ŞCOALA GENERALĂ NR.1",MĂRĂCINENI,AG,1508,15,4,0,19,40,13,0,53,57,25,0,82,78,30,0,108,88,34,0,122
13383,373,"ŞCOALA GENERALĂ ARGEŞELU",ARGEŞELU,AG,1699,5,14,0,19,28,21,0,49,49,28,0,77,70,35,0,105,74,38,0,112
17165,374,"ŞCOALA PRIMARĂ DOBROGOSTEA",DOBROGOSTEA,AG,1026,5,0,0,5,8,0,0,8,9,1,0,10,13,1,0,14,14,1,0,15
17129,375,"ȘCOALA GENERALĂ BORLEȘTI",BORLEŞTI,AG,475,7,3,0,10,7,3,0,10,10,5,0,15,12,7,0,19,12,8,0,20
17110,376,"CĂMINUL CULTURAL MERIŞANI",MERIŞANI,AG,676,13,0,0,13,17,2,0,19,21,3,0,24,25,3,0,28,26,3,0,29
17174,377,"ŞCOALA PRIMARĂ MALU VÂNĂT","MALU VÎNĂT",AG,637,3,1,0,4,12,5,0,17,31,5,0,36,50,5,0,55,64,7,0,71
17192,378,"CĂMINUL CULTURAL VÎLCELELE",VÎLCELELE,AG,758,5,0,0,5,5,1,0,6,6,5,0,11,7,8,0,15,9,13,0,22
17218,379,"ŞCOALA GIMNAZIALA NR.1 MICEŞTI",MICEŞTI,AG,1445,12,2,0,14,16,7,0,23,26,7,0,33,51,7,0,58,61,11,0,72
17245,380,"CĂMIN CULTURAL PURCĂRENI",PURCĂRENI,AG,1401,3,2,0,5,9,2,0,11,16,2,0,18,27,2,0,29,32,2,0,34
17236,381,"ŞCOALA PRIMARA NR.2 PĂULEASCA",PĂULEASCA,AG,782,2,0,0,2,10,0,0,10,18,0,0,18,25,1,0,26,30,2,0,32
17263,382,"CĂMINUL CULTURAL MIHĂEȘTI",MIHĂEŞTI,AG,2008,8,3,0,11,12,4,0,16,21,4,0,25,32,4,0,36,34,7,0,41
17316,383,"ȘCOALAGENERALĂ VALEA POPII","VALEA POPII",AG,787,7,5,0,12,15,5,0,20,20,6,0,26,32,8,0,40,32,8,0,40
17272,384,"ȘCOALA GENERALĂ DRĂGHICI",DRĂGHICI,AG,893,5,2,0,7,7,2,0,9,12,2,0,14,16,4,0,20,18,4,0,22
17325,385,"ȘCOALA GENERALĂ VĂCAREA",VĂCAREA,AG,466,4,1,0,5,6,1,0,7,9,3,0,12,17,3,0,20,20,3,0,23
17281,386,"ȘCOALA CU CLASELE I-IV FURNICOSI",FURNICOŞI,AG,728,5,2,0,7,5,2,0,7,7,2,0,9,10,2,0,12,14,2,0,16
17343,387,"CĂMIN CULTURAL MĂŢĂU",MĂŢĂU,AG,1002,5,0,0,5,9,0,0,9,12,2,0,14,12,3,0,15,13,5,0,18
17389,388,"ŞCOALA PRIMARĂ I-IV SUSLĂNEŞTI",SUSLĂNEŞTI,AG,337,3,3,0,6,8,5,0,13,8,6,0,14,13,8,0,21,16,9,0,25
17405,389,"CĂMIN CULTURAL MIROŞI",MIROŞI,AG,1204,12,0,0,12,25,1,0,26,35,1,0,36,40,2,0,42,42,4,0,46
17414,390,"ŞCOALA SURDULEŞTI",SURDULEŞTI,AG,748,4,2,0,6,6,4,0,10,11,6,0,17,17,8,0,25,22,10,0,32
17432,391,"ŞCOALA GENERALĂ CU CLASELE I-VIII MORĂREŞTI",MORĂREŞTI,AG,904,1,0,0,1,13,2,0,15,21,3,0,24,30,5,0,35,30,7,0,37
17441,392,"ŞCOALA CU CLASELE I-IV DEDULEŞTI",DEDULEŞTI,AG,613,3,0,0,3,7,2,0,9,10,4,0,14,13,4,0,17,19,5,0,24
17502,393,"CĂMIN CULTURAL MOŞOAIA",MOŞOAIA,AG,1435,2,0,0,2,13,1,0,14,32,1,0,33,39,1,0,40,39,1,0,40
17548,394,"ŞCOALA CU CLASELE I-VIII HINŢEŞTI",HINŢEŞTI,AG,972,4,2,0,6,6,2,0,8,11,2,0,13,15,2,0,17,16,2,0,18
17566,395,"ŞCOALA CU CLASELE I-IV SMEURA",SMEURA,AG,1282,4,0,0,4,6,0,0,6,18,0,0,18,24,2,0,26,27,2,0,29
17520,396,"ŞCOALA CU CLASELE I-IV CIOCĂNĂI",CIOCĂNĂI,AG,543,0,0,0,0,0,0,0,0,3,0,0,3,4,0,0,4,4,1,0,5
17566,397,"SOCIETATEA COMERCIALĂ BUILDING ASTROM SOCIETATE CU RĂSPUNDERE LIMITATĂ",SMEURA,AG,861,3,0,0,3,8,1,0,9,27,4,0,31,45,6,0,51,51,9,0,60
17584,398,"LICEUL TEHNOLOGIC LIVIU REBREANU MOZĂCENI",MOZĂCENI,AG,1234,13,2,0,15,20,5,0,25,28,6,0,34,36,7,0,43,41,7,0,48
17584,399,"ŞCOALA GENERALĂ MIŞEI",MOZĂCENI,AG,507,1,0,0,1,4,2,0,6,4,6,0,10,5,9,0,14,5,9,0,14
17655,400,"CĂMIN CULTURAL CONSTANTIN DOBRESCU ARGEȘ - ROBAIA",MUSĂŢEŞTI,AG,1190,1,0,0,1,12,1,0,13,16,1,0,17,32,5,0,37,36,5,0,41
17628,401,"SEDIUL PRIMĂRIEI VECHI - VILSĂNEȘTI",VÎLSĂNEŞTI,AG,460,2,4,0,6,4,6,0,10,8,7,0,15,9,8,0,17,9,11,0,20
17646,402,"ŞCOALA GENERALĂ COSTEŞTI - VÎLSAN",COSTEŞTI-VÎSLAN,AG,559,0,0,0,0,1,0,0,1,1,1,0,2,2,1,0,3,2,3,0,5
17682,403,"ŞCOALA GENERALĂ STROEŞTI",STROEŞTI,AG,868,8,0,0,8,14,1,0,15,14,3,0,17,22,3,0,25,23,3,0,26
17735,404,"ŞCOALA NEGRAŞI",NEGRAŞI,AG,618,5,0,0,5,5,2,0,7,6,2,0,8,8,4,0,12,8,4,0,12
17744,405,"GRĂDINIŢA BÎRLOGU",BÎRLOGU,AG,662,3,2,0,5,8,4,0,12,15,7,0,22,19,11,0,30,19,12,0,31
17762,406,"ŞCOALA MOZACU",MOZACU,AG,250,3,1,0,4,5,2,0,7,7,3,0,10,9,5,0,14,12,6,0,18
17753,407,"ŞCOALA BUTA",BUTA,AG,154,3,0,0,3,6,5,0,11,10,6,0,16,12,6,0,18,15,6,0,21
17780,408,"CĂMIN CULTURAL NUCŞOARA",NUCŞOARA,AG,382,4,1,0,5,6,1,0,7,8,3,0,11,11,5,0,16,13,5,0,18
17806,409,"CĂMIN CULTURAL SBOGHIŢEŞTI",SBOGHIŢEŞTI,AG,348,0,0,0,0,2,3,0,5,7,3,0,10,9,3,0,12,12,3,0,15
17815,410,"CĂMIN CULTURAL SLATINA",SLATINA,AG,427,7,5,0,12,12,7,0,19,18,7,0,25,31,7,0,38,37,7,0,44
17833,411,"ȘCOALA GIMNAZIALĂ ”D. RĂDULESCU” OARJA",OARJA,AG,1447,14,2,0,16,26,3,0,29,43,3,0,46,66,7,0,73,71,7,0,78
17833,412,"ŞCOALA PRIMARĂ OARJA SAT",OARJA,AG,795,9,2,0,11,13,2,0,15,20,3,0,23,35,4,0,39,38,8,0,46
17860,413,"SALA DE SPORT PIETROŞANI",PIETROŞANI,AG,1447,6,0,0,6,14,1,0,15,16,2,0,18,16,3,0,19,19,4,0,23
17879,414,"CĂMIN CULTURAL BĂDEŞTI",BĂDEŞTI,AG,1272,6,0,0,6,15,1,0,16,25,1,0,26,32,5,0,37,37,5,0,42
17897,415,"ŞCOALA GENERALĂ CU CLASELE I-IV RETEVOIEŞTI",RETEVOIEŞTI,AG,1386,3,1,0,4,5,2,0,7,10,2,0,12,19,3,0,22,19,3,0,22
17888,416,"ŞCOALAGENERALĂ CU CLASELE I-IV GĂNEŞTI",GĂNEŞTI,AG,540,3,2,0,5,4,5,0,9,5,5,0,10,9,6,0,15,9,6,0,15
18037,417,"ŞCOALA CU CLASELE I-VIII POIANA LACULUI","POIANA LACULUI",AG,1506,3,1,0,4,8,2,0,10,21,2,0,23,34,8,0,42,37,11,0,48
18082,418,"ŞCOALA CU CLASELEI-IV DINCULEŞTI",DINCULEŞTI,AG,283,3,4,0,7,4,5,0,9,14,5,0,19,23,7,0,30,24,7,0,31
18046,419,"ŞCOALA CU CLASELE I-IV CĂTUNAŞI",CĂTUNAŞI,AG,397,1,0,0,1,1,0,0,1,5,1,0,6,10,1,0,11,13,4,0,17
18153,420,"ŞCOALA CU CLASELE I-VIII SĂMARA",SĂMARA,AG,766,0,0,0,0,3,0,0,3,5,0,0,5,9,0,0,9,10,0,0,10
18126,421,"ŞCOALA CU CLASELE I-IV METOFU",METOFU,AG,283,0,0,0,0,1,2,0,3,2,3,0,5,2,3,0,5,2,3,0,5
18073,422,"ŞCOALA CU CLASELE I-IV DEALUL VIILOR","DEALU VIILOR",AG,304,0,2,0,2,4,3,0,7,5,3,0,8,8,5,0,13,8,5,0,13
18135,423,"GRĂDINIŢA PĂDUROIUDIN DEAL","PĂDUROIU DIN DEAL",AG,737,0,0,0,0,3,1,0,4,3,1,0,4,14,1,0,15,19,2,0,21
18144,424,"GRĂDINIŢA PĂDUROIUDIN VALE","PĂDUROIU DIN VALE",AG,639,4,0,0,4,4,0,0,4,4,1,0,5,4,3,0,7,9,3,0,12
18108,425,"ŞCOALA CU CLASELE I-IV GĂRDINEŞTI",GĂRDINEŞTI,AG,378,2,0,0,2,3,0,0,3,4,3,0,7,6,3,0,9,7,3,0,10
17922,426,"CĂMIN CULTURAL POIENARI",POIENARI,AG,651,3,0,0,3,5,1,0,6,7,1,0,8,9,2,0,11,9,2,0,11
17940,427,"ŞCOALA GENERALĂ I-IV IOANICEŞTI",IOANICEŞTI,AG,191,1,0,0,1,2,2,0,4,3,2,0,5,3,5,0,8,3,5,0,8
17977,428,"ŞCOALA GIMNAZIALA NR.1 POIENARII DE MUSCEL",POIENARI,AG,1217,0,2,0,2,3,3,0,6,9,3,0,12,15,8,0,23,18,8,0,26
17995,429,"ŞCOALA PRIMARĂ NR.1JUGUR",JUGUR,AG,916,4,0,0,4,5,1,0,6,6,2,0,8,8,3,0,11,10,3,0,13
17986,430,"GRĂDINIŢA CU PROGRAM NORMAL NR.2 GROŞANI",GROŞANI,AG,624,5,1,0,6,10,2,0,12,10,2,0,12,20,2,0,22,25,2,0,27
18171,431,"ŞCOALA POPEŞTI",POPEŞTI,AG,511,2,0,0,2,11,4,0,15,19,5,0,24,24,6,0,30,24,9,0,33
18233,432,"ŞCOALA SLOBOZIA",SLOBOZIA,AG,562,7,1,0,8,9,2,0,11,9,3,0,12,40,5,0,45,67,5,0,72
18215,433,"ŞCOALA PURCĂRENI",PURCĂRENI,AG,572,10,0,0,10,13,0,0,13,26,0,0,26,45,0,0,45,50,3,0,53
18251,434,"ȘCOALA GIMNAZIALĂ ""C. RĂDULESCU CODIN""",PRIBOIENI,AG,1436,3,1,0,4,15,1,0,16,19,3,0,22,26,6,0,32,29,6,0,35
18251,435,"CLUBUL TINERETULUI PRIBOIENI",PRIBOIENI,AG,1555,20,0,0,20,36,1,0,37,44,3,0,47,57,3,0,60,60,4,0,64
18402,436,"CĂMINUL CULTURAL TIGVENI",TIGVENI,AG,659,2,0,0,2,5,0,0,5,7,2,0,9,8,4,0,12,8,5,0,13
18368,437,"ŞCOALA CU CLASELEI-IV FURDUEŞTI",FURDUEŞTI,AG,436,2,2,0,4,8,2,0,10,14,3,0,17,17,3,0,20,17,3,0,20
18386,438,"ŞCOALA CU CLASELEI-IV NEJLOVELU",NEJLOVELU,AG,408,1,1,0,2,3,1,0,4,8,3,0,11,12,4,0,16,13,4,0,17
18395,439,"ŞCOALA CU CLASELEI-IV PĂTULENI",PĂTULENI,AG,756,1,1,0,2,4,1,0,5,12,1,0,13,20,3,0,23,22,3,0,25
18377,440,"ŞCOALA CU CLASELEI-IV MAVRODOLU",MAVRODOLU,AG,136,0,1,0,1,5,1,0,6,9,2,0,11,10,5,0,15,11,5,0,16
18224,441,"CAMINUL CULTURAL RÂCA",RÂCA,AG,862,14,4,0,18,49,11,0,60,90,17,0,107,122,21,0,143,135,21,0,156
18420,442,"ŞCOALA GENERALA NR. 1 RECEA",RECEA,AG,1464,6,2,0,8,23,3,0,26,28,4,0,32,39,5,0,44,43,6,0,49
18439,443,"ŞCOALA CU CLASELE I-VIII DEAGURILE","DEAGU DE JOS",AG,785,4,5,0,9,9,5,0,14,12,5,0,17,15,6,0,21,18,8,0,26
18484,444,"GRĂDINIŢA CU PROGRAM NORMAL ""MARIN ANGELESCU"", ROCIU",ROCIU,AG,376,2,3,0,5,4,5,0,9,8,6,0,14,22,6,0,28,23,7,0,30
18493,445,"GRĂDINIŢA CU PROGRAM NORMAL ""THEODOR ANGHEL"", GLIGANU DE JOS","GLIGANU DE JOS",AG,351,8,0,0,8,12,1,0,13,14,1,0,15,18,4,0,22,20,5,0,25
18509,446,"ŞCOALA PRIMARĂ ""ION BĂLTEANU"", GLIGANU DE SUS","GLIGANU DE SUS",AG,549,10,1,0,11,15,8,0,23,20,8,0,28,25,10,0,35,26,10,0,36
18518,447,"ŞCOALA GIMNAZIALĂ""GHEORGHE MOCANU"" PRIMAR, GIMNAZIAL, ŞERBĂNEŞTI",ŞERBĂNEŞTI,AG,798,12,0,0,12,19,4,0,23,21,5,0,26,26,9,0,35,30,9,0,39
18536,448,"LICEUL TEHNOLOGIC "" VICTOR SLĂVESCU"" - SALA DE SPORT",RUCĂR,AG,1286,10,0,0,10,28,2,0,30,41,3,0,44,57,6,0,63,60,7,0,67
18536,449,"ŞCOALA GENERALĂ NR.2 - CLASA NR. 1",RUCĂR,AG,1052,4,0,0,4,10,3,0,13,20,3,0,23,22,5,0,27,24,5,0,29
18536,450,"ŞCOALA GIMNAZIALĂ ""NAE A GHICA"" -SALA DE SPORT",RUCĂR,AG,1017,5,0,0,5,20,7,0,27,25,8,0,33,41,12,0,53,47,12,0,59
18545,451,ŞCOALASĂTIC,SĂTIC,AG,99,1,7,0,8,1,11,0,12,5,13,0,18,5,13,0,18,7,13,0,20
18536,452,"ȘCOALA GIMNAZIALĂ ”NAE A. GHICA” - SALA CLASĂ PREGĂTITOARE",RUCĂR,AG,1477,8,2,0,10,21,6,0,27,37,8,0,45,61,9,0,70,66,9,0,75
18563,453,"CĂMINUL CULTURAL SĂLĂTRUCU CENTRU",SĂLĂTRUCU,AG,1223,11,3,0,14,13,7,0,20,19,7,0,26,19,7,0,26,23,7,0,30
18572,454,"ŞCOALA CU CLASELEI-IV VĂLENI",VĂLENI,AG,546,1,0,0,1,12,1,0,13,16,5,0,21,16,5,0,21,19,5,0,24
18616,455,"ŞCOALA GENERALĂ DEALU BRADULUI","DEALU BRADULUI",AG,159,1,0,0,1,5,2,0,7,8,5,0,13,16,5,0,21,21,5,0,26
18652,456,"CĂMIN CULTURAL POPEŞTI",POPEŞTI,AG,663,1,7,0,8,5,13,0,18,10,13,0,23,18,19,0,37,25,21,0,46
18607,457,"ŞCOALA GIMNAZIALĂ DUMITRU UDRESCU SĂPATA",BĂNĂREŞTI,AG,325,3,4,0,7,3,5,0,8,6,5,0,11,6,6,0,12,19,9,0,28
18590,458,"IMOBIL PROPRIETATE MIU COSMIN",MÎRŢEŞTI,AG,215,1,2,0,3,5,4,0,9,7,4,0,11,11,6,0,17,14,8,0,22
18714,459,"ŞCOALA CU CLASELE V-VIII LĂZĂREŞTI",LĂZĂREŞTI,AG,1069,6,0,0,6,13,2,0,15,22,4,0,26,27,4,0,31,30,6,0,36
18689,460,"CĂMIN CULTURAL SCHITU GOLEŞTI","SCHITU GOLEŞTI",AG,1244,8,2,0,10,14,2,0,16,24,2,0,26,33,2,0,35,40,3,0,43
18714,461,"CĂMIN CULTURAL LĂZĂREŞTI",LĂZĂREŞTI,AG,1783,15,1,0,16,19,2,0,21,27,3,0,30,29,5,0,34,46,5,0,51
18750,462,"ŞCOALA GEN.NR.2 CLASELE I-IV",SLOBOZIA,AG,1905,6,0,0,6,9,2,0,11,17,6,0,23,25,7,0,32,27,7,0,34
18769,463,"ŞCOALA NIGRIŞOARA",NIGRIŞOARA,AG,248,1,2,0,3,6,4,0,10,10,5,0,15,13,6,0,19,13,6,0,19
18750,464,"ȘOALA GENERALĂ DIN CENTRUL COMUNEI",SLOBOZIA,AG,1694,3,0,0,3,7,1,0,8,13,1,0,14,16,1,0,17,16,1,0,17
18787,465,"GRĂDINIŢA CU PROGRAM PRELUNGIT STÎLPENI",STÎLPENI,AG,1588,9,1,0,10,23,7,0,30,38,9,0,47,48,11,0,59,62,12,0,74
18803,466,"CAMINUL CULTURAL LIVEZENI",LIVEZENI,AG,1206,5,0,0,5,12,0,0,12,20,1,0,21,28,6,0,34,33,7,0,40
18849,467,"CAMINUL CULTURAL RĂDEŞTI",RĂDEŞTI,AG,1398,8,1,0,9,23,8,0,31,25,9,0,34,35,14,0,49,39,15,0,54
18867,468,"CĂMIN CULTURAL STOENEŞTI",STOENEŞTI,AG,1083,2,0,0,2,6,1,0,7,7,1,0,8,8,7,0,15,12,11,0,23
18876,469,"CĂMIN CULTURAL BĂDENI",BĂDENI,AG,1465,4,1,0,5,11,1,0,12,17,1,0,18,20,4,0,24,33,6,0,39
18901,470,"CĂMIN CULTURAL PIATRA",PIATRA,AG,409,4,0,0,4,9,3,0,12,12,3,0,15,12,5,0,17,13,5,0,18
18929,471,"ŞCOALA GEN. VALEA BĂDENILOR","VALEA BĂDENILOR",AG,616,1,0,0,1,4,0,0,4,10,0,0,10,10,0,0,10,10,0,0,10
18947,472,"GRĂDINIȚA CU PROGRAM NORMAL STOLNICI",STOLNICI,AG,1511,3,1,0,4,11,11,0,22,22,16,0,38,39,19,0,58,43,23,0,66
18974,473,"CĂMINUL CULTURAL FÎLFANI",FÎLFANI,AG,1030,5,0,0,5,12,3,0,15,18,9,0,27,25,15,0,40,28,17,0,45
19034,474,"ŞCOALA PRIMARĂ IOAN RIZESCU",CERŞANI,AG,624,2,0,0,2,7,0,0,7,9,2,0,11,11,2,0,13,13,2,0,15
19016,475,"PRIMĂRIA COMUNEI SUSENI",SUSENI,AG,897,1,2,0,3,2,2,0,4,4,4,0,8,9,11,0,20,9,11,0,20
19105,476,"ŞCOALA PRIMARĂ GHEOGHE TOMA",ŢUŢULEŞTI,AG,1044,5,2,0,7,6,2,0,8,9,4,0,13,12,5,0,17,12,7,0,19
19123,477,"ŞCOALA CU CLASELE I-VIIIŞTEFAN CEL MARE","ŞTEFAN CEL MARE",AG,703,1,4,0,5,3,6,0,9,6,6,0,12,8,6,0,14,9,6,0,15
19123,478,"ŞCOALA CU CLASELE I-VIIIŞTEFAN CEL MARE","ŞTEFAN CEL MARE",AG,841,4,0,0,4,5,0,0,5,13,0,0,13,17,0,0,17,22,0,0,22
19132,479,"ŞCOALA GLAVACIOC",GLAVACIOC,AG,364,2,1,0,3,4,3,0,7,5,3,0,8,8,3,0,11,8,3,0,11
19150,480,"CĂMIN CULTURAL ŞUICI",ŞUICI,AG,1015,2,0,0,2,3,0,0,3,4,0,0,4,4,0,0,4,4,0,0,4
19196,481,"ŞCOALA PRIMARĂ RUDENI",RUDENI,AG,698,2,1,0,3,6,2,0,8,8,2,0,10,8,2,0,10,8,2,0,10
19169,482,"ŞCOALA IANCULEŞTI",IANCULEŞTI,AG,227,0,0,0,0,2,3,0,5,4,3,0,7,5,3,0,8,5,3,0,8
19203,483,"ŞCOALA PRIMARĂ VALEA CALULUI","VALEA CALULUI",AG,79,1,1,0,2,3,1,0,4,3,1,0,4,3,1,0,4,4,1,0,5
19221,484,"CĂMIN CULTURAL TEIU",TEIU,AG,957,11,3,0,14,15,3,0,18,37,6,0,43,50,10,0,60,52,10,0,62
19230,485,"ŞCOALA GENERALĂ LEŞILE",LEŞILE,AG,155,2,0,0,2,2,3,0,5,3,3,0,6,5,3,0,8,5,3,0,8
19258,486,"PRIMĂRIA TIGVENI",TIGVENI,AG,1507,8,2,0,10,31,12,0,43,38,12,0,50,54,12,0,66,54,12,0,66
19294,487,"ȘCOALA CU CLASELE I-IV BÎRSEȘTII DE JOS","BÎRSEŞTII DE JOS",AG,1024,8,1,0,9,11,1,0,12,15,2,0,17,18,2,0,20,21,2,0,23
19329,488,"ŞCOALA CU CLASELE I-IV VLĂDEŞTI",VLĂDEŞTI,AG,207,0,0,0,0,2,0,0,2,2,0,0,2,2,0,0,2,3,0,0,3
19356,489,"PRIMĂRIA COMUNEI ȚIȚEȘTI",BUCŞENEŞTI-LOTAŞI,AG,1249,5,1,0,6,9,2,0,11,13,2,0,15,13,2,0,15,13,2,0,15
19383,490,"ȘCOALA CU CLASELE I-IV VALEA STÂNII","VALEA STÎNII",AG,854,6,2,0,8,11,2,0,13,20,2,0,22,27,4,0,31,28,4,0,32
19347,491,"ȘCOALA CU CLASELE I-IV ȚIȚEȘTI",ŢIŢEŞTI,AG,1002,5,0,0,5,12,0,0,12,12,0,0,12,18,0,0,18,20,0,0,20
19374,492,"ȘCOALA CU CLASELE I-IV VALEA MĂNĂSTIRII","VALEA MĂNĂSTIRII",AG,780,2,0,0,2,3,1,0,4,6,2,0,8,7,2,0,9,7,3,0,10
19409,493,"ŞCOALA I-VIII UDA",UDA,AG,542,4,1,0,5,5,2,0,7,6,2,0,8,9,2,0,11,12,3,0,15
19454,494,"ŞCOALA COTU",COTU,AG,211,3,1,0,4,6,1,0,7,6,3,0,9,10,5,0,15,10,5,0,15
19551,495,"ŞCOALA I - IV SĂLIŞTEA",SĂLIŞTEA,AG,467,4,0,0,4,4,3,0,7,7,4,0,11,12,4,0,16,14,7,0,21
19533,496,"CĂMIN CULTURAL GOVORA",RÎJLEŢU-GOVORA,AG,401,3,2,0,5,6,5,0,11,8,5,0,13,9,6,0,15,11,6,0,17
19579,497,"ŞCOALA CU CLASELE I-VIII UNGHENI",UNGHENI,AG,607,9,3,0,12,13,3,0,16,24,5,0,29,32,5,0,37,35,6,0,41
19588,498,"ŞCOALA COLŢU",COLŢU,AG,599,6,3,0,9,27,9,0,36,48,12,0,60,60,16,0,76,65,16,0,81
19613,499,"SOCIETATEA AGRICOLA ALBINA",HUMELE,AG,1105,2,3,0,5,10,6,0,16,17,8,0,25,27,8,0,35,34,9,0,43
19640,500,"CĂMINUL CULTURAL VALEA DANULUI","VALEA DANULUI",AG,1669,8,0,0,8,11,0,0,11,17,0,0,17,24,0,0,24,26,0,0,26
19686,501,"CĂMINUL CULTURAL VERNEŞTI",VERNEŞTI,AG,884,2,0,0,2,2,0,0,2,3,2,0,5,3,2,0,5,5,4,0,9
19702,502,"ŞCOALA GIMNAZIALĂ VALEA IAŞULUI","VALEA IAŞULUI",AG,849,0,1,0,1,6,4,0,10,8,5,0,13,9,62,0,71,11,62,0,73
19739,503,"GRĂDINIŢA BOROVINEŞTI",BOROVINEŞTI,AG,188,2,0,0,2,3,2,0,5,3,5,0,8,4,6,0,10,6,7,0,13
19757,504,"ŞCOALA PRIMARĂ MUSTĂTEŞTI",MUSTĂŢEŞTI,AG,1049,4,0,0,4,10,1,0,11,16,1,0,17,21,1,0,22,21,1,0,22
19748,505,"GRĂDINIŢA CERBURENI",CERBURENI,AG,313,2,0,0,2,4,1,0,5,5,1,0,6,8,1,0,9,14,1,0,15
13533,506,"CĂMIN CULTURAL VALEA MARE PRAVĂŢ","VALEA MARE PRAVĂŢ",AG,1216,7,0,0,7,18,1,0,19,32,2,0,34,33,4,0,37,39,5,0,44
13588,507,"CĂMIN CULTURAL NĂMĂEŞTI",NĂMĂEŞTI,AG,509,3,3,0,6,12,17,0,29,14,20,0,34,28,22,0,50,28,22,0,50
13542,508,"ŞCOALA BILCEŞTI",BILCEŞTI,AG,721,0,0,0,0,4,1,0,5,4,1,0,5,6,3,0,9,6,6,0,12
13579,509,"ŞCOALA GURA PRAVĂŢ","GURA PRAVĂŢ",AG,883,1,0,0,1,4,0,0,4,6,3,0,9,8,3,0,11,8,3,0,11
19800,510,"LICEUL TEHNOLOGIC VEDEA",VEDEA,AG,755,4,3,0,7,6,3,0,9,6,3,0,9,10,60,48,118,16,9,48,73
19962,511,"ŞCOALA VAŢA",VAŢA,AG,534,4,6,0,10,9,8,0,17,13,8,0,21,13,13,0,26,13,13,0,26
19944,512,"ŞCOALA PRODANI",PRODANI,AG,600,4,1,0,5,5,1,0,6,10,3,0,13,10,3,0,13,11,3,0,14
19882,513,"ŞCOALA FATA",FATA,AG,458,5,1,0,6,6,1,0,7,9,1,0,10,15,3,0,18,16,3,0,19
19917,514,"ŞCOALA IZVORU DE SUS","IZVORU DE SUS",AG,287,1,6,0,7,1,6,0,7,4,6,0,10,4,9,0,13,6,9,0,15
19891,515,"ŞCOALA FRĂTICI",FRĂTICI,AG,349,2,0,0,2,3,0,0,3,8,0,0,8,8,2,0,10,9,2,0,11
20000,516,"GRĂDINIŢA NR. 3",VLĂDEŞTI,AG,1670,6,0,0,6,15,3,0,18,25,3,0,28,41,3,0,44,45,4,0,49
20000,517,"ŞCOALAPRIMARĂNR. 2",VLĂDEŞTI,AG,867,1,0,0,1,8,0,0,8,16,0,0,16,21,0,0,21,22,0,0,22
16720,518,"PRIMĂRIA VULTUREȘTI",VULTUREŞTI,AG,1590,2,0,0,2,5,1,0,6,5,2,0,7,13,2,0,15,14,2,0,16
16677,519,"CĂMINUL CULTURAL BÂRZEȘTI",BÂRZEŞTI,AG,466,1,2,0,3,4,3,0,7,5,3,0,8,5,4,0,9,6,4,0,10
16695,520,"ȘCOALA PRIMARĂ HULUBA",HULUBA,AG,177,0,0,0,0,0,0,0,0,0,0,0,0,1,0,0,1,2,0,0,2
9271,1,"COLEGIUL ECONOMIC",ARAD,AR,865,10,12,0,22,27,36,0,63,39,53,0,92,58,63,0,121,65,65,0,130
9271,2,"POLICLINICA MUNICIPALĂ",ARAD,AR,1090,17,7,0,24,43,15,0,58,59,20,0,79,76,41,0,117,86,42,0,128
9271,3,"SPITALUL CLINIC MUNICIPAL- SECŢIA ORL",ARAD,AR,1122,17,2,0,19,62,6,0,68,89,8,0,97,104,12,0,116,115,16,0,131
9271,4,"COLEGIUL NAŢIONAL „VASILE GOLDIŞ” (FOSTA ŞCOALĂ GENERALĂ NR. 4)",ARAD,AR,1257,8,5,0,13,63,9,0,72,84,11,0,95,111,20,0,131,125,25,0,150
9271,5,"COLEGIUL NAŢIONAL „VASILE GOLDIŞ” (FOSTA ŞCOALĂ GENERALĂ NR. 4)",ARAD,AR,1225,20,0,0,20,48,3,0,51,74,4,0,78,103,9,0,112,108,10,0,118
9271,6,"COLEGIUL NAŢIONAL „VASILE GOLDIŞ” (FOSTA ŞCOALĂ GENERALĂ NR. 4)",ARAD,AR,929,15,0,0,15,49,1,0,50,67,1,0,68,83,2,0,85,85,2,0,87
9271,7,"COLEGIUL NAŢIONAL „VASILE GOLDIŞ” (FOSTA ŞCOALĂ GENERALĂ NR. 4)",ARAD,AR,932,18,1,0,19,35,1,0,36,49,1,57,107,70,3,57,130,76,4,57,137
9271,8,"COLEGIUL NAŢIONAL „VASILE GOLDIŞ”",ARAD,AR,1826,18,0,0,18,63,4,0,67,89,4,90,183,114,8,90,212,132,8,90,230
9271,9,"LICEUL DE ARTE „SABIN DRĂGOI”",ARAD,AR,1039,16,6,0,22,38,10,0,48,50,13,0,63,74,21,0,95,80,22,0,102
9271,10,"LICEUL DE ARTE „SABIN DRĂGOI”",ARAD,AR,1229,9,1,0,10,36,4,0,40,50,7,0,57,75,8,0,83,85,10,0,95
9271,11,"LICEUL TEHNOLOGIC DE ELECTRONICĂ ŞI AUTOMATIZĂRI „CAIUS IACOB”",ARAD,AR,1381,13,2,0,15,52,4,0,56,67,7,0,74,84,9,0,93,90,9,0,99
9271,12,"LICEUL TEOLOGIC BAPTIST „ALEXA POPOVICI”",ARAD,AR,869,14,6,0,20,37,9,0,46,56,9,0,65,84,10,0,94,84,10,0,94
9271,13,"LICEUL TEOLOGIC BAPTIST „ALEXA POPOVICI”",ARAD,AR,1007,18,4,0,22,39,4,0,43,58,4,0,62,82,6,0,88,88,6,0,94
9271,14,"LICEUL NAȚIONAL DE INFORMATICĂ",ARAD,AR,1392,11,0,0,11,43,1,0,44,62,1,0,63,82,1,0,83,93,4,0,97
9271,15,"SALA POLIVALENTĂ",ARAD,AR,1014,18,3,0,21,42,5,0,47,60,8,0,68,84,9,0,93,89,9,0,98
9271,16,"SALA POLIVALENTĂ",ARAD,AR,921,12,3,0,15,35,3,0,38,55,5,0,60,74,5,0,79,81,6,0,87
9271,17,"UNIVERSITATEA „AUREL VLAICU”",ARAD,AR,1480,9,2,0,11,50,3,0,53,82,8,0,90,101,15,0,116,117,22,0,139
9271,18,"UNIVERSITATEA „AUREL VLAICU”",ARAD,AR,1398,8,3,0,11,45,3,0,48,76,4,0,80,115,4,0,119,115,5,0,120
9271,19,"UNIVERSITATEA „AUREL VLAICU”",ARAD,AR,1256,13,6,0,19,30,7,0,37,53,8,1,62,90,10,1,101,102,10,1,113
9271,20,"UNIVERSITATEA „AUREL VLAICU”",ARAD,AR,1340,12,4,0,16,38,8,0,46,52,8,0,60,73,8,0,81,86,8,0,94
9271,21,"GRĂDINIȚA CU PROGRAM PRELUNGIT „PRICHINDEL” ARAD",ARAD,AR,1626,22,6,0,28,54,10,0,64,89,10,0,99,109,13,0,122,128,13,0,141
9271,22,"ŞCOALA GIMNAZIALĂ „REGINA MARIA” (FOSTA ŞCOALĂ GENERALĂ NR. 12)",ARAD,AR,1506,26,2,0,28,56,4,0,60,88,6,0,94,112,8,0,120,117,11,0,128
9271,23,"ŞCOALA GIMNAZIALĂ „REGINA MARIA” (FOSTA ŞCOALĂ GENERALĂ NR. 12)",ARAD,AR,1331,14,0,0,14,74,0,0,74,77,6,0,83,105,6,0,111,116,6,0,122
9271,24,"ŞCOALA GIMNAZIALĂ „REGINA MARIA” (FOSTA ŞCOALĂ GENERALĂ NR. 12)",ARAD,AR,1424,19,0,0,19,49,0,0,49,63,2,0,65,84,2,0,86,87,2,0,89
9271,25,"ȘCOALA GIMNAZIALĂ „CAIUS IACOB” (FOSTA ŞCOALĂ GENERALĂ NR. 22)",ARAD,AR,1415,12,0,0,12,49,1,0,50,82,2,0,84,111,4,0,115,127,4,0,131
9271,26,"ȘCOALA GIMNAZIALĂ „CAIUS IACOB” (FOSTA ŞCOALĂ GENERALĂ NR. 22)",ARAD,AR,1267,22,3,0,25,46,5,0,51,61,5,0,66,72,5,0,77,78,5,0,83
9271,27,"ȘCOALA GIMNAZIALĂ „CAIUS IACOB” (FOSTA ŞCOALĂ GENERALĂ NR. 22)",ARAD,AR,1369,17,3,0,20,46,3,0,49,79,3,0,82,98,3,0,101,113,4,0,117
9271,28,"ȘCOALA GIMNAZIALĂ „CAIUS IACOB” (FOSTA ŞCOALĂ GENERALĂ NR. 22)",ARAD,AR,1515,9,0,0,9,33,3,0,36,57,9,0,66,69,13,0,82,77,13,0,90
9271,29,"ȘCOALA GIMNAZIALĂ „CAIUS IACOB” (FOSTA ŞCOALĂ GENERALĂ NR. 22)",ARAD,AR,1259,18,1,0,19,49,3,0,52,66,11,0,77,93,12,0,105,105,12,0,117
9271,30,"ȘCOALA GIMNAZIALĂ „CAIUS IACOB” (FOSTA ŞCOALĂ GENERALĂ NR. 22)",ARAD,AR,1404,8,3,0,11,36,7,0,43,57,11,0,68,92,12,0,104,107,13,0,120
9271,31,"DIRECŢIA DE DEZVOLTARE ŞI ASISTENŢĂ COMUNITARĂ ARAD",ARAD,AR,1536,18,4,0,22,49,6,0,55,73,8,0,81,101,11,0,112,144,14,0,158
9271,32,"GRĂDINIŢA PP NR. 7",ARAD,AR,1501,17,8,0,25,63,13,0,76,85,13,0,98,106,14,0,120,119,14,0,133
9271,33,"GRĂDINIȚA P.P. NR. 7",ARAD,AR,1497,19,4,0,23,56,5,0,61,69,6,0,75,91,6,0,97,101,7,0,108
9271,34,"GRĂDINIȚA CU PROGRAM PRELUNGIT „PRICHINDEL”ARAD",ARAD,AR,1493,13,3,0,16,46,6,0,52,83,13,0,96,107,14,0,121,119,14,0,133
9271,35,"ŞCOALA GIMNAZIALĂ „ARON COTRUŞ”ARAD (FOSTA ŞCOALĂ GENERALĂ NR. 13)",ARAD,AR,1137,7,4,0,11,42,4,0,46,73,6,0,79,86,7,0,93,116,8,0,124
9271,36,"ŞCOALA GIMNAZIALĂ „ARON COTRUŞ”ARAD (FOSTA ŞCOALĂ GENERALĂ NR. 13)",ARAD,AR,1669,19,0,0,19,76,0,0,76,103,0,0,103,133,0,0,133,151,0,0,151
9271,37,"ŞCOALA GIMNAZIALĂ „ARON COTRUŞ”ARAD (FOSTA ŞCOALĂ GENERALĂ NR. 13)",ARAD,AR,1216,8,5,0,13,31,6,0,37,46,8,0,54,66,9,0,75,86,9,0,95
9271,38,"ŞCOALA GIMNAZIALĂ „ARON COTRUŞ”ARAD (FOSTA ŞCOALĂ GENERALĂ NR. 13)",ARAD,AR,1470,25,2,0,27,52,3,0,55,73,5,0,78,100,7,0,107,106,13,0,119
9271,39,"ŞCOALA GIMNAZIALĂ „ARON COTRUŞ”ARAD (FOSTA ŞCOALĂ GENERALĂ NR. 13)",ARAD,AR,831,8,0,0,8,21,0,0,21,30,0,0,30,43,0,0,43,43,0,0,43
9271,40,"ŞCOALA GIMNAZIALĂ „ARON COTRUŞ”ARAD (FOSTA ŞCOALĂ GENERALĂ NR. 13)",ARAD,AR,1222,12,1,0,13,32,2,0,34,59,5,58,122,83,6,58,147,91,8,58,157
9271,41,"ŞCOALA GIMNAZIALĂ „ARON COTRUŞ”ARAD (FOSTA ŞCOALĂ GENERALĂ NR. 13)",ARAD,AR,1430,17,0,0,17,56,3,0,59,85,3,0,88,110,5,0,115,117,5,0,122
9271,42,"GRĂDINIŢA P.P. NR. 11 ARAD",ARAD,AR,1353,14,6,0,20,67,8,0,75,91,9,0,100,132,12,0,144,146,13,0,159
9271,43,"GRĂDINIŢA CU PROGRAM NORMAL NR. 9",ARAD,AR,733,7,1,0,8,25,8,0,33,42,9,0,51,56,9,0,65,63,9,0,72
9271,44,"GRĂDINIŢA CU PROGRAM SĂPTĂMÂNAL NR. 2 ARAD",ARAD,AR,1232,12,0,0,12,32,0,0,32,49,1,0,50,74,1,0,75,87,1,0,88
9271,45,"ŞCOALA GIMNAZIALĂ „AUREL VLAICU”ARAD (FOSTA ŞCOALĂ GENERALĂ NR. 21)",ARAD,AR,1312,17,0,0,17,49,10,0,59,81,13,0,94,105,14,0,119,118,18,0,136
9271,46,"ŞCOALA GIMNAZIALĂ „AUREL VLAICU”ARAD (FOSTA ŞCOALĂ GENERALĂ NR. 21)",ARAD,AR,1077,14,1,0,15,54,1,0,55,75,1,0,76,87,1,0,88,93,1,0,94
9271,47,"ŞCOALA GIMNAZIALĂ „AUREL VLAICU”ARAD (FOSTA ŞCOALĂ GENERALĂ NR. 21)",ARAD,AR,1256,11,0,0,11,43,1,0,44,81,1,0,82,107,2,0,109,116,2,0,118
9271,48,"ȘCOALA GIMNAZIALĂ „NICOLAE BĂLCESCU” (FOSTA ŞCOALĂ GENERALĂ NR.11)",ARAD,AR,1727,27,4,0,31,66,4,0,70,96,4,0,100,123,5,0,128,143,7,0,150
9271,49,"ȘCOALA GIMNAZIALĂ „NICOLAE BĂLCESCU” (FOSTA ŞCOALĂ GENERALĂ NR.11)",ARAD,AR,1683,15,5,0,20,50,8,0,58,83,12,0,95,98,13,0,111,111,14,0,125
9271,50,"ȘCOALA GIMNAZIALĂ „NICOLAE BĂLCESCU” (FOSTA ŞCOALĂ GENERALĂ NR.11)",ARAD,AR,1264,11,8,0,19,36,9,0,45,52,9,0,61,70,11,0,81,78,11,0,89
9271,51,"GRĂDINIȚA CU PROGRAM PRELUNGIT „PALATUL FERMECAT” ARAD",ARAD,AR,1657,17,1,0,18,74,2,0,76,96,2,0,98,129,5,0,134,137,9,0,146
9271,52,"GRĂDINIȚA CU PROGRAM PRELUNGIT „PALATUL FERMECAT” ARAD",ARAD,AR,1677,21,0,0,21,73,1,0,74,96,2,0,98,133,11,0,144,149,12,0,161
9271,53,"CENTRUL DE VÂRSTNICI",ARAD,AR,1569,14,3,0,17,32,4,0,36,46,4,0,50,80,7,0,87,94,8,0,102
9271,54,"GRĂDINIŢA P.N. NR. 8",ARAD,AR,1832,16,0,0,16,54,8,0,62,73,10,0,83,123,10,0,133,141,11,0,152
9271,55,"GRĂDINIŢA P.P. NR. 8 ARAD",ARAD,AR,1700,10,3,0,13,37,5,0,42,70,9,0,79,90,12,0,102,100,12,0,112
9271,56,"ŞCOALA GIMNAZIALĂ „FRAŢII NEUMANN” (FOSTA ŞCOALĂ GENERALĂ NR. 10)",ARAD,AR,889,6,0,0,6,17,1,0,18,26,3,0,29,32,3,0,35,40,3,0,43
9271,57,"ŞCOALA GIMNAZIALĂ „FRAŢII NEUMANN” (FOSTA ŞCOALĂ GENERALĂ NR. 10)",ARAD,AR,1405,11,2,0,13,36,2,0,38,64,2,0,66,86,8,0,94,93,10,0,103
9271,58,"LICEUL CU PROGRAM SPORTIV (FOSTA ŞCOALĂ GENERALĂ NR. 9)",ARAD,AR,1577,27,3,0,30,63,4,0,67,91,5,0,96,135,5,0,140,156,6,0,162
9271,59,"LICEUL CU PROGRAM SPORTIV (FOSTA ŞCOALĂ GENERALĂ NR. 9)",ARAD,AR,1314,12,0,0,12,35,0,0,35,63,0,0,63,91,1,0,92,107,4,0,111
9271,60,"LICEUL CU PROGRAM SPORTIV (FOSTA ŞCOALĂ GENERALĂ NR. 9)",ARAD,AR,1556,16,0,0,16,62,4,0,66,96,5,0,101,129,6,0,135,157,6,0,163
9271,61,"LICEUL CU PROGRAM SPORTIV (FOSTA ŞCOALĂ GENERALĂ NR. 9)",ARAD,AR,1235,22,0,0,22,47,2,0,49,58,2,0,60,95,4,0,99,116,4,0,120
9271,62,"LICEUL CU PROGRAM SPORTIV (FOSTA ŞCOALĂ GENERALĂ NR. 9)",ARAD,AR,1409,20,3,0,23,56,3,0,59,102,7,0,109,152,11,0,163,181,12,0,193
9271,63,"GRĂDINIŢA CU PROGRAM PRELUNGIT „GRĂDINIŢA PRIETENIEI” ARAD",ARAD,AR,1699,22,0,0,22,70,4,0,74,89,5,0,94,126,8,0,134,139,9,0,148
9271,64,"GRĂDINIŢA CU PROGRAM PRELUNGIT „GRĂDINIŢA PRIETENIEI” ARAD",ARAD,AR,1553,14,0,0,14,38,4,0,42,54,7,0,61,75,8,0,83,81,14,0,95
9271,65,"COLEGIUL TEHNIC DE CONSTRUCȚII ȘI PROTECȚIA MEDIULUI (FOSTA ŞCOALĂ GENERALĂ NR. 6)",ARAD,AR,1502,24,1,0,25,60,3,0,63,100,6,0,106,134,8,0,142,143,10,0,153
9271,66,"COLEGIUL TEHNIC DE CONSTRUCȚII ȘI PROTECȚIA MEDIULUI (FOSTA ŞCOALĂ GENERALĂ NR. 6)",ARAD,AR,1617,20,5,0,25,50,7,0,57,105,9,0,114,147,9,0,156,158,9,0,167
9271,67,"GRĂDINIŢA CU PROGRAM PRELUNGIT „FURNICUŢA” ARAD",ARAD,AR,1686,15,0,0,15,53,2,0,55,81,3,0,84,112,3,0,115,123,3,0,126
9271,68,"GRĂDINIŢA CU PROGRAM PRELUNGIT „FURNICUŢA” ARAD",ARAD,AR,1405,22,4,0,26,74,7,0,81,113,8,0,121,154,12,0,166,168,12,0,180
9271,69,"ŞCOALA GIMNAZIALĂ „AVRAM IANCU” (FOSTA ŞCOALĂ GENERALĂ NR. 18)",ARAD,AR,1239,18,3,0,21,35,7,0,42,55,7,0,62,82,7,0,89,88,7,0,95
9271,70,"ŞCOALA GIMNAZIALĂ „AVRAM IANCU” (FOSTA ŞCOALĂ GENERALĂ NR. 18)",ARAD,AR,1458,10,5,0,15,42,7,0,49,78,11,0,89,97,13,0,110,109,17,0,126
9271,71,"COLEGIUL TEHNIC DE CONSTRUCȚII ȘI PROTECȚIA MEDIULUI",ARAD,AR,1389,15,2,0,17,34,2,0,36,57,6,0,63,81,10,0,91,95,11,0,106
9271,72,"COLEGIUL TEHNIC DE CONSTRUCȚII ȘI PROTECȚIA MEDIULUI",ARAD,AR,1474,12,0,0,12,42,1,0,43,45,1,0,46,55,1,0,56,77,3,0,80
9271,73,"ŞCOALA GIMNAZIALĂ „ILARION FELEA” (FOSTA ŞCOALĂ GENERALĂ NR. 8)",ARAD,AR,1501,8,4,0,12,19,4,0,23,22,4,0,26,35,5,0,40,43,5,0,48
9271,74,"AGENȚIA NAȚIONALĂ DE ADMINISTRARE FISCALĂ, FOSTA DIRECȚIE VAMALĂ",ARAD,AR,1056,9,2,0,11,44,3,0,47,54,4,0,58,60,4,124,188,78,6,124,208
9271,75,"AGENȚIA NAȚIONALĂ DE ADMINISTRARE FISCALĂ, FOSTA DIRECȚIE VAMALĂ",ARAD,AR,1284,7,5,0,12,34,8,0,42,49,11,0,60,65,13,120,198,76,15,120,211
9271,76,"GRĂDINIŢAP.N. NR. 12 ARAD",ARAD,AR,1677,19,5,0,24,54,12,0,66,90,14,0,104,116,15,0,131,130,15,0,145
9271,77,"GRĂDINIŢAP.N. NR. 12 ARAD",ARAD,AR,1233,11,0,0,11,30,1,0,31,52,4,0,56,68,5,0,73,79,5,0,84
9271,78,"CENTRU PENTRU ACORDAREA AJUTOARELOR BĂNEŞTI PENTRU ÎNCĂLZIREA LOCUINŢELOR",ARAD,AR,1555,22,0,0,22,60,3,0,63,90,6,0,96,108,10,0,118,120,11,0,131
9271,79,"ŞCOALA GIMNAZIALĂ „IOSIF MOLDOVAN” (FOSTA ŞCOALĂ GENERALĂ NR. 3)",ARAD,AR,1583,17,0,0,17,48,1,0,49,64,3,0,67,84,4,0,88,99,5,0,104
9271,80,"ŞCOALA GIMNAZIALĂ „IOSIF MOLDOVAN” (FOSTA ŞCOALĂ GENERALĂ NR. 3)",ARAD,AR,1246,11,4,0,15,34,6,0,40,46,10,0,56,77,13,0,90,78,15,0,93
9271,81,"ŞCOALA GIMNAZIALĂ „IOSIF MOLDOVAN” (FOSTA ŞCOALĂ GENERALĂ NR. 3)",ARAD,AR,1218,14,8,0,22,40,10,0,50,58,10,0,68,75,11,0,86,82,11,0,93
9271,82,"ŞCOALA GIMNAZIALĂ „IOSIF MOLDOVAN” (FOSTA ŞCOALĂ GENERALĂ NR. 3)",ARAD,AR,1386,8,4,0,12,28,5,0,33,39,5,0,44,63,5,0,68,77,5,0,82
9271,83,"ŞCOALA GIMNAZIALĂ „IOSIF MOLDOVAN” (FOSTA ŞCOALĂ GENERALĂ NR. 3)",ARAD,AR,1494,10,0,0,10,22,1,0,23,50,3,0,53,70,9,32,111,82,12,32,126
9271,84,"ŞCOALA GIMNAZIALĂ ""IOSIF MOLDOVAN"" (FOSTA ŞCOALA GENERALĂ NR. 3)",ARAD,AR,1851,5,0,0,5,34,1,0,35,50,1,0,51,75,2,0,77,82,4,0,86
9271,85,"CĂMINUL SOCIAL",ARAD,AR,1573,10,0,0,10,34,0,0,34,51,3,0,54,67,4,0,71,76,4,0,80
9271,86,"GRĂDINIȚA CU PROGRAM PRELUNGIT „ELEFĂNŢELUL ALFA” ARAD",ARAD,AR,1236,5,2,0,7,18,3,0,21,27,3,0,30,45,3,0,48,48,3,0,51
9271,87,"GRĂDINIȚA CU PROGRAM PRELUNGIT „ELEFĂNŢELUL ALFA” ARAD",ARAD,AR,1371,8,0,0,8,32,4,0,36,50,4,0,54,58,8,0,66,64,9,0,73
9271,88,"STAȚIUNEA DE CERCETARE - DEZVOLTARE PENTRU CREȘTEREA BOVINELOR ARAD",ARAD,AR,320,6,2,0,8,9,2,0,11,12,3,0,15,21,4,0,25,29,4,0,33
9271,89,"LICEUL TEHNOLOGIC DE TRANSPORTURI AUTO „HENRI COANDĂ”",ARAD,AR,979,8,4,0,12,28,6,0,34,37,7,0,44,52,7,0,59,55,8,0,63
9271,90,"ŞCOALA GIMNAZIALĂ „MIHAI EMINESCU” (FOSTA ŞCOALĂ GENERALĂ NR. 1)",ARAD,AR,1465,11,2,0,13,35,3,0,38,59,3,22,84,78,7,22,107,84,7,22,113
9271,91,"COLEGIUL TEHNOLOGIC DE INDUSTRIE ALIMENTARĂ ARAD",ARAD,AR,1535,13,3,0,16,49,5,24,78,75,5,24,104,101,5,25,131,105,5,25,135
9271,92,"COLEGIUL TEHNOLOGIC DE INDUSTRIE ALIMENTARĂ ARAD",ARAD,AR,990,9,3,0,12,29,5,0,34,45,6,0,51,57,8,0,65,73,10,0,83
9271,93,"COLEGIUL „CSIKY GERGELY”",ARAD,AR,1190,9,5,0,14,27,7,0,34,42,8,0,50,58,11,0,69,72,13,0,85
9271,94,"LICEUL TEHNOLOGIC „FRANCISC NEUMANN”",ARAD,AR,1243,4,0,0,4,12,0,0,12,23,0,0,23,32,0,0,32,41,0,0,41
9271,95,"LICEUL TEHNOLOGIC „FRANCISC NEUMANN”",ARAD,AR,1459,9,0,0,9,20,1,0,21,42,1,0,43,64,1,0,65,70,1,0,71
9271,96,"LICEUL TEHNOLOGIC „FRANCISC NEUMANN”",ARAD,AR,1258,8,2,0,10,12,2,0,14,30,3,0,33,51,3,0,54,57,3,0,60
9271,97,"PRIMĂRIA MUNICIPIULUI ARAD, DIRECȚIA VENITURI",ARAD,AR,1517,8,3,0,11,24,4,0,28,43,8,0,51,55,11,0,66,58,12,0,70
9271,98,"COLEGIUL TEHNIC „AUREL VLAICU”",ARAD,AR,1045,11,1,0,12,43,3,0,46,55,7,0,62,68,7,0,75,73,8,0,81
9271,99,"LICEUL TEHNOLOGIC „FRANCISC NEUMANN” (INTERNAT)",ARAD,AR,1029,11,1,0,12,39,9,0,48,58,10,0,68,67,12,1,80,71,12,1,84
9271,100,"GRĂDINIŢA P.P. NR. 14 ARAD",ARAD,AR,1291,21,4,0,25,39,7,0,46,70,8,0,78,85,12,0,97,94,15,0,109
9271,101,"GRĂDINIŢA P.N. NR. 13 ARAD",ARAD,AR,486,7,5,0,12,16,7,0,23,18,7,0,25,22,8,0,30,27,8,0,35
9271,102,"PATINOARUL MUNICIPAL ARAD",ARAD,AR,774,3,3,0,6,4,6,0,10,13,8,0,21,23,9,0,32,26,9,0,35
9271,103,"LICEUL TEORETIC „ADAM M. GUTTENBRUNN” (FOSTA ȘCOALĂ GENERALĂ NR. 20)",ARAD,AR,1696,9,0,0,9,43,0,0,43,68,2,0,70,90,3,0,93,100,4,0,104
9271,104,"IMOBIL FOSTA GRĂDINIŢĂ P.N. NR. 25",ARAD,AR,726,3,0,0,3,10,0,0,10,23,0,0,23,26,0,0,26,34,0,0,34
9271,105,"LICEUL TEORETIC „ADAM M. GUTTENBRUNN”, CLASELE I-VIII",ARAD,AR,1042,7,2,0,9,23,2,0,25,30,2,0,32,43,5,0,48,52,5,0,57
9271,106,"GRĂDINIŢA P.P. NR. 3 ARAD",ARAD,AR,1617,7,0,0,7,19,1,0,20,50,1,0,51,68,4,0,72,82,5,0,87
9271,107,"LICEUL TEORETIC „ADAM M. GUTTENBRUNN”",ARAD,AR,1097,10,1,0,11,29,2,0,31,50,3,0,53,81,4,0,85,87,4,0,91
9271,108,"LICEUL TEHNOLOGIC „IULIU MOLDOVAN” (FOST GRUP ŞCOLAR FORESTIER)",ARAD,AR,1590,15,4,0,19,43,4,0,47,61,5,0,66,83,5,0,88,88,5,0,93
9271,109,"GRĂDINIȚA P.N. NR.26 ARAD",ARAD,AR,1041,4,1,0,5,24,5,0,29,39,5,0,44,65,5,0,70,74,9,0,83
9271,110,"GRĂDINIȚA P.N. NR.26 ARAD",ARAD,AR,903,13,6,0,19,29,6,0,35,42,6,0,48,57,6,0,63,65,6,0,71
9271,111,"ŞCOALA GIMNAZIALĂ „ADAM NICOLAE” (FOSTA ŞCOALĂ GENERALĂ NR. 7)",ARAD,AR,1625,9,0,0,9,26,0,0,26,40,2,0,42,65,2,0,67,72,3,0,75
9271,112,"ŞCOALA GIMNAZIALĂ „ADAM NICOLAE” (FOSTA ŞCOALĂ GENERALĂ NR. 7)",ARAD,AR,1271,9,0,0,9,23,0,0,23,42,3,0,45,50,7,0,57,52,7,0,59
9271,113,"ŞCOALA GIMNAZIALĂ „ADAM NICOLAE” (FOSTA ŞCOALĂ GENERALĂ NR. 7)",ARAD,AR,1506,14,2,0,16,37,2,0,39,75,2,0,77,99,2,0,101,109,2,0,111
9271,114,"CÂMPUL DUMBRAVA ROŞIE",ARAD,AR,123,2,1,0,3,2,1,0,3,2,1,0,3,3,1,0,4,8,1,0,9
9271,115,"CÂMPUL ALBINELOR",ARAD,AR,153,0,0,0,0,4,5,0,9,5,5,0,10,6,6,0,12,8,6,0,14
9468,116,"LICEUL TEORETIC „MIHAI VELICIU”",CHIŞINEU-CRIŞ,AR,1340,16,0,0,16,37,0,0,37,48,2,0,50,69,6,0,75,73,6,0,79
9468,117,"LICEUL TEORETIC „MIHAI VELICIU""",CHIŞINEU-CRIŞ,AR,891,11,0,0,11,20,0,0,20,30,0,0,30,45,0,0,45,49,0,0,49
9468,118,"ȘCOALA GENERALĂ CHIȘINEU-CRIȘ",CHIŞINEU-CRIŞ,AR,1534,46,0,0,46,72,1,0,73,95,2,0,97,117,5,0,122,131,7,0,138
9468,119,"GRĂDINIŢA „PĂDURENI”",CHIŞINEU-CRIŞ,AR,1621,6,0,0,6,19,1,0,20,40,4,0,44,55,5,0,60,57,5,0,62
9477,120,"ŞCOALA GIMNAZIALĂ NĂDAB",NADAB,AR,1456,9,2,0,11,22,3,0,25,26,3,0,29,33,3,0,36,43,6,0,49
9501,121,"CASA DE CULTURĂ CURTICI",CURTICI,AR,1364,21,2,0,23,57,9,0,66,75,9,0,84,96,11,0,107,101,20,0,121
9501,122,"GRĂDINIŢA CU PROGRAM PRELUNGIT „GRĂDINIŢA VESELIEI""",CURTICI,AR,1380,16,0,0,16,41,0,0,41,51,0,0,51,61,1,0,62,65,1,0,66
9501,123,"LICEUL TEHNOLOGIC „ION CREANGĂ""",CURTICI,AR,1413,18,0,0,18,46,0,0,46,58,1,0,59,68,2,0,70,72,2,0,74
9501,124,"LICEUL TEHNOLOGIC „ION CREANGĂ""",CURTICI,AR,1477,15,0,0,15,30,2,0,32,42,5,0,47,47,5,0,52,48,5,0,53
9501,125,"LICEUL TEHNOLOGIC „ION CREANGĂ""",CURTICI,AR,1382,21,0,0,21,53,0,0,53,68,0,0,68,76,0,0,76,90,0,0,90
9547,126,"ȘCOALA GIMNAZIALĂ INEU",INEU,AR,1492,11,3,0,14,34,4,0,38,48,4,0,52,69,8,0,77,81,10,0,91
9547,127,"GRĂDINIȚA PN INEU",INEU,AR,1531,5,0,0,5,31,2,0,33,39,7,0,46,49,7,0,56,57,8,0,65
9547,128,"LICEUL ,,MIHAI VITEAZUL'' INEU",INEU,AR,1591,10,4,0,14,40,5,0,45,53,6,0,59,81,10,0,91,85,14,0,99
9547,129,"CĂMINUL CULTURAL DIN CARTIERUL TRAIAN",INEU,AR,1390,9,0,0,9,24,1,0,25,46,1,0,47,70,1,0,71,89,2,0,91
9547,130,"SALA DE SPORT",INEU,AR,1335,16,0,0,16,31,0,0,31,47,3,0,50,61,7,0,68,62,9,0,71
9556,131,"ŞCOALA GIMNAZIALĂ MOCREA",MOCREA,AR,618,3,0,0,3,8,0,0,8,10,0,0,10,17,2,0,19,20,2,0,22
9583,132,"LICEUL ATANASIE MARIENESCU",LIPOVA,AR,946,5,3,0,8,17,3,0,20,23,3,0,26,31,3,0,34,37,4,0,41
9583,133,"SEDIUL ASOCIAŢIA CARITAS BANAT SANCTUS GERHARDUS LIPOVA",LIPOVA,AR,1155,10,0,0,10,28,0,0,28,42,0,0,42,55,0,0,55,58,0,0,58
9583,134,"CLĂDIRE PAROHIA ROMANO-CATOLICĂ LIPOVA",LIPOVA,AR,1041,14,4,0,18,27,7,0,34,34,9,0,43,42,10,0,52,45,11,0,56
9583,135,"CLĂDIRE PAROHIA ORTODOXĂ LIPOVA",LIPOVA,AR,1061,16,4,0,20,42,4,0,46,50,4,0,54,67,6,0,73,71,6,0,77
9583,136,"CENTRU NAȚIONAL DE INFORMARE ȘI PROMOVARE TURISTICĂ LIPOVA",LIPOVA,AR,923,12,0,0,12,21,2,0,23,24,4,0,28,37,7,0,44,38,7,0,45
9583,137,"LICEUL SEVER BOCU (GRĂDINIŢA P.P. LIPOVA)",LIPOVA,AR,1693,17,1,0,18,39,1,0,40,55,3,0,58,87,7,0,94,100,8,0,108
9609,138,"CLĂDIRE PAROHIA ORTODOXĂ ȘOIMOȘ",ŞOIMOŞ,AR,596,3,7,0,10,15,9,0,24,24,10,0,34,47,12,0,59,52,12,0,64
9592,139,"SEDIU AGENȚIA DE PLĂȚI ȘI INTERVENȚIE PENTRU AGRICULTURĂ RADNA",RADNA,AR,1129,7,1,0,8,27,2,0,29,41,3,0,44,59,3,0,62,63,3,0,66
9592,140,"LICEUL ATANASIE MARIENESCU",RADNA,AR,962,6,1,0,7,33,3,2,38,49,3,2,54,68,4,2,74,86,6,2,94
9636,141,"LICEUL TEORETIC „JOZEF GREGOR TAJOVSKY” NĂDLAC, PIAŢA UNIRII",NĂDLAC,AR,1639,6,3,0,9,13,4,0,17,18,4,0,22,29,5,0,34,34,7,0,41
9636,142,"CASA DE CULTURĂ NĂDLAC, STRADA 1 DECEMBRIE (STRADA 23 AUGUST),",NĂDLAC,AR,1560,11,0,0,11,22,2,0,24,39,2,0,41,61,4,0,65,65,5,0,70
9636,143,"LICEUL TEORETIC „JOZEF GREGOR TAJOVSKY” NĂDLAC, STRADA 1 DECEMBRIE (STRADA 23 AUGUST)",NĂDLAC,AR,1763,10,0,0,10,23,0,0,23,30,3,0,33,39,3,0,42,42,3,0,45
9636,144,"PICHET GRĂNICERI (DIRECȚIA POLIȚIEI DE FRONTIERĂ ORADEA), STRADA GRĂNICERILOR,",NĂDLAC,AR,1670,6,5,0,11,21,5,0,26,26,8,0,34,28,8,0,36,31,8,0,39
11593,145,"CASA DE CULTURĂ „DORU IOAN PETESCU”",PECICA,AR,1081,18,6,0,24,42,10,0,52,52,11,0,63,67,11,0,78,70,11,0,81
11593,146,"LICEUL TEORETIC „GHEORGHE LAZĂR”",PECICA,AR,1743,22,4,0,26,60,5,0,65,87,8,0,95,92,9,0,101,111,9,0,120
11593,147,"CLĂDIRE PRIVATĂ (CANTINA I.A.S)",PECICA,AR,1348,9,0,0,9,15,0,0,15,24,0,0,24,35,0,0,35,42,0,0,42
11593,148,"PRIMĂRIA ORAȘULUI PECICA",PECICA,AR,1324,8,3,0,11,21,3,0,24,26,5,0,31,37,7,0,44,39,8,0,47
11593,149,"ŞCOALA PRIMARĂ 2 PECICA",PECICA,AR,1435,7,1,0,8,20,1,0,21,24,1,0,25,34,1,0,35,39,1,0,40
11593,150,"ŞCOALA PRIMARĂ 3 PECICA",PECICA,AR,1602,7,0,0,7,12,0,0,12,14,1,0,15,18,7,0,25,20,9,0,29
11593,151,"ŞCOALA PRIMARĂ 1 PECICA",PECICA,AR,1636,13,2,0,15,31,4,0,35,45,4,0,49,70,5,0,75,77,5,0,82
11628,152,"CLĂDIREA PRIMĂRIEI ORAȘULUI PECICA (FOSTA PRIMĂRIE TURNU)",TURNU,AR,1014,7,3,0,10,11,3,0,14,18,5,0,23,23,7,0,30,27,7,0,34
11619,153,"ŞCOALA PRIMARĂ SEDERHAT",SEDERHAT,AR,274,5,2,0,7,8,2,0,10,13,4,0,17,13,4,0,17,13,4,0,17
9663,154,"CLĂDIRE „BUCURIA COPIILOR""",PÎNCOTA,AR,1066,17,4,0,21,43,8,1,52,71,10,1,82,94,10,1,105,106,15,1,122
9663,155,"LICEUL TEORETIC PÎNCOTA",PÎNCOTA,AR,1350,14,0,0,14,32,2,0,34,53,2,0,55,77,9,0,86,92,9,0,101
9663,156,"LICEUL TEORETIC PÎNCOTA",PÎNCOTA,AR,1452,21,0,0,21,35,0,0,35,47,0,0,47,83,0,0,83,87,0,0,87
9663,157,"GRĂDINIŢA PN PÎNCOTA",PÎNCOTA,AR,1300,3,5,0,8,21,7,0,28,39,7,0,46,49,7,0,56,58,7,0,65
9672,158,"ŞCOALA GIMNAZIALĂ MĂDERAT",MĂDERAT,AR,1268,9,0,0,9,27,2,0,29,30,2,0,32,42,2,0,44,76,5,0,81
12108,159,"ȘCOALA GIMNAZIALĂ „SFÂNTA ANA” SÂNTANA - SECȚIA GERMANĂ, NR. 56",SÂNTANA,AR,1301,6,0,0,6,12,0,0,12,16,0,0,16,22,0,0,22,23,0,0,23
12108,160,"LICEUL TEHNOLOGIC SÂNTANA, NR. 6",SÂNTANA,AR,1761,8,0,0,8,19,3,0,22,31,3,0,34,43,4,0,47,54,4,0,58
12108,161,"CLUBUL COPIILOR ȘI ELEVILOR, NR. 31",SÂNTANA,AR,1056,1,0,0,1,4,2,0,6,12,8,0,20,16,8,0,24,17,8,0,25
12108,162,"ȘCOALA GIMNAZIALĂ SÂNTANA, NR. 36",SÂNTANA,AR,1431,9,2,0,11,17,5,0,22,24,5,0,29,34,5,0,39,36,5,0,41
12108,163,"GRĂDINIȚA PP NR. 2 SÂNTANA, NR. 37",SÂNTANA,AR,1290,4,0,0,4,19,3,0,22,30,11,0,41,33,11,0,44,43,11,0,54
12108,164,"GRĂDINIȚA PP NR. 2 SÂNTANA, NR. 178",SÂNTANA,AR,1666,2,0,0,2,17,0,0,17,30,0,0,30,42,0,0,42,48,4,0,52
12108,165,"BIBLIOTECA ORAȘULUI SÂNTANA, NR. 117",SÂNTANA,AR,1018,7,6,0,13,14,6,0,20,23,6,0,29,36,6,0,42,37,7,0,44
12108,166,"CĂMIN CULTURAL SATU NOU, NR. 1 BIS",SÂNTANA,AR,1097,13,2,0,15,23,4,0,27,40,5,0,45,48,5,0,53,52,6,0,58
12108,167,"GRĂDINIȚA PP NR. 1 SÂNTANA, NR. 1 BIS",SÂNTANA,AR,931,3,0,0,3,15,1,0,16,28,1,0,29,43,2,0,45,43,2,0,45
12117,168,"CĂMINUL CULTURAL CAPORAL ALEXA, NR. 195","CAPORAL ALEXA",AR,1160,14,4,0,18,34,5,0,39,58,5,0,63,72,9,0,81,77,9,0,86
9707,169,"CASA DE CULTURĂ SEBIȘ",SEBIŞ,AR,1558,25,0,0,25,59,3,0,62,95,3,0,98,123,8,0,131,141,9,0,150
9707,170,"LICEUL ORAŞULUI SEBIŞ",SEBIŞ,AR,1538,21,1,0,22,62,5,0,67,89,7,0,96,112,9,0,121,138,12,0,150
9707,171,"ŞCOALA GIMNAZIALĂ SEBIŞ",SEBIŞ,AR,1298,16,1,0,17,39,1,0,40,69,5,0,74,101,5,0,106,115,6,0,121
9707,172,"ŞCOALA PRIMARĂ PRĂJEŞTI",SEBIŞ,AR,200,1,4,0,5,6,5,0,11,8,5,0,13,9,5,0,14,11,5,0,16
9725,173,"ŞCOALA PRIMARĂ PRUNIŞOR",PRUNIŞOR,AR,487,4,3,0,7,5,3,0,8,7,4,0,11,15,5,0,20,17,5,0,22
9716,174,"ŞCOALA PRIMARĂ DONCENI",DONCENI,AR,127,1,1,0,2,4,1,0,5,5,1,0,6,8,6,0,14,9,6,0,15
9734,175,"CĂMINUL CULTURAL SĂLĂJENI",SĂLĂJENI,AR,147,0,7,0,7,2,8,0,10,3,8,0,11,5,8,0,13,5,8,0,13
9752,176,"CĂMINUL CULTURAL ALMAŞ",ALMAŞ,AR,1131,11,0,0,11,30,1,0,31,51,1,0,52,74,1,0,75,80,3,0,83
9761,177,"CĂMINUL CULTURAL CIL",CIL,AR,481,8,0,0,8,14,1,0,15,16,2,0,18,17,4,0,21,22,4,0,26
9789,178,"CĂMINUL CULTURAL RĂDEŞTI",RĂDEŞTI,AR,350,9,2,0,11,13,3,0,16,17,3,0,20,33,11,0,44,34,11,0,45
9770,179,"CĂMINUL CULTURAL JOIA MARE","JOIA MARE",AR,165,0,5,0,5,4,6,0,10,5,6,0,11,6,6,0,12,6,6,0,12
9805,180,"ȘCOALA GIMNAZIALĂ ”GHEORGHE POPOVICI” APATEU,",APATEU,AR,945,3,0,0,3,5,0,0,5,8,1,0,9,22,1,0,23,31,1,0,32
9805,181,"ȘCOALA GIMNAZIALĂ ”GHEORGHE POPOVICI” APATEU,",APATEU,AR,946,5,0,0,5,11,0,0,11,16,0,0,16,20,0,0,20,29,0,0,29
9814,182,"ŞCOALA PRIMARĂ BERECHIU",BERECHIU,AR,649,6,1,0,7,9,1,0,10,14,3,0,17,16,9,0,25,19,9,0,28
9823,183,"ŞCOALA GENERALĂ MOŢIORI",MOŢIORI,AR,234,5,0,0,5,7,0,0,7,10,0,0,10,13,1,0,14,15,1,0,16
9841,184,"PRIMĂRIA COMUNEI ARCHIŞ",ARCHIŞ,AR,307,11,0,0,11,16,3,0,19,23,5,0,28,29,5,0,34,45,6,0,51
9878,185,"GRĂDINIŢA CU PROGRAM NORMAL NERMIȘ",NERMIŞ,AR,158,4,0,0,4,8,0,0,8,8,0,0,8,11,2,0,13,18,5,0,23
9850,186,"GRĂDINIŢA CU PROGRAM NORMAL BÎRZEŞTI",BÎRZEŞTI,AR,135,5,1,0,6,8,1,0,9,9,1,0,10,13,1,0,14,31,1,0,32
9869,187,"ŞCOALA GIMNAZIALĂ GROŞENI",GROŞENI,AR,643,4,0,0,4,17,2,0,19,26,2,0,28,32,4,0,36,32,4,0,36
9896,188,"PRIMĂRIA COMUNEI BATA",BATA,AR,343,4,2,0,6,6,2,0,8,12,3,0,15,16,7,0,23,18,8,0,26
9921,189,"CAMIN CULTURAL ȚELA",ŢELA,AR,262,3,0,0,3,4,0,0,4,4,0,0,4,4,4,0,8,4,4,0,8
9903,190,"CĂMINUL CULTURAL BACĂUL DE MIJLOC","BACĂU DE MIJLOC",AR,152,2,3,0,5,2,4,0,6,3,4,0,7,3,4,0,7,3,4,0,7
9912,191,"CĂMINUL CULTURAL BULCI",BULCI,AR,88,4,1,0,5,6,1,0,7,10,1,0,11,12,1,0,13,12,7,0,19
9949,192,"PRIMĂRIA COMUNEI BELIU",BELIU,AR,1431,12,0,0,12,36,4,0,40,48,6,0,54,80,7,0,87,92,8,0,100
9994,193,"CĂMINUL CULTURAL TĂGĂDĂU",TĂGĂDĂU,AR,403,4,3,0,7,16,3,0,19,22,5,0,27,25,6,0,31,37,6,0,43
9958,194,"CĂMINUL CULTURAL BENEŞTI",BENEŞTI,AR,90,7,7,0,14,12,7,0,19,14,7,0,21,21,8,0,29,22,8,0,30
9967,195,"CĂMINUL CULTURAL BOCHIA",BOCHIA,AR,51,4,5,0,9,6,5,0,11,8,5,0,13,10,5,0,15,10,5,0,15
9985,196,"CĂMINUL CULTURAL SECACI",SECACI,AR,123,4,2,0,6,6,3,0,9,13,5,0,18,18,5,0,23,20,5,0,25
9976,197,"ȘCOALA PRIMARĂ VASILE GOLDIŞ","VASILE GOLDIŞ",AR,396,10,2,0,12,15,3,0,18,19,4,0,23,27,4,0,31,27,6,0,33
10015,198,"CĂMINUL CULTURAL BIRCHIŞ",BIRCHIŞ,AR,540,3,1,0,4,5,1,0,6,8,1,0,9,10,1,0,11,10,1,0,11
10024,199,"ŞCOALA GIMNAZIALĂ CĂPĂLNAŞ",CĂPĂLNAŞ,AR,744,10,0,0,10,14,0,0,14,16,3,0,19,18,3,0,21,18,3,0,21
10033,200,"CĂMINUL CULTURAL OSTROV",OSTROV,AR,216,0,3,0,3,1,5,0,6,2,8,0,10,4,10,0,14,4,10,0,14
10060,201,"GRĂDINIŢA PN BÎRSA",BÎRSA,AR,795,4,0,0,4,18,1,0,19,20,3,0,23,25,3,0,28,25,3,0,28
10079,202,"CĂMIN CULTURAL ALDEŞTI",ALDEŞTI,AR,436,1,1,0,2,9,1,0,10,15,1,0,16,22,1,0,23,27,3,0,30
10088,203,"CLĂDIREA COMUNEI BÎRSA (FOSTA ŞCOALĂ CU CLASELE I-IV HODIŞ)",HODIŞ,AR,144,1,0,0,1,1,0,0,1,3,0,0,3,4,0,0,4,4,0,0,4
10097,204,"CLĂDIREA COMUNEI BÎRSA (FOSTA ŞCOALĂ CU CLASELE I-IV VOIVODENI)",VOIVODENI,AR,154,3,5,0,8,5,7,0,12,6,7,0,13,9,7,0,16,11,7,0,18
10113,205,"PRIMĂRIA COMUNEIBÎRZAVA",BÎRZAVA,AR,763,6,0,0,6,16,2,0,18,25,5,0,30,27,5,0,32,32,5,0,37
10177,206,"ŞCOALA GENERALĂ MONOROŞTIA",MONOROŞTIA,AR,252,6,1,0,7,8,4,0,12,9,4,0,13,10,4,0,14,11,4,0,15
10131,207,"CENTRU LOCAL DE INFORMARE ȘI PROMOVARE TURISTICĂ CĂPRUȚA",CĂPRUŢA,AR,212,0,0,0,0,1,2,0,3,2,2,0,4,6,2,0,8,8,2,0,10
10140,208,"CĂMINUL CULTURALDUMBRĂVIŢA",DUMBRĂVIŢA,AR,234,3,0,0,3,7,1,0,8,8,1,0,9,9,4,0,13,9,4,0,13
10159,209,"ŞCOALA GIMNAZIALĂ GROŞII NOI","GROŞII NOI",AR,174,3,0,0,3,7,0,0,7,10,3,0,13,11,4,0,15,12,4,0,16
10186,210,"CĂMIN CULTURAL SLATINA DE MUREŞ","SLATINA DE MUREŞ",AR,136,1,3,0,4,1,3,0,4,3,3,0,6,9,6,0,15,18,6,0,24
10122,211,"ŞCOALA GENERALĂ BĂTUŢA",BĂTUŢA,AR,54,1,0,0,1,3,0,0,3,4,0,0,4,4,1,0,5,4,1,0,5
10168,212,"ŞCOALA GENERALĂ LALAŞINŢ",LALAŞINŢ,AR,272,5,5,0,10,7,9,0,16,8,12,0,20,13,13,0,26,13,14,0,27
10202,213,"CĂMINUL CULTURAL BOCSIG",BOCSIG,AR,1530,9,0,0,9,34,2,0,36,47,2,0,49,56,4,0,60,59,6,0,65
10202,214,"ȘCOALA PRIMARĂ BOCSIG CARTIER",BOCSIG,AR,335,13,8,0,21,24,8,0,32,31,8,0,39,32,8,0,40,32,8,0,40
10211,215,"CĂMINUL CULTURAL MÎNERĂU",MÎNERĂU,AR,296,3,6,0,9,6,7,0,13,8,9,0,17,15,9,0,24,15,9,0,24
10220,216,"ŞCOALA PRIMARĂ RĂPSIG",RĂPSIG,AR,594,5,2,0,7,18,2,0,20,32,3,0,35,41,5,0,46,41,6,0,47
10248,217,"PRIMĂRIA COMUNEI BRAZII",BRAZII,AR,73,1,0,0,1,1,2,0,3,1,3,0,4,2,3,0,5,2,3,0,5
10266,218,"CĂMINUL CULTURAL IACOBINI",IACOBINI,AR,165,5,0,0,5,8,0,0,8,9,1,0,10,15,1,0,16,17,1,0,18
10284,219,"CĂMINUL CULTURAL SECAŞ",SECAŞ,AR,387,9,0,0,9,15,2,0,17,21,2,0,23,30,3,0,33,37,6,0,43
10257,220,"CĂMINUL CULTURAL BUCEAVA",BUCEAVA-ŞOIMUŞ,AR,72,1,3,0,4,3,4,0,7,3,4,0,7,6,4,0,10,10,4,0,14
10257,221,"CĂMINUL CULTURAL ŞOIMUŞ",BUCEAVA-ŞOIMUŞ,AR,76,1,0,0,1,1,0,0,1,5,0,0,5,6,2,0,8,8,2,0,10
10275,222,"CĂMINUL CULTURAL MĂDRIGEŞTI",MĂDRIGEŞTI,AR,225,4,2,0,6,9,4,0,13,17,4,0,21,20,4,0,24,20,4,0,24
10300,223,"PRIMĂRIA COMUNEI BUTENI",BUTENI,AR,774,6,0,0,6,17,0,0,17,25,1,0,26,33,1,0,34,34,4,0,38
10300,224,"CĂMINUL CULTURAL BUTENI",BUTENI,AR,995,9,1,0,10,24,1,0,25,33,4,0,37,44,9,0,53,50,9,0,59
10328,225,"CLĂDIREA PRIMĂRIEI BUTENI (FOSTA PRIMĂRIE CUIED)",CUIED,AR,545,2,1,0,3,7,1,0,8,12,1,0,13,17,4,0,21,17,4,0,21
10337,226,"CĂMINUL CULTURAL PĂULIAN",PĂULIAN,AR,269,6,4,0,10,8,5,0,13,9,5,0,14,11,5,0,16,12,5,0,17
10319,227,"CĂMINUL CULTURAL BERINDIA",BERINDIA,AR,178,4,3,0,7,7,3,0,10,8,3,0,11,24,3,0,27,29,4,0,33
10355,228,"CĂMINULCULTURAL CĂRAND",CĂRAND,AR,501,6,1,0,7,27,3,0,30,43,8,0,51,52,8,0,60,56,9,0,65
10364,229,"CĂMINULCULTURAL SELIŞTEA",SELIŞTEA,AR,425,5,2,0,7,14,4,0,18,16,5,0,21,23,6,0,29,31,6,0,37
10382,230,"PRIMĂRIA COMUNEI CERMEI, NR. 304",CERMEI,AR,1535,16,0,0,16,39,3,0,42,52,4,0,56,69,6,0,75,78,6,0,84
10408,231,"PUNCT DE LUCRU AL PRIMĂRIEI,NR.339",ŞOMOŞCHEŞ,AR,701,7,2,0,9,14,2,0,16,20,2,0,22,23,5,0,28,31,6,0,37
10426,232,"PRIMĂRIA COMUNEI CHISINDIA",CHISINDIA,AR,719,7,0,0,7,15,2,0,17,18,2,0,20,21,2,0,23,24,6,0,30
10435,233,"CĂMIN CULTURAL PĂIUŞENI",PĂIUŞENI,AR,321,0,0,0,0,0,0,0,0,1,1,0,2,2,1,0,3,2,1,0,3
10444,234,"CĂMIN CULTURAL VĂSOAIA",VĂSOAIA,AR,42,0,1,0,1,0,1,0,1,0,1,0,1,0,3,0,3,2,6,0,8
10462,235,"ŞCOALA GIMNAZIALĂCONOP",CONOP,AR,480,3,1,0,4,9,1,0,10,13,1,0,14,13,1,0,14,15,2,0,17
10471,236,"ŞCOALA PRIMARĂBELOTINŢ",BELOTINŢ,AR,239,3,5,0,8,5,5,0,10,8,5,0,13,9,5,0,14,9,5,0,14
10480,237,"CĂMINUL CULTURAL CHELMAC",CHELMAC,AR,232,6,1,0,7,9,2,0,11,12,3,0,15,12,4,0,16,14,4,0,18
10499,238,"ŞCOALA PRIMARĂ MILOVA",MILOVA,AR,440,1,0,0,1,8,0,0,8,15,0,0,15,27,4,0,31,27,4,0,31
10505,239,"ŞCOALA PRIMARĂODVOŞ",ODVOŞ,AR,381,2,5,0,7,2,6,0,8,4,7,0,11,14,8,0,22,18,10,0,28
10523,240,"CĂMIN CULTURAL COVĂSÎNŢ",COVĂSINŢ,AR,1071,15,0,0,15,31,1,0,32,52,4,0,56,64,9,0,73,73,9,0,82
10523,241,"PRIMĂRIA COMUNEI COVĂSÎNŢ",COVĂSINŢ,AR,1038,13,1,0,14,25,5,0,30,29,5,0,34,47,6,0,53,62,6,0,68
10541,242,"PRIMĂRIA COMUNEI CRAIVA",CRAIVA,AR,488,11,0,0,11,13,8,0,21,17,10,0,27,23,13,0,36,27,14,0,41
10550,243,"ŞCOALA PRIMARĂ CHIŞLACA",CHIŞLACA,AR,567,4,0,0,4,12,3,0,15,22,4,0,26,30,5,0,35,36,5,0,41
10587,244,"ŞCOALA PRIMARĂ MĂRĂUŞ",MĂRĂUŞ,AR,244,5,0,0,5,8,0,0,8,10,0,0,10,13,0,0,13,14,0,0,14
10603,245,"ŞCOALA PRIMARĂ STOINEŞTI",STOINEŞTI,AR,140,1,0,0,1,5,2,0,7,8,3,0,11,16,4,0,20,21,4,0,25
10612,246,"ŞCOALA PRIMARĂ SUSAG",SUSAG,AR,292,2,0,0,2,3,0,0,3,6,0,0,6,7,0,0,7,7,0,0,7
10578,247,"CĂMINUL CULTURAL COROI",COROI,AR,131,8,0,0,8,11,8,0,19,13,8,0,21,15,8,0,23,15,8,0,23
10621,248,"ŞCOALA PRIMARĂ ŞIAD",ŞIAD,AR,198,9,3,0,12,12,6,0,18,18,6,0,24,19,10,0,29,25,10,0,35
10596,249,"ŞCOALA PRIMARĂ ROGOZ DE BELIU","ROGOZ DE BELIU",AR,112,4,1,0,5,9,4,0,13,13,9,0,22,17,11,0,28,19,11,0,30
10569,250,"ŞCOALA PRIMARĂ CIUNTEŞTI",CIUNTEŞTI,AR,129,0,0,0,0,1,0,0,1,4,0,0,4,14,0,0,14,14,1,0,15
10658,251,"CĂMINUL CULTURAL DEZNA",DEZNA,AR,675,6,2,0,8,19,2,0,21,24,2,0,26,33,5,1,39,40,6,1,47
10667,252,"CĂMINUL CULTURAL BUHANI",BUHANI,AR,154,3,1,0,4,6,3,0,9,12,3,0,15,15,4,0,19,15,5,0,20
10685,253,"CĂMINUL CULTURAL NEAGRA",NEAGRA,AR,81,4,2,0,6,5,3,0,8,5,3,0,8,7,3,0,10,7,3,0,10
10694,254,"IMOBIL PROPRIETATEA PRIMARIEI COMUNEI DEZNA AMPLASAT ÎN SATUL SLATINA DE CRIȘ","SLATINA DE CRIŞ",AR,109,1,0,0,1,2,2,0,4,3,3,0,6,4,5,0,9,6,5,0,11
10676,255,"CĂMINUL CULTURAL LAZ",LAZ,AR,41,0,0,0,0,0,0,0,0,3,0,0,3,5,3,0,8,5,4,0,9
10710,256,"CĂMINUL CULTURAL DIECI",DIECI,AR,625,4,0,0,4,21,0,0,21,24,0,0,24,36,4,14,54,44,6,14,64
10738,257,"CĂMINUL CULTURAL CROCNA",CROCNA,AR,321,12,1,0,13,17,3,0,20,21,3,0,24,26,3,0,29,29,5,0,34
10747,258,"CĂMINUL CULTURAL REVETIŞ",REVETIŞ,AR,266,6,0,0,6,13,0,0,13,19,4,0,23,34,5,0,39,36,5,0,41
10756,259,"CĂMINUL CULTURAL ROŞIA",ROŞIA,AR,41,0,0,0,0,4,2,0,6,4,2,0,6,4,4,0,8,4,4,0,8
9510,260,"CĂMIN CULTURAL DOROBANŢI",DOROBANŢI,AR,1398,4,0,0,4,13,3,0,16,14,3,0,17,21,3,0,24,24,3,0,27
9299,261,"PRIMĂRIA COMUNEI FÎNTÎNELE",FÂNTÂNELE,AR,1177,7,4,0,11,30,4,0,34,34,4,0,38,47,4,0,51,48,4,0,52
9299,262,"ŞCOALA GIMNAZIALĂ FÎNTÎNELE",FÂNTÂNELE,AR,996,8,4,0,12,16,4,0,20,26,4,0,30,40,4,0,44,40,5,0,45
9324,263,"CĂMINULCULTURAL TISA NOUĂ","TISA NOUĂ",AR,836,12,4,0,16,21,4,0,25,27,5,0,32,33,5,0,38,39,5,0,44
10836,264,"ȘCOALA GIMNAZIALĂ „AUREL SEBEȘAN” FELNAC",FELNAC,AR,1118,4,0,0,4,25,3,0,28,41,4,0,45,51,7,0,58,54,7,0,61
10836,265,"ȘCOALA GIMNAZIALĂ „AUREL SEBEȘAN” FELNAC",FELNAC,AR,1154,18,1,0,19,26,2,0,28,41,3,0,44,63,3,0,66,66,3,0,69
10854,266,"ŞCOALA PRIMARĂ CĂLUGĂRENI",CĂLUGĂRENI,AR,219,2,0,0,2,6,0,0,6,7,1,0,8,7,1,0,8,8,1,0,9
9315,267,"CĂMINUL CULTURAL FRUMUŞENI",FRUMUŞENI,AR,1482,7,0,0,7,17,4,0,21,29,4,0,33,39,5,0,44,43,5,0,48
9306,268,"CĂMINUL CULTURAL ALUNIŞ",ALUNIŞ,AR,839,7,0,0,7,16,1,0,17,25,1,0,26,38,1,0,39,41,1,0,42
10881,269,"PRIMĂRIA COMUNEI GHIOROC",GHIOROC,AR,1548,18,2,0,20,36,5,0,41,46,6,0,52,59,9,1,69,77,9,1,87
10890,270,"CĂMINUL CULTURAL CUVIN",CUVIN,AR,1350,6,0,0,6,23,3,0,26,30,7,0,37,51,11,0,62,92,17,0,109
10907,271,"CĂMINUL CULTURAL MINIŞ",MINIŞ,AR,561,9,0,0,9,15,0,0,15,21,2,0,23,32,2,0,34,34,3,0,37
10925,272,"PRIMĂRIA COMUNEI GRĂNICERI",GRĂNICERI,AR,1065,1,1,0,2,7,1,0,8,9,1,0,10,11,1,0,12,12,1,0,13
10934,273,"ŞCOALA GIMNAZIALĂ ŞICLĂU",ŞICLĂU,AR,970,4,1,0,5,8,1,0,9,10,3,0,13,14,4,0,18,17,4,0,21
10952,274,"PRIMĂRIA COMUNEI GURAHONŢ",GURAHONŢ,AR,767,21,4,0,25,50,7,0,57,70,8,0,78,79,9,0,88,83,9,0,92
10952,275,"PRIMĂRIA COMUNEI GURAHONŢ",GURAHONŢ,AR,728,22,4,0,26,50,5,0,55,68,11,0,79,85,12,0,97,95,12,0,107
10961,276,"CĂMINUL CULTURAL BONŢEŞTI",BONŢEŞTI,AR,547,7,4,0,11,19,4,0,23,35,9,0,44,53,12,0,65,64,12,0,76
10989,277,"CĂMINUL CULTURAL FENIŞ",FENIŞ,AR,93,7,4,0,11,8,4,0,12,8,4,0,12,11,4,0,15,11,4,0,15
10998,278,"CĂMINUL CULTURAL HONŢIŞOR",HONŢIŞOR,AR,275,5,0,0,5,9,1,0,10,12,1,0,13,21,2,0,23,23,2,0,25
11003,279,"CĂMINUL CULTURAL IOSAŞ",IOSAŞ,AR,203,7,0,0,7,13,2,0,15,16,2,0,18,23,2,0,25,29,2,0,31
11021,280,"CĂMINUL CULTURAL PESCARI",PESCARI,AR,225,2,0,0,2,2,1,0,3,2,4,0,6,4,5,0,9,5,7,0,12
11049,281,"CĂMINUL CULTURAL ZIMBRU",ZIMBRU,AR,389,3,0,0,3,6,1,0,7,12,4,0,16,16,5,0,21,18,5,0,23
11067,282,"PRIMĂRIA COMUNEI HĂLMAGIU",HĂLMAGIU,AR,1010,14,0,0,14,35,1,0,36,40,5,0,45,47,6,0,53,54,6,0,60
11076,283,"CĂMINUL CULTURAL BĂNEȘTI",BĂNEŞTI,AR,258,0,0,0,0,2,0,0,2,3,0,0,3,4,0,0,4,4,0,0,4
11094,284,"ŞCOALA GENERALĂ",BRUSTURI,AR,306,1,0,0,1,1,0,0,1,1,1,0,2,1,1,0,2,1,1,0,2
11156,285,"ŞCOALA GENERALĂ",TISA,AR,157,3,1,0,4,5,1,0,6,6,2,0,8,6,2,0,8,6,2,0,8
11165,286,"CĂMIN CULTURAL ŢĂRMURE",ŢĂRMURE,AR,292,3,0,0,3,3,0,0,3,3,0,0,3,3,0,0,3,4,0,0,4
11129,287,"CĂMINUL CULTURAL LEASA",LEASA,AR,172,0,0,0,0,5,1,0,6,9,2,0,11,13,4,0,17,15,4,0,19
11147,288,"ŞCOALA GENERALĂ",POIENARI,AR,156,0,1,0,1,3,1,0,4,6,1,0,7,9,1,0,10,11,2,0,13
11183,289,"PRIMĂRIA COMUNEI HĂLMĂGEL",HĂLMĂGEL,AR,497,0,0,0,0,13,2,0,15,18,4,0,22,19,6,0,25,20,7,0,27
11192,290,"ŞCOALA PRIMARĂ LUNCŞOARA",LUNCŞOARA,AR,303,0,0,0,0,1,2,0,3,3,2,0,5,7,4,0,11,9,4,0,13
11209,291,"CĂMINULCULTURAL SÎRBI",SÎRBI,AR,81,1,2,0,3,1,3,0,4,1,3,0,4,3,3,0,6,3,3,0,6
11218,292,"ŞCOALA PRIMARĂ TÎRNĂVIŢA",TÎRNĂVIŢA,AR,122,1,0,0,1,1,0,0,1,2,0,0,2,3,1,0,4,6,3,0,9
11245,293,"CĂMINULCULTURAL HĂŞMAŞ",HĂŞMAŞ,AR,350,14,1,0,15,17,1,0,18,24,1,0,25,29,5,0,34,31,5,0,36
11281,294,"CĂMINUL CULTURAL COMĂNEŞTI",COMĂNEŞTI,AR,86,2,1,0,3,5,1,0,6,9,4,0,13,10,4,0,14,11,5,0,16
11254,295,"CĂMINUL CULTURAL AGRIŞU MIC","AGRIŞU MIC",AR,140,9,2,0,11,11,3,0,14,14,4,0,18,21,4,0,25,21,4,0,25
11263,296,"CĂMINUL CULTURAL BOTFEI",BOTFEI,AR,194,6,1,0,7,17,1,0,18,24,1,0,25,30,1,0,31,36,4,0,40
11290,297,"CĂMINUL CULTURAL URVIŞU DE BELIU","URVIŞU DE BELIU",AR,179,2,0,0,2,5,0,0,5,9,0,0,9,15,2,0,17,21,2,0,23
11272,298,"CĂMINULCULTURAL CLIT",CLIT,AR,59,2,2,0,4,3,3,0,6,4,3,0,7,4,3,0,7,4,3,0,7
11316,299,"CĂMINUL CULTURAL IGNEŞTI",IGNEŞTI,AR,230,5,2,0,7,7,2,0,9,11,2,0,13,12,3,0,15,17,5,0,22
11325,300,"CLĂDIREA FOSTEI ȘCOLI PRIMARE MINEAD",MINEAD,AR,79,0,1,0,1,2,1,0,3,5,2,0,7,7,5,0,12,8,5,0,13
11334,301,"CĂMINUL CULTURAL NĂDĂLBEȘTI",NĂDĂLBEŞTI,AR,101,0,0,0,0,0,0,0,0,1,4,0,5,1,4,0,5,2,5,0,7
11343,302,"ȘCOALA PRIMARĂ SUSANI",SUSANI,AR,177,4,1,0,5,7,1,0,8,9,2,0,11,15,2,0,17,17,2,0,19
11361,303,"CONSILIUL LOCAL IRATOŞU",IRATOŞU,AR,1618,2,1,0,3,11,2,0,13,23,3,0,26,36,6,0,42,39,8,0,47
11370,304,"ŞCOALA GIMNAZIALĂ VARIAŞU MARE","VARIAŞU MARE",AR,416,0,0,0,0,4,3,0,7,4,3,0,7,11,5,0,16,11,5,0,16
11389,305,"ŞCOALA GIMNAZIALĂ VARIAŞU MIC","VARIAŞU MIC",AR,103,4,1,0,5,5,1,0,6,6,1,0,7,7,1,0,8,7,2,0,9
9342,306,"ŞCOALA GIMNAZIALĂ LIVADA",LIVADA,AR,1583,10,5,0,15,32,6,0,38,58,9,0,67,88,12,1,101,116,12,1,129
9351,307,"ŞCOALA GIMNAZIALĂ SÎNLEANI",SÎNLEANI,AR,1433,10,0,0,10,35,0,0,35,51,1,0,52,84,2,0,86,96,4,0,100
11405,308,"ŞCOALA GIMNAZIALĂ PAVEL COVACI MACEA",MACEA,AR,1830,13,0,0,13,37,0,0,37,60,0,0,60,74,3,0,77,83,3,0,86
11405,309,"ŞCOALA GIMNAZIALĂ PAVEL COVACI MACEA",MACEA,AR,1923,2,1,0,3,10,5,0,15,14,7,0,21,27,7,0,34,37,9,0,46
11414,310,"ŞCOALA GIMNAZIALĂ PAVEL COVACI MACEA",SÎNMARTIN,AR,1139,8,2,0,10,16,6,0,22,27,8,0,35,35,8,0,43,46,9,0,55
11414,311,"ŞCOALA GIMNAZIALĂ PAVEL COVACI MACEA",SÎNMARTIN,AR,1015,0,5,0,5,8,5,0,13,10,6,0,16,20,6,0,26,22,8,0,30
11432,312,"CĂMINUL CULTURAL MIȘCA",MIŞCA,AR,1019,4,0,0,4,16,1,0,17,20,2,0,22,31,4,0,35,42,6,0,48
11441,313,"CLĂDIREAPRIMĂRIEIDINSATULSATU NOU","SATU NOU",AR,674,0,0,0,0,11,0,0,11,11,0,0,11,13,0,0,13,13,0,0,13
11450,314,CLĂDIREAPRIMĂRIEIDINSATULVÎNĂTORI,VÎNĂTORI,AR,919,0,0,0,0,5,0,0,5,6,0,0,6,6,1,0,7,6,1,0,7
11469,315,"ŞCOALA PRIMARĂ DIN SATUL ZERINDU MIC","ZERINDU MIC",AR,143,2,0,0,2,5,0,0,5,7,0,0,7,8,1,0,9,8,1,0,9
11487,316,"ȘCOALA GENERALĂ „GHEORGHE GROZA”",MONEASA,AR,585,6,4,0,10,16,75,0,91,22,109,0,131,37,119,0,156,41,126,0,167
11496,317,"ŞCOALA PRIMARĂ RĂNUŞA",RĂNUŞA,AR,199,4,1,0,5,8,2,0,10,12,2,0,14,15,6,0,21,18,6,0,24
11511,318,"PRIMĂRIA COMUNEI OLARI",OLARI,AR,1288,3,1,0,4,14,1,0,15,16,2,0,18,22,2,0,24,23,2,0,25
11520,319,"ŞCOALA PRIMARĂ SINTEA MICĂ","SINTEA MICĂ",AR,328,0,0,0,0,2,0,0,2,3,0,0,3,4,2,0,6,4,2,0,6
11548,320,"PRIMĂRIA COMUNEI PĂULIŞ",PĂULIŞ,AR,1538,14,1,0,15,33,8,0,41,44,16,0,60,63,24,0,87,71,30,0,101
11575,321,"CĂMINUL CULTURAL SÎMBĂTENI",SÎMBĂTENI,AR,1588,39,0,0,39,121,5,0,126,152,6,0,158,219,12,0,231,245,18,0,263
11566,322,"CĂMINUL CULTURAL CLADOVA",CLADOVA,AR,251,0,0,0,0,5,2,0,7,7,5,0,12,11,6,0,17,13,7,0,20
11557,323,"CENTRUL LOCAL DE INFORMARE TURISTICĂ BARAŢCA",BARAŢCA,AR,205,2,1,0,3,6,1,0,7,7,1,0,8,9,1,0,10,10,1,0,11
11646,324,"PRIMĂRIA COMUNEI PEREGU MARE","PEREGU MARE",AR,773,6,2,0,8,8,2,0,10,10,3,0,13,10,3,0,13,11,3,0,14
11655,325,"CLĂDIREA PRIMĂRIEI DIN SATUL PEREGU MIC","PEREGU MIC",AR,799,8,1,0,9,14,1,0,15,22,1,0,23,26,4,0,30,26,4,0,30
11673,326,"PRIMĂRIA PETRIŞ",PETRIŞ,AR,367,3,3,0,6,6,4,0,10,8,4,0,12,13,6,0,19,16,6,0,22
11691,327,"CĂMINUL CULTURAL ILTEU",ILTEU,AR,197,4,0,0,4,5,3,0,8,5,4,0,9,9,4,0,13,10,4,0,14
11726,328,"CĂMINUL CULTURAL SELIŞTE",SELIŞTE,AR,97,0,0,0,0,4,0,0,4,5,0,0,5,7,0,0,7,7,0,0,7
11682,329,"CĂMINUL CULTURAL CORBEŞTI",CORBEŞTI,AR,152,2,0,0,2,5,0,0,5,7,0,0,7,10,0,0,10,14,3,0,17
11717,330,"CĂMINUL CULTURAL ROŞIA NOUĂ","ROŞIA NOUĂ",AR,230,2,0,0,2,3,0,0,3,8,2,0,10,13,3,0,16,18,7,0,25
11708,331,"CĂMINUL CULTURAL OBÎRŞIA",OBÎRŞIA,AR,93,4,1,0,5,4,1,0,5,4,1,0,5,4,1,0,5,4,1,0,5
11744,332,"PRIMĂRIA COMUNEI PILU",PILU,AR,869,8,0,0,8,12,0,0,12,16,0,0,16,26,2,0,28,33,2,0,35
11753,333,"ŞCOALA GIMNAZIALĂ VĂRȘAND",VĂRŞAND,AR,770,6,1,0,7,8,1,0,9,13,1,0,14,14,1,0,15,14,1,0,15
11771,334,"PRIMĂRIA COMUNEI PLEŞCUŢA",PLEŞCUŢA,AR,246,3,0,0,3,7,0,0,7,13,0,0,13,14,3,0,17,15,3,0,18
11833,335,"CĂMINUL CULTURAL TĂLAGIU",TĂLAGIU,AR,322,7,1,0,8,11,2,0,13,11,2,0,13,15,4,0,19,21,4,0,25
11780,336,"CĂMINUL CULTURAL ACIUŢA",ACIUŢA,AR,181,2,0,0,2,10,2,0,12,11,3,0,14,15,3,0,18,15,3,0,18
11815,337,"CĂMINUL CULTURAL GURA VĂII","GURA VĂII",AR,229,2,0,0,2,2,0,0,2,5,0,0,5,8,2,0,10,12,2,0,14
11851,338,"PRIMĂRIA COMUNEI SĂVÂRŞIN",SĂVÎRŞIN,AR,1281,11,3,0,14,33,11,0,44,40,12,0,52,59,12,0,71,68,12,0,80
11897,339,"ŞCOALA PRIMARĂ PÎRNEŞTI",PÎRNEŞTI,AR,144,1,0,0,1,2,0,0,2,2,0,0,2,3,0,0,3,4,0,0,4
11922,340,"ŞCOALA PRIMARĂ TROAŞ",TROAŞ,AR,142,7,0,0,7,8,1,0,9,8,3,0,11,10,4,0,14,12,4,0,16
11904,341,"CĂMINUL CULTURAL TEMEŞEŞTI",TEMEŞEŞTI,AR,112,5,3,0,8,7,3,0,10,9,3,0,12,12,3,0,15,12,3,0,15
11913,342,"ŞCOALA PRIMARĂ TOC",TOC,AR,350,5,2,0,7,11,2,0,13,11,2,0,13,11,2,0,13,13,3,0,16
11860,343,"ŞCOALA PRIMARĂ CĂPRIOARA",CĂPRIOARA,AR,215,6,2,0,8,14,4,0,18,17,4,0,21,18,4,0,22,18,5,0,23
11931,344,"CĂMIN CULTURAL VALEA MARE","VALEA MARE",AR,184,3,0,0,3,6,3,0,9,6,3,0,9,10,4,0,14,12,4,0,16
11959,345,"PRIMĂRIA COMUNEI SECUSIGIU",SECUSIGIU,AR,880,18,0,0,18,26,8,0,34,35,9,0,44,46,11,0,57,48,11,0,59
11959,346,"ȘCOALA GIMNAZIALĂ SECUSIGIU",SECUSIGIU,AR,954,8,1,0,9,17,4,0,21,29,4,0,33,38,5,0,43,46,7,0,53
11977,347,"CLĂDIREA PRIMĂRIEI DIN SATU MARE","SATU MARE",AR,812,4,0,0,4,12,3,0,15,14,5,0,19,21,7,0,28,23,7,0,30
11968,348,"CĂMINUL CULTURAL MUNAR",MUNAR,AR,416,4,0,0,4,4,1,0,5,6,1,0,7,11,2,0,13,11,2,0,13
11986,349,"REMIZA P.S.I SÎNPETRU GERMAN","SÎNPETRU GERMAN",AR,871,10,2,0,12,16,2,0,18,22,2,0,24,30,2,0,32,36,2,0,38
11986,350,"ȘCOALA GIMNAZIALĂ SÎNPETRU GERMAN","SÎNPETRU GERMAN",AR,875,8,2,0,10,16,5,0,21,21,5,0,26,25,5,0,30,31,5,0,36
12000,351,"PRIMĂRIA COMUNEI SELEUŞ",SELEUŞ,AR,1534,26,0,0,26,58,6,0,64,69,7,0,76,100,18,0,118,106,19,0,125
12019,352,"ŞCOALA PRIMARĂ IERMATA",IERMATA,AR,333,6,2,0,8,23,2,0,25,34,3,0,37,41,5,0,46,45,5,0,50
12028,353,"CĂMINUL CULTURAL MORODA",MORODA,AR,581,6,3,0,9,10,3,0,13,16,3,0,19,34,5,0,39,39,5,0,44
12046,354,"ȘCOALA GIMNAZIALĂ „DR. IOAN DANICICO”",SEMLAC,AR,1739,17,3,0,20,35,4,0,39,42,5,0,47,57,5,0,62,69,6,0,75
12046,355,"ȘCOALA GIMNAZIALĂ SEMLAC",SEMLAC,AR,1637,5,0,0,5,18,0,0,18,29,4,0,33,34,5,0,39,42,5,0,47
12064,356,"CĂMINUL CULTURAL SINTEA MARE","SINTEA MARE",AR,1028,6,0,0,6,12,0,0,12,16,0,0,16,19,0,0,19,27,0,0,27
12073,357,"ŞCOALA GIMNAZIALĂ ,,OLOSZ LAJOS"" ADEA",ADEA,AR,843,4,0,0,4,7,0,0,7,7,0,0,7,14,0,0,14,14,0,0,14
12082,358,"CLĂDIREA ADMINISTRATIVĂ A PRIMĂRIEI SINTEA MARE",ŢIPAR,AR,1140,1,0,0,1,7,4,0,11,11,4,0,15,15,4,0,19,16,4,0,20
12135,359,"PRIMĂRIA COMUNEI SOCODOR",SOCODOR,AR,905,13,0,0,13,23,0,0,23,28,1,0,29,41,2,0,43,51,2,0,53
12135,360,"CĂMINUL CULTURAL SOCODOR",SOCODOR,AR,905,5,0,0,5,9,0,0,9,17,0,0,17,25,2,0,27,29,2,0,31
12153,361,"PRIMĂRIA COMUNEI ȘAGU",ŞAGU,AR,1226,7,0,0,7,10,0,0,10,19,0,0,19,37,1,0,38,37,1,0,38
12153,362,"PRIMĂRIA COMUNEI ȘAGU",ŞAGU,AR,601,3,0,0,3,7,3,0,10,11,4,0,15,19,5,0,24,21,8,0,29
12162,363,"ŞCOALA GENERALĂ",CRUCENI,AR,601,3,0,0,3,6,0,0,6,9,0,0,9,23,0,0,23,26,0,0,26
12171,364,"ŞCOALA GENERALĂ",FIRITEAZ,AR,380,8,2,0,10,15,2,0,17,17,3,0,20,19,5,0,24,20,5,0,25
12180,365,"ŞCOALA GIMNAZIALĂ",FISCUT,AR,456,1,0,0,1,5,0,0,5,10,0,0,10,18,1,0,19,20,5,0,25
12199,366,"CĂMINUL CULTURAL HUNEDOARA TIMIȘANĂ","HUNEDOARA TIMIŞANĂ",AR,159,2,1,0,3,6,2,0,8,6,2,0,8,9,2,0,11,9,2,0,11
12215,367,"PRIMĂRIA COMUNEI ȘEITIN",ŞEITIN,AR,1219,5,1,0,6,15,2,0,17,19,4,0,23,30,4,0,34,33,4,0,37
12215,368,"ȘCOALA GIMNAZIALĂ „ȘTEFAN BOZIAN” ȘEITIN",ŞEITIN,AR,1234,8,0,0,8,18,4,0,22,23,4,0,27,34,5,0,39,36,5,0,41
12233,369,"ŞCOALA GIMNAZIALĂ ,,MIHAI VELICIU""",ŞEPREUŞ,AR,975,13,0,0,13,19,0,0,19,20,0,0,20,25,1,0,26,34,1,0,35
12233,370,"ŞCOALA GIMNAZIALĂ ,,MIHAI VELICIU""",ŞEPREUŞ,AR,1182,14,0,0,14,22,0,0,22,30,0,0,30,34,0,0,34,42,0,0,42
12279,371,"ŞCOALA GIMNAZIALĂ GURBA",GURBA,AR,918,4,2,0,6,9,2,0,11,14,2,0,16,22,5,0,27,25,5,0,30
12260,372,"ŞCOALA GIMNAZIALĂ CHERELUȘ",CHERELUŞ,AR,758,12,0,0,12,22,0,0,22,27,2,0,29,36,2,0,38,38,2,0,40
12251,373,"CĂMINUL CULTURAL ȘICULA",ŞICULA,AR,931,16,1,0,17,27,4,0,31,39,8,0,47,56,8,0,64,68,10,0,78
12251,374,"ȘCOALA GIMNAZIALĂ ȘICULA",ŞICULA,AR,923,6,0,0,6,11,0,0,11,20,0,0,20,30,0,0,30,43,2,0,45
12297,375,"CĂMINUL CULTURAL ȘILINDIA",ŞILINDIA,AR,711,5,0,0,5,12,2,0,14,15,3,0,18,22,7,0,29,27,7,0,34
12359,376,"ȘCOALA GIMNAZIALĂ ŞIMAND",ŞIMAND,AR,1388,3,0,0,3,25,3,0,28,42,4,0,46,55,5,0,60,62,5,0,67
12359,377,"ȘCOALA PRIMARĂ ŞIMAND",ŞIMAND,AR,1227,4,0,0,4,14,1,0,15,15,2,0,17,20,3,0,23,24,5,0,29
12359,378,"ȘCOALA GIMNAZIALĂ ȘIMAND - GRĂDINIȚA CU PROGRAM NORMAL NR.2",ŞIMAND,AR,795,3,2,0,5,9,3,0,12,18,3,0,21,30,3,0,33,40,3,0,43
12377,379,"CĂMINUL CULTURAL ȘIRIA",ŞIRIA,AR,1385,2,3,0,5,15,3,0,18,27,11,0,38,41,14,0,55,44,16,0,60
12377,380,"CĂMINUL CULTURAL ȘIRIA",ŞIRIA,AR,1339,6,5,0,11,14,5,0,19,19,5,0,24,21,5,0,26,36,5,0,41
12386,381,"CĂMINUL CULTURAL GALȘA",GALŞA,AR,1885,5,0,0,5,26,2,0,28,40,3,0,43,63,4,0,67,70,6,0,76
12395,382,"CĂMINUL CULTURAL MÎSCA",MÎSCA,AR,755,13,3,0,16,35,5,0,40,45,6,0,51,54,6,0,60,59,8,0,67
12377,383,"CLĂDIRE ADMINISTRATIVĂ(FOSTA ȘCOALA GIMNAZIALĂ)",ŞIRIA,AR,1750,5,0,0,5,10,0,0,10,16,0,0,16,21,2,0,23,33,2,0,35
12411,384,"PRIMĂRIA COMUNEI ȘIȘTAROVĂȚ",ŞIŞTAROVĂŢ,AR,273,10,1,0,11,13,1,0,14,22,9,0,31,28,10,0,38,28,13,0,41
9379,385,"CĂMINUL CULTURAL ŞOFRONEA",ŞOFRONEA,AR,1800,16,2,0,18,64,4,0,68,85,7,0,92,108,8,0,116,119,13,0,132
9388,386,"CĂMINUL CULTURALSÎNPAUL",SÎNPAUL,AR,598,2,0,0,2,11,0,0,11,12,0,0,12,19,0,0,19,20,7,0,27
12475,387,"ŞCOALA PRIMARĂ MINIŞEL",MINIŞEL,AR,125,2,1,0,3,4,1,0,5,4,4,0,8,5,5,0,10,6,5,0,11
12466,388,"CĂMINUL CULTURAL TAUŢ",TAUŢ,AR,577,13,0,0,13,14,11,0,25,17,11,0,28,20,12,0,32,25,12,0,37
12493,389,"CĂMINUL CULTURAL NADĂŞ",NADĂŞ,AR,628,4,0,0,4,8,0,0,8,8,0,0,8,12,3,0,15,17,3,0,20
12484,390,"CĂMINUL CULTURAL MINIŞU DE SUS","MINIŞU DE SUS",AR,55,2,0,0,2,2,0,0,2,8,1,0,9,10,1,0,11,10,1,0,11
12518,391,"CĂMINUL CULTURAL TÎRNOVA",TÎRNOVA,AR,1492,31,3,0,34,72,5,0,77,101,7,0,108,124,9,0,133,137,11,0,148
12545,392,"CĂMINUL CULTURAL CHIER",CHIER,AR,971,13,2,0,15,37,8,0,45,55,11,0,66,75,12,0,87,75,13,0,88
12527,393,"CĂMINUL CULTURAL AGRIŞU MARE","AGRIŞU MARE",AR,909,10,2,0,12,41,4,0,45,52,5,0,57,71,5,0,76,76,5,0,81
12536,394,"CĂMINUL CULTURAL ARĂNEAG",ARĂNEAG,AR,332,7,5,0,12,10,8,0,18,13,8,0,21,16,8,0,24,17,9,0,26
12554,395,"CĂMINUL CULTURAL DRAUŢ",DRAUŢ,AR,680,12,1,0,13,23,2,0,25,28,2,0,30,36,5,0,41,38,5,0,43
12563,396,"CĂMINUL CULTURAL DUD",DUD,AR,544,14,2,0,16,32,2,0,34,44,5,0,49,59,5,0,64,78,6,0,84
10809,397,"ŞCOALA GIMNAZIALĂ ""TEODOR PĂCĂŢIAN"" USUSĂU",USUSĂU,AR,486,5,0,0,5,15,3,0,18,17,3,0,20,29,5,0,34,33,5,0,38
10774,398,"GRĂDINIŢA CU PROGRAM NORMAL DORGOŞ",DORGOŞ,AR,234,3,0,0,3,5,2,0,7,5,3,0,8,11,3,0,14,13,3,0,16
10818,399,"ŞCOALA PRIMARĂ ZĂBALŢ",ZĂBALŢ,AR,239,5,1,0,6,7,1,0,8,13,3,0,16,16,3,0,19,21,3,0,24
10783,400,"GRĂDINIŢA CU PROGRAM NORMAL BRUZNIC",BRUZNIC,AR,90,0,2,0,2,1,4,0,5,1,5,0,6,1,6,0,7,4,6,0,10
12581,401,"CĂMINUL CULTURAL VĂRĂDIA DE MUREȘ","VĂRĂDIA DE MUREŞ",AR,481,5,1,0,6,7,1,0,8,16,3,0,19,21,3,0,24,28,5,0,33
12616,402,"CĂMINUL CULTURAL LUPEȘTI",LUPEŞTI,AR,222,7,2,0,9,12,2,0,14,13,2,0,15,20,2,0,22,25,5,0,30
12590,403,"CĂMINUL CULTURAL BAIA",BAIA,AR,102,2,2,0,4,2,2,0,4,3,2,0,5,4,5,0,9,6,5,0,11
12607,404,"ŞCOALA PRIMARĂ JULIȚA",JULIŢA,AR,300,2,3,0,5,5,4,0,9,6,5,0,11,8,5,0,13,16,6,0,22
12625,405,"CĂMINUL CULTURAL NICOLAE BĂLCESCU","NICOLAE BĂLCESCU",AR,197,0,1,0,1,2,1,0,3,2,1,0,3,5,2,0,7,5,4,0,9
12634,406,"CĂMINUL CULTURAL STEJAR",STEJAR,AR,117,1,0,0,1,4,3,0,7,7,4,0,11,8,4,0,12,10,5,0,15
12652,407,"PRIMĂRIA COMUNEI VINGA",VINGA,AR,914,6,2,0,8,13,3,0,16,26,4,0,30,32,4,0,36,33,4,0,37
12652,408,"ŞCOALA GIMNAZIALĂ NR. 2 VINGA",VINGA,AR,1258,5,0,0,5,10,1,0,11,17,2,0,19,27,3,0,30,29,4,0,33
12652,409,"GRĂDINIŢA PN VINGA",VINGA,AR,1589,8,0,0,8,16,0,0,16,18,0,0,18,23,0,0,23,26,0,0,26
12661,410,"ŞCOALA GENERALĂ MAILAT",MAILAT,AR,800,1,0,0,1,7,2,0,9,10,7,0,17,19,8,0,27,21,8,0,29
12670,411,"ŞCOALA GENERALĂ MĂNĂŞTUR",MĂNĂŞTUR,AR,983,4,0,0,4,13,4,0,17,15,4,0,19,18,4,0,22,21,4,0,25
12698,412,"CĂMINUL CULTURAL VÎRFURILE",VÎRFURILE,AR,995,4,0,0,4,11,2,0,13,16,8,0,24,23,8,0,31,24,9,0,33
12705,413,"ŞCOALA GENERALĂ AVRAM IANCU","AVRAM IANCU",AR,649,1,0,0,1,2,1,0,3,5,1,0,6,9,5,0,14,9,5,0,14
12723,414,"CĂMIN CULTURAL LAZURI",LAZURI,AR,653,2,0,0,2,4,1,0,5,5,1,0,6,13,1,0,14,15,1,0,16
9431,415,"ŞCOALA GIMNAZIALĂ MÎNDRULOC",MÎNDRULOC,AR,1138,9,2,0,11,24,2,0,26,34,4,0,38,53,5,0,58,69,5,0,74
9413,416,"ŞCOALA GIMNAZIALĂ CICIR",CICIR,AR,851,7,0,0,7,19,1,0,20,28,3,0,31,39,4,0,43,45,6,0,51
9404,417,"CĂMINUL CULTURAL VLADIMIRESCU",VLADIMIRESCU,AR,1860,7,0,0,7,26,3,0,29,40,5,0,45,66,7,0,73,71,7,0,78
9404,418,"PRIMĂRIA COMUNEI VLADIMIRESCU",VLADIMIRESCU,AR,1558,7,1,0,8,37,5,0,42,61,6,0,67,67,9,0,76,83,10,0,93
9404,419,"CENTRU DE ZI VÂRSTNICI VLADIMIRESCU",VLADIMIRESCU,AR,1753,11,0,0,11,40,1,0,41,60,1,0,61,93,2,0,95,109,4,0,113
9404,420,"ȘCOALA GIMNAZIALĂ VLADIMIRESCU",VLADIMIRESCU,AR,1879,18,0,0,18,40,1,0,41,60,7,0,67,78,8,0,86,98,10,0,108
9422,421,"ȘCOALA GIMNAZIALĂ HORIA",HORIA,AR,1051,5,0,0,5,25,0,0,25,40,5,0,45,48,7,0,55,57,9,0,66
9422,422,"CLĂDIRE TAXE ŞI IMPOZITE HORIA",HORIA,AR,1098,13,4,0,17,22,7,0,29,35,7,0,42,47,7,0,54,54,8,0,62
12803,423,"CĂMIN CULTURAL",NEUDORF,AR,848,4,0,0,4,7,2,0,9,9,2,0,11,12,2,0,14,17,2,0,19
12787,424,"CĂMIN CULTURAL ZĂBRANI",ZĂBRANI,AR,1011,8,3,0,11,17,4,0,21,20,4,0,24,33,5,0,38,47,6,0,53
12787,425,"GRĂDINIŢA CU PROGRAM NORMAL ZĂBRANI",ZĂBRANI,AR,908,5,0,0,5,21,0,0,21,32,0,0,32,40,0,0,40,46,1,0,47
12796,426,"GRĂDINIŢA PROGRAM NORMALCHESINŢ",CHESINŢ,AR,957,5,0,0,5,16,0,0,16,19,1,0,20,33,1,0,34,38,2,0,40
10845,427,"CĂMINUL CULTURAL BODROGU NOU, NR. 68","BODROGU NOU",AR,231,4,0,0,4,15,3,0,18,24,5,0,29,25,7,0,32,26,10,0,36
10863,428,"SALA DE ŞEDINŢE A CONSILIULUI LOCAL ZĂDĂRENI",ZĂDĂRENI,AR,999,10,3,0,13,25,4,0,29,33,4,0,37,47,6,0,53,63,6,0,69
10863,429,"SEDIU S.V.S.U. ZĂDĂRENI",ZĂDĂRENI,AR,1094,11,2,0,13,31,2,0,33,40,3,0,43,73,4,0,77,73,5,0,78
12830,430,"ŞCOALA GIMNAZIALĂ CINTEI",CINTEI,AR,968,2,0,0,2,21,2,0,23,34,4,0,38,68,15,0,83,79,18,0,97
12821,431,"PRIMĂRIA COMUNEI ZĂRAND",ZĂRAND,AR,1144,7,0,0,7,15,0,0,15,23,0,0,23,30,0,0,30,34,2,0,36
12858,432,"PRIMĂRIA COMUNEI ZERIND",ZERIND,AR,713,1,0,0,1,3,0,0,3,3,0,0,3,6,2,0,8,6,4,0,10
12867,433,"ŞCOALA PRIMARA IERMATA NEAGRA","IERMATA NEAGRĂ",AR,465,0,0,0,0,2,0,0,2,6,3,0,9,7,3,0,10,7,3,0,10
12885,434,"CĂMINULCULTURAL ZIMANDU NOU","ZIMANDU NOU",AR,1409,9,0,0,9,15,0,0,15,18,1,0,19,28,2,0,30,30,2,0,32
12894,435,"CĂMINUL CULTURAL ANDREI ȘAGUNA","ANDREI ŞAGUNA",AR,1253,5,0,0,5,12,1,0,13,25,3,0,28,41,3,0,44,49,3,0,52
12901,436,"ŞCOALA PRIMARĂ ZIMANDCUZ",ZIMANDCUZ,AR,1354,6,0,0,6,16,7,0,23,35,9,0,44,44,11,0,55,45,11,0,56
12885,437,"ȘCOALA GIMNAZIALĂ ZIMANDU NOU (UTVINIȘ)","ZIMANDU NOU",AR,107,6,2,0,8,10,2,0,12,10,4,0,14,11,5,0,16,11,7,0,18
179141,1,"LICEUL TEORETIC ""NICOLAE IORGA""","BUCUREŞTI SECTORUL 1",B,1320,16,3,0,19,59,10,0,69,97,20,0,117,106,20,0,126,120,20,0,140
179141,2,"LICEUL TEORETIC ""NICOLAE IORGA""","BUCUREŞTI SECTORUL 1",B,1583,18,0,0,18,81,3,0,84,103,5,0,108,142,10,0,152,149,12,0,161
179141,3,"LICEUL TEORETIC ""NICOLAE IORGA""","BUCUREŞTI SECTORUL 1",B,1398,22,1,0,23,96,3,0,99,125,6,0,131,147,9,0,156,147,9,0,156
179141,4,"LICEUL TEORETIC ""NICOLAE IORGA""","BUCUREŞTI SECTORUL 1",B,1095,17,0,0,17,50,0,0,50,75,6,0,81,96,9,0,105,101,9,0,110
179141,5,"LICEUL GRECO-CATOLIC ""TIMOTEI CIPARIU""","BUCUREŞTI SECTORUL 1",B,1624,14,0,0,14,34,0,0,34,56,4,0,60,95,8,0,103,103,8,0,111
179141,6,"LICEUL GRECO-CATOLIC ""TIMOTEI CIPARIU""","BUCUREŞTI SECTORUL 1",B,1022,10,1,0,11,25,3,0,28,46,3,0,49,55,3,0,58,57,3,0,60
179141,7,"LICEUL GRECO-CATOLIC ""TIMOTEI CIPARIU""","BUCUREŞTI SECTORUL 1",B,1313,9,1,0,10,28,1,0,29,44,3,0,47,55,6,0,61,69,6,0,75
179141,8,"ȘCOALA GIMNAZIALĂ NR.13","BUCUREŞTI SECTORUL 1",B,957,7,0,0,7,25,0,0,25,26,0,0,26,39,0,0,39,42,0,0,42
179141,9,"ŞCOALA GIMNAZIALĂ NR.13","BUCUREŞTI SECTORUL 1",B,1000,6,0,0,6,24,0,0,24,30,0,0,30,49,0,0,49,54,0,0,54
179141,10,"ŞCOALA GIMNAZIALĂ NR.13","BUCUREŞTI SECTORUL 1",B,1577,4,0,0,4,19,1,0,20,34,1,0,35,45,4,0,49,51,4,0,55
179141,11,"ŞCOALA GIMNAZIALĂ NR.13","BUCUREŞTI SECTORUL 1",B,934,7,0,0,7,24,2,0,26,38,2,0,40,49,5,0,54,56,5,0,61
179141,12,"ŞCOALA GIMNAZIALĂ NR.179","BUCUREŞTI SECTORUL 1",B,1420,9,2,0,11,34,5,0,39,52,5,0,57,63,10,0,73,64,10,0,74
179141,13,"ŞCOALA GIMNAZIALĂ NR.179","BUCUREŞTI SECTORUL 1",B,1842,9,1,0,10,39,1,0,40,78,3,0,81,94,4,0,98,99,5,0,104
179141,14,"ŞCOALA GIMNAZIALĂ NR.179","BUCUREŞTI SECTORUL 1",B,1028,11,0,0,11,27,0,0,27,44,1,0,45,59,1,0,60,62,2,0,64
179141,15,"ŞCOALA GIMNAZIALĂ NR.179","BUCUREŞTI SECTORUL 1",B,1753,2,0,0,2,53,1,0,54,83,5,0,88,103,5,0,108,117,5,0,122
179141,16,"LICEUL TEORETIC ""C-TIN BRÂNCOVEANU""","BUCUREŞTI SECTORUL 1",B,1616,15,5,0,20,49,13,0,62,92,20,0,112,110,23,0,133,124,25,0,149
179141,17,"LICEUL TEORETIC ""C-TIN BRÂNCOVEANU""","BUCUREŞTI SECTORUL 1",B,926,14,4,0,18,40,4,0,44,59,5,0,64,80,5,0,85,85,5,0,90
179141,18,"LICEUL TEORETIC ""C-TIN BRÂNCOVEANU""","BUCUREŞTI SECTORUL 1",B,1020,13,1,0,14,51,1,0,52,71,2,0,73,83,2,0,85,88,2,0,90
179141,19,"LICEUL TEORETIC ""C-TIN BRÂNCOVEANU""","BUCUREŞTI SECTORUL 1",B,1468,18,3,0,21,55,5,0,60,105,7,0,112,129,8,0,137,140,8,0,148
179141,20,"ȘCOALA GIMNAZIALĂ NR.178","BUCUREŞTI SECTORUL 1",B,1453,17,0,0,17,59,1,0,60,87,3,0,90,116,15,0,131,139,19,0,158
179141,21,"ŞCOALA GIMNAZIALĂ NR.178","BUCUREŞTI SECTORUL 1",B,1374,23,0,0,23,61,5,0,66,100,6,0,106,110,7,0,117,123,7,0,130
179141,22,"ŞCOALA GIMNAZIALĂ NR.178","BUCUREŞTI SECTORUL 1",B,1064,11,0,0,11,47,1,0,48,61,4,0,65,76,4,0,80,81,4,0,85
179141,23,"ŞCOALA GIMNAZIALĂ SPECIALĂ NR.8","BUCUREŞTI SECTORUL 1",B,1411,5,0,0,5,21,1,0,22,48,3,0,51,75,9,0,84,82,9,0,91
179141,24,"ŞCOALA GIMNAZIALĂ SPECIALĂ NR.8","BUCUREŞTI SECTORUL 1",B,1656,7,0,0,7,28,3,0,31,48,7,0,55,77,14,0,91,87,14,0,101
179141,25,"ȘCOALA GIMNAZIALĂ SPECIALĂ NR.8","BUCUREŞTI SECTORUL 1",B,1571,9,3,0,12,37,4,0,41,57,6,0,63,88,7,0,95,106,7,0,113
179141,26,"ŞCOALA GIMNAZIALĂ ""NICOLAE GRIGORESCU""","BUCUREŞTI SECTORUL 1",B,1943,17,3,0,20,48,8,0,56,91,13,0,104,122,16,0,138,135,17,0,152
179141,27,"ŞCOALA GIMNAZIALĂ ""NICOLAE GRIGORESCU""","BUCUREŞTI SECTORUL 1",B,1950,19,0,0,19,47,1,0,48,69,8,0,77,96,8,0,104,113,8,0,121
179141,28,"CENTRUL SOCIAL SF. LAZĂR","BUCUREŞTI SECTORUL 1",B,1577,16,1,0,17,39,4,0,43,57,7,0,64,86,8,0,94,88,8,0,96
179141,29,"CENTRUL SOCIAL SF. LAZĂR","BUCUREŞTI SECTORUL 1",B,1029,3,0,0,3,14,7,0,21,30,9,0,39,39,15,0,54,46,18,0,64
179141,30,"CENTRUL SOCIAL SF. LAZĂR","BUCUREŞTI SECTORUL 1",B,1458,5,4,0,9,24,5,0,29,44,5,0,49,69,6,0,75,74,6,0,80
179141,31,"ŞCOALA GIMNAZIALĂ NR.6","BUCUREŞTI SECTORUL 1",B,960,4,5,0,9,11,5,0,16,34,6,0,40,43,9,0,52,51,10,0,61
179141,32,"ŞCOALA GIMNAZIALĂ NR.6","BUCUREŞTI SECTORUL 1",B,1064,10,2,0,12,17,3,0,20,43,3,0,46,59,6,0,65,66,8,0,74
179141,33,"UNIVERSITATEA DE ȘTIINȚE AGRONOMICE ȘI MEDICINĂ VETERINARĂ BUCUREȘTI","BUCUREŞTI SECTORUL 1",B,1369,6,0,0,6,43,7,0,50,77,13,0,90,102,15,0,117,120,62,18,200
179141,34,"UNIVERSITATEA DE ŞTIINŢE AGRONOMICE ŞI MEDICINĂ VETERINARĂ BUCUREŞTI","BUCUREŞTI SECTORUL 1",B,820,8,5,0,13,31,8,0,39,45,12,0,57,49,14,0,63,59,16,0,75
179141,35,"DIRECŢIA PUBLICĂ DE EVIDENŢĂ A PERSOANEI ŞI STARE CIVILĂ SECT.1","BUCUREŞTI SECTORUL 1",B,1126,15,2,0,17,49,3,0,52,67,7,0,74,92,8,0,100,104,12,0,116
179141,36,"ŞCOALA GIMNAZIALĂ NR.7","BUCUREŞTI SECTORUL 1",B,1299,18,0,0,18,59,6,0,65,77,10,0,87,107,15,0,122,115,15,0,130
179141,37,"ŞCOALA GIMNAZIALĂ NR.7","BUCUREŞTI SECTORUL 1",B,1527,27,4,0,31,65,5,0,70,86,6,0,92,112,10,0,122,124,10,0,134
179141,38,"ŞCOALA GIMNAZIALĂ NR.7","BUCUREŞTI SECTORUL 1",B,1444,12,0,0,12,42,0,0,42,55,1,0,56,82,2,0,84,92,5,0,97
179141,39,"COLEGIUL AGRICOL ""VIACESLAV HARNAJ""","BUCUREŞTI SECTORUL 1",B,1437,8,3,0,11,56,5,0,61,67,6,0,73,93,6,0,99,99,6,0,105
179141,40,"COLEGIUL AGRICOL ""VIACESLAV HARNAJ""","BUCUREŞTI SECTORUL 1",B,1348,4,0,0,4,19,0,0,19,30,3,0,33,45,3,0,48,61,4,0,65
179141,41,"ŞCOALA GIMNAZIALĂ ""HERĂSTRĂU""","BUCUREŞTI SECTORUL 1",B,1701,9,1,0,10,47,8,0,55,71,9,1,81,100,20,1,121,120,23,1,144
179141,42,"ŞCOALA GIMNAZIALĂ ""HERĂSTRĂU""","BUCUREŞTI SECTORUL 1",B,938,5,1,0,6,21,1,0,22,40,4,0,44,57,7,0,64,70,7,0,77
179141,43,"ŞCOALA GIMNAZIALĂ ""HERĂSTRĂU""","BUCUREŞTI SECTORUL 1",B,1337,14,2,0,16,41,3,0,44,57,3,0,60,78,5,0,83,91,5,0,96
179141,44,"ŞCOALA GIMNAZIALĂ ""HERĂSTRĂU""","BUCUREŞTI SECTORUL 1",B,1451,13,0,0,13,38,0,0,38,49,2,0,51,78,3,0,81,81,3,0,84
179141,45,"ŞCOALA GIMNAZIALĂ ""HERĂSTRĂU""","BUCUREŞTI SECTORUL 1",B,1515,12,1,0,13,54,4,0,58,73,13,0,86,110,16,0,126,120,17,0,137
179141,46,"ŞCOALA GIMNAZIALĂ ""HERĂSTRĂU""","BUCUREŞTI SECTORUL 1",B,768,4,0,0,4,11,5,0,16,29,9,0,38,45,15,0,60,53,16,0,69
179141,47,"ŞCOALA GIMNAZIALĂ ""HERĂSTRĂU""","BUCUREŞTI SECTORUL 1",B,994,5,0,0,5,32,0,0,32,54,3,0,57,59,3,0,62,65,3,0,68
179141,48,"ŞCOALA GIMNAZIALĂ ""HERĂSTRĂU""","BUCUREŞTI SECTORUL 1",B,1459,9,0,0,9,32,2,0,34,58,5,0,63,65,6,0,71,73,6,0,79
179141,49,"ŞCOALA GIMNAZIALĂ ""HERĂSTRĂU""","BUCUREŞTI SECTORUL 1",B,1364,9,3,0,12,38,4,0,42,63,5,0,68,88,5,0,93,101,6,0,107
179141,50,"ŞCOALA GIMNAZIALĂ ""HERĂSTRĂU""","BUCUREŞTI SECTORUL 1",B,1199,9,5,0,14,30,5,0,35,57,6,0,63,72,7,0,79,79,7,0,86
179141,51,"ŞCOALA GIMNAZIALĂ ""HERĂSTRĂU""","BUCUREŞTI SECTORUL 1",B,1269,5,4,0,9,30,4,0,34,53,5,0,58,72,6,0,78,78,6,0,84
179141,52,"ŞCOALA GIMNAZIALĂ ""HERĂSTRĂU""","BUCUREŞTI SECTORUL 1",B,1165,9,2,0,11,44,3,0,47,68,3,0,71,84,3,0,87,86,3,0,89
179141,53,"ŞCOALA GIMNAZIALĂ ""PIA BRĂTIANU""","BUCUREŞTI SECTORUL 1",B,1285,15,0,0,15,49,9,0,58,74,15,0,89,97,19,0,116,105,21,0,126
179141,54,"ŞCOALA GIMNAZIALĂ ""PIA BRĂTIANU""","BUCUREŞTI SECTORUL 1",B,1243,14,1,0,15,52,2,0,54,67,2,0,69,86,2,0,88,99,2,0,101
179141,55,"COMPLEXUL SOCIAL DE SERVICII ""ODĂI""","BUCUREŞTI SECTORUL 1",B,762,7,0,0,7,32,1,0,33,56,2,0,58,79,4,0,83,79,4,0,83
179141,56,"COLEGIUL NAŢIONAL DE INFORMATICĂ ""TUDOR VIANU""","BUCUREŞTI SECTORUL 1",B,1171,11,3,0,14,57,5,16,78,79,5,16,100,104,5,17,126,109,5,17,131
179141,57,"COLEGIUL NAŢIONAL DE INFORMATICĂ ""TUDOR VIANU""","BUCUREŞTI SECTORUL 1",B,1379,23,0,1,24,51,9,6,66,78,9,7,94,121,9,12,142,128,9,14,151
179141,58,"COLEGIUL NAŢIONAL DE INFORMATICĂ ""TUDOR VIANU""","BUCUREŞTI SECTORUL 1",B,1058,13,2,0,15,43,6,6,55,58,9,6,73,73,13,6,92,84,14,6,104
179141,59,"COLEGIUL NAŢIONAL ""I.L. CARAGIALE""","BUCUREŞTI SECTORUL 1",B,921,9,2,0,11,32,2,0,34,44,7,37,88,58,10,37,105,64,12,40,116
179141,60,"COLEGIUL NAŢIONAL ""I.L. CARAGIALE""","BUCUREŞTI SECTORUL 1",B,1122,13,1,0,14,44,3,0,47,71,7,0,78,94,11,0,105,105,12,0,117
179141,61,"ŞCOALA GIMNAZIALĂ ""TITU MAIORESCU""","BUCUREŞTI SECTORUL 1",B,1482,12,1,0,13,70,3,0,73,112,8,0,120,122,14,0,136,136,14,0,150
179141,62,"ŞCOALA GIMNAZIALĂ ""TITU MAIORESCU""","BUCUREŞTI SECTORUL 1",B,1340,17,3,0,20,66,4,0,70,99,7,0,106,136,9,0,145,146,9,0,155
179141,63,"LICEUL TEORETIC ""JEAN MONNET""","BUCUREŞTI SECTORUL 1",B,1391,28,1,0,29,58,3,0,61,86,4,0,90,113,6,0,119,129,6,0,135
179141,64,"LICEUL TEORETIC ""JEAN MONNET""","BUCUREŞTI SECTORUL 1",B,1222,8,5,0,13,37,10,0,47,40,15,0,55,88,21,0,109,96,27,0,123
179141,65,"COLEGIUL ECONOMIC ""V. MADGEARU""","BUCUREŞTI SECTORUL 1",B,1029,10,1,0,11,57,4,0,61,82,11,0,93,84,14,1,99,92,19,1,112
179141,66,"COLEGIUL ECONOMIC ""V. MADGEARU""","BUCUREŞTI SECTORUL 1",B,1056,12,0,0,12,33,1,0,34,77,4,0,81,93,7,0,100,104,7,0,111
179141,67,"ACADEMIA DE STUDII ECONOMICE DIN BUCUREŞTI","BUCUREŞTI SECTORUL 1",B,970,11,5,0,16,34,11,0,45,50,18,0,68,63,27,0,90,71,31,0,102
179141,68,"ACADEMIA DE STUDII ECONOMICE DIN BUCUREŞTI","BUCUREŞTI SECTORUL 1",B,644,7,2,0,9,28,5,0,33,42,10,0,52,59,17,0,76,68,20,0,88
179141,69,"UNIVERSITATEA DE ARHITECTURĂ ŞI URBANISM ION MINCU","BUCUREŞTI SECTORUL 1",B,906,14,3,0,17,50,8,0,58,69,19,0,88,91,27,0,118,95,32,0,127
179141,70,"UNIVERSITATEA DE ARHITECTURĂ ŞI URBANISM ION MINCU","BUCUREŞTI SECTORUL 1",B,1093,5,0,0,5,26,5,0,31,46,9,0,55,61,13,0,74,69,14,0,83
179141,71,"ŞCOALA GIMNAZIALĂ NR.5","BUCUREŞTI SECTORUL 1",B,1104,9,2,0,11,39,10,0,49,60,15,0,75,82,19,0,101,82,21,0,103
179141,72,"ŞCOALA GIMNAZIALĂ NR.5","BUCUREŞTI SECTORUL 1",B,696,5,0,0,5,19,0,0,19,30,1,0,31,41,1,0,42,48,2,0,50
179141,73,"COLEGIUL NAŢIONAL DE MUZICĂ ""GEORGE ENESCU""","BUCUREŞTI SECTORUL 1",B,1056,9,1,0,10,37,5,0,42,60,12,0,72,78,25,0,103,81,28,0,109
179141,74,"COLEGIUL NAŢIONAL DE MUZICĂ ""GEORGE ENESCU""","BUCUREŞTI SECTORUL 1",B,1297,8,0,0,8,30,0,0,30,54,5,0,59,60,9,0,69,64,9,0,73
179141,75,"COLEGIUL TEHNIC DE ARHITECTURĂ ŞI LUCRĂRI PUBLICE ""IOAN N. SOCOLESCU""","BUCUREŞTI SECTORUL 1",B,974,9,4,0,13,33,5,0,38,49,7,0,56,64,10,0,74,73,13,0,86
179141,76,"COLEGIUL NAŢIONAL ""SFÂNTUL SAVA""","BUCUREŞTI SECTORUL 1",B,786,11,4,0,15,38,10,0,48,50,15,0,65,60,20,0,80,63,22,0,85
179141,77,"COLEGIUL NAŢIONAL ""SFÂNTUL SAVA""","BUCUREŞTI SECTORUL 1",B,951,7,2,0,9,27,4,0,31,40,6,0,46,57,10,0,67,61,10,0,71
179141,78,"COLEGIUL NAŢIONAL ""SFÂNTUL SAVA""","BUCUREŞTI SECTORUL 1",B,1031,15,2,0,17,49,3,0,52,65,5,0,70,86,5,0,91,92,6,0,98
179141,79,"COLEGIUL NAŢIONAL ""SFÂNTUL SAVA""","BUCUREŞTI SECTORUL 1",B,1182,6,0,0,6,39,0,0,39,65,0,0,65,74,2,0,76,81,2,0,83
179141,80,"UNIVERSITATEA NAŢIONALĂ DE MUZICĂ DIN BUCUREŞTI","BUCUREŞTI SECTORUL 1",B,926,9,1,0,10,21,5,0,26,50,5,0,55,62,15,0,77,62,18,0,80
179141,81,"UNIVERSITATEA NAŢIONALĂ DE MUZICĂ DIN BUCUREŞTI","BUCUREŞTI SECTORUL 1",B,921,7,1,0,8,31,5,0,36,64,9,0,73,82,18,0,100,92,18,0,110
179141,82,"LICEUL DE ARTE PLASTICE ""NICOLAE TONITZA""","BUCUREŞTI SECTORUL 1",B,692,2,2,0,4,13,5,0,18,20,5,0,25,28,6,0,34,33,6,0,39
179141,83,"LICEUL DE ARTE PLASTICE ""NICOLAE TONITZA""","BUCUREŞTI SECTORUL 1",B,758,1,5,0,6,15,9,0,24,34,11,0,45,40,12,0,52,41,12,0,53
179141,84,"LICEUL DE ARTE PLASTICE ""NICOLAE TONITZA""","BUCUREŞTI SECTORUL 1",B,1119,14,1,0,15,43,3,0,46,68,4,0,72,87,4,0,91,91,5,0,96
179141,85,"LICEUL DE ARTE PLASTICE ""NICOLAE TONITZA""","BUCUREŞTI SECTORUL 1",B,1229,20,1,0,21,55,3,0,58,85,6,1,92,110,6,1,117,121,6,1,128
179141,86,"LICEUL DE ARTE PLASTICE ""NICOLAE TONITZA""","BUCUREŞTI SECTORUL 1",B,1381,9,0,0,9,63,1,0,64,87,3,0,90,106,4,0,110,116,4,0,120
179141,87,"CENTRUL NAŢIONAL DE CALIFICARE ŞI INSTRUIRE FEROVIARĂ CENAFER","BUCUREŞTI SECTORUL 1",B,1477,12,4,0,16,40,7,0,47,61,16,0,77,81,20,0,101,88,21,0,109
179141,88,"CENTRUL NAŢIONAL DE CALIFICARE ŞI INSTRUIRE FEROVIARĂ CENAFER","BUCUREŞTI SECTORUL 1",B,1214,13,1,0,14,45,3,0,48,67,3,0,70,82,5,0,87,82,5,0,87
179141,89,"CENTRUL NAŢIONAL DE CALIFICARE ŞI INSTRUIRE FEROVIARĂ CENAFER","BUCUREŞTI SECTORUL 1",B,1469,19,0,0,19,62,0,0,62,89,2,0,91,115,8,1,124,124,8,1,133
179141,90,"ŞCOALA GIMNAZIALĂ ""NICOLAE TITULESCU""","BUCUREŞTI SECTORUL 1",B,1290,10,0,0,10,36,1,38,75,53,1,38,92,71,4,38,113,77,4,38,119
179141,91,"ŞCOALA GIMNAZIALĂ ""NICOLAE TITULESCU""","BUCUREŞTI SECTORUL 1",B,917,4,1,0,5,27,3,0,30,47,9,0,56,65,16,0,81,71,17,0,88
179141,92,"ŞCOALA GIMNAZIALĂ ""NICOLAE TITULESCU""","BUCUREŞTI SECTORUL 1",B,1392,12,2,0,14,59,6,0,65,95,19,0,114,123,21,0,144,138,21,0,159
179141,93,"ŞCOALA GIMNAZIALĂ ""NICOLAE TITULESCU""","BUCUREŞTI SECTORUL 1",B,1265,20,0,0,20,67,4,0,71,102,7,0,109,134,8,0,142,144,8,0,152
179141,94,"ȘCOALA GIMNAZIALĂ ""NICOLAE TITULESCU""","BUCUREŞTI SECTORUL 1",B,1463,12,0,0,12,60,0,1,61,103,0,1,104,150,5,1,156,169,5,1,175
179141,95,"LICEUL TEORETIC ""ALEXANDRU VLAHUŢĂ""","BUCUREŞTI SECTORUL 1",B,1186,8,3,0,11,42,3,0,45,66,3,0,69,84,3,0,87,89,3,0,92
179141,96,"LICEUL TEORETIC ""ALEXANDRU VLAHUŢĂ""","BUCUREŞTI SECTORUL 1",B,1430,10,2,0,12,42,3,0,45,75,4,0,79,101,4,0,105,120,4,0,124
179141,97,"LICEUL TEORETIC ""ALEXANDRU VLAHUŢĂ""","BUCUREŞTI SECTORUL 1",B,1268,11,2,0,13,37,4,0,41,61,5,65,131,86,7,65,158,96,8,65,169
179141,98,"ŞCOALA GIMNAZIALĂ ""ELENA VĂCĂRESCU""","BUCUREŞTI SECTORUL 1",B,1221,7,1,0,8,31,8,0,39,60,13,0,73,92,15,0,107,87,18,0,105
179141,99,"COLEGIUL GERMAN ""GOETHE""","BUCUREŞTI SECTORUL 1",B,937,7,2,0,9,23,3,0,26,45,3,0,48,64,6,0,70,74,7,0,81
179141,100,"COLEGIUL GERMAN ""GOETHE""","BUCUREŞTI SECTORUL 1",B,786,9,4,0,13,21,8,0,29,27,8,0,35,47,8,0,55,51,8,0,59
179141,101,"COLEGIUL GERMAN ""GOETHE""","BUCUREŞTI SECTORUL 1",B,889,9,4,0,13,33,5,0,38,49,5,0,54,77,5,0,82,85,5,0,90
179141,102,"LICEUL TEORETIC BILINGV ""MIGUEL DE CERVANTES""","BUCUREŞTI SECTORUL 1",B,1012,12,2,0,14,30,7,0,37,53,10,0,63,68,15,0,83,77,16,0,93
179141,103,"LICEUL TEORETIC BILINGV ""MIGUEL DE CERVANTES""","BUCUREŞTI SECTORUL 1",B,992,7,0,0,7,23,6,0,29,35,9,0,44,51,12,0,63,59,12,0,71
179141,104,"ȘCOALA GIMNAZIALĂ ""URUGUAY""","BUCUREŞTI SECTORUL 1",B,1066,5,0,0,5,27,0,0,27,36,7,0,43,50,8,0,58,53,9,0,62
179141,105,"ȘCOALA GIMNAZIALĂ ""URUGUAY""","BUCUREŞTI SECTORUL 1",B,1252,4,2,0,6,19,3,0,22,29,3,0,32,43,3,0,46,45,4,110,159
179141,106,"ŞCOALA GIMNAZIALĂ ""URUGUAY""","BUCUREŞTI SECTORUL 1",B,938,5,3,0,8,29,5,0,34,52,5,0,57,75,6,0,81,85,6,0,91
179141,107,"ŞCOALA GIMNAZIALĂ ""URUGUAY""","BUCUREŞTI SECTORUL 1",B,1440,17,1,0,18,54,1,0,55,74,1,0,75,98,3,0,101,108,3,0,111
179141,108,"CLUBUL SPORTIV ŞCOLAR NR.5","BUCUREŞTI SECTORUL 1",B,1033,7,0,0,7,16,2,0,18,25,5,0,30,44,13,0,57,50,13,0,63
179141,109,"CLUBUL SPORTIV ŞCOLAR NR.5","BUCUREŞTI SECTORUL 1",B,1018,12,0,0,12,18,1,0,19,35,2,0,37,42,2,0,44,51,4,0,55
179141,110,"ŞCOALA GIMNAZIALĂ ""SFINŢII VOIEVOZI""","BUCUREŞTI SECTORUL 1",B,1012,14,0,0,14,42,2,0,44,64,4,0,68,69,5,0,74,73,7,0,80
179141,111,"ŞCOALA GIMNAZIALĂ ""SFINŢII VOIEVOZI""","BUCUREŞTI SECTORUL 1",B,952,8,2,0,10,24,4,0,28,41,5,0,46,50,10,0,60,51,12,0,63
179141,112,"ŞCOALA GIMNAZIALĂ ""SFINŢII VOIEVOZI""","BUCUREŞTI SECTORUL 1",B,1041,14,4,0,18,42,6,0,48,58,6,0,64,76,11,0,87,82,13,0,95
179141,113,"ŞCOALA GIMNAZIALĂ ""SFINŢII VOIEVOZI""","BUCUREŞTI SECTORUL 1",B,1441,15,0,0,15,52,0,0,52,71,2,0,73,91,8,0,99,99,8,0,107
179141,114,"ŞCOALA GIMNAZIALĂ ""SFINŢII VOIEVOZI""","BUCUREŞTI SECTORUL 1",B,1012,2,1,0,3,12,1,0,13,25,3,0,28,38,8,9,55,49,8,9,66
179141,115,"COLEGIUL NAŢIONAL ""ION NECULCE""","BUCUREŞTI SECTORUL 1",B,1512,20,2,0,22,56,5,0,61,97,7,0,104,123,13,0,136,134,16,0,150
179141,116,"COLEGIUL NAŢIONAL ""ION NECULCE""","BUCUREŞTI SECTORUL 1",B,1430,3,1,0,4,29,3,0,32,58,3,0,61,80,3,0,83,91,4,0,95
179141,117,"COLEGIUL NAŢIONAL ""ION NECULCE""","BUCUREŞTI SECTORUL 1",B,1632,7,0,0,7,45,2,0,47,81,2,0,83,103,2,136,241,112,2,136,250
179141,118,"COLEGIUL NAŢIONAL ""ION NECULCE""","BUCUREŞTI SECTORUL 1",B,1513,13,0,0,13,44,1,14,59,56,2,14,72,87,3,14,104,102,3,14,119
179141,119,"COLEGIUL NAŢIONAL ""ION NECULCE""","BUCUREŞTI SECTORUL 1",B,1462,15,0,0,15,33,0,0,33,55,0,0,55,68,1,0,69,83,1,0,84
179141,120,"ŞCOALA GIMNAZIALĂ ""GEO BOGZA""","BUCUREŞTI SECTORUL 1",B,1119,5,0,0,5,22,1,0,23,47,3,0,50,55,6,0,61,66,6,0,72
179141,121,"ŞCOALA GIMNAZIALĂ ""GEO BOGZA""","BUCUREŞTI SECTORUL 1",B,1167,7,0,0,7,27,0,0,27,53,0,0,53,67,1,0,68,69,1,0,70
179141,122,"ŞCOALA GIMNAZIALĂ ""GEO BOGZA""","BUCUREŞTI SECTORUL 1",B,883,10,0,0,10,34,2,0,36,44,3,0,47,64,3,0,67,73,3,0,76
179141,123,"ŞCOALA GIMNAZIALĂ ""PETRE ISPIRESCU""","BUCUREŞTI SECTORUL 1",B,1397,16,2,0,18,50,6,0,56,76,9,0,85,103,12,0,115,120,12,0,132
179141,124,"ŞCOALA GIMNAZIALĂ ""PETRE ISPIRESCU""","BUCUREŞTI SECTORUL 1",B,1429,9,0,0,9,49,0,1,50,62,0,1,63,80,0,1,81,90,3,1,94
179141,125,"ŞCOALA GIMNAZIALĂ ""PETRE ISPIRESCU""","BUCUREŞTI SECTORUL 1",B,1330,10,0,0,10,49,1,0,50,74,1,0,75,94,1,0,95,106,2,0,108
179141,126,"ŞCOALA GIMNAZIALĂ ""PETRE ISPIRESCU""","BUCUREŞTI SECTORUL 1",B,1068,9,0,0,9,30,1,0,31,54,1,0,55,72,2,0,74,81,3,0,84
179141,127,"ŞCOALA GIMNAZIALĂ ""PETRE ISPIRESCU""","BUCUREŞTI SECTORUL 1",B,1051,9,0,0,9,29,0,0,29,41,3,0,44,58,3,0,61,68,3,0,71
179141,128,"ŞCOALA GIMNAZIALĂ ""SF.NICOLAE""","BUCUREŞTI SECTORUL 1",B,1471,10,1,0,11,38,2,0,40,64,4,0,68,88,6,0,94,93,6,0,99
179141,129,"ŞCOALA GIMNAZIALĂ ""SF.NICOLAE""","BUCUREŞTI SECTORUL 1",B,1259,8,5,0,13,35,9,0,44,51,9,0,60,77,9,0,86,83,9,0,92
179141,130,"COLEGIUL NAŢIONAL ""AUREL VLAICU""","BUCUREŞTI SECTORUL 1",B,1232,14,0,0,14,42,0,0,42,71,0,0,71,100,0,0,100,94,13,0,107
179141,131,"COLEGIUL NAŢIONAL ""AUREL VLAICU""","BUCUREŞTI SECTORUL 1",B,1208,9,0,0,9,41,5,0,46,77,5,0,82,97,7,0,104,105,7,0,112
179141,132,"COLEGIUL NAŢIONAL ""AUREL VLAICU""","BUCUREŞTI SECTORUL 1",B,889,9,0,0,9,30,3,0,33,47,4,0,51,53,4,0,57,60,5,0,65
179141,133,"COLEGIUL TEHNIC MECANIC ""GRIVIŢA""","BUCUREŞTI SECTORUL 1",B,1155,16,4,0,20,47,8,0,55,69,9,0,78,88,10,0,98,93,11,0,104
179141,134,"COLEGIUL TEHNIC MECANIC ""GRIVIŢA""","BUCUREŞTI SECTORUL 1",B,1456,11,3,0,14,39,6,0,45,74,11,0,85,85,11,0,96,95,13,0,108
179141,135,"COLEGIUL TEHNIC MECANIC ""GRIVIŢA""","BUCUREŞTI SECTORUL 1",B,1315,8,0,0,8,31,0,0,31,61,4,0,65,86,4,0,90,99,4,0,103
179141,136,"COLEGIUL TEHNIC FEROVIAR ""MIHAI I""","BUCUREŞTI SECTORUL 1",B,1249,5,0,0,5,22,0,0,22,29,0,0,29,48,1,0,49,55,1,0,56
179141,137,"COLEGIUL TEHNIC FEROVIAR ""MIHAI I""","BUCUREŞTI SECTORUL 1",B,1200,10,0,0,10,41,2,0,43,50,3,0,53,60,4,0,64,71,4,0,75
179141,138,"ŞCOALA GIMNAZIALĂ NR.162","BUCUREŞTI SECTORUL 1",B,1244,6,0,0,6,25,1,0,26,34,2,0,36,52,2,0,54,56,2,0,58
179141,139,"ŞCOALA GIMNAZIALĂ NR.162","BUCUREŞTI SECTORUL 1",B,1576,22,0,0,22,50,0,0,50,65,1,0,66,85,2,0,87,96,3,0,99
179141,140,"ŞCOALA GIMNAZIALĂ ""ALEXANDRU COSTESCU"" NR.182","BUCUREŞTI SECTORUL 1",B,1421,14,1,0,15,36,2,0,38,53,2,0,55,75,6,0,81,79,9,0,88
179141,141,"ŞCOALA GIMNAZIALĂ ""ALEXANDRU COSTESCU"" NR.182","BUCUREŞTI SECTORUL 1",B,1914,11,0,0,11,28,0,0,28,61,1,0,62,103,1,0,104,112,1,0,113
179141,142,"ŞCOALA GIMNAZIALĂ ""ALEXANDRU COSTESCU"" NR.182","BUCUREŞTI SECTORUL 1",B,1423,13,2,0,15,38,7,0,45,47,7,0,54,88,8,0,96,104,8,0,112
179141,143,"ȘCOALA GIMNAZIALĂ ""ALEXANDRU COSTESCU"" NR.182","BUCUREŞTI SECTORUL 1",B,1493,5,2,0,7,41,2,0,43,54,3,0,57,76,3,0,79,90,4,0,94
179141,144,"ŞCOALA GIMNAZIALĂ NR.183","BUCUREŞTI SECTORUL 1",B,1324,4,0,0,4,17,2,0,19,22,4,0,26,37,4,0,41,40,4,0,44
179141,145,"ŞCOALA GIMNAZIALĂ NR.183","BUCUREŞTI SECTORUL 1",B,1307,6,2,0,8,20,2,0,22,42,2,0,44,46,2,0,48,50,3,0,53
179141,146,"ŞCOALA GIMNAZIALĂ NR.183","BUCUREŞTI SECTORUL 1",B,1222,15,0,0,15,24,0,0,24,36,0,0,36,47,0,0,47,56,0,0,56
179141,147,"ŞCOALA GIMNAZIALĂ NR.183","BUCUREŞTI SECTORUL 1",B,1462,9,0,0,9,32,0,0,32,49,3,0,52,69,6,0,75,72,6,0,78
179141,148,"ŞCOALA GIMNAZIALĂ NR.183","BUCUREŞTI SECTORUL 1",B,1183,10,5,0,15,41,7,0,48,61,7,0,68,69,7,0,76,80,7,0,87
179141,149,"ŞCOALA GIMNAZIALĂ NR.183","BUCUREŞTI SECTORUL 1",B,1677,12,4,0,16,37,7,0,44,56,7,0,63,83,8,0,91,88,8,0,96
179141,150,"ȘCOALA GIMNAZIALĂ NR.183","BUCUREŞTI SECTORUL 1",B,1497,13,0,0,13,55,0,0,55,75,0,0,75,86,0,0,86,90,0,0,90
179141,151,"ŞCOALA GIMNAZIALĂ NR.153","BUCUREŞTI SECTORUL 1",B,1500,4,0,0,4,15,0,0,15,25,0,1,26,31,0,1,32,35,0,1,36
179141,152,"ŞCOALA GIMNAZIALĂ NR.184","BUCUREŞTI SECTORUL 1",B,1389,6,1,0,7,14,3,0,17,25,5,0,30,38,9,0,47,43,9,0,52
179141,153,"ŞCOALA GIMNAZIALĂ NR.184","BUCUREŞTI SECTORUL 1",B,1668,10,2,0,12,30,4,0,34,48,5,0,53,59,5,0,64,61,6,0,67
179141,154,"ŞCOALA GIMNAZIALĂ NR.184","BUCUREŞTI SECTORUL 1",B,1321,2,0,0,2,12,0,0,12,24,0,0,24,38,7,0,45,47,7,0,54
179141,155,"ŞCOALA GIMNAZIALĂ NR.184","BUCUREŞTI SECTORUL 1",B,1312,12,0,0,12,26,0,0,26,42,0,0,42,59,2,1,62,73,2,1,76
179141,156,"ȘCOALA GIMNAZIALĂ NR.184","BUCUREŞTI SECTORUL 1",B,1603,11,0,0,11,28,3,0,31,64,3,0,67,84,3,0,87,97,4,0,101
179141,157,"ŞCOALA GIMNAZIALĂ NR.181","BUCUREŞTI SECTORUL 1",B,1226,7,1,0,8,24,5,0,29,39,7,0,46,59,7,0,66,67,9,0,76
179141,158,"ŞCOALA GIMNAZIALĂ NR.181","BUCUREŞTI SECTORUL 1",B,1431,7,3,0,10,25,5,0,30,44,5,0,49,61,6,0,67,67,7,0,74
179141,159,"ŞCOALA GIMNAZIALĂ NR.181","BUCUREŞTI SECTORUL 1",B,1314,7,0,0,7,30,0,0,30,33,0,0,33,60,1,0,61,63,3,0,66
179141,160,"ŞCOALA GIMNAZIALĂ NR.181","BUCUREŞTI SECTORUL 1",B,1062,5,0,0,5,28,1,0,29,41,3,0,44,62,4,0,66,68,4,0,72
179141,161,"SCOALA GIMNAZIALĂ NR. 192","BUCUREŞTI SECTORUL 1",B,1724,17,0,0,17,65,5,0,70,94,7,0,101,118,7,0,125,127,7,0,134
179141,162,"ȘCOALA GIMNAZIALĂ NR.192","BUCUREŞTI SECTORUL 1",B,1360,7,0,0,7,35,0,10,45,68,2,10,80,86,3,10,99,90,3,10,103
179141,163,"ŞCOALA GIMNAZIALĂ NR.192","BUCUREŞTI SECTORUL 1",B,1479,14,0,0,14,72,2,0,74,99,9,0,108,114,17,0,131,121,17,0,138
179141,164,"ACADEMIA DE POLIȚIE ”ALEXANDRU IOAN CUZA”","BUCUREŞTI SECTORUL 1",B,830,1,2,0,3,15,41,0,56,24,69,0,93,28,101,0,129,28,118,0,146
179141,165,"COLEGIUL TEHNOLOGIC ”VIACESLAV HARNAJ”","BUCUREŞTI SECTORUL 1",B,1269,12,3,0,15,54,6,0,60,80,14,0,94,103,14,1,118,108,17,1,126
179141,166,"ŞCOALA GIMNAZIALĂ AVENOR","BUCUREŞTI SECTORUL 1",B,1578,13,4,0,17,26,6,0,32,78,10,0,88,80,17,0,97,80,21,0,101
179150,167,"ŞCOALA GIMNAZIALĂ NR. 28","BUCUREŞTI SECTORUL 2",B,1700,6,0,0,6,48,1,0,49,79,8,0,87,122,18,1,141,132,22,1,155
179150,168,"ŞCOALA GIMNAZIALĂ NR. 28","BUCUREŞTI SECTORUL 2",B,1188,5,0,0,5,22,1,0,23,49,2,0,51,73,10,64,147,79,14,64,157
179150,169,"ŞCOALA GIMNAZIALĂ NR. 28","BUCUREŞTI SECTORUL 2",B,1403,5,0,0,5,42,3,0,45,79,3,0,82,114,11,0,125,129,15,0,144
179150,170,"ŞCOALA GIMNAZIALĂ""MARIA ROSETTI""","BUCUREŞTI SECTORUL 2",B,1745,18,4,0,22,58,6,0,64,70,10,0,80,107,14,0,121,117,14,0,131
179150,171,"ŞCOALA GIMNAZIALĂ ""MARIA ROSETTI""","BUCUREŞTI SECTORUL 2",B,924,15,0,0,15,38,2,0,40,66,2,0,68,84,2,0,86,94,5,0,99
179150,172,"ŞCOALA GIMNAZIALĂ ""MARIA ROSETTI""","BUCUREŞTI SECTORUL 2",B,943,7,1,0,8,24,1,1,26,49,3,1,53,58,8,1,67,60,10,1,71
179150,173,"LICEUL TEORETIC""C.A. ROSETTI ""","BUCUREŞTI SECTORUL 2",B,1094,14,0,0,14,57,3,0,60,81,5,0,86,94,8,0,102,102,10,0,112
179150,174,"LICEUL TEORETIC""C.A. ROSETTI ""","BUCUREŞTI SECTORUL 2",B,1610,17,1,0,18,59,4,2,65,96,7,2,105,107,8,2,117,124,10,2,136
179150,175,"LICEUL TEORETIC""C.A. ROSETTI ""","BUCUREŞTI SECTORUL 2",B,1547,15,0,0,15,48,0,0,48,66,0,0,66,99,1,0,100,105,1,0,106
179150,176,"LICEUL TEORETIC ""TRAIAN""","BUCUREŞTI SECTORUL 2",B,1902,18,1,0,19,67,3,0,70,104,6,0,110,130,11,0,141,142,15,0,157
179150,177,"LICEUL TEORETIC""TRAIAN""","BUCUREŞTI SECTORUL 2",B,1918,14,1,0,15,57,4,0,61,86,7,0,93,112,9,0,121,124,10,0,134
179150,178,"LICEUL TEORETIC""TRAIAN""","BUCUREŞTI SECTORUL 2",B,1931,6,2,0,8,26,3,0,29,51,5,0,56,67,5,0,72,79,10,0,89
179150,179,"LICEUL TEORETIC""TRAIAN""","BUCUREŞTI SECTORUL 2",B,1899,23,1,0,24,60,1,0,61,137,2,0,139,250,2,0,252,257,2,0,259
179150,180,"ŞCOALA GIMNAZIALĂ NR. 31","BUCUREŞTI SECTORUL 2",B,1557,11,0,0,11,47,0,0,47,66,0,0,66,96,0,0,96,105,0,0,105
179150,181,"ŞCOALA GIMNAZIALĂ NR. 31","BUCUREŞTI SECTORUL 2",B,1913,25,2,0,27,70,5,0,75,90,11,0,101,121,17,0,138,126,17,0,143
179150,182,"ŞCOALA GIMNAZIALĂ NR. 31","BUCUREŞTI SECTORUL 2",B,1756,16,0,0,16,44,5,0,49,86,6,0,92,123,7,0,130,131,9,0,140
179150,183,"ŞCOALA GIMNAZIALĂ NR. 31","BUCUREŞTI SECTORUL 2",B,1724,27,2,0,29,69,4,0,73,86,7,0,93,113,8,1,122,119,8,1,128
179150,184,"ŞCOALA GIMNAZIALĂ NR. 31","BUCUREŞTI SECTORUL 2",B,1827,16,1,0,17,64,7,0,71,89,14,0,103,111,18,0,129,118,23,0,141
179150,185,"UNIVERSITATEA TEHNICĂ DE CONSTRUCŢII BUCUREŞTI","BUCUREŞTI SECTORUL 2",B,1787,11,2,0,13,60,7,0,67,97,10,0,107,146,13,19,178,159,17,19,195
179150,186,"UNIVERSITATEA TEHNICĂ DE CONSTRUCŢII BUCUREŞTI","BUCUREŞTI SECTORUL 2",B,1811,10,4,0,14,43,4,0,47,67,4,0,71,90,4,0,94,100,5,0,105
179150,187,"UNIVERSITATEA TEHNICĂ DE CONSTRUCŢII BUCUREŞTI","BUCUREŞTI SECTORUL 2",B,1607,8,5,0,13,24,6,0,30,54,10,0,64,75,12,1,88,77,13,1,91
179150,188,"UNIVERSITATEA TEHNICĂ DE CONSTRUCŢII BUCUREŞTI","BUCUREŞTI SECTORUL 2",B,1715,8,4,0,12,22,4,0,26,35,4,0,39,38,5,0,43,62,7,0,69
179150,189,"UNIVERSITATEA TEHNICĂ DE CONSTRUCŢII BUCUREŞTI","BUCUREŞTI SECTORUL 2",B,1801,9,2,0,11,40,8,0,48,66,12,0,78,81,13,0,94,91,16,0,107
179150,190,"UNIVERSITATEA TEHNICĂ DE CONSTRUCŢII BUCUREŞTI","BUCUREŞTI SECTORUL 2",B,1911,8,3,0,11,37,3,0,40,61,4,0,65,91,7,0,98,99,7,0,106
179150,191,"UNIVERSITATEA TEHNICĂ DE CONSTRUCŢII BUCUREŞTI","BUCUREŞTI SECTORUL 2",B,1602,5,2,0,7,34,2,0,36,59,2,0,61,77,5,0,82,83,5,0,88
179150,192,"UNIVERSITATEA TEHNICĂ DE CONSTRUCŢII BUCUREŞTI","BUCUREŞTI SECTORUL 2",B,1302,2,3,0,5,10,5,0,15,14,5,0,19,26,5,0,31,29,5,0,34
179150,193,"UNIVERSITATEA TEHNICĂ DE CONSTRUCŢII BUCUREŞTI","BUCUREŞTI SECTORUL 2",B,1710,8,0,0,8,32,4,0,36,57,10,0,67,86,12,0,98,91,12,0,103
179150,194,"UNIVERSITATEA TEHNICĂ DE CONSTRUCŢII BUCUREŞTI","BUCUREŞTI SECTORUL 2",B,1717,13,0,0,13,46,0,0,46,54,0,0,54,64,0,0,64,64,0,0,64
179150,195,"LICEUL TEHNOLOGIC CONSTANTIN BRÂNCUŞI","BUCUREŞTI SECTORUL 2",B,922,5,4,0,9,20,7,0,27,31,11,0,42,34,18,0,52,35,19,0,54
179150,196,"ŞCOALA GIMNAZIALĂ NR. 27","BUCUREŞTI SECTORUL 2",B,1582,15,2,0,17,34,6,0,40,65,13,0,78,90,16,0,106,94,27,0,121
179150,197,"ŞCOALA GIMNAZIALĂ NR. 27","BUCUREŞTI SECTORUL 2",B,1564,20,0,0,20,83,0,0,83,109,11,0,120,134,13,0,147,157,13,0,170
179150,198,"ŞCOALA GIMNAZIALĂ NR. 27","BUCUREŞTI SECTORUL 2",B,1281,4,1,0,5,26,5,0,31,50,7,0,57,72,7,0,79,74,7,0,81
179150,199,"ŞCOALA GIMNAZIALĂ NR. 27","BUCUREŞTI SECTORUL 2",B,1362,23,5,0,28,49,6,0,55,71,8,0,79,101,10,0,111,119,10,0,129
179150,200,"ŞCOALA GIMNAZIALĂ NR. 27","BUCUREŞTI SECTORUL 2",B,1058,9,4,0,13,40,4,1,45,58,6,1,65,86,10,1,97,96,10,1,107
179150,201,"ŞCOALA GIMNAZIALĂ ""GRIGORE GHICA VOIEVOD""","BUCUREŞTI SECTORUL 2",B,1773,5,1,0,6,37,1,0,38,64,5,0,69,89,7,0,96,102,9,0,111
179150,202,"ŞCOALA GIMNAZIALĂ ""GRIGORE GHICA VOIEVOD""","BUCUREŞTI SECTORUL 2",B,1533,8,0,0,8,39,0,0,39,63,0,0,63,91,2,0,93,103,2,0,105
179150,203,"ŞCOALA GIMNAZIALĂ ""GRIGORE GHICA VOIEVOD""","BUCUREŞTI SECTORUL 2",B,1908,21,1,0,22,68,1,0,69,98,2,0,100,129,2,0,131,137,2,0,139
179150,204,"ŞCOALA GIMNAZIALĂ ""GRIGORE GHICA VOIEVOD""","BUCUREŞTI SECTORUL 2",B,1877,3,18,0,21,68,3,0,71,68,3,0,71,94,4,0,98,104,4,0,108
179150,205,"ŞCOALA GIMNAZIALĂ ""GRIGORE GHICA VOIEVOD""","BUCUREŞTI SECTORUL 2",B,1654,19,0,0,19,72,2,0,74,97,3,0,100,124,4,0,128,138,4,0,142
179150,206,"ŞCOALA GIMNAZIALĂ ""GRIGORE GHICA VOIEVOD""","BUCUREŞTI SECTORUL 2",B,1480,7,0,0,7,34,6,0,40,50,6,0,56,75,8,0,83,79,8,0,87
179150,207,"ŞCOALA GIMNAZIALĂ ""GRIGORE GHICA VOIEVOD""","BUCUREŞTI SECTORUL 2",B,1740,11,4,0,15,38,8,0,46,62,16,0,78,81,18,0,99,91,21,0,112
179150,208,"GRĂDINIŢA NR. 233","BUCUREŞTI SECTORUL 2",B,1437,13,0,0,13,64,0,0,64,81,0,0,81,108,0,0,108,117,0,0,117
179150,209,"GRĂDINIŢA NR. 233","BUCUREŞTI SECTORUL 2",B,1305,24,0,0,24,70,0,0,70,95,0,0,95,121,1,0,122,124,1,0,125
179150,210,"ŞCOALA GIMNAZIALĂ NR. 39","BUCUREŞTI SECTORUL 2",B,1620,13,1,0,14,54,8,0,62,80,9,0,89,117,13,0,130,127,15,0,142
179150,211,"ŞCOALA GIMNAZIALĂ NR. 39","BUCUREŞTI SECTORUL 2",B,1404,8,0,0,8,49,1,0,50,74,1,0,75,97,3,0,100,105,3,0,108
179150,212,"ŞCOALA GIMNAZIALĂ NR. 39","BUCUREŞTI SECTORUL 2",B,1650,8,0,0,8,20,0,0,20,35,0,0,35,56,0,0,56,66,1,0,67
179150,213,"ŞCOALA GIMNAZIALĂ NR. 39","BUCUREŞTI SECTORUL 2",B,1535,6,0,0,6,34,0,0,34,54,0,0,54,71,0,0,71,81,0,0,81
179150,214,"ŞCOALA GIMNAZIALĂ NR. 39","BUCUREŞTI SECTORUL 2",B,1608,12,0,0,12,39,0,0,39,61,0,0,61,83,1,0,84,98,1,0,99
179150,215,"ŞCOALA GIMNAZIALĂ NR. 39","BUCUREŞTI SECTORUL 2",B,1645,6,0,0,6,40,0,0,40,51,0,0,51,70,2,0,72,71,3,0,74
179150,216,"ŞCOALA GIMNAZIALĂ NR. 39","BUCUREŞTI SECTORUL 2",B,1614,5,4,0,9,45,7,0,52,79,7,0,86,101,10,0,111,110,10,0,120
179150,217,"ŞCOALA GIMNAZIALĂ NR. 40","BUCUREŞTI SECTORUL 2",B,1722,6,0,0,6,28,6,0,34,49,6,0,55,63,7,0,70,72,11,0,83
179150,218,"ŞCOALA GIMNAZIALĂ NR. 40","BUCUREŞTI SECTORUL 2",B,1727,11,3,0,14,30,3,0,33,58,3,0,61,82,3,0,85,94,3,0,97
179150,219,"ŞCOALA GIMNAZIALĂ NR. 40","BUCUREŞTI SECTORUL 2",B,1728,12,1,0,13,35,1,0,36,61,1,0,62,77,2,0,79,85,3,0,88
179150,220,"ŞCOALA GIMNAZIALĂ NR. 40","BUCUREŞTI SECTORUL 2",B,1620,11,0,0,11,27,1,0,28,37,3,0,40,66,3,0,69,77,3,0,80
179150,221,"ŞCOALA GIMNAZIALĂ NR. 40","BUCUREŞTI SECTORUL 2",B,1963,7,0,0,7,30,1,0,31,41,1,0,42,64,1,0,65,71,1,0,72
179150,222,"ŞCOALA GIMNAZIALĂNR. 40","BUCUREŞTI SECTORUL 2",B,1912,13,0,0,13,30,0,0,30,55,0,0,55,73,5,0,78,79,5,0,84
179150,223,"ŞCOALA GIMNAZIALĂ NR. 41","BUCUREŞTI SECTORUL 2",B,1677,12,0,0,12,24,1,0,25,33,3,0,36,58,5,0,63,63,5,0,68
179150,224,"ŞCOALA GIMNAZIALĂ NR. 41","BUCUREŞTI SECTORUL 2",B,1967,11,0,0,11,30,0,0,30,44,0,0,44,56,0,0,56,66,0,0,66
179150,225,"ŞCOALA GIMNAZIALĂ NR. 41","BUCUREŞTI SECTORUL 2",B,1941,15,0,0,15,37,0,0,37,59,3,0,62,80,6,1,87,88,7,1,96
179150,226,"ŞCOALA GIMNAZIALĂ NR. 32","BUCUREŞTI SECTORUL 2",B,1744,5,1,0,6,14,2,0,16,24,2,0,26,46,2,0,48,52,2,0,54
179150,227,"ŞCOALA GIMNAZIALĂ NR. 32","BUCUREŞTI SECTORUL 2",B,1660,6,0,0,6,29,3,0,32,34,5,0,39,51,7,0,58,52,7,0,59
179150,228,"ŞCOALA GIMNAZIALĂ NR. 32","BUCUREŞTI SECTORUL 2",B,1695,13,0,0,13,29,5,0,34,53,8,0,61,77,9,0,86,90,11,0,101
179150,229,"ŞCOALA GIMNAZIALĂ NR. 32","BUCUREŞTI SECTORUL 2",B,1770,8,0,0,8,40,1,0,41,69,2,0,71,95,2,0,97,106,2,0,108
179150,230,"ŞCOALA GIMNAZIALĂ NR. 32","BUCUREŞTI SECTORUL 2",B,1272,6,0,0,6,23,0,0,23,32,0,0,32,42,0,0,42,48,1,0,49
179150,231,"COLEGIUL NAŢIONAL ""VICTOR BABEŞ""","BUCUREŞTI SECTORUL 2",B,1841,11,2,0,13,25,6,0,31,39,6,0,45,50,6,0,56,67,6,0,73
179150,232,"COLEGIUL NAŢIONAL ""VICTOR BABEŞ""","BUCUREŞTI SECTORUL 2",B,1757,10,4,0,14,35,4,0,39,52,5,0,57,66,5,0,71,69,7,0,76
179150,233,"COLEGIUL NAŢIONAL ""VICTOR BABEŞ""","BUCUREŞTI SECTORUL 2",B,2032,10,1,0,11,30,1,0,31,58,1,0,59,75,3,0,78,98,7,0,105
179150,234,"COLEGIUL NAŢIONAL ""VICTOR BABEŞ""","BUCUREŞTI SECTORUL 2",B,1976,9,0,0,9,31,1,0,32,48,1,0,49,75,2,0,77,85,2,0,87
179150,235,"ŞCOALA GIMNAZIALĂ NR.25 ( FOSTA GRĂDINITĂNR. 11)","BUCUREŞTI SECTORUL 2",B,1780,21,9,0,30,90,10,0,100,163,13,0,176,106,14,0,120,113,15,0,128
179150,236,"ŞCOALA GIMNAZIALĂ NR.25 ( FOSTA GRĂDINITĂNR. 11)","BUCUREŞTI SECTORUL 2",B,1617,17,4,0,21,45,4,0,49,73,4,0,77,90,5,0,95,103,7,0,110
179150,237,"ŞCOALA GIMNAZIALĂ NR. 145","BUCUREŞTI SECTORUL 2",B,2000,11,0,0,11,40,0,0,40,57,1,0,58,69,2,0,71,82,2,0,84
179150,238,"ŞCOALA GIMNAZIALĂ NR. 145","BUCUREŞTI SECTORUL 2",B,1604,6,0,0,6,26,3,0,29,42,4,0,46,63,4,0,67,65,6,0,71
179150,239,"ŞCOALA GIMNAZIALĂ NR. 145","BUCUREŞTI SECTORUL 2",B,1673,8,0,0,8,38,0,0,38,50,0,0,50,71,3,0,74,80,3,0,83
179150,240,"ŞCOALA GIMNAZIALĂ NR. 145","BUCUREŞTI SECTORUL 2",B,1869,14,0,0,14,26,1,0,27,47,1,0,48,63,6,0,69,66,6,0,72
179150,241,"ŞCOALA GIMNAZIALĂ NR. 145","BUCUREŞTI SECTORUL 2",B,1666,9,6,15,30,31,13,44,88,52,14,66,132,66,19,0,85,69,19,0,88
179150,242,"ŞCOALA GIMNAZIALĂ NR. 145","BUCUREŞTI SECTORUL 2",B,1654,7,0,0,7,22,2,0,24,34,2,0,36,44,6,0,50,50,7,0,57
179150,243,"ŞCOALA GIMNAZIALĂ NR. 145","BUCUREŞTI SECTORUL 2",B,1801,5,0,0,5,27,0,0,27,42,3,0,45,68,5,0,73,79,5,0,84
179150,244,"ŞCOALA GIMNAZIALĂ NR. 145","BUCUREŞTI SECTORUL 2",B,1610,5,0,0,5,19,0,0,19,37,0,0,37,41,0,0,41,47,0,0,47
179150,245,"ŞCOALA GIMNAZIALĂNR. 62","BUCUREŞTI SECTORUL 2",B,1656,17,0,0,17,45,0,0,45,81,0,0,81,104,0,0,104,111,1,0,112
179150,246,"ŞCOALA GIMNAZIALĂNR. 62","BUCUREŞTI SECTORUL 2",B,1354,9,0,0,9,25,0,9,34,37,0,9,46,51,1,9,61,56,1,9,66
179150,247,"ŞCOALA GIMNAZIALĂNR. 62","BUCUREŞTI SECTORUL 2",B,1355,12,0,0,12,38,2,0,40,67,4,0,71,90,6,0,96,95,9,0,104
179150,248,"ŞCOALA GIMNAZIALĂNR. 62","BUCUREŞTI SECTORUL 2",B,1582,18,1,0,19,52,2,0,54,64,2,0,66,92,3,0,95,98,5,0,103
179150,249,"ŞCOALA GIMNAZIALĂNR. 62","BUCUREŞTI SECTORUL 2",B,1485,21,1,0,22,38,1,0,39,57,1,0,58,83,2,0,85,89,2,0,91
179150,250,"ŞCOALA GIMNAZIALĂNR. 62","BUCUREŞTI SECTORUL 2",B,1321,10,3,0,13,50,3,0,53,66,4,0,70,92,4,0,96,95,4,0,99
179150,251,"ŞCOALA GIMNAZIALĂNR. 62","BUCUREŞTI SECTORUL 2",B,1134,10,7,0,17,27,10,0,37,43,11,0,54,59,13,0,72,68,14,0,82
179150,252,"LICEUL TEHNOLOGIC""SF. PANTELIMON""","BUCUREŞTI SECTORUL 2",B,1870,20,0,0,20,62,0,0,62,108,1,0,109,142,1,0,143,156,2,0,158
179150,253,"LICEUL TEHNOLOGIC""SF. PANTELIMON""","BUCUREŞTI SECTORUL 2",B,1338,10,2,0,12,54,2,0,56,78,3,0,81,108,8,0,116,120,9,0,129
179150,254,"LICEUL TEHNOLOGIC""SF. PANTELIMON""","BUCUREŞTI SECTORUL 2",B,1361,17,1,0,18,42,2,0,44,62,2,0,64,89,2,0,91,102,2,0,104
179150,255,"LICEUL TEHNOLOGIC""SF. PANTELIMON""","BUCUREŞTI SECTORUL 2",B,1631,8,2,0,10,44,3,0,47,70,4,0,74,100,4,0,104,109,4,0,113
179150,256,"ŞCOALA GIMNAZIALĂ NR. 51","BUCUREŞTI SECTORUL 2",B,1515,9,0,0,9,63,0,0,63,93,1,0,94,119,2,0,121,128,2,0,130
179150,257,"ŞCOALA GIMNAZIALĂ NR. 51","BUCUREŞTI SECTORUL 2",B,1543,9,0,0,9,29,0,0,29,56,0,0,56,67,1,0,68,71,2,0,73
179150,258,"ŞCOALA GIMNAZIALĂ NR. 51","BUCUREŞTI SECTORUL 2",B,1397,12,0,0,12,49,0,0,49,70,0,0,70,79,0,0,79,92,2,0,94
179150,259,"GRADINIŢA NR. 280","BUCUREŞTI SECTORUL 2",B,1305,10,3,0,13,59,6,0,65,78,9,0,87,92,12,0,104,98,12,0,110
179150,260,"GRADINIŢA NR. 280","BUCUREŞTI SECTORUL 2",B,1796,11,0,0,11,44,1,0,45,60,1,0,61,82,2,0,84,88,2,0,90
179150,261,"ŞCOALA GIMNAZIALĂ NR. 77","BUCUREŞTI SECTORUL 2",B,1460,10,4,0,14,35,4,0,39,67,6,0,73,99,6,0,105,106,7,0,113
179150,262,"ŞCOALA GIMNAZIALĂ NR. 77","BUCUREŞTI SECTORUL 2",B,1455,11,2,0,13,74,2,0,76,105,5,0,110,132,5,0,137,140,5,0,145
179150,263,"ŞCOALA GIMNAZIALĂ NR. 77","BUCUREŞTI SECTORUL 2",B,1566,17,2,0,19,42,2,0,44,62,4,0,66,92,6,0,98,111,6,0,117
179150,264,"ŞCOALA GIMNAZIALĂ NR. 77","BUCUREŞTI SECTORUL 2",B,1551,21,2,0,23,53,2,0,55,75,3,0,78,103,6,0,109,114,9,0,123
179150,265,"ŞCOALA GIMNAZIALĂ NR. 77","BUCUREŞTI SECTORUL 2",B,1940,16,4,0,20,60,5,0,65,90,6,0,96,120,7,0,127,128,10,0,138
179150,266,"ŞCOALA GIMNAZIALĂ NR. 77","BUCUREŞTI SECTORUL 2",B,1585,8,2,0,10,51,3,0,54,74,3,0,77,106,4,0,110,116,4,0,120
179150,267,"LICEUL TEORETIC""LUCIAN BLAGA""","BUCUREŞTI SECTORUL 2",B,1705,19,1,0,20,63,1,0,64,94,1,0,95,136,1,0,137,148,1,0,149
179150,268,"LICEUL TEORETIC""LUCIAN BLAGA""","BUCUREŞTI SECTORUL 2",B,1850,7,1,0,8,34,2,0,36,49,2,0,51,67,2,0,69,72,2,0,74
179150,269,"LICEUL TEORETIC""LUCIAN BLAGA""","BUCUREŞTI SECTORUL 2",B,1847,19,1,0,20,44,1,0,45,76,3,0,79,94,3,0,97,103,3,0,106
179150,270,"LICEUL TEORETIC""LUCIAN BLAGA""","BUCUREŞTI SECTORUL 2",B,1865,19,4,0,23,58,6,0,64,94,9,0,103,119,12,0,131,124,14,0,138
179150,271,"LICEUL TEORETIC""LUCIAN BLAGA""","BUCUREŞTI SECTORUL 2",B,1906,19,0,0,19,51,0,0,51,76,1,0,77,97,1,0,98,110,1,0,111
179150,272,"ŞCOALA GIMNAZIALĂ NR. 66","BUCUREŞTI SECTORUL 2",B,1770,24,0,0,24,67,3,0,70,97,3,0,100,137,3,0,140,147,3,0,150
179150,273,"ŞCOALA GIMNAZIALĂ NR. 66","BUCUREŞTI SECTORUL 2",B,1234,11,0,0,11,64,5,0,69,84,9,0,93,111,10,0,121,118,10,0,128
179150,274,"ŞCOALA GIMNAZIALĂ NR. 66","BUCUREŞTI SECTORUL 2",B,1601,14,0,0,14,30,0,0,30,48,0,0,48,69,1,0,70,78,1,0,79
179150,275,"ŞCOALA GIMNAZIALĂ NR. 66","BUCUREŞTI SECTORUL 2",B,1326,19,2,0,21,50,3,0,53,65,4,0,69,78,6,0,84,84,7,0,91
179150,276,"ŞCOALA GIMNAZIALĂ NR. 66","BUCUREŞTI SECTORUL 2",B,1844,12,2,0,14,50,6,0,56,57,10,0,67,79,10,0,89,84,11,0,95
179150,277,"GRADINIŢA NR. 189","BUCUREŞTI SECTORUL 2",B,1043,11,2,0,13,38,5,0,43,58,6,0,64,74,9,0,83,86,10,0,96
179150,278,"GRADINIŢA NR. 189","BUCUREŞTI SECTORUL 2",B,1046,14,0,0,14,34,0,0,34,54,0,0,54,68,0,0,68,74,0,0,74
179150,279,"COLEGUL TEHNIC ""DIMITRIE LEONIDA""","BUCUREŞTI SECTORUL 2",B,1072,10,7,0,17,46,10,0,56,54,11,0,65,67,11,0,78,78,11,0,89
179150,280,"COLEGUL TEHNIC ""DIMITRIE LEONIDA""","BUCUREŞTI SECTORUL 2",B,1391,4,5,0,9,27,6,0,33,50,6,0,56,78,10,0,88,95,10,0,105
179150,281,"ŞCOALA GIMNAZIALĂ ""PETRE GHELMEZ""","BUCUREŞTI SECTORUL 2",B,1672,17,0,0,17,55,1,0,56,87,6,0,93,107,8,0,115,124,8,0,132
179150,282,"ŞCOALA GIMNAZIALĂ ""PETRE GHELMEZ""","BUCUREŞTI SECTORUL 2",B,1755,12,2,0,14,57,5,0,62,81,5,0,86,104,7,0,111,114,7,0,121
179150,283,"ŞCOALA GIMNAZIALĂ ""PETRE GHELMEZ""","BUCUREŞTI SECTORUL 2",B,1631,10,1,0,11,35,6,0,41,52,6,0,58,72,8,0,80,82,12,0,94
179150,284,"ŞCOALA GIMNAZIALĂ ""PETRE GHELMEZ""","BUCUREŞTI SECTORUL 2",B,1324,13,0,0,13,32,1,0,33,53,5,0,58,78,6,0,84,83,9,0,92
179150,285,"ŞCOALA GIMNAZIALĂ ""PETRE GHELMEZ""","BUCUREŞTI SECTORUL 2",B,1715,13,2,0,15,53,3,0,56,66,3,0,69,98,3,0,101,101,3,0,104
179150,286,"ŞCOALA GIMNAZIALĂ ""PETRE GHELMEZ""","BUCUREŞTI SECTORUL 2",B,1558,18,0,0,18,49,0,0,49,73,0,0,73,91,1,0,92,105,1,0,106
179150,287,"ŞCOALA GIMNAZIALĂ NR. 4","BUCUREŞTI SECTORUL 2",B,1667,23,4,0,27,47,7,0,54,67,7,0,74,93,9,0,102,107,9,0,116
179150,288,"ŞCOALA GIMNAZIALĂ NR. 4","BUCUREŞTI SECTORUL 2",B,1717,11,2,0,13,42,7,0,49,73,8,0,81,114,9,0,123,128,9,0,137
179150,289,"ŞCOALA GIMNAZIALĂ NR. 4","BUCUREŞTI SECTORUL 2",B,1840,7,0,0,7,48,0,0,48,71,0,0,71,94,0,0,94,106,2,0,108
179150,290,"ŞCOALA GIMNAZIALĂ NR. 4","BUCUREŞTI SECTORUL 2",B,1944,14,2,0,16,48,3,0,51,70,3,0,73,108,3,0,111,128,3,0,131
179150,291,"ŞCOALA GIMNAZIALĂ NR. 4","BUCUREŞTI SECTORUL 2",B,1456,12,3,0,15,40,3,0,43,61,3,0,64,76,4,0,80,84,4,0,88
179150,292,"ŞCOALA GIMNAZIALĂ NR. 25","BUCUREŞTI SECTORUL 2",B,1828,17,1,0,18,58,3,0,61,83,5,0,88,118,6,0,124,124,6,0,130
179150,293,"ŞCOALA GIMNAZIALĂ NR. 25","BUCUREŞTI SECTORUL 2",B,1949,6,0,0,6,39,3,0,42,58,5,0,63,79,7,0,86,92,7,0,99
179150,294,"ŞCOALA GIMNAZIALĂ NR. 25","BUCUREŞTI SECTORUL 2",B,1828,7,0,0,7,43,5,0,48,62,5,0,67,80,6,0,86,91,6,0,97
179150,295,"ŞCOALA GIMNAZIALĂ NR. 25","BUCUREŞTI SECTORUL 2",B,2107,8,0,0,8,56,0,0,56,76,0,0,76,105,0,0,105,109,0,0,109
179150,296,"ŞCOALA GIMNAZIALĂ ""FERDINAND I"" (FOSTA ȘCOALĂNR. 64)","BUCUREŞTI SECTORUL 2",B,1467,12,2,0,14,52,3,0,55,89,5,0,94,118,10,0,128,123,12,0,135
179150,297,"ŞCOALA GIMNAZIALĂ ""FERDINAND I"" (FOSTA ȘCOALĂNR. 64)","BUCUREŞTI SECTORUL 2",B,1446,9,0,0,9,40,1,0,41,60,1,0,61,83,3,0,86,88,5,0,93
179150,298,"ŞCOALA GIMNAZIALĂ ""FERDINAND I"" (FOSTA ȘCOALĂNR. 64)","BUCUREŞTI SECTORUL 2",B,1207,12,4,0,16,30,4,0,34,51,4,0,55,63,6,0,69,71,6,0,77
179150,299,"ŞCOALA GIMNAZIALĂ ""FERDINAND I"" (FOSTA ȘCOALĂNR. 64)","BUCUREŞTI SECTORUL 2",B,1878,12,1,0,13,50,2,0,52,73,2,0,75,82,2,0,84,87,2,0,89
179150,300,"ŞCOALA GIMNAZIALĂ ""FERDINAND I"" (FOSTA ȘCOALĂNR. 64)","BUCUREŞTI SECTORUL 2",B,1449,7,0,0,7,29,2,0,31,49,2,0,51,65,2,0,67,66,2,0,68
179150,301,"LICEUL TEHNOLOGIC ELECTRONICA INDUSTRIALĂ","BUCUREŞTI SECTORUL 2",B,1619,7,1,0,8,42,6,0,48,76,6,0,82,113,8,0,121,136,8,0,144
179150,302,"LICEUL TEHNOLOGIC ELECTRONICA INDUSTRIALĂ","BUCUREŞTI SECTORUL 2",B,1531,12,0,0,12,51,0,0,51,73,0,0,73,104,5,0,109,116,6,0,122
179150,303,"LICEUL TEHNOLOGIC ELECTRONICA INDUSTRIALĂ","BUCUREŞTI SECTORUL 2",B,1242,16,0,0,16,64,2,0,66,85,2,0,87,112,5,0,117,116,5,0,121
179150,304,"COLEGIUL NAŢIONAL ""IULIA HAŞDEU""","BUCUREŞTI SECTORUL 2",B,1393,15,3,0,18,52,11,0,63,84,18,0,102,111,23,0,134,120,27,0,147
179150,305,"COLEGIUL NAŢIONAL ""IULIA HAŞDEU""","BUCUREŞTI SECTORUL 2",B,1417,14,2,0,16,57,12,0,69,88,16,0,104,104,19,0,123,122,23,0,145
179150,306,"COLEGIUL NAŢIONAL ""IULIA HAŞDEU""","BUCUREŞTI SECTORUL 2",B,1536,12,5,0,17,44,10,0,54,59,12,0,71,77,12,0,89,95,12,0,107
179150,307,"LICEUL TEHNOLOGIC ""I.C. BRĂTIANU"" (FOST LICEUL TEHNOLOGIC MECANICĂ FINĂ)","BUCUREŞTI SECTORUL 2",B,1392,14,0,0,14,52,4,0,56,75,7,0,82,95,7,0,102,104,7,0,111
179150,308,"LICEUL TEHNOLOGIC ""I.C. BRĂTIANU"" (FOST LICEUL TEHNOLOGIC MECANICĂ FINĂ)","BUCUREŞTI SECTORUL 2",B,1225,16,0,0,16,49,5,0,54,72,7,0,79,90,9,0,99,98,9,0,107
179150,309,"LICEUL TEHNOLOGIC ""I.C. BRĂTIANU"" (FOST LICEUL TEHNOLOGIC MECANICĂ FINĂ)","BUCUREŞTI SECTORUL 2",B,1103,9,0,0,9,45,0,0,45,68,2,0,70,81,2,0,83,88,2,0,90
179150,310,"LICEUL TEHNOLOGIC ""I.C. BRĂTIANU"" (FOST LICEUL TEHNOLOGIC MECANICĂ FINĂ)","BUCUREŞTI SECTORUL 2",B,1656,20,2,0,22,62,5,0,67,87,6,0,93,127,7,0,134,141,10,0,151
179150,311,"CLUB SPORTIV ŞCOLAR NR. 2","BUCUREŞTI SECTORUL 2",B,1570,16,2,0,18,52,5,0,57,82,14,0,96,105,15,0,120,117,19,0,136
179150,312,"CLUB SPORTIV ŞCOLAR NR. 2","BUCUREŞTI SECTORUL 2",B,1436,6,0,0,6,46,2,0,48,67,5,0,72,93,6,0,99,94,6,0,100
179150,313,"GRĂDINIȚA CLOPOȚEL (FOSTA GRADINIŢA NR. 201)","BUCUREŞTI SECTORUL 2",B,1383,14,3,0,17,37,5,0,42,53,5,0,58,74,9,0,83,90,11,0,101
179150,314,"GRĂDINIȚA CLOPOȚEL (FOSTA GRADINIŢA NR. 201)","BUCUREŞTI SECTORUL 2",B,1593,20,1,0,21,64,2,0,66,119,3,0,122,145,3,0,148,159,4,0,163
179150,315,"GRĂDINIȚA CLOPOȚEL (FOSTA GRADINIŢA NR. 201)","BUCUREŞTI SECTORUL 2",B,1366,18,0,0,18,62,0,0,62,89,0,0,89,104,0,0,104,118,0,0,118
179150,316,"GRĂDINIȚA CLOPOȚEL (FOSTA GRADINIŢA NR. 201)","BUCUREŞTI SECTORUL 2",B,1291,10,3,0,13,54,3,0,57,74,3,0,77,100,5,0,105,108,6,0,114
179150,317,"COLEGIUL NAŢIONAL ""EMIL RACOVIŢĂ""","BUCUREŞTI SECTORUL 2",B,1476,11,5,0,16,50,10,0,60,85,11,0,96,108,15,0,123,130,18,0,148
179150,318,"COLEGIUL NAŢIONAL ""EMIL RACOVIŢĂ""","BUCUREŞTI SECTORUL 2",B,1095,13,0,0,13,60,0,0,60,86,3,0,89,104,3,0,107,113,3,0,116
179150,319,"COLEGIUL NAŢIONAL ""EMIL RACOVIŢĂ""","BUCUREŞTI SECTORUL 2",B,1830,20,0,0,20,60,1,0,61,85,5,0,90,120,8,0,128,127,8,0,135
179150,320,"GRĂDINIŢA LUMINIȚA (FOSTA GRADINITA NR. 16)","BUCUREŞTI SECTORUL 2",B,1282,19,1,0,20,46,10,0,56,71,13,0,84,81,14,0,95,85,15,0,100
179150,321,"GRĂDINIŢA LUMINIȚA (FOSTA GRADINITA NR. 16)","BUCUREŞTI SECTORUL 2",B,1205,12,0,0,12,52,2,0,54,79,2,0,81,96,2,0,98,104,2,0,106
179150,322,"GRĂDINIŢA NR. 256","BUCUREŞTI SECTORUL 2",B,1570,13,3,0,16,50,3,0,53,81,3,0,84,111,4,0,115,126,4,0,130
179150,323,"ŞCOALA GIMNAZIALĂ NR. 49","BUCUREŞTI SECTORUL 2",B,1207,18,5,0,23,54,12,0,66,79,14,0,93,101,15,0,116,106,15,0,121
179150,324,"ŞCOALA GIMNAZIALĂ NR. 49","BUCUREŞTI SECTORUL 2",B,1189,22,0,0,22,52,4,0,56,72,6,0,78,87,14,0,101,95,14,0,109
179150,325,"ŞCOALA GIMNAZIALĂ NR. 46","BUCUREŞTI SECTORUL 2",B,1466,8,0,0,8,36,0,0,36,54,3,0,57,68,3,0,71,74,4,0,78
179150,326,"ŞCOALA GIMNAZIALĂ NR. 46","BUCUREŞTI SECTORUL 2",B,1553,18,0,0,18,52,4,0,56,67,12,0,79,114,12,0,126,119,12,0,131
179150,327,"ŞCOALA GIMNAZIALĂ NR. 46","BUCUREŞTI SECTORUL 2",B,1591,14,0,0,14,61,3,0,64,84,4,0,88,107,10,0,117,128,10,0,138
179150,328,"ŞCOALA GIMNAZIALĂ NR. 46","BUCUREŞTI SECTORUL 2",B,1875,30,0,0,30,73,0,0,73,121,1,0,122,168,1,0,169,181,1,0,182
179150,329,"ŞCOALA GIMNAZIALĂ TUDOR ARGHEZI (FOSTA ȘCOALĂ NR. 19)","BUCUREŞTI SECTORUL 2",B,1092,11,4,0,15,32,8,0,40,64,14,0,78,81,16,1,98,89,17,1,107
179150,330,"ŞCOALA GIMNAZIALĂ TUDOR ARGHEZI (FOSTA ȘCOALĂ NR. 19)","BUCUREŞTI SECTORUL 2",B,939,3,5,0,8,27,8,0,35,51,9,0,60,73,11,0,84,85,11,0,96
179150,331,"COLEGIUL NAŢIONAL “SPIRU HARET”","BUCUREŞTI SECTORUL 2",B,1195,9,1,0,10,31,8,0,39,48,12,0,60,63,12,0,75,68,12,0,80
179150,332,"COLEGIUL NAŢIONAL “SPIRU HARET”","BUCUREŞTI SECTORUL 2",B,1167,10,0,0,10,36,4,0,40,55,5,0,60,74,9,0,83,79,10,0,89
179150,333,"COLEGIUL NAŢIONAL “CANTEMIR VODĂ”","BUCUREŞTI SECTORUL 2",B,964,9,1,0,10,37,6,0,43,54,10,0,64,70,10,0,80,71,13,0,84
179150,334,"COLEGIUL NAŢIONAL “CANTEMIR VODĂ”","BUCUREŞTI SECTORUL 2",B,1204,10,3,0,13,40,5,0,45,66,6,0,72,89,6,0,95,95,7,0,102
179150,335,"COLEGIUL NAŢIONAL “CANTEMIR VODĂ”","BUCUREŞTI SECTORUL 2",B,1249,9,0,0,9,33,1,0,34,49,2,0,51,65,4,0,69,82,9,0,91
179150,336,"COLEGIUL NAŢIONAL “CANTEMIR VODĂ”","BUCUREŞTI SECTORUL 2",B,1565,11,0,0,11,45,0,0,45,77,1,0,78,93,1,0,94,105,2,0,107
179150,337,"ŞCOALA GIMNAZIALĂ NR. 24","BUCUREŞTI SECTORUL 2",B,1798,7,0,0,7,27,1,0,28,55,4,0,59,69,4,0,73,73,4,0,77
179150,338,"ŞCOALA GIMNAZIALĂ NR. 24","BUCUREŞTI SECTORUL 2",B,1606,14,0,0,14,51,2,5,58,87,3,5,95,107,4,6,117,116,4,6,126
179150,339,"ŞCOALA GIMNAZIALĂ NR. 24","BUCUREŞTI SECTORUL 2",B,1395,5,1,0,6,19,2,0,21,28,5,0,33,49,8,0,57,62,8,0,70
179150,340,"ŞCOALA GIMNAZIALĂ NR. 24","BUCUREŞTI SECTORUL 2",B,1383,4,0,0,4,23,4,0,27,48,5,0,53,69,7,0,76,75,7,0,82
179150,341,"ȘCOALA GIMNAZIALĂ ""MAICA DOMNULUI"" (FOSTA ŞCOALA NR. 26)","BUCUREŞTI SECTORUL 2",B,1215,5,4,0,9,33,6,0,39,53,7,0,60,74,8,0,82,76,8,0,84
179150,342,"ȘCOALA GIMNAZIALĂ ""MAICA DOMNULUI"" (FOSTA ŞCOALA NR. 26)","BUCUREŞTI SECTORUL 2",B,1360,6,1,0,7,51,1,0,52,85,3,0,88,94,3,0,97,101,3,0,104
179150,343,"ŞCOALA PROFESIONALĂ SPECIALĂ NR. 3","BUCUREŞTI SECTORUL 2",B,1570,12,0,0,12,32,8,0,40,51,8,0,59,75,9,0,84,87,9,0,96
179150,344,"ŞCOALA PROFESIONALĂ SPECIALĂ NR. 3","BUCUREŞTI SECTORUL 2",B,1339,3,0,0,3,16,0,0,16,27,6,1,34,42,7,1,50,51,7,1,59
179150,345,"ŞCOALA GIMNAZIALĂ NR. 307","BUCUREŞTI SECTORUL 2",B,1360,13,2,0,15,33,3,0,36,53,11,0,64,79,12,0,91,83,15,0,98
179150,346,"ŞCOALA GIMNAZIALĂ NR. 307","BUCUREŞTI SECTORUL 2",B,1041,8,2,0,10,37,7,0,44,46,15,0,61,66,18,0,84,70,19,0,89
179150,347,"ŞCOALA GIMNAZIALĂ NR. 307","BUCUREŞTI SECTORUL 2",B,1513,17,0,0,17,69,3,0,72,101,4,0,105,125,5,0,130,132,13,0,145
179150,348,"ŞCOALA GIMNAZIALĂ NR. 71","BUCUREŞTI SECTORUL 2",B,1381,12,1,0,13,43,5,0,48,62,9,0,71,77,13,0,90,88,13,0,101
179150,349,"ŞCOALA GIMNAZIALĂ NR. 71","BUCUREŞTI SECTORUL 2",B,1276,7,1,0,8,42,5,0,47,65,6,0,71,90,6,0,96,101,8,0,109
179150,350,"COLEGIUL ECONOMIC ""A.D. XENOPOL""","BUCUREŞTI SECTORUL 2",B,1235,12,0,0,12,46,5,0,51,69,6,0,75,88,8,0,96,94,10,0,104
179150,351,"COLEGIUL ECONOMIC ""A.D. XENOPOL""","BUCUREŞTI SECTORUL 2",B,1001,5,5,0,10,19,8,0,27,38,12,0,50,50,13,0,63,60,16,0,76
179150,352,"COLEGIUL ECONOMIC ""A.D. XENOPOL""","BUCUREŞTI SECTORUL 2",B,1329,6,3,0,9,27,7,0,34,43,7,0,50,54,7,0,61,61,7,0,68
179150,353,"COLEGIUL ECONOMIC ""A.D. XENOPOL""","BUCUREŞTI SECTORUL 2",B,1481,9,0,0,9,45,5,0,50,59,6,0,65,87,6,0,93,92,7,0,99
179150,354,"COLEGIUL NAŢIONAL BILINGV""GEORGE COŞBUC""","BUCUREŞTI SECTORUL 2",B,1440,17,0,0,17,48,4,0,52,80,8,0,88,120,12,0,132,130,12,0,142
179150,355,"COLEGIUL NAŢIONALBILINGV ""GEORGE COŞBUC""","BUCUREŞTI SECTORUL 2",B,1720,7,0,0,7,43,0,0,43,72,3,0,75,100,4,0,104,106,4,0,110
179150,356,"ŞCOALA GIMNAZIALĂ ""MAICA DOMNULUI"" (FOSTA ȘCOALĂ NR. 50)","BUCUREŞTI SECTORUL 2",B,1492,18,2,0,20,65,3,0,68,94,3,1,98,137,7,1,145,145,8,1,154
179150,357,"ŞCOALA GIMNAZIALĂ ""MAICA DOMNULUI"" (FOSTA ȘCOALĂ NR. 50)","BUCUREŞTI SECTORUL 2",B,1556,15,0,0,15,68,0,0,68,107,1,0,108,130,1,0,131,139,2,0,141
179150,358,"ŞCOALA GIMNAZIALĂ ""MAICA DOMNULUI"" (FOSTA ȘCOALĂ NR. 50)","BUCUREŞTI SECTORUL 2",B,1798,13,0,0,13,51,1,0,52,82,5,0,87,106,9,0,115,122,16,0,138
179150,359,"COLEGIUL NAŢIONAL ""MIHAI VITEAZUL""","BUCUREŞTI SECTORUL 2",B,1673,13,2,0,15,51,5,0,56,76,8,0,84,88,10,0,98,96,10,0,106
179150,360,"COLEGIUL NAŢIONAL ""MIHAI VITEAZUL""","BUCUREŞTI SECTORUL 2",B,1455,11,0,0,11,32,4,0,36,44,9,76,129,60,9,76,145,62,13,76,151
179150,361,"ŞCOALA GIMNAZIALĂ NR. 56","BUCUREŞTI SECTORUL 2",B,1427,4,3,0,7,57,8,0,65,82,11,1,94,110,12,1,123,123,13,1,137
179150,362,"ŞCOALA GIMNAZIALĂ NR. 56","BUCUREŞTI SECTORUL 2",B,1215,9,3,0,12,44,4,0,48,75,4,0,79,98,4,0,102,110,4,0,114
179150,363,"ŞCOALA GIMNAZIALĂ NR. 85","BUCUREŞTI SECTORUL 2",B,1019,7,0,0,7,46,0,0,46,56,0,0,56,82,1,0,83,90,2,0,92
179150,364,"ŞCOALA GIMNAZIALĂ NR. 85","BUCUREŞTI SECTORUL 2",B,1285,2,4,0,6,30,6,0,36,50,7,0,57,61,8,0,69,73,9,0,82
179150,365,"ŞCOALA GIMNAZIALĂ NR. 85","BUCUREŞTI SECTORUL 2",B,1201,8,0,0,8,51,3,0,54,69,6,0,75,86,7,0,93,93,7,0,100
179150,366,"ŞCOALA GIMNAZIALĂ NR. 85","BUCUREŞTI SECTORUL 2",B,1155,15,3,0,18,62,6,0,68,76,6,0,82,92,7,0,99,109,7,0,116
179150,367,"ŞCOALA GIMNAZIALĂ NR. 85","BUCUREŞTI SECTORUL 2",B,1274,7,0,0,7,36,0,0,36,50,2,0,52,65,3,0,68,69,3,0,72
179150,368,"ŞCOALA GIMNAZIALĂ NR. 85","BUCUREŞTI SECTORUL 2",B,1738,24,1,0,25,57,4,0,61,83,5,0,88,102,6,0,108,119,6,0,125
179169,369,"ŞCOALA SUPERIOARĂ COMERCIALĂ ""NICOLAE KRETZULESCU"";","BUCUREŞTI SECTORUL 3",B,1023,4,4,0,8,24,7,0,31,41,15,0,56,52,16,0,68,54,16,0,70
179169,370,"ŞCOALA SUPERIOARĂ COMERCIALĂ ""NICOLAE KRETZULESCU"";","BUCUREŞTI SECTORUL 3",B,888,5,0,0,5,16,0,0,16,23,5,1,29,28,5,1,34,29,5,1,35
179169,371,"ŞCOALA SUPERIOARĂ COMERCIALĂ ""NICOLAE KRETZULESCU"";","BUCUREŞTI SECTORUL 3",B,873,10,2,0,12,31,2,0,33,46,2,0,48,56,2,0,58,58,3,0,61
179169,372,"ŞCOALA SUPERIOARĂ COMERCIALĂ ""NICOLAE KRETZULESCU"";","BUCUREŞTI SECTORUL 3",B,1202,7,4,0,11,16,4,0,20,38,13,0,51,52,14,0,66,57,15,0,72
179169,373,"ŞCOALA SUPERIOARĂ COMERCIALĂ ""NICOLAE KRETZULESCU"";","BUCUREŞTI SECTORUL 3",B,1133,11,1,0,12,29,2,0,31,40,2,0,42,58,7,0,65,62,7,0,69
179169,374,"ŞCOALA SUPERIOARĂ COMERCIALĂ ""NICOLAE KRETZULESCU"";","BUCUREŞTI SECTORUL 3",B,1460,6,1,0,7,21,1,0,22,45,4,0,49,58,4,0,62,60,4,0,64
179169,375,"ŞCOALA GIMNAZIALĂ ""BARBU DELAVRANCEA""","BUCUREŞTI SECTORUL 3",B,1796,16,7,0,23,61,8,0,69,84,12,0,96,111,20,0,131,122,20,0,142
179169,376,"ŞCOALA GIMNAZIALĂ ""BARBU DELAVRANCEA""","BUCUREŞTI SECTORUL 3",B,2198,0,3,0,3,0,7,0,7,1,9,0,10,1,9,0,10,1,9,0,10
179169,377,"ȘCOALA GIMNAZIALĂ ""BARBU DELAVRANCEA""","BUCUREŞTI SECTORUL 3",B,2492,0,0,0,0,1,0,0,1,1,0,0,1,1,0,0,1,1,0,0,1
179169,378,"ŞCOALA GIMNAZIALĂ ""BARBU DELAVRANCEA""","BUCUREŞTI SECTORUL 3",B,2403,0,3,0,3,1,3,0,4,1,3,0,4,1,3,0,4,1,3,0,4
179169,379,"COLEGIUL NAŢIONAL ""MATEI BASARAB"";","BUCUREŞTI SECTORUL 3",B,2421,0,0,0,0,0,1,0,1,0,5,0,5,0,6,0,6,0,10,0,10
179169,380,"COLEGIUL NAŢIONAL ""MATEI BASARAB"";","BUCUREŞTI SECTORUL 3",B,1884,6,3,0,9,32,3,0,35,61,5,0,66,85,8,0,93,94,8,0,102
179169,381,"COLEGIUL NAŢIONAL ""MATEI BASARAB"";","BUCUREŞTI SECTORUL 3",B,1782,10,0,0,10,53,0,0,53,82,0,0,82,95,1,0,96,111,1,0,112
179169,382,"COLEGIUL NAȚIONAL ""MATEI BASARAB""","BUCUREŞTI SECTORUL 3",B,2454,0,0,0,0,0,0,0,0,0,0,0,0,0,0,0,0,0,0,0,0
179169,383,"COLEGIUL NAŢIONAL""MATEI BASARAB"";","BUCUREŞTI SECTORUL 3",B,1838,13,1,0,14,55,1,0,56,101,1,0,102,123,1,0,124,132,3,0,135
179169,384,"ŞCOALA GIMNAZIALĂ SPECIALĂ NR.5;","BUCUREŞTI SECTORUL 3",B,1305,13,6,0,19,52,7,0,59,79,7,0,86,108,8,0,116,116,9,0,125
179169,385,"ŞCOALA GIMNAZIALĂ SPECIALĂ NR.5;","BUCUREŞTI SECTORUL 3",B,1539,6,2,0,8,37,5,0,42,55,7,0,62,72,10,0,82,88,11,0,99
179169,386,"ŞCOALA GIMNAZIALĂ SPECIALĂ NR.5;","BUCUREŞTI SECTORUL 3",B,1086,10,0,0,10,32,0,0,32,49,3,0,52,68,3,0,71,72,3,0,75
179169,387,"ŞCOALA GIMNAZIALĂ SPECIALĂ NR.5;","BUCUREŞTI SECTORUL 3",B,1367,10,2,0,12,30,2,0,32,45,2,0,47,55,4,0,59,59,4,0,63
179169,388,"ŞCOALA GIMNAZIALĂ SPECIALĂ NR.5;","BUCUREŞTI SECTORUL 3",B,1300,11,1,0,12,25,2,0,27,47,2,0,49,71,5,0,76,72,7,0,79
179169,389,"ŞCOALA GIMNAZIALĂ SPECIALĂ NR.5;","BUCUREŞTI SECTORUL 3",B,1612,4,0,0,4,45,2,0,47,68,4,0,72,85,4,0,89,89,4,0,93
179169,390,"ŞCOALA GIMNAZIALĂ SPECIALĂ NR.5;","BUCUREŞTI SECTORUL 3",B,1194,0,0,0,0,14,0,0,14,33,2,0,35,43,4,0,47,55,4,0,59
179169,391,"ŞCOALA GIMNAZIALĂ ""CEZAR BOLLIAC"";","BUCUREŞTI SECTORUL 3",B,1471,16,1,0,17,41,1,0,42,70,1,0,71,87,2,0,89,94,2,0,96
179169,392,"ŞCOALA GIMNAZIALĂ ""CEZAR BOLLIAC"";","BUCUREŞTI SECTORUL 3",B,1476,13,5,0,18,41,9,0,50,66,13,0,79,96,17,0,113,104,23,0,127
179169,393,"ŞCOALA GIMNAZIALĂ ""CEZAR BOLLIAC"";","BUCUREŞTI SECTORUL 3",B,1393,10,0,0,10,53,5,0,58,92,9,0,101,115,11,0,126,128,13,0,141
179169,394,"ŞCOALA GIMNAZIALĂ ""CEZAR BOLLIAC"";","BUCUREŞTI SECTORUL 3",B,1476,14,1,0,15,56,1,0,57,88,2,0,90,110,2,0,112,126,3,0,129
179169,395,"ŞCOALA GIMNAZIALĂ ""CEZAR BOLLIAC"";","BUCUREŞTI SECTORUL 3",B,1280,20,0,0,20,70,2,0,72,94,4,0,98,119,6,0,125,137,8,0,145
179169,396,"ŞCOALA GIMNAZIALĂ ""CEZAR BOLLIAC"";","BUCUREŞTI SECTORUL 3",B,1620,14,2,0,16,58,4,0,62,79,6,0,85,101,6,0,107,112,7,0,119
179169,397,"ŞCOALA GIMNAZIALĂ ""CEZAR BOLLIAC"";","BUCUREŞTI SECTORUL 3",B,1523,17,3,0,20,53,5,0,58,72,5,0,77,91,6,0,97,110,6,0,116
179169,398,"ŞCOALA GIMNAZIALĂ ""CEZAR BOLLIAC"";","BUCUREŞTI SECTORUL 3",B,1496,8,0,0,8,57,1,0,58,86,2,0,88,111,2,0,113,123,3,0,126
179169,399,"ŞCOALA GIMNAZIALĂ NR.80;","BUCUREŞTI SECTORUL 3",B,1335,17,3,0,20,52,14,0,66,71,24,0,95,99,30,0,129,136,33,0,169
179169,400,"ŞCOALA GIMNAZIALĂ NR.80;","BUCUREŞTI SECTORUL 3",B,1275,11,0,0,11,47,8,0,55,74,10,0,84,93,18,0,111,99,20,0,119
179169,401,"ŞCOALA GIMNAZIALĂ NR.80;","BUCUREŞTI SECTORUL 3",B,1730,15,0,0,15,50,0,0,50,77,3,0,80,99,8,0,107,113,8,0,121
179169,402,"ŞCOALA GIMNAZIALĂ NR.80;","BUCUREŞTI SECTORUL 3",B,1570,8,0,0,8,46,0,0,46,96,0,0,96,113,11,1,125,123,12,1,136
179169,403,"ŞCOALA GIMNAZIALĂ NR.80;","BUCUREŞTI SECTORUL 3",B,1056,8,0,0,8,29,1,0,30,56,1,0,57,68,1,0,69,77,2,0,79
179169,404,"ŞCOALA GIMNAZIALĂ NR.80;","BUCUREŞTI SECTORUL 3",B,1043,14,0,0,14,27,2,0,29,49,2,0,51,64,3,0,67,68,3,0,71
179169,405,"ŞCOALA GIMNAZIALĂ NR.80;","BUCUREŞTI SECTORUL 3",B,858,3,0,0,3,23,0,0,23,29,0,0,29,48,3,0,51,57,3,0,60
179169,406,"ŞCOALA GIMNAZIALĂ NR.80;","BUCUREŞTI SECTORUL 3",B,1087,5,0,0,5,24,0,0,24,44,5,0,49,59,7,0,66,63,7,0,70
179169,407,"ŞCOALA GIMNAZIALĂ NR.81;","BUCUREŞTI SECTORUL 3",B,1837,17,1,0,18,60,2,0,62,101,3,0,104,139,6,0,145,154,11,0,165
179169,408,"ŞCOALA GIMNAZIALĂ NR.81;","BUCUREŞTI SECTORUL 3",B,1500,10,0,0,10,35,6,0,41,64,16,0,80,85,24,0,109,97,24,0,121
179169,409,"ŞCOALA GIMNAZIALĂ NR.81;","BUCUREŞTI SECTORUL 3",B,1373,8,2,0,10,21,8,0,29,42,15,0,57,51,19,0,70,73,19,0,92
179169,410,"ŞCOALA GIMNAZIALĂ NR.81;","BUCUREŞTI SECTORUL 3",B,1154,15,0,0,15,33,1,0,34,50,2,0,52,59,3,0,62,70,5,0,75
179169,411,"ŞCOALA GIMNAZIALĂ NR.81;","BUCUREŞTI SECTORUL 3",B,1741,4,0,0,4,47,6,0,53,78,6,0,84,100,11,0,111,114,14,0,128
179169,412,"ŞCOALA GIMNAZIALĂ NR.81;","BUCUREŞTI SECTORUL 3",B,1307,13,0,0,13,32,0,0,32,43,0,0,43,63,0,0,63,74,0,0,74
179169,413,"ŞCOALA GIMNAZIALĂ NR.81;","BUCUREŞTI SECTORUL 3",B,1474,9,2,0,11,33,2,0,35,58,4,0,62,94,5,0,99,96,5,0,101
179169,414,"ŞCOALA GIMNAZIALĂ NR.81;","BUCUREŞTI SECTORUL 3",B,1378,13,0,0,13,31,0,0,31,53,1,0,54,73,3,0,76,81,4,0,85
179169,415,"ŞCOALA GIMNAZIALĂ NR.81;","BUCUREŞTI SECTORUL 3",B,1199,10,0,0,10,37,2,0,39,57,5,0,62,84,8,0,92,95,10,0,105
179169,416,"COLEGIUL TEHNIC ""MIHAI BRAVU"";","BUCUREŞTI SECTORUL 3",B,1458,1,1,0,2,14,14,0,28,20,29,0,49,36,44,0,80,43,48,0,91
179169,417,"COLEGIUL TEHNIC ""MIHAI BRAVU"";","BUCUREŞTI SECTORUL 3",B,1533,9,3,0,12,23,9,0,32,36,10,0,46,60,12,0,72,73,12,0,85
179169,418,"COLEGIUL TEHNIC ""MIHAI BRAVU"";","BUCUREŞTI SECTORUL 3",B,1326,9,0,0,9,47,0,0,47,67,0,0,67,83,0,1,84,93,0,1,94
179169,419,"COLEGIUL TEHNIC ""MIHAI BRAVU"";","BUCUREŞTI SECTORUL 3",B,1544,13,2,0,15,43,2,0,45,71,2,0,73,87,4,0,91,101,4,0,105
179169,420,"COLEGIUL TEHNIC ""MIHAI BRAVU"";","BUCUREŞTI SECTORUL 3",B,1060,6,0,0,6,24,0,0,24,43,0,0,43,64,0,0,64,65,0,0,65
179169,421,"COLEGIUL TEHNIC ""MIHAI BRAVU"";","BUCUREŞTI SECTORUL 3",B,1553,14,0,0,14,35,5,0,40,52,5,0,57,83,8,0,91,90,8,0,98
179169,422,"COLEGIUL TEHNIC ""MIHAI BRAVU"";","BUCUREŞTI SECTORUL 3",B,1322,7,1,0,8,30,1,0,31,55,1,0,56,80,2,0,82,91,2,0,93
179169,423,"COLEGIUL TEHNIC ""MIHAI BRAVU"";","BUCUREŞTI SECTORUL 3",B,1179,9,0,0,9,47,0,0,47,67,1,0,68,86,1,0,87,89,1,0,90
179169,424,"COLEGIUL TEHNIC ""MIHAI BRAVU"";","BUCUREŞTI SECTORUL 3",B,1276,13,0,0,13,51,0,0,51,66,1,0,67,82,1,0,83,102,1,0,103
179169,425,"COLEGIUL TEHNIC ""MIHAI BRAVU"";","BUCUREŞTI SECTORUL 3",B,1294,12,2,0,14,41,2,0,43,58,4,0,62,84,4,0,88,91,4,0,95
179169,426,"COLEGIUL TEHNIC ""MIHAI BRAVU"";","BUCUREŞTI SECTORUL 3",B,1184,7,0,0,7,30,2,0,32,55,2,0,57,64,2,1,67,70,2,1,73
179169,427,"COLEGIUL TEHNIC ""MIHAI BRAVU"";","BUCUREŞTI SECTORUL 3",B,1428,8,0,0,8,30,2,0,32,59,2,0,61,78,2,0,80,87,3,0,90
179169,428,"COLEGIUL TEHNIC ""MIHAI BRAVU"";","BUCUREŞTI SECTORUL 3",B,1119,12,2,0,14,58,3,0,61,69,5,0,74,77,5,0,82,77,5,0,82
179169,429,"ŞCOALA GIMNAZIALĂ NR.95;","BUCUREŞTI SECTORUL 3",B,1478,18,3,0,21,44,13,0,57,60,20,1,81,80,27,1,108,88,29,1,118
179169,430,"ŞCOALA GIMNAZIALĂ NR.95;","BUCUREŞTI SECTORUL 3",B,1848,5,0,0,5,20,4,0,24,33,4,0,37,58,5,0,63,59,5,0,64
179169,431,"ŞCOALA GIMNAZIALĂ NR.95;","BUCUREŞTI SECTORUL 3",B,1361,6,0,0,6,25,1,0,26,40,3,1,44,60,4,1,65,64,5,1,70
179169,432,"ŞCOALA GIMNAZIALĂ NR.95;","BUCUREŞTI SECTORUL 3",B,959,3,1,0,4,23,1,0,24,37,1,0,38,42,1,0,43,51,1,0,52
179169,433,"ŞCOALA GIMNAZIALĂ NR.95;","BUCUREŞTI SECTORUL 3",B,1514,12,0,0,12,40,0,0,40,54,0,0,54,70,0,0,70,80,0,0,80
179169,434,"ŞCOALA GIMNAZIALĂ NR.95;","BUCUREŞTI SECTORUL 3",B,1444,6,0,0,6,21,1,0,22,31,2,0,33,44,3,0,47,46,3,1,50
179169,435,"ŞCOALA GIMNAZIALĂ NR.95;","BUCUREŞTI SECTORUL 3",B,1366,5,0,0,5,35,0,0,35,40,0,0,40,54,0,0,54,60,0,0,60
179169,436,"ŞCOALA GIMNAZIALĂ NR.95;","BUCUREŞTI SECTORUL 3",B,1383,14,1,0,15,35,1,0,36,50,1,0,51,57,1,0,58,66,1,0,67
179169,437,"ŞCOALA GIMNAZIALĂ NR.95;","BUCUREŞTI SECTORUL 3",B,1718,14,0,0,14,36,1,0,37,53,2,0,55,76,2,0,78,92,2,0,94
179169,438,"ŞCOALA GIMNAZIALĂ NR.95;","BUCUREŞTI SECTORUL 3",B,1588,5,1,0,6,33,1,0,34,56,4,0,60,71,4,0,75,84,4,0,88
179169,439,"ŞCOALA GIMNAZIALĂ NR.84","BUCUREŞTI SECTORUL 3",B,1544,9,2,0,11,46,8,0,54,76,18,0,94,84,20,0,104,94,20,0,114
179169,440,"ŞCOALA GIMNAZIALĂ NR.84","BUCUREŞTI SECTORUL 3",B,1451,8,0,0,8,24,1,0,25,37,2,0,39,47,2,0,49,51,2,0,53
179169,441,"ŞCOALA GIMNAZIALĂ NR.84","BUCUREŞTI SECTORUL 3",B,1299,11,0,0,11,23,0,0,23,40,11,0,51,55,12,0,67,57,12,0,69
179169,442,"ŞCOALA GIMNAZIALĂ NR.84","BUCUREŞTI SECTORUL 3",B,1476,8,0,0,8,35,5,0,40,58,14,0,72,92,17,0,109,96,18,0,114
179169,443,"ŞCOALA GIMNAZIALĂ NR.84","BUCUREŞTI SECTORUL 3",B,1401,0,0,0,0,7,2,0,9,31,9,0,40,64,9,0,73,70,10,0,80
179169,444,"ŞCOALA GIMNAZIALĂ NR.84;","BUCUREŞTI SECTORUL 3",B,1216,11,0,0,11,35,0,0,35,47,0,0,47,65,4,0,69,70,6,0,76
179169,445,"ŞCOALA GIMNAZIALĂ NR.86;","BUCUREŞTI SECTORUL 3",B,1360,13,0,0,13,45,4,0,49,62,4,2,68,84,10,2,96,90,12,2,104
179169,446,"ŞCOALA GIMNAZIALĂ NR.86;","BUCUREŞTI SECTORUL 3",B,1689,12,0,0,12,50,3,0,53,73,3,0,76,102,5,0,107,108,5,0,113
179169,447,"ŞCOALA GIMNAZIALĂ NR.86;","BUCUREŞTI SECTORUL 3",B,1642,7,2,0,9,80,3,0,83,101,3,0,104,125,4,0,129,131,4,0,135
179169,448,"ŞCOALA GIMNAZIALĂ NR.86;","BUCUREŞTI SECTORUL 3",B,1661,26,0,0,26,65,1,0,66,91,1,0,92,111,3,0,114,120,3,0,123
179169,449,"ŞCOALA GIMNAZIALĂ NR.86;","BUCUREŞTI SECTORUL 3",B,1615,11,2,0,13,28,3,0,31,47,3,0,50,67,3,0,70,74,3,0,77
179169,450,"ŞCOALA GIMNAZIALĂ NR.86;","BUCUREŞTI SECTORUL 3",B,1339,17,0,0,17,53,0,0,53,68,0,0,68,88,0,0,88,96,1,0,97
179169,451,"ŞCOALA GIMNAZIALĂ NR.86;","BUCUREŞTI SECTORUL 3",B,1659,14,0,0,14,56,1,0,57,84,1,0,85,101,1,0,102,110,1,0,111
179169,452,"ŞCOALA GIMNAZIALĂ ""LEONARDO DA VINCI"";","BUCUREŞTI SECTORUL 3",B,1566,4,2,8,14,45,4,8,57,67,9,8,84,89,14,8,111,95,17,8,120
179169,453,"ŞCOALA GIMNAZIALĂ ""LEONARDO DA VINCI"";","BUCUREŞTI SECTORUL 3",B,1372,8,0,0,8,36,3,0,39,66,9,0,75,73,10,0,83,80,12,0,92
179169,454,"ŞCOALA GIMNAZIALĂ ""LEONARDO DA VINCI"";","BUCUREŞTI SECTORUL 3",B,1508,12,0,0,12,33,0,0,33,65,1,0,66,82,1,0,83,97,1,0,98
179169,455,"ŞCOALA GIMNAZIALĂ ""LEONARDO DA VINCI"";","BUCUREŞTI SECTORUL 3",B,1253,8,0,0,8,48,0,0,48,76,0,0,76,104,0,0,104,111,0,0,111
179169,456,"ŞCOALA GIMNAZIALĂ ""LEONARDO DA VINCI"";","BUCUREŞTI SECTORUL 3",B,1206,6,18,0,24,38,18,0,56,55,18,0,73,75,19,0,94,86,20,0,106
179169,457,"ŞCOALA GIMNAZIALĂ ""LEONARDO DA VINCI"";","BUCUREŞTI SECTORUL 3",B,1090,4,1,0,5,31,5,0,36,51,8,0,59,69,8,0,77,75,9,0,84
179169,458,"ŞCOALA GIMNAZIALĂ ""LEONARDO DA VINCI"";","BUCUREŞTI SECTORUL 3",B,1067,10,1,0,11,31,1,0,32,56,2,0,58,77,2,0,79,83,2,0,85
179169,459,"ŞCOALA GIMNAZIALĂ ""LEONARDO DA VINCI"";","BUCUREŞTI SECTORUL 3",B,1028,5,0,0,5,30,3,0,33,44,5,0,49,65,5,0,70,68,6,0,74
179169,460,"ŞCOALA GIMNAZIALĂ ""LEONARDO DA VINCI"";","BUCUREŞTI SECTORUL 3",B,1184,9,0,0,9,34,0,0,34,54,1,1,56,68,3,1,72,78,3,1,82
179169,461,"LICEUL TEORETIC ""BENJAMIN FRANKLIN"";","BUCUREŞTI SECTORUL 3",B,1275,6,0,0,6,32,9,0,41,45,9,0,54,62,12,0,74,70,12,0,82
179169,462,"LICEUL TEORETIC ""BENJAMIN FRANKLIN"";","BUCUREŞTI SECTORUL 3",B,1157,1,7,0,8,30,7,0,37,46,7,0,53,63,9,0,72,78,9,0,87
179169,463,"LICEUL TEORETIC ""BENJAMIN FRANKLIN"";","BUCUREŞTI SECTORUL 3",B,972,10,0,0,10,35,3,0,38,53,3,0,56,67,3,0,70,71,4,0,75
179169,464,"LICEUL TEORETIC ""BENJAMIN FRANKLIN"";","BUCUREŞTI SECTORUL 3",B,1103,12,0,0,12,45,1,0,46,70,5,0,75,102,6,0,108,111,6,0,117
179169,465,"ŞCOALA GIMNAZIALĂ""ALEXANDRU IOAN CUZA"";","BUCUREŞTI SECTORUL 3",B,1219,11,1,0,12,25,1,0,26,43,2,0,45,61,2,0,63,66,2,0,68
179169,466,"ŞCOALA GIMNAZIALĂ""ALEXANDRU IOAN CUZA"";","BUCUREŞTI SECTORUL 3",B,1361,4,6,0,10,26,10,0,36,30,10,0,40,58,14,0,72,65,15,0,80
179169,467,"ŞCOALA GIMNAZIALĂ""ALEXANDRU IOAN CUZA"";","BUCUREŞTI SECTORUL 3",B,1626,11,2,0,13,36,2,0,38,61,3,0,64,85,5,0,90,98,5,0,103
179169,468,"ŞCOALA GIMNAZIALĂ""ALEXANDRU IOAN CUZA"";","BUCUREŞTI SECTORUL 3",B,1280,10,0,0,10,47,2,0,49,61,3,0,64,74,3,0,77,82,3,0,85
179169,469,"ŞCOALA GIMNAZIALĂ""ALEXANDRU IOAN CUZA"";","BUCUREŞTI SECTORUL 3",B,1009,7,0,0,7,27,0,0,27,44,0,0,44,58,1,0,59,64,1,0,65
179169,470,"COLEGIUL TEHNIC ""ANGHEL SALIGNY"";","BUCUREŞTI SECTORUL 3",B,1184,12,2,0,14,28,8,0,36,44,8,0,52,58,16,0,74,67,16,0,83
179169,471,"COLEGIUL TEHNIC ""ANGHEL SALIGNY"";","BUCUREŞTI SECTORUL 3",B,1071,17,0,0,17,40,0,0,40,54,3,0,57,67,3,1,71,70,3,1,74
179169,472,"ŞCOALA GIMNAZIALĂ NR.88","BUCUREŞTI SECTORUL 3",B,1398,18,0,0,18,50,4,0,54,83,12,0,95,105,18,0,123,128,21,0,149
179169,473,"ŞCOALA GIMNAZIALĂ NR.88","BUCUREŞTI SECTORUL 3",B,1413,10,0,0,10,49,5,0,54,70,6,0,76,92,9,1,102,98,11,1,110
179169,474,"ŞCOALA GIMNAZIALĂ NR.88","BUCUREŞTI SECTORUL 3",B,1314,11,0,0,11,45,0,0,45,65,1,0,66,88,2,0,90,98,2,0,100
179169,475,"ŞCOALA GIMNAZIALĂ NR.88","BUCUREŞTI SECTORUL 3",B,1481,23,0,0,23,64,0,0,64,94,2,0,96,133,3,0,136,137,4,0,141
179169,476,"ŞCOALA GIMNAZIALĂ NR.88","BUCUREŞTI SECTORUL 3",B,1512,19,3,0,22,59,3,0,62,88,3,0,91,107,3,0,110,121,3,0,124
179169,477,"ŞCOALA GIMNAZIALĂ NR.88","BUCUREŞTI SECTORUL 3",B,1316,11,0,0,11,35,2,0,37,57,2,0,59,85,2,0,87,94,2,0,96
179169,478,"ŞCOALA GIMNAZIALĂ ""MIHAI BOTEZ"";","BUCUREŞTI SECTORUL 3",B,1330,7,0,0,7,26,6,0,32,41,12,0,53,47,27,0,74,55,31,0,86
179169,479,"ŞCOALA GIMNAZIALĂ ""MIHAI BOTEZ"";","BUCUREŞTI SECTORUL 3",B,1082,7,0,0,7,23,1,0,24,37,3,0,40,51,7,0,58,52,8,0,60
179169,480,"ŞCOALA GIMNAZIALĂ ""MIHAI BOTEZ"";","BUCUREŞTI SECTORUL 3",B,1390,13,1,0,14,33,1,0,34,47,1,0,48,63,3,0,66,67,3,0,70
179169,481,"ŞCOALA GIMNAZIALĂ ""MIHAI BOTEZ"";","BUCUREŞTI SECTORUL 3",B,2037,15,0,0,15,49,0,0,49,64,0,0,64,75,0,0,75,76,1,0,77
179169,482,"ŞCOALA GIMNAZIALĂ ""MIHAI BOTEZ"";","BUCUREŞTI SECTORUL 3",B,1420,10,0,0,10,42,2,0,44,63,2,0,65,77,3,0,80,88,6,0,94
179169,483,"ŞCOALA GIMNAZIALĂ ""MIHAI BOTEZ"";","BUCUREŞTI SECTORUL 3",B,1355,11,0,0,11,29,0,0,29,35,1,0,36,49,2,0,51,57,3,0,60
179169,484,"ŞCOALA GIMNAZIALĂ ""MIHAI BOTEZ"";","BUCUREŞTI SECTORUL 3",B,1363,10,0,0,10,42,1,0,43,64,1,0,65,81,1,0,82,93,1,0,94
179169,485,"ŞCOALA GIMNAZIALĂ ""MIHAI BOTEZ"";","BUCUREŞTI SECTORUL 3",B,1382,9,0,0,9,24,1,0,25,53,3,0,56,73,3,0,76,77,3,0,80
179169,486,"ŞCOALA GIMNAZIALĂ ""MIHAI BOTEZ"";","BUCUREŞTI SECTORUL 3",B,1512,9,2,0,11,40,3,0,43,56,6,0,62,85,6,0,91,91,6,0,97
179169,487,"ŞCOALA GIMNAZIALĂ ""MIHAI BOTEZ"";","BUCUREŞTI SECTORUL 3",B,1506,18,0,0,18,51,0,0,51,70,0,0,70,80,0,0,80,81,0,0,81
179169,488,"ŞCOALA GIMNAZIALĂ ""MIHAI BOTEZ"";","BUCUREŞTI SECTORUL 3",B,1139,10,0,0,10,29,0,0,29,41,0,0,41,55,0,0,55,59,0,0,59
179169,489,"LICEUL TEORETIC ""DANTE ALIGHIERI"";","BUCUREŞTI SECTORUL 3",B,1430,12,2,0,14,61,5,0,66,94,6,0,100,130,8,0,138,140,11,0,151
179169,490,"LICEUL TEORETIC ""DANTE ALIGHIERI"";","BUCUREŞTI SECTORUL 3",B,1384,12,0,0,12,52,2,0,54,72,4,0,76,85,5,0,90,87,5,0,92
179169,491,"LICEUL TEORETIC ""DANTE ALIGHIERI"";","BUCUREŞTI SECTORUL 3",B,1108,15,0,0,15,39,0,0,39,56,0,0,56,75,0,0,75,81,0,0,81
179169,492,"LICEUL TEORETIC ""DANTE ALIGHIERI"";","BUCUREŞTI SECTORUL 3",B,1112,8,4,0,12,41,4,0,45,61,5,0,66,83,6,0,89,88,6,0,94
179169,493,"LICEUL TEORETIC ""DANTE ALIGHIERI"";","BUCUREŞTI SECTORUL 3",B,1263,16,0,0,16,39,2,0,41,63,4,0,67,72,7,0,79,90,7,0,97
179169,494,"ŞCOALA GIMNAZIALĂ NR.195;","BUCUREŞTI SECTORUL 3",B,1223,14,0,0,14,46,4,0,50,83,5,0,88,116,8,0,124,120,14,0,134
179169,495,"ŞCOALA GIMNAZIALĂ NR.195;","BUCUREŞTI SECTORUL 3",B,1183,14,2,0,16,50,4,0,54,67,5,0,72,81,9,0,90,89,9,0,98
179169,496,"ŞCOALA GIMNAZIALĂ NR.195;","BUCUREŞTI SECTORUL 3",B,1167,0,0,0,0,14,1,0,15,33,5,0,38,64,7,0,71,73,7,0,80
179169,497,"ŞCOALA GIMNAZIALĂ NR.195;","BUCUREŞTI SECTORUL 3",B,1005,9,0,0,9,49,1,0,50,71,1,0,72,87,2,0,89,91,3,0,94
179169,498,"ŞCOALA GIMNAZIALĂ NR.195;","BUCUREŞTI SECTORUL 3",B,1055,18,0,0,18,35,2,0,37,51,3,0,54,71,6,0,77,76,6,0,82
179169,499,"LICEUL TEHNOLOGIC ""ELIE RADU"";","BUCUREŞTI SECTORUL 3",B,1427,11,1,0,12,27,2,12,41,40,4,12,56,63,10,12,85,79,15,12,106
179169,500,"LICEUL TEHNOLOGIC ""ELIE RADU"";","BUCUREŞTI SECTORUL 3",B,1474,10,0,0,10,35,0,0,35,50,1,0,51,62,2,0,64,69,2,0,71
179169,501,"LICEUL TEHNOLOGIC ""ELIE RADU"";","BUCUREŞTI SECTORUL 3",B,1032,6,0,0,6,25,7,0,32,38,13,0,51,49,14,0,63,49,17,0,66
179169,502,"LICEUL TEHNOLOGIC ""ELIE RADU"";","BUCUREŞTI SECTORUL 3",B,1625,6,0,0,6,32,0,0,32,43,0,0,43,49,0,0,49,57,3,0,60
179169,503,"LICEUL TEHNOLOGIC ""ELIE RADU"";","BUCUREŞTI SECTORUL 3",B,1468,10,2,0,12,24,2,0,26,38,2,0,40,46,3,0,49,51,3,0,54
179169,504,"LICEUL TEORETIC BILINGV ""DECEBAL"";","BUCUREŞTI SECTORUL 3",B,1150,6,2,0,8,29,3,0,32,38,3,0,41,51,4,0,55,58,6,0,64
179169,505,"LICEUL TEORETIC BILINGV ""DECEBAL"";","BUCUREŞTI SECTORUL 3",B,1430,9,4,0,13,34,6,0,40,56,6,0,62,68,6,0,74,79,6,0,85
179169,506,"LICEUL TEORETIC BILINGV ""DECEBAL"";","BUCUREŞTI SECTORUL 3",B,1485,3,0,0,3,18,0,0,18,31,0,0,31,41,1,0,42,47,3,0,50
179169,507,"LICEUL TEORETIC BILINGV ""DECEBAL"";","BUCUREŞTI SECTORUL 3",B,1433,7,4,0,11,14,4,0,18,20,4,0,24,27,5,0,32,29,5,0,34
179169,508,"ŞCOALA GIMNAZIALĂ NR.54;","BUCUREŞTI SECTORUL 3",B,1046,4,2,0,6,22,3,0,25,36,4,0,40,50,4,0,54,51,4,0,55
179169,509,"ŞCOALA GIMNAZIALĂ NR.54;","BUCUREŞTI SECTORUL 3",B,1342,15,2,0,17,32,2,0,34,52,3,0,55,69,7,0,76,74,7,0,81
179169,510,"ŞCOALA GIMNAZIALĂ NR.54;","BUCUREŞTI SECTORUL 3",B,1524,6,1,0,7,36,4,0,40,51,4,0,55,72,5,0,77,77,5,0,82
179169,511,"ŞCOALA GIMNAZIALĂ NR.54;","BUCUREŞTI SECTORUL 3",B,1375,22,0,0,22,56,2,0,58,72,2,0,74,97,4,0,101,110,4,0,114
179169,512,"ŞCOALA GIMNAZIALĂ NR.54;","BUCUREŞTI SECTORUL 3",B,1335,7,2,0,9,24,2,0,26,44,2,0,46,56,3,0,59,70,3,0,73
179169,513,"ŞCOALA GIMNAZIALĂ NR.54;","BUCUREŞTI SECTORUL 3",B,1143,10,0,0,10,27,2,0,29,41,2,0,43,55,2,0,57,59,2,0,61
179169,514,"ŞCOALA GIMNAZIALĂ NR.54;","BUCUREŞTI SECTORUL 3",B,1350,10,0,0,10,21,0,0,21,39,1,0,40,50,1,0,51,60,1,0,61
179169,515,"ŞCOALA GIMNAZIALĂ NR.54;","BUCUREŞTI SECTORUL 3",B,1187,8,1,0,9,19,8,0,27,29,8,0,37,54,8,0,62,54,10,0,64
179169,516,"ŞCOALA GIMNAZIALĂ NR.54;","BUCUREŞTI SECTORUL 3",B,1233,17,0,0,17,44,1,0,45,66,1,0,67,83,2,0,85,96,3,0,99
179169,517,"ŞCOALA GIMNAZIALĂ NR.54;","BUCUREŞTI SECTORUL 3",B,1463,13,0,0,13,35,0,2,37,50,0,2,52,64,0,2,66,71,0,2,73
179169,518,"ŞCOALA GIMNAZIALĂ ""NICOLAE LABIŞ"";","BUCUREŞTI SECTORUL 3",B,1540,14,0,0,14,45,1,0,46,65,3,0,68,94,4,0,98,100,4,0,104
179169,519,"ŞCOALA GIMNAZIALĂ ""NICOLAE LABIŞ"";","BUCUREŞTI SECTORUL 3",B,1194,6,3,0,9,28,6,0,34,39,7,0,46,56,9,0,65,63,9,0,72
179169,520,"ŞCOALA GIMNAZIALĂ ""NICOLAE LABIŞ"";","BUCUREŞTI SECTORUL 3",B,1726,4,2,0,6,22,3,0,25,40,7,0,47,65,7,0,72,73,10,0,83
179169,521,"ŞCOALA GIMNAZIALĂ ""NICOLAE LABIŞ"";","BUCUREŞTI SECTORUL 3",B,1435,17,1,0,18,43,1,1,45,64,1,1,66,81,2,1,84,88,2,1,91
179169,522,"ŞCOALA GIMNAZIALĂ ""NICOLAE LABIŞ"";","BUCUREŞTI SECTORUL 3",B,1586,4,0,0,4,19,0,0,19,42,0,0,42,61,0,0,61,68,0,0,68
179169,523,"ŞCOALA GIMNAZIALĂ ""NICOLAE LABIŞ"";","BUCUREŞTI SECTORUL 3",B,1656,8,0,0,8,26,0,0,26,47,2,0,49,55,2,0,57,56,2,0,58
179169,524,"ŞCOALA GIMNAZIALĂ ""NICOLAE LABIŞ"";","BUCUREŞTI SECTORUL 3",B,1194,6,1,0,7,32,2,0,34,50,2,0,52,63,5,0,68,76,5,0,81
179169,525,"ŞCOALA GIMNAZIALĂ ""NICOLAE LABIŞ"";","BUCUREŞTI SECTORUL 3",B,1252,12,3,0,15,39,13,0,52,52,14,0,66,93,4,0,97,96,5,0,101
179169,526,"ŞCOALA GIMNAZIALĂ NR.92;","BUCUREŞTI SECTORUL 3",B,1879,19,3,0,22,47,4,0,51,75,9,0,84,85,9,0,94,97,11,0,108
179169,527,"ŞCOALA GIMNAZIALĂ NR.92;","BUCUREŞTI SECTORUL 3",B,1425,11,0,0,11,59,0,0,59,79,2,0,81,93,4,0,97,100,5,0,105
179169,528,"ŞCOALA GIMNAZIALĂ NR.92;","BUCUREŞTI SECTORUL 3",B,1851,15,0,0,15,40,0,0,40,62,0,0,62,78,0,0,78,88,0,0,88
179169,529,"ŞCOALA GIMNAZIALĂ NR.92;","BUCUREŞTI SECTORUL 3",B,1382,7,0,0,7,35,0,0,35,46,0,0,46,73,0,0,73,79,0,0,79
179169,530,"ŞCOALA GIMNAZIALĂ NR.92;","BUCUREŞTI SECTORUL 3",B,1126,3,1,0,4,32,1,0,33,60,1,0,61,76,4,0,80,85,5,0,90
179169,531,"ŞCOALA GIMNAZIALĂ NR.92;","BUCUREŞTI SECTORUL 3",B,1692,14,0,0,14,49,0,0,49,58,0,0,58,71,0,0,71,96,1,0,97
179169,532,"ŞCOALA GIMNAZIALĂ NR.92;","BUCUREŞTI SECTORUL 3",B,1519,9,0,0,9,31,1,0,32,48,1,0,49,71,1,0,72,77,1,0,78
179169,533,"ŞCOALA GIMNAZIALĂ NR.92;","BUCUREŞTI SECTORUL 3",B,1359,19,4,0,23,55,6,0,61,80,6,0,86,104,7,0,111,112,7,0,119
179169,534,"ŞCOALA GIMNAZIALĂ NR.92;","BUCUREŞTI SECTORUL 3",B,1466,12,0,0,12,35,0,0,35,67,0,0,67,84,0,1,85,92,0,1,93
179169,535,"ŞCOALA GIMNAZIALĂ NR.20;","BUCUREŞTI SECTORUL 3",B,1439,19,0,0,19,61,0,0,61,84,0,0,84,104,1,0,105,116,1,0,117
179169,536,"ŞCOALA GIMNAZIALĂ NR.20;","BUCUREŞTI SECTORUL 3",B,1718,23,1,0,24,59,3,0,62,76,3,0,79,96,7,0,103,100,8,0,108
179169,537,"ŞCOALA GIMNAZIALĂ NR.20;","BUCUREŞTI SECTORUL 3",B,1974,10,2,0,12,62,5,0,67,89,10,0,99,101,13,0,114,121,18,0,139
179169,538,"ŞCOALA GIMNAZIALĂ NR.20;","BUCUREŞTI SECTORUL 3",B,1389,14,0,0,14,36,1,0,37,55,1,0,56,70,1,0,71,78,4,0,82
179169,539,"ŞCOALA GIMNAZIALĂ NR.20;","BUCUREŞTI SECTORUL 3",B,1456,10,0,0,10,31,3,0,34,62,3,0,65,87,3,0,90,98,3,0,101
179169,540,"ŞCOALA GIMNAZIALĂ NR.20;","BUCUREŞTI SECTORUL 3",B,1419,13,0,0,13,57,1,0,58,73,2,0,75,96,4,0,100,105,6,0,111
179169,541,"COLEGIUL TEHNIC ""COSTIN D. NENIŢESCU"";","BUCUREŞTI SECTORUL 3",B,2065,9,5,0,14,43,11,0,54,87,20,0,107,113,37,0,150,121,38,0,159
179169,542,"COLEGIUL TEHNIC ""COSTIN D. NENIŢESCU"";","BUCUREŞTI SECTORUL 3",B,1363,11,0,0,11,46,0,0,46,65,4,0,69,79,24,0,103,79,24,0,103
179169,543,"COLEGIUL TEHNIC ""COSTIN D. NENIŢESCU"";","BUCUREŞTI SECTORUL 3",B,1488,11,3,0,14,31,3,0,34,52,3,0,55,73,3,0,76,86,4,0,90
179169,544,"COLEGIUL TEHNIC ""COSTIN D. NENIŢESCU"";","BUCUREŞTI SECTORUL 3",B,1508,20,2,0,22,50,2,0,52,75,2,0,77,97,2,0,99,100,2,0,102
179169,545,"COLEGIUL TEHNIC ""COSTIN D. NENIŢESCU"";","BUCUREŞTI SECTORUL 3",B,1833,12,0,0,12,42,1,0,43,60,1,0,61,79,1,0,80,97,1,0,98
179169,546,"ŞCOALA GIMNAZIALĂ NR.112;","BUCUREŞTI SECTORUL 3",B,1246,14,1,0,15,35,5,0,40,56,6,0,62,86,8,0,94,90,8,0,98
179169,547,"ŞCOALA GIMNAZIALĂ NR.112;","BUCUREŞTI SECTORUL 3",B,1170,11,0,0,11,37,3,0,40,54,4,0,58,71,8,0,79,75,11,0,86
179169,548,"ŞCOALA GIMNAZIALĂ NR.112;","BUCUREŞTI SECTORUL 3",B,1270,16,0,0,16,47,3,0,50,69,3,0,72,84,6,0,90,88,7,0,95
179169,549,"ŞCOALA GIMNAZIALĂ NR.112;","BUCUREŞTI SECTORUL 3",B,1549,17,1,0,18,47,3,0,50,65,3,0,68,100,4,0,104,102,4,0,106
179169,550,"ŞCOALA GIMNAZIALĂ NR.112;","BUCUREŞTI SECTORUL 3",B,1218,13,2,0,15,39,2,0,41,53,3,0,56,63,3,0,66,72,3,0,75
179169,551,"ŞCOALA GIMNAZIALĂ NR.112;","BUCUREŞTI SECTORUL 3",B,1230,17,2,0,19,48,7,0,55,67,7,0,74,75,7,1,83,78,8,1,87
179169,552,"ŞCOALA GIMNAZIALĂ NR.112;","BUCUREŞTI SECTORUL 3",B,1186,8,0,0,8,28,0,0,28,41,2,0,43,51,2,0,53,61,3,0,64
179169,553,"ŞCOALA GIMNAZIALĂ NR.112;","BUCUREŞTI SECTORUL 3",B,1143,7,0,0,7,28,0,0,28,48,0,0,48,74,0,0,74,79,0,0,79
179169,554,"ŞCOALA GIMNAZIALĂ NR.112;","BUCUREŞTI SECTORUL 3",B,1285,16,0,0,16,39,0,0,39,53,2,0,55,70,2,0,72,77,2,0,79
179169,555,"ŞCOALA GIMNAZIALĂ NR.112;","BUCUREŞTI SECTORUL 3",B,1195,12,0,0,12,35,0,0,35,52,1,0,53,58,1,0,59,59,1,0,60
179169,556,"ŞCOALA GIMNAZIALĂ NR.200;","BUCUREŞTI SECTORUL 3",B,1599,14,0,0,14,42,5,0,47,76,10,0,86,107,18,0,125,118,19,0,137
179169,557,"ŞCOALA GIMNAZIALĂ NR.200;","BUCUREŞTI SECTORUL 3",B,1585,17,4,0,21,50,7,0,57,76,11,0,87,109,12,0,121,119,13,0,132
179169,558,"ŞCOALA GIMNAZIALĂ NR.200;","BUCUREŞTI SECTORUL 3",B,1405,5,0,0,5,35,3,0,38,58,5,21,84,84,6,21,111,91,7,21,119
179169,559,"ŞCOALA GIMNAZIALĂ NR.200;","BUCUREŞTI SECTORUL 3",B,1532,10,2,0,12,28,4,0,32,56,5,0,61,80,6,0,86,88,6,0,94
179169,560,"ŞCOALA GIMNAZIALĂ NR.200;","BUCUREŞTI SECTORUL 3",B,1476,5,0,0,5,48,0,0,48,64,1,0,65,85,1,0,86,94,1,0,95
179169,561,"ŞCOALA GIMNAZIALĂ NR.200;","BUCUREŞTI SECTORUL 3",B,1387,8,0,0,8,33,0,0,33,48,0,0,48,55,0,0,55,55,0,0,55
179169,562,"ŞCOALA GIMNAZIALĂ NR.200;","BUCUREŞTI SECTORUL 3",B,1875,8,5,0,13,33,5,0,38,67,7,0,74,87,9,0,96,95,10,0,105
179169,563,"ŞCOALA GIMNAZIALĂ""FEDERICO GARCIA LORCA"";","BUCUREŞTI SECTORUL 3",B,1203,7,1,0,8,29,6,0,35,58,7,0,65,69,11,0,80,73,13,0,86
179169,564,"ŞCOALA GIMNAZIALĂ""FEDERICO GARCIA LORCA"";","BUCUREŞTI SECTORUL 3",B,1053,18,4,0,22,40,6,0,46,53,8,0,61,72,10,0,82,77,10,0,87
179169,565,"ŞCOALA GIMNAZIALĂ""FEDERICO GARCIA LORCA"";","BUCUREŞTI SECTORUL 3",B,1233,10,0,0,10,39,5,0,44,67,8,0,75,91,12,0,103,107,13,0,120
179169,566,"ŞCOALA GIMNAZIALĂ""FEDERICO GARCIA LORCA"";","BUCUREŞTI SECTORUL 3",B,1555,21,4,0,25,57,4,0,61,71,4,0,75,93,7,0,100,102,7,0,109
179169,567,"ŞCOALA GIMNAZIALĂ""FEDERICO GARCIA LORCA"";","BUCUREŞTI SECTORUL 3",B,1385,9,0,0,9,33,1,0,34,51,2,0,53,75,3,0,78,82,5,0,87
179169,568,"ŞCOALA GIMNAZIALĂ""FEDERICO GARCIA LORCA"";","BUCUREŞTI SECTORUL 3",B,1259,14,2,0,16,49,2,0,51,69,3,0,72,82,4,0,86,88,4,0,92
179169,569,"ŞCOALA GIMNAZIALĂ""FEDERICO GARCIA LORCA"";","BUCUREŞTI SECTORUL 3",B,1420,9,0,0,9,30,0,0,30,41,3,0,44,64,4,0,68,71,4,0,75
179169,570,"ŞCOALA GIMNAZIALĂ ""MEXIC"";","BUCUREŞTI SECTORUL 3",B,1704,17,1,0,18,50,2,0,52,63,4,0,67,90,4,0,94,96,4,0,100
179169,571,"ŞCOALA GIMNAZIALĂ ""MEXIC"";","BUCUREŞTI SECTORUL 3",B,1785,11,3,0,14,28,7,0,35,48,7,0,55,67,7,0,74,75,11,0,86
179169,572,"ŞCOALA GIMNAZIALĂ ""MEXIC"";","BUCUREŞTI SECTORUL 3",B,1760,10,1,0,11,29,2,0,31,45,8,0,53,59,9,0,68,74,10,0,84
179169,573,"ŞCOALA GIMNAZIALĂ ""MEXIC"";","BUCUREŞTI SECTORUL 3",B,1804,11,1,0,12,32,1,0,33,45,3,0,48,63,4,0,67,66,4,0,70
179169,574,"ŞCOALA GIMNAZIALĂ ""MEXIC"";","BUCUREŞTI SECTORUL 3",B,1796,15,2,0,17,48,2,0,50,65,2,0,67,84,2,0,86,91,2,0,93
179169,575,"ŞCOALA GIMNAZIALĂ ""MEXIC"";","BUCUREŞTI SECTORUL 3",B,1538,12,3,0,15,43,3,0,46,62,3,0,65,79,4,0,83,95,4,0,99
179169,576,"ŞCOALA GIMNAZIALĂ ""MEXIC"";","BUCUREŞTI SECTORUL 3",B,1815,4,6,0,10,42,7,0,49,63,7,0,70,82,7,0,89,93,7,0,100
179169,577,"ŞCOALA GIMNAZIALĂ ""MEXIC"";","BUCUREŞTI SECTORUL 3",B,1853,16,0,0,16,29,0,0,29,51,0,0,51,71,0,0,71,80,1,0,81
179169,578,"ŞCOALA GIMNAZIALĂ ""LIVIU REBREANU"";","BUCUREŞTI SECTORUL 3",B,1385,15,0,0,15,33,4,0,37,43,9,0,52,61,12,0,73,65,12,0,77
179169,579,"ŞCOALA GIMNAZIALĂ ""LIVIU REBREANU"";","BUCUREŞTI SECTORUL 3",B,1038,8,0,0,8,24,0,0,24,39,0,0,39,51,1,0,52,67,1,0,68
179169,580,"LICEUL TEORETIC ""AL. I. CUZA"";","BUCUREŞTI SECTORUL 3",B,1394,15,0,0,15,50,3,0,53,80,4,0,84,100,5,0,105,103,5,0,108
179169,581,"LICEUL TEORETIC ""AL. I. CUZA"";","BUCUREŞTI SECTORUL 3",B,1340,13,0,0,13,45,0,0,45,64,0,0,64,75,0,0,75,78,0,0,78
179169,582,"LICEUL TEORETIC ""AL. I. CUZA"";","BUCUREŞTI SECTORUL 3",B,1266,26,2,0,28,67,7,0,74,89,10,0,99,100,12,0,112,109,12,0,121
179169,583,"LICEUL TEORETIC ""AL. I. CUZA"";","BUCUREŞTI SECTORUL 3",B,1346,18,0,0,18,62,0,0,62,70,2,0,72,96,3,0,99,111,5,0,116
179169,584,"LICEUL TEORETIC ""AL. I. CUZA"";","BUCUREŞTI SECTORUL 3",B,1323,20,0,0,20,64,2,0,66,92,3,0,95,117,3,0,120,117,3,0,120
179169,585,"LICEUL TEORETIC ""AL. I. CUZA"";","BUCUREŞTI SECTORUL 3",B,1488,13,0,0,13,57,0,1,58,86,1,1,88,106,2,1,109,109,3,1,113
179169,586,"LICEUL TEORETIC ""NICHITA STĂNESCU"";","BUCUREŞTI SECTORUL 3",B,1181,12,0,0,12,37,0,0,37,59,8,0,67,75,19,0,94,85,20,0,105
179169,587,"LICEUL TEORETIC ""NICHITA STĂNESCU"";","BUCUREŞTI SECTORUL 3",B,1000,8,0,0,8,25,4,0,29,32,4,0,36,44,4,0,48,53,5,0,58
179169,588,"LICEUL TEORETIC ""NICHITA STĂNESCU"";","BUCUREŞTI SECTORUL 3",B,1522,14,1,0,15,36,4,0,40,51,5,0,56,71,7,0,78,79,7,0,86
179169,589,"LICEUL TEORETIC ""NICHITA STĂNESCU"";","BUCUREŞTI SECTORUL 3",B,1126,5,4,0,9,21,5,0,26,30,5,0,35,43,5,0,48,52,5,0,57
179169,590,"LICEUL TEORETIC ""NICHITA STĂNESCU"";","BUCUREŞTI SECTORUL 3",B,1380,15,4,0,19,33,4,0,37,65,6,0,71,81,7,0,88,88,7,0,95
179169,591,"LICEUL TEORETIC ""NICHITA STĂNESCU"";","BUCUREŞTI SECTORUL 3",B,1470,5,0,0,5,32,1,0,33,46,1,0,47,60,1,0,61,67,2,0,69
179169,592,"ŞCOALA GIMNAZIALĂ ""VOIEVOD NEAGOE BASARAB"";","BUCUREŞTI SECTORUL 3",B,1399,16,2,0,18,46,5,0,51,65,6,0,71,88,6,0,94,99,6,0,105
179169,593,"ŞCOALA GIMNAZIALĂ ""VOIEVOD NEAGOE BASARAB"";","BUCUREŞTI SECTORUL 3",B,1224,9,2,0,11,35,4,0,39,56,4,0,60,73,5,0,78,82,6,0,88
179169,594,"ŞCOALA GIMNAZIALĂ ""VOIEVOD NEAGOE BASARAB"";","BUCUREŞTI SECTORUL 3",B,1539,16,0,0,16,42,0,0,42,60,0,0,60,85,0,0,85,94,0,0,94
179169,595,"ŞCOALA GIMNAZIALĂ ""VOIEVOD NEAGOE BASARAB"";","BUCUREŞTI SECTORUL 3",B,1379,11,0,0,11,61,1,0,62,81,3,0,84,95,3,0,98,104,3,0,107
179169,596,"ŞCOALA GIMNAZIALĂ NR.149;","BUCUREŞTI SECTORUL 3",B,1523,19,2,0,21,71,11,1,83,93,11,1,105,138,13,1,152,149,15,1,165
179169,597,"ŞCOALA GIMNAZIALĂ NR.149;","BUCUREŞTI SECTORUL 3",B,1610,16,0,0,16,35,0,0,35,53,0,0,53,68,0,0,68,76,0,0,76
179169,598,"ŞCOALA GIMNAZIALĂ NR.149;","BUCUREŞTI SECTORUL 3",B,1430,11,1,0,12,43,3,0,46,69,4,0,73,93,7,0,100,103,7,0,110
179169,599,"ŞCOALA GIMNAZIALĂ NR. 82;","BUCUREŞTI SECTORUL 3",B,1279,7,2,0,9,32,7,0,39,53,17,0,70,89,23,0,112,92,25,0,117
179169,600,"ŞCOALA GIMNAZIALĂ NR. 82;","BUCUREŞTI SECTORUL 3",B,1375,9,2,5,16,42,6,5,53,50,7,5,62,76,9,5,90,85,11,5,101
179169,601,"ŞCOALA GIMNAZIALĂ NR. 82;","BUCUREŞTI SECTORUL 3",B,1452,8,0,0,8,46,0,0,46,67,2,0,69,95,2,0,97,101,2,0,103
179169,602,"ŞCOALA GIMNAZIALĂ NR. 82;","BUCUREŞTI SECTORUL 3",B,1486,25,7,0,32,53,7,0,60,68,8,0,76,89,9,0,98,95,9,0,104
179169,603,"ŞCOALA GIMNAZIALĂ NR. 82;","BUCUREŞTI SECTORUL 3",B,1272,0,0,0,0,16,0,0,16,37,0,0,37,52,0,0,52,58,0,0,58
179169,604,"ŞCOALA GIMNAZIALĂ NR. 82;","BUCUREŞTI SECTORUL 3",B,1712,7,0,0,7,51,0,0,51,76,0,0,76,97,0,0,97,108,0,0,108
179169,605,"ŞCOALA GIMNAZIALĂ NR. 82;","BUCUREŞTI SECTORUL 3",B,1343,4,0,0,4,45,1,0,46,62,1,0,63,82,2,0,84,92,2,0,94
179169,606,"ŞCOALA GIMNAZIALĂ NR. 82;","BUCUREŞTI SECTORUL 3",B,1785,6,0,0,6,39,1,0,40,61,1,0,62,84,1,0,85,102,1,0,103
179169,607,"ŞCOALA GIMNAZIALĂ NR.116;","BUCUREŞTI SECTORUL 3",B,1672,7,0,0,7,34,0,0,34,58,0,0,58,82,1,0,83,94,2,0,96
179169,608,"ŞCOALA GIMNAZIALĂ NR.116;","BUCUREŞTI SECTORUL 3",B,2000,15,2,0,17,41,2,0,43,59,3,0,62,85,5,0,90,90,7,0,97
179169,609,"ŞCOALA GIMNAZIALĂ NR.116;","BUCUREŞTI SECTORUL 3",B,1577,4,0,0,4,35,2,0,37,51,2,0,53,71,4,0,75,80,5,0,85
179169,610,"ŞCOALA GIMNAZIALĂ NR.116;","BUCUREŞTI SECTORUL 3",B,1561,15,3,0,18,52,4,0,56,73,6,0,79,100,7,0,107,115,7,0,122
179169,611,"ŞCOALA GIMNAZIALĂ NR.116;","BUCUREŞTI SECTORUL 3",B,1419,13,0,0,13,39,2,0,41,68,2,0,70,87,2,0,89,97,3,0,100
179169,612,"ŞCOALA GIMNAZIALĂ NR.116;","BUCUREŞTI SECTORUL 3",B,1362,14,0,0,14,30,0,0,30,39,0,0,39,61,0,0,61,67,0,0,67
179169,613,"ŞCOALA GIMNAZIALĂ NR.116;","BUCUREŞTI SECTORUL 3",B,1749,8,2,0,10,27,7,0,34,42,10,0,52,57,16,0,73,75,17,0,92
179169,614,"ŞCOALA GIMNAZIALĂ NR.55;","BUCUREŞTI SECTORUL 3",B,2098,0,0,0,0,2,0,0,2,3,0,0,3,4,0,0,4,5,0,0,5
179169,615,"ŞCOALA GIMNAZIALĂ NR.55;","BUCUREŞTI SECTORUL 3",B,1845,1,0,0,1,2,0,0,2,3,0,0,3,3,4,0,7,3,4,0,7
179169,616,"ŞCOALA GIMNAZIALĂ NR.55;","BUCUREŞTI SECTORUL 3",B,1607,0,3,0,3,2,3,0,5,8,3,0,11,12,4,0,16,12,4,0,16
179169,617,"ŞCOALA GIMNAZIALĂ NR.55;","BUCUREŞTI SECTORUL 3",B,1868,2,1,0,3,6,2,0,8,11,2,0,13,15,3,0,18,15,3,0,18
179169,618,"ŞCOALA GIMNAZIALĂ NR.55;","BUCUREŞTI SECTORUL 3",B,1821,0,0,0,0,9,0,0,9,11,0,0,11,15,0,0,15,15,0,0,15
179169,619,"ŞCOALA GIMNAZIALĂ NR.55;","BUCUREŞTI SECTORUL 3",B,1545,3,0,0,3,3,0,0,3,4,0,0,4,4,0,0,4,7,0,0,7
179169,620,"ŞCOALA GIMNAZIALĂ NR.55;","BUCUREŞTI SECTORUL 3",B,1723,1,1,0,2,8,1,0,9,15,1,0,16,16,3,0,19,18,3,0,21
179169,621,"ŞCOALA GIMNAZIALĂ NR.55;","BUCUREŞTI SECTORUL 3",B,1599,4,5,0,9,14,5,0,19,17,5,0,22,26,5,0,31,29,5,0,34
179169,622,"ŞCOALA GIMNAZIALĂ NR.55;","BUCUREŞTI SECTORUL 3",B,1711,5,0,0,5,22,0,0,22,23,0,0,23,28,0,0,28,30,0,0,30
179169,623,"ŞCOALA GIMNAZIALĂ NR.55;","BUCUREŞTI SECTORUL 3",B,1875,0,0,0,0,1,0,0,1,16,1,0,17,32,2,0,34,35,2,0,37
179169,624,"ŞCOALA GIMNAZIALĂ NR.55;","BUCUREŞTI SECTORUL 3",B,2476,5,0,0,5,11,0,0,11,14,0,0,14,18,0,0,18,21,0,0,21
179169,625,"ŞCOALA GIMNAZIALĂ NR.55;","BUCUREŞTI SECTORUL 3",B,1410,0,0,0,0,0,1,0,1,0,1,0,1,0,1,0,1,0,1,0,1
179169,626,"ŞCOALA GIMNAZIALĂ NR.55;","BUCUREŞTI SECTORUL 3",B,2617,1,0,0,1,6,2,0,8,10,2,0,12,11,2,0,13,14,2,0,16
179169,627,"ŞCOALA GIMNAZIALĂ NR.55;","BUCUREŞTI SECTORUL 3",B,2273,0,0,0,0,1,2,0,3,2,2,0,4,3,2,0,5,5,2,0,7
179169,628,"ŞCOALA GIMNAZIALĂ NR.55;","BUCUREŞTI SECTORUL 3",B,2284,0,0,0,0,1,0,0,1,6,0,0,6,8,0,0,8,8,0,0,8
179169,629,"ŞCOALA GIMNAZIALĂ NR.55;","BUCUREŞTI SECTORUL 3",B,1530,9,3,0,12,12,3,0,15,17,3,0,20,22,3,0,25,23,3,0,26
179169,630,"ŞCOALA GIMNAZIALĂ NR.55;","BUCUREŞTI SECTORUL 3",B,1864,8,0,0,8,18,0,0,18,21,0,0,21,27,0,0,27,29,0,0,29
179169,631,"ŞCOALA GIMNAZIALĂ NR.55;","BUCUREŞTI SECTORUL 3",B,1712,7,0,0,7,21,0,0,21,30,0,0,30,42,0,0,42,46,0,0,46
179169,632,"ŞCOALA GIMNAZIALĂ NR.47;","BUCUREŞTI SECTORUL 3",B,2489,0,0,0,0,0,0,0,0,0,0,0,0,0,0,0,0,1,0,0,1
179169,633,"ŞCOALA GIMNAZIALĂ NR.47;","BUCUREŞTI SECTORUL 3",B,2299,0,3,0,3,0,3,0,3,6,3,0,9,9,3,0,12,14,3,0,17
179169,634,"ŞCOALA GIMNAZIALĂ NR.47;","BUCUREŞTI SECTORUL 3",B,2314,4,2,0,6,6,3,0,9,14,3,0,17,14,3,0,17,14,3,0,17
179169,635,"ŞCOALA GIMNAZIALĂ NR.47;","BUCUREŞTI SECTORUL 3",B,2178,0,0,0,0,2,0,0,2,3,0,0,3,4,0,0,4,4,0,0,4
179169,636,"ŞCOALA GIMNAZIALĂ NR.47;","BUCUREŞTI SECTORUL 3",B,2191,0,0,0,0,3,1,0,4,4,2,0,6,14,3,0,17,16,3,0,19
179169,637,"ŞCOALA GIMNAZIALĂ NR.47;","BUCUREŞTI SECTORUL 3",B,2174,0,0,0,0,0,0,0,0,0,0,0,0,2,0,0,2,2,0,0,2
179169,638,"ŞCOALA GIMNAZIALĂ NR.47;","BUCUREŞTI SECTORUL 3",B,2117,0,0,0,0,2,0,0,2,8,0,0,8,11,1,0,12,11,1,0,12
179169,639,"ŞCOALA GIMNAZIALĂ NR.47;","BUCUREŞTI SECTORUL 3",B,2581,0,0,0,0,0,0,0,0,0,4,0,4,0,4,0,4,0,4,0,4
179169,640,"ȘCOALA GIMNAZIALĂ NR.47;","BUCUREŞTI SECTORUL 3",B,1882,2,0,0,2,11,2,0,13,12,2,0,14,14,2,0,16,14,2,0,16
179169,641,"ŞCOALA GIMNAZIALĂ NR.47;","BUCUREŞTI SECTORUL 3",B,1938,2,0,0,2,9,0,0,9,13,0,0,13,14,5,0,19,16,5,0,21
179169,642,"ŞCOALA GIMNAZIALĂ NR.78;","BUCUREŞTI SECTORUL 3",B,1958,6,0,0,6,19,0,0,19,29,6,0,35,37,6,0,43,37,7,0,44
179169,643,"ŞCOALA GIMNAZIALĂ NR.78;","BUCUREŞTI SECTORUL 3",B,1780,6,0,0,6,17,0,0,17,30,0,0,30,62,0,0,62,64,0,0,64
179169,644,"ŞCOALA GIMNAZIALĂ NR.78;","BUCUREŞTI SECTORUL 3",B,1917,5,0,0,5,8,0,0,8,9,0,0,9,13,0,0,13,13,0,0,13
179169,645,"ŞCOALA GIMNAZIALĂ NR.78;","BUCUREŞTI SECTORUL 3",B,1907,4,0,0,4,5,0,0,5,5,0,0,5,8,0,0,8,8,0,0,8
179169,646,"ŞCOALA GIMNAZIALĂ NR.78;","BUCUREŞTI SECTORUL 3",B,1862,5,0,0,5,9,0,0,9,13,0,0,13,20,0,0,20,22,0,0,22
179169,647,"ŞCOALA GIMNAZIALĂ NR.78;","BUCUREŞTI SECTORUL 3",B,1850,3,0,0,3,17,4,0,21,29,4,0,33,39,4,0,43,42,4,0,46
179169,648,"ŞCOALA GIMNAZIALĂ NR.78;","BUCUREŞTI SECTORUL 3",B,2178,0,0,0,0,0,0,0,0,0,3,0,3,0,3,0,3,0,3,0,3
179169,649,"ŞCOALA GIMNAZIALĂ NR.78;","BUCUREŞTI SECTORUL 3",B,2196,0,0,0,0,1,0,0,1,2,0,0,2,2,0,0,2,3,1,0,4
179169,650,"ŞCOALA GIMNAZIALĂ NR.67;","BUCUREŞTI SECTORUL 3",B,1620,14,1,0,15,31,1,0,32,47,3,0,50,68,3,0,71,71,4,0,75
179169,651,"ŞCOALA GIMNAZIALĂ NR.67;","BUCUREŞTI SECTORUL 3",B,1737,12,5,0,17,27,5,0,32,39,5,0,44,60,6,0,66,63,6,0,69
179178,652,"COLEGIUL NAŢIONAL ""MIHAI EMINESCU""","BUCUREŞTI SECTORUL 4",B,1601,16,7,0,23,55,21,0,76,88,29,0,117,120,43,0,163,129,48,0,177
179178,653,"COLEGIUL NAŢIONAL ""MIHAI EMINESCU""","BUCUREŞTI SECTORUL 4",B,1386,8,0,0,8,44,10,28,82,68,13,28,109,93,14,28,135,99,14,28,141
179178,654,"COLEGIUL NAŢIONAL ""MIHAI EMINESCU""","BUCUREŞTI SECTORUL 4",B,1124,10,6,0,16,28,7,0,35,38,9,0,47,48,15,0,63,51,15,0,66
179178,655,"COLEGIUL NAȚIONAL DE ARTE ""DINU LIPATTI""","BUCUREŞTI SECTORUL 4",B,1171,3,2,0,5,13,2,0,15,38,9,0,47,47,16,0,63,51,16,0,67
179178,656,"LICEUL NAȚIONAL DE ARTE ""DINU LIPATTI""","BUCUREŞTI SECTORUL 4",B,1263,1,3,0,4,21,5,0,26,33,6,0,39,45,7,0,52,57,9,0,66
179178,657,"ŞCOALA GIMNAZIALĂ ""IENĂCHIŢĂ VĂCĂRESCU""","BUCUREŞTI SECTORUL 4",B,1155,18,0,0,18,63,24,0,87,85,27,0,112,102,31,0,133,105,32,0,137
179178,658,"ŞCOALA GIMNAZIALĂ ""IENĂCHIŢĂ VĂCĂRESCU""","BUCUREŞTI SECTORUL 4",B,1183,15,0,0,15,48,9,0,57,73,16,0,89,91,20,0,111,94,20,0,114
179178,659,"ŞCOALA GIMNAZIALĂ ""IENĂCHIŢĂ VĂCĂRESCU""","BUCUREŞTI SECTORUL 4",B,1140,8,0,0,8,36,2,0,38,55,12,0,67,68,13,0,81,78,15,0,93
179178,660,"ŞCOALA GIMNAZIALĂ ""IENĂCHIŢĂ VĂCĂRESCU""","BUCUREŞTI SECTORUL 4",B,1449,7,0,0,7,34,3,0,37,60,8,0,68,69,17,0,86,77,18,0,95
179178,661,"ŞCOALA GIMNAZIALĂ NR. 79","BUCUREŞTI SECTORUL 4",B,990,13,1,0,14,38,6,0,44,55,10,0,65,72,10,0,82,83,10,0,93
179178,662,"ŞCOALA GIMNAZIALĂ NR. 79","BUCUREŞTI SECTORUL 4",B,1031,3,6,0,9,27,18,0,45,41,20,0,61,54,23,0,77,69,25,0,94
179178,663,"ŞCOALA GIMNAZIALĂ NR. 79","BUCUREŞTI SECTORUL 4",B,1361,8,0,0,8,26,1,0,27,44,3,0,47,53,4,0,57,62,6,0,68
179178,664,"COLEGIUL NAŢIONALION CREANGĂ","BUCUREŞTI SECTORUL 4",B,1326,13,1,0,14,27,2,0,29,40,12,0,52,54,12,0,66,59,15,0,74
179178,665,"COLEGIUL NAŢIONALION CREANGĂ","BUCUREŞTI SECTORUL 4",B,1033,3,1,0,4,25,4,0,29,47,11,0,58,57,17,0,74,60,19,0,79
179178,666,"COLEGIUL TEHNIC GRIGORE CERCHEZ","BUCUREŞTI SECTORUL 4",B,1060,12,0,0,12,38,4,0,42,92,5,0,97,92,5,0,97,92,5,0,97
179178,667,"COLEGIUL TEHNIC GRIGORE CERCHEZ","BUCUREŞTI SECTORUL 4",B,1375,8,0,24,32,27,0,24,51,51,0,24,75,67,1,24,92,81,1,24,106
179178,668,"COLEGIUL NAŢIONAL GH.ŞINCAI","BUCUREŞTI SECTORUL 4",B,1149,7,0,0,7,36,0,0,36,65,0,0,65,101,0,0,101,101,0,0,101
179178,669,"COLEGIUL NAŢIONAL GH.ŞINCAI","BUCUREŞTI SECTORUL 4",B,1171,11,0,0,11,40,0,0,40,70,0,0,70,83,7,0,90,93,8,0,101
179178,670,"COLEGIUL NAŢIONAL GH.ŞINCAI","BUCUREŞTI SECTORUL 4",B,1253,15,2,0,17,58,9,0,67,88,19,0,107,113,27,0,140,117,33,0,150
179178,671,"COLEGIUL NAŢIONAL GH.ŞINCAI","BUCUREŞTI SECTORUL 4",B,1100,9,0,0,9,42,0,0,42,69,16,0,85,99,21,0,120,109,25,0,134
179178,672,"COLEGIUL NAŢIONAL GH.ŞINCAI","BUCUREŞTI SECTORUL 4",B,1458,9,5,0,14,57,6,0,63,83,7,0,90,114,9,0,123,124,9,0,133
179178,673,"ŞCOALA GIMNAZIALĂNR. 97","BUCUREŞTI SECTORUL 4",B,1301,9,1,0,10,46,4,0,50,68,6,0,74,73,6,0,79,82,6,0,88
179178,674,"ŞCOALA GIMNAZIALĂNR. 97","BUCUREŞTI SECTORUL 4",B,1368,18,3,0,21,58,8,0,66,86,13,0,99,111,19,0,130,127,20,0,147
179178,675,"ŞCOALA GIMNAZIALĂNR. 97","BUCUREŞTI SECTORUL 4",B,1342,20,2,0,22,50,7,0,57,73,12,0,85,99,16,0,115,115,19,0,134
179178,676,"ŞCOALA GIMNAZIALĂNR. 97","BUCUREŞTI SECTORUL 4",B,1247,6,3,0,9,41,4,0,45,61,8,0,69,91,9,0,100,111,11,0,122
179178,677,"ŞCOALA GIMNAZIALĂNR. 97","BUCUREŞTI SECTORUL 4",B,1041,8,2,0,10,32,2,0,34,48,7,0,55,56,9,0,65,64,10,0,74
179178,678,"COLEGIUL TEHNIC PETRU RAREŞ","BUCUREŞTI SECTORUL 4",B,1159,18,0,0,18,69,5,0,74,89,7,0,96,105,9,0,114,110,15,0,125
179178,679,"COLEGIUL TEHNIC PETRU RAREŞ","BUCUREŞTI SECTORUL 4",B,1386,11,2,0,13,42,2,0,44,60,2,0,62,82,3,0,85,90,3,0,93
179178,680,"COLEGIUL TEHNIC PETRU RAREŞ","BUCUREŞTI SECTORUL 4",B,1060,12,0,0,12,48,2,0,50,71,3,0,74,94,6,0,100,104,6,0,110
179178,681,"COLEGIUL TEHNIC PETRU RAREŞ","BUCUREŞTI SECTORUL 4",B,995,6,1,0,7,31,2,0,33,58,2,0,60,62,2,0,64,76,3,0,79
179178,682,"COLEGIUL TEHNIC PETRU RAREŞ","BUCUREŞTI SECTORUL 4",B,1585,15,3,0,18,41,3,0,44,65,8,0,73,94,8,0,102,109,11,0,120
179178,683,"COLEGIUL TEHNIC PETRU RAREŞ","BUCUREŞTI SECTORUL 4",B,1374,13,0,0,13,46,8,0,54,77,10,0,87,105,12,0,117,121,13,0,134
179178,684,"COLEGIUL TEHNIC PETRU RAREŞ","BUCUREŞTI SECTORUL 4",B,1182,5,0,0,5,30,0,0,30,47,0,0,47,72,0,0,72,75,0,0,75
179178,685,"COLEGIUL TEHNIC PETRU RAREŞ","BUCUREŞTI SECTORUL 4",B,1439,21,0,0,21,58,0,0,58,82,0,0,82,104,3,0,107,115,5,0,120
179178,686,"COLEGIUL TEHNIC PETRU RAREŞ","BUCUREŞTI SECTORUL 4",B,1572,19,0,0,19,49,0,0,49,75,2,0,77,98,3,0,101,114,3,0,117
179178,687,"LICEUL TEHNOLOGIC DACIA","BUCUREŞTI SECTORUL 4",B,1949,2,3,0,5,30,7,0,37,53,10,0,63,68,14,0,82,94,20,0,114
179178,688,"LICEUL TEHNOLOGIC DACIA","BUCUREŞTI SECTORUL 4",B,1671,11,0,0,11,25,0,0,25,34,0,0,34,46,0,0,46,52,0,0,52
179178,689,"LICEUL TEHNOLOGIC DACIA","BUCUREŞTI SECTORUL 4",B,1804,14,0,0,14,31,1,0,32,50,1,0,51,63,3,0,66,66,5,0,71
179178,690,"LICEUL TEHNOLOGIC DACIA","BUCUREŞTI SECTORUL 4",B,1836,7,0,0,7,22,0,0,22,26,0,0,26,37,0,0,37,46,2,0,48
179178,691,"LICEUL TEHNOLOGIC DACIA","BUCUREŞTI SECTORUL 4",B,1504,0,1,0,1,5,1,0,6,19,1,0,20,22,1,0,23,24,4,0,28
179178,692,"LICEUL TEHNOLOGIC DACIA","BUCUREŞTI SECTORUL 4",B,1674,3,0,0,3,22,1,0,23,27,1,0,28,43,1,0,44,49,1,0,50
179178,693,"LICEUL TEHNOLOGIC DACIA","BUCUREŞTI SECTORUL 4",B,1453,0,1,0,1,10,1,0,11,19,1,0,20,35,2,0,37,38,2,0,40
179178,694,"LICEUL TEHNOLOGIC DACIA","BUCUREŞTI SECTORUL 4",B,1670,2,3,0,5,8,3,0,11,13,3,0,16,27,4,0,31,35,4,0,39
179178,695,"ȘCOALA GIMNAZIALĂ NR. 133","BUCUREŞTI SECTORUL 4",B,1407,4,0,0,4,24,0,0,24,28,1,0,29,53,1,0,54,57,2,0,59
179178,696,"ȘCOALA GIMNAZIALĂ NR. 133","BUCUREŞTI SECTORUL 4",B,1729,7,3,0,10,28,3,0,31,37,4,0,41,46,4,0,50,53,6,0,59
179178,697,"ȘCOALA GIMNAZIALĂ NR. 133","BUCUREŞTI SECTORUL 4",B,1890,8,2,0,10,25,2,0,27,50,2,0,52,67,3,0,70,68,3,0,71
179178,698,"ȘCOALA GIMNAZIALĂ NR. 133","BUCUREŞTI SECTORUL 4",B,1633,6,2,0,8,24,2,0,26,36,2,0,38,60,2,0,62,74,2,0,76
179178,699,"ȘCOALA GIMNAZIALĂ NR. 133","BUCUREŞTI SECTORUL 4",B,1745,8,5,0,13,35,5,0,40,49,5,0,54,58,5,0,63,62,5,0,67
179178,700,"ȘCOALA GIMNAZIALĂ NR. 133","BUCUREŞTI SECTORUL 4",B,1212,3,0,0,3,15,1,0,16,30,2,0,32,47,4,0,51,50,5,0,55
179178,701,"ŞCOALA GIMNAZIALĂ NR. 133","BUCUREŞTI SECTORUL 4",B,1614,11,0,0,11,31,2,0,33,45,2,0,47,55,3,0,58,65,3,0,68
179178,702,"ŞCOALA GIMNAZIALĂ NR. 133","BUCUREŞTI SECTORUL 4",B,1592,11,1,0,12,47,5,0,52,64,8,0,72,98,10,0,108,114,10,0,124
179178,703,"ŞCOALA GIMNAZIALĂ NR. 133","BUCUREŞTI SECTORUL 4",B,1539,14,1,0,15,56,1,0,57,84,1,0,85,99,3,0,102,108,5,0,113
179178,704,"ŞCOALA GIMNAZIALĂ NR. 133","BUCUREŞTI SECTORUL 4",B,1654,12,3,0,15,31,5,0,36,64,5,0,69,80,5,0,85,93,7,0,100
179178,705,"ŞCOALA GIMNAZIALĂ NR. 133","BUCUREŞTI SECTORUL 4",B,1625,10,0,0,10,38,0,0,38,61,0,0,61,82,0,0,82,91,0,0,91
179178,706,"ŞCOALA GIMNAZIALĂ NR. 133","BUCUREŞTI SECTORUL 4",B,1528,8,0,0,8,44,2,0,46,74,3,0,77,92,4,0,96,112,4,0,116
179178,707,"ŞCOALA GIMNAZIALĂG-RAL EREMIAGRIGORESCU","BUCUREŞTI SECTORUL 4",B,1829,6,3,0,9,26,4,0,30,48,5,0,53,69,5,0,74,80,6,0,86
179178,708,"ŞCOALA GIMNAZIALĂG-RAL EREMIAGRIGORESCU","BUCUREŞTI SECTORUL 4",B,1740,13,2,0,15,44,3,0,47,72,3,0,75,106,3,0,109,115,7,0,122
179178,709,"ŞCOALA GIMNAZIALĂG-RAL EREMIAGRIGORESCU","BUCUREŞTI SECTORUL 4",B,1787,8,4,0,12,30,12,0,42,54,15,3,72,70,19,3,92,82,19,3,104
179178,710,"ŞCOALA GIMNAZIALĂG-RAL EREMIAGRIGORESCU","BUCUREŞTI SECTORUL 4",B,1981,14,1,0,15,37,6,0,43,45,10,0,55,64,28,0,92,70,31,0,101
179178,711,"ŞCOALA GIMNAZIALĂG-RAL EREMIAGRIGORESCU","BUCUREŞTI SECTORUL 4",B,1824,8,0,0,8,33,2,0,35,47,2,0,49,73,2,0,75,79,2,0,81
179178,712,"ŞCOALA GIMNAZIALĂG-RAL EREMIAGRIGORESCU","BUCUREŞTI SECTORUL 4",B,1900,5,0,0,5,26,0,0,26,51,0,0,51,74,0,0,74,80,0,0,80
179178,713,"ŞCOALA GIMNAZIALĂG-RAL EREMIAGRIGORESCU","BUCUREŞTI SECTORUL 4",B,1714,16,1,0,17,47,1,0,48,66,1,0,67,84,2,0,86,94,2,0,96
179178,714,"ŞCOALA GIMNAZIALĂNR. 113","BUCUREŞTI SECTORUL 4",B,1745,24,5,0,29,63,11,0,74,93,12,0,105,116,16,0,132,130,18,0,148
179178,715,"ŞCOALA GIMNAZIALĂNR. 113","BUCUREŞTI SECTORUL 4",B,1873,29,0,0,29,54,0,0,54,94,0,0,94,133,1,0,134,148,1,0,149
179178,716,"ŞCOALA GIMNAZIALĂNR. 113","BUCUREŞTI SECTORUL 4",B,1751,10,0,0,10,45,0,0,45,69,0,0,69,95,1,0,96,108,2,0,110
179178,717,"ŞCOALA GIMNAZIALĂNR. 113","BUCUREŞTI SECTORUL 4",B,1826,22,0,0,22,63,1,0,64,90,2,0,92,101,2,0,103,122,3,0,125
179178,718,"ŞCOALA GIMNAZIALĂNR. 113","BUCUREŞTI SECTORUL 4",B,1996,13,8,0,21,46,11,0,57,73,11,0,84,92,13,0,105,107,13,0,120
179178,719,"ŞCOALA GIMNAZIALĂNR. 113","BUCUREŞTI SECTORUL 4",B,1842,13,5,0,18,52,5,0,57,76,5,0,81,99,6,0,105,116,6,0,122
179178,720,"ŞCOALA GIMNAZIALĂ“MĂRŢIŞOR”","BUCUREŞTI SECTORUL 4",B,1778,15,0,0,15,35,6,0,41,51,11,0,62,80,17,0,97,90,19,0,109
179178,721,"ŞCOALA GIMNAZIALĂ“MĂRŢIŞOR”","BUCUREŞTI SECTORUL 4",B,1654,9,0,0,9,48,0,0,48,69,2,0,71,88,2,0,90,105,4,0,109
179178,722,"ŞCOALA GIMNAZIALĂ“MĂRŢIŞOR”","BUCUREŞTI SECTORUL 4",B,1622,15,0,0,15,46,0,0,46,74,1,0,75,101,2,0,103,113,2,0,115
179178,723,"ŞCOALA GIMNAZIALĂ“MĂRŢIŞOR”","BUCUREŞTI SECTORUL 4",B,1411,4,0,0,4,32,1,0,33,51,1,0,52,71,1,0,72,73,1,0,74
179178,724,"ŞCOALA GIMNAZIALĂ“MĂRŢIŞOR”","BUCUREŞTI SECTORUL 4",B,1695,20,0,0,20,52,0,0,52,79,0,0,79,105,0,0,105,120,1,0,121
179178,725,"ŞCOALA GIMNAZIALĂ NR. 190","BUCUREŞTI SECTORUL 4",B,1745,22,0,0,22,67,3,0,70,97,11,0,108,107,17,0,124,139,20,0,159
179178,726,"ŞCOALA GIMNAZIALĂ NR. 190","BUCUREŞTI SECTORUL 4",B,1368,12,4,0,16,39,6,0,45,73,8,0,81,85,8,0,93,91,8,0,99
179178,727,"ŞCOALA GIMNAZIALĂ NR. 190","BUCUREŞTI SECTORUL 4",B,1322,10,7,0,17,39,7,0,46,52,7,0,59,77,9,0,86,85,9,0,94
179178,728,"ŞCOALA GIMNAZIALĂ NR. 190","BUCUREŞTI SECTORUL 4",B,1487,14,0,0,14,31,0,0,31,56,0,0,56,69,2,0,71,83,3,0,86
179178,729,"ŞCOALA GIMNAZIALĂ NR. 190","BUCUREŞTI SECTORUL 4",B,1348,10,0,0,10,28,0,0,28,52,2,0,54,66,3,0,69,71,3,0,74
179178,730,"ŞCOALA GIMNAZIALĂ NR. 190","BUCUREŞTI SECTORUL 4",B,1188,11,0,0,11,31,0,0,31,50,0,0,50,57,3,0,60,66,6,0,72
179178,731,"ŞCOALA GIMNAZIALĂ NR. 190","BUCUREŞTI SECTORUL 4",B,1335,8,2,0,10,49,2,0,51,57,6,0,63,82,11,0,93,82,11,0,93
179178,732,"ŞCOALA GIMNAZIALĂ NR. 190","BUCUREŞTI SECTORUL 4",B,1804,4,0,0,4,23,0,0,23,48,0,0,48,64,0,0,64,76,0,0,76
179178,733,"ŞCOALA GIMNAZIALĂ NR. 190","BUCUREŞTI SECTORUL 4",B,1664,10,2,0,12,40,2,0,42,72,2,0,74,95,2,0,97,110,2,0,112
179178,734,"ŞCOALA GIMNAZIALĂ NR. 190","BUCUREŞTI SECTORUL 4",B,1341,5,0,0,5,20,7,0,27,38,10,0,48,59,12,0,71,69,13,0,82
179178,735,"ȘCOALA GIMNAZIALĂ NR.190","BUCUREŞTI SECTORUL 4",B,1270,3,0,0,3,17,0,0,17,35,0,0,35,45,0,0,45,49,0,0,49
179178,736,"ŞCOALA GIMNAZIALĂ NR. 96","BUCUREŞTI SECTORUL 4",B,956,8,0,0,8,34,0,0,34,50,1,0,51,63,1,0,64,66,1,0,67
179178,737,"ŞCOALA GIMNAZIALĂ NR. 96","BUCUREŞTI SECTORUL 4",B,1188,11,5,0,16,30,8,0,38,48,14,0,62,76,14,0,90,85,14,0,99
179178,738,"ŞCOALA GIMNAZIALĂ NR. 96","BUCUREŞTI SECTORUL 4",B,1091,13,4,0,17,27,6,0,33,42,8,0,50,63,10,0,73,73,11,0,84
179178,739,"ŞCOALA GIMNAZIALĂ NR. 96","BUCUREŞTI SECTORUL 4",B,1619,11,1,0,12,47,1,0,48,67,1,0,68,91,4,0,95,105,7,0,112
179178,740,"ŞCOALA GIMNAZIALĂ NR. 96","BUCUREŞTI SECTORUL 4",B,1231,8,0,0,8,42,0,0,42,69,0,0,69,91,0,0,91,101,0,0,101
179178,741,"COLEGIUL NAŢIONAL OCTAV ONICESCU","BUCUREŞTI SECTORUL 4",B,1748,16,0,0,16,58,1,0,59,84,2,0,86,107,4,0,111,120,6,0,126
179178,742,"COLEGIUL NAŢIONAL OCTAV ONICESCU","BUCUREŞTI SECTORUL 4",B,1192,14,5,0,19,53,5,0,58,74,5,0,79,92,6,0,98,102,8,0,110
179178,743,"COLEGIUL NAŢIONAL OCTAV ONICESCU","BUCUREŞTI SECTORUL 4",B,1500,11,2,0,13,41,2,0,43,70,3,0,73,85,5,0,90,93,7,0,100
179178,744,"COLEGIUL NAŢIONAL OCTAV ONICESCU","BUCUREŞTI SECTORUL 4",B,1388,17,2,0,19,47,2,0,49,68,2,0,70,101,2,0,103,111,2,0,113
179178,745,"ŞCOALA GIMNAZIALĂ NR. 108","BUCUREŞTI SECTORUL 4",B,1349,9,0,0,9,52,1,0,53,75,7,0,82,107,7,0,114,110,7,0,117
179178,746,"ŞCOALA GIMNAZIALĂ NR. 108","BUCUREŞTI SECTORUL 4",B,1333,17,4,0,21,58,4,0,62,91,5,0,96,119,6,0,125,129,6,0,135
179178,747,"ŞCOALA GIMNAZIALĂ NR. 108","BUCUREŞTI SECTORUL 4",B,1484,15,1,0,16,60,1,0,61,87,1,0,88,118,2,0,120,125,4,0,129
179178,748,"ŞCOALA GIMNAZIALĂ NR. 108","BUCUREŞTI SECTORUL 4",B,1552,19,3,0,22,48,3,0,51,77,4,0,81,104,4,0,108,116,4,0,120
179178,749,"ŞCOALA GIMNAZIALĂ NR. 108","BUCUREŞTI SECTORUL 4",B,1337,11,2,0,13,50,2,0,52,74,6,0,80,93,6,0,99,104,7,0,111
179178,750,"ŞCOALA GIMNAZIALĂ AVRAM IANCU","BUCUREŞTI SECTORUL 4",B,1865,18,1,0,19,60,1,0,61,83,4,0,87,114,11,0,125,122,15,0,137
179178,751,"ŞCOALA GIMNAZIALĂ AVRAM IANCU","BUCUREŞTI SECTORUL 4",B,1331,18,3,0,21,46,6,0,52,73,8,0,81,88,9,0,97,99,10,0,109
179178,752,"ŞCOALA GIMNAZIALĂ AVRAM IANCU","BUCUREŞTI SECTORUL 4",B,1152,7,4,0,11,31,4,0,35,52,4,0,56,54,4,0,58,55,5,0,60
179178,753,"ŞCOALA GIMNAZIALĂ AVRAM IANCU","BUCUREŞTI SECTORUL 4",B,1846,15,1,0,16,42,2,0,44,59,4,0,63,81,6,0,87,89,6,0,95
179178,754,"ŞCOALA GIMNAZIALĂ AVRAM IANCU","BUCUREŞTI SECTORUL 4",B,1488,23,0,0,23,71,0,0,71,108,0,0,108,131,0,0,131,146,0,0,146
179178,755,"ŞCOALA GIMNAZIALĂ NR. 189","BUCUREŞTI SECTORUL 4",B,1855,7,3,0,10,26,5,0,31,56,6,0,62,61,9,0,70,67,12,0,79
179178,756,"ŞCOALA GIMNAZIALĂ NR. 189","BUCUREŞTI SECTORUL 4",B,1461,15,0,0,15,40,2,0,42,71,3,0,74,84,5,0,89,94,7,0,101
179178,757,"ŞCOALA GIMNAZIALĂ NR. 189","BUCUREŞTI SECTORUL 4",B,1285,11,1,0,12,37,3,0,40,70,3,0,73,82,4,0,86,88,4,0,92
179178,758,"ŞCOALA GIMNAZIALĂ NR. 189","BUCUREŞTI SECTORUL 4",B,1858,24,0,0,24,71,0,0,71,96,1,1,98,113,1,1,115,123,2,1,126
179178,759,"ŞCOALA GIMNAZIALĂ NR. 189","BUCUREŞTI SECTORUL 4",B,1327,12,0,0,12,32,2,0,34,50,2,0,52,71,2,0,73,74,2,0,76
179178,760,"ŞCOALA GIMNAZIALĂ EMIL RACOVIŢĂ","BUCUREŞTI SECTORUL 4",B,1621,9,1,0,10,31,1,0,32,50,4,0,54,67,5,0,72,74,5,0,79
179178,761,"ŞCOALA GIMNAZIALĂ EMIL RACOVIŢĂ","BUCUREŞTI SECTORUL 4",B,1666,20,0,0,20,65,0,0,65,93,1,0,94,115,2,0,117,123,4,0,127
179178,762,"ŞCOALA GIMNAZIALĂ EMIL RACOVIŢĂ","BUCUREŞTI SECTORUL 4",B,1661,10,4,0,14,40,5,0,45,75,7,0,82,91,7,0,98,99,7,0,106
179178,763,"ŞCOALA GIMNAZIALĂ EMIL RACOVIŢĂ","BUCUREŞTI SECTORUL 4",B,1589,8,6,0,14,30,11,0,41,57,11,0,68,98,15,0,113,104,16,0,120
179178,764,"GRĂDINIŢA""101 DALMAŢIENI""","BUCUREŞTI SECTORUL 4",B,1288,12,1,0,13,45,4,0,49,66,4,0,70,93,4,1,98,108,4,0,112
179178,765,"GRĂDINIŢA""101 DALMAŢIENI""","BUCUREŞTI SECTORUL 4",B,1005,8,0,0,8,40,0,0,40,61,4,0,65,83,7,0,90,85,7,0,92
179178,766,"GRĂDINIŢA""101 DALMAŢIENI""","BUCUREŞTI SECTORUL 4",B,1446,14,2,0,16,51,5,0,56,72,7,0,79,104,12,0,116,113,13,0,126
179178,767,"ŞCOALA GIMNAZIALĂ NR. 194","BUCUREŞTI SECTORUL 4",B,1014,8,2,0,10,30,4,0,34,47,4,0,51,52,5,0,57,59,6,0,65
179178,768,"ŞCOALA GIMNAZIALĂ NR. 194","BUCUREŞTI SECTORUL 4",B,927,9,0,0,9,42,0,0,42,50,0,0,50,57,0,0,57,59,0,0,59
179178,769,"ŞCOALA GIMNAZIALĂ NR. 194","BUCUREŞTI SECTORUL 4",B,1257,5,4,0,9,35,4,0,39,56,6,0,62,71,6,0,77,82,6,0,88
179178,770,"ŞCOALA GIMNAZIALĂ NR. 194","BUCUREŞTI SECTORUL 4",B,1579,18,1,0,19,53,1,0,54,72,1,0,73,102,1,0,103,106,3,0,109
179178,771,"ŞCOALA GIMNAZIALĂ NR. 194","BUCUREŞTI SECTORUL 4",B,1145,10,0,0,10,37,2,0,39,65,4,0,69,78,4,0,82,90,4,0,94
179178,772,"ŞCOALA GIMNAZIALĂ NR. 194","BUCUREŞTI SECTORUL 4",B,1184,14,0,10,24,30,2,10,42,63,2,10,75,95,6,10,111,101,7,10,118
179178,773,"GRĂDINIŢA ""DUMBRAVA MINUNATA""","BUCUREŞTI SECTORUL 4",B,1011,16,3,0,19,53,4,0,57,69,5,0,74,86,8,0,94,95,11,0,106
179178,774,"GRĂDINIŢA ""DUMBRAVA MINUNATA""","BUCUREŞTI SECTORUL 4",B,1109,14,4,0,18,45,5,0,50,59,5,0,64,80,6,0,86,87,8,0,95
179178,775,"ŞCOALA GIMNAZIALĂ”GEORGE BACOVIA”","BUCUREŞTI SECTORUL 4",B,1488,15,5,0,20,33,7,0,40,60,7,0,67,79,7,0,86,85,7,0,92
179178,776,"ŞCOALA GIMNAZIALĂ”GEORGE BACOVIA”","BUCUREŞTI SECTORUL 4",B,1340,3,3,0,6,24,6,0,30,55,7,0,62,73,9,0,82,77,10,0,87
179178,777,"ŞCOALA GIMNAZIALĂ”GEORGE BACOVIA”","BUCUREŞTI SECTORUL 4",B,1897,12,1,0,13,53,8,0,61,70,15,0,85,91,20,0,111,102,24,0,126
179178,778,"ŞCOALA GIMNAZIALĂ”GEORGE BACOVIA”","BUCUREŞTI SECTORUL 4",B,1842,15,1,0,16,47,1,0,48,72,1,0,73,102,1,0,103,108,1,0,109
179178,779,"ŞCOALA GIMNAZIALĂ”GEORGE BACOVIA”","BUCUREŞTI SECTORUL 4",B,1770,9,0,0,9,44,0,0,44,70,0,1,71,91,0,1,92,108,0,1,109
179178,780,"ŞCOALA GIMNAZIALĂ”GEORGE BACOVIA”","BUCUREŞTI SECTORUL 4",B,1640,11,0,0,11,49,0,0,49,75,0,0,75,111,0,0,111,121,1,0,122
179178,781,"ŞCOALA GIMNAZIALĂ”GEORGE BACOVIA”","BUCUREŞTI SECTORUL 4",B,1793,10,1,0,11,33,1,0,34,50,3,0,53,73,3,0,76,80,3,0,83
179178,782,"GRĂDINIŢA ”CIUPERCUTA”","BUCUREŞTI SECTORUL 4",B,1136,29,5,0,34,69,7,0,76,83,8,0,91,105,11,1,117,114,14,1,129
179178,783,"GRĂDINIŢA ”CIUPERCUTA”","BUCUREŞTI SECTORUL 4",B,1367,13,6,0,19,39,6,0,45,62,6,0,68,84,7,0,91,88,7,0,95
179178,784,"ŞCOALA GIMNAZIALĂ “ŞERBAN VODĂ”","BUCUREŞTI SECTORUL 4",B,1720,5,0,0,5,34,0,0,34,43,2,0,45,51,9,0,60,54,9,0,63
179178,785,"ŞCOALA GIMNAZIALĂ “ŞERBAN VODĂ”","BUCUREŞTI SECTORUL 4",B,1761,15,0,0,15,40,0,0,40,58,0,0,58,79,2,0,81,84,2,0,86
179178,786,"ŞCOALA GIMNAZIALĂ “ŞERBAN VODĂ”","BUCUREŞTI SECTORUL 4",B,1546,11,0,0,11,49,1,0,50,82,4,0,86,96,4,0,100,103,4,0,107
179178,787,"ŞCOALA GIMNAZIALĂ “ŞERBAN VODĂ”","BUCUREŞTI SECTORUL 4",B,1411,14,2,0,16,31,3,0,34,54,8,0,62,68,8,0,76,74,8,0,82
179178,788,"ŞCOALA GIMNAZIALĂ “ŞERBAN VODĂ”","BUCUREŞTI SECTORUL 4",B,1442,21,3,0,24,52,3,0,55,72,4,0,76,79,4,0,83,97,4,0,101
179178,789,"GRĂDINIŢA “ALBĂ CA ZAPADA ŞI PITICII”","BUCUREŞTI SECTORUL 4",B,1397,8,1,0,9,30,9,0,39,56,9,0,65,65,10,0,75,70,10,0,80
179178,790,"GRĂDINIŢA “ALBĂ CA ZAPADA ŞI PITICII”","BUCUREŞTI SECTORUL 4",B,1227,7,5,0,12,25,5,0,30,34,5,0,39,47,7,0,54,58,7,0,65
179178,791,GRĂDINIŢA“PITICOT”,"BUCUREŞTI SECTORUL 4",B,1532,19,0,0,19,40,1,0,41,60,2,0,62,78,9,0,87,84,9,0,93
179178,792,GRĂDINIŢA“PITICOT”,"BUCUREŞTI SECTORUL 4",B,1411,18,0,0,18,45,1,0,46,70,1,0,71,91,1,0,92,99,1,0,100
179178,793,"ŞCOALA GIMNAZIALĂ NR. 308","BUCUREŞTI SECTORUL 4",B,1329,9,1,0,10,39,4,0,43,70,4,0,74,91,6,0,97,107,6,0,113
179178,794,"ŞCOALA GIMNAZIALĂ NR. 308","BUCUREŞTI SECTORUL 4",B,1234,7,0,0,7,37,0,0,37,64,0,0,64,85,0,0,85,92,0,0,92
179178,795,"ŞCOALA GIMNAZIALĂ NR. 308","BUCUREŞTI SECTORUL 4",B,1470,7,0,0,7,32,1,0,33,52,1,0,53,64,1,0,65,72,1,0,73
179178,796,"ŞCOALA GIMNAZIALĂ NR. 308","BUCUREŞTI SECTORUL 4",B,1545,10,0,0,10,33,0,0,33,47,0,0,47,55,0,0,55,65,0,0,65
179178,797,"ŞCOALA GIMNAZIALĂ NR. 308","BUCUREŞTI SECTORUL 4",B,1857,13,2,0,15,52,3,0,55,67,4,0,71,94,5,0,99,99,5,0,104
179178,798,"ŞCOALA GIMNAZIALĂ NR. 308","BUCUREŞTI SECTORUL 4",B,1898,12,0,0,12,47,3,0,50,78,4,0,82,104,5,0,109,113,5,0,118
179178,799,"ŞCOALA GIMNAZIALĂ NR. 308","BUCUREŞTI SECTORUL 4",B,1660,16,0,0,16,43,0,0,43,71,0,0,71,97,0,0,97,107,0,0,107
179178,800,"ŞCOALA GIMNAZIALĂ NR. 308","BUCUREŞTI SECTORUL 4",B,1887,22,1,0,23,40,1,0,41,65,3,0,68,81,3,0,84,90,3,0,93
179178,801,"ŞCOALA GIMNAZIALĂ NR. 119","BUCUREŞTI SECTORUL 4",B,2000,7,0,0,7,20,0,0,20,42,0,0,42,49,1,0,50,51,1,0,52
179178,802,"ŞCOALA GIMNAZIALĂ NR. 119","BUCUREŞTI SECTORUL 4",B,1955,2,0,0,2,27,0,0,27,42,0,0,42,57,0,0,57,59,0,0,59
179178,803,"ŞCOALA GIMNAZIALĂ NR. 119","BUCUREŞTI SECTORUL 4",B,1916,31,3,0,34,79,7,0,86,109,10,0,119,128,10,0,138,145,11,0,156
179178,804,"ŞCOALA GIMNAZIALĂ NR. 119","BUCUREŞTI SECTORUL 4",B,1929,16,0,0,16,63,0,0,63,106,0,0,106,142,0,0,142,146,4,0,150
179178,805,"ŞCOALA GIMNAZIALĂ NR. 119","BUCUREŞTI SECTORUL 4",B,1945,9,2,0,11,50,2,0,52,82,2,0,84,118,7,0,125,129,7,0,136
179178,806,"ŞCOALA GIMNAZIALĂ NR. 119","BUCUREŞTI SECTORUL 4",B,1879,7,0,0,7,36,2,0,38,49,3,0,52,77,5,0,82,83,5,0,88
179178,807,"ŞCOALA GIMNAZIALĂ GEORGE TOPÂRCEANU","BUCUREŞTI SECTORUL 4",B,1508,12,0,0,12,19,1,0,20,52,3,0,55,69,4,0,73,72,5,0,77
179178,808,"ŞCOALA GIMNAZIALĂ GEORGE TOPÂRCEANU","BUCUREŞTI SECTORUL 4",B,1516,12,2,0,14,46,3,0,49,64,3,0,67,85,3,0,88,90,3,0,93
179178,809,"ŞCOALA GIMNAZIALĂ GEORGE TOPÂRCEANU","BUCUREŞTI SECTORUL 4",B,1411,17,0,0,17,30,1,0,31,45,2,0,47,63,4,0,67,68,4,0,72
179178,810,"ŞCOALA GIMNAZIALĂ GEORGE TOPÂRCEANU","BUCUREŞTI SECTORUL 4",B,1632,14,0,0,14,39,0,0,39,53,0,0,53,80,1,0,81,87,1,0,88
179178,811,"ŞCOALA GIMNAZIALĂ NR. 129","BUCUREŞTI SECTORUL 4",B,1413,15,1,0,16,48,3,0,51,72,5,0,77,88,5,0,93,95,5,0,100
179178,812,"ŞCOALA GIMNAZIALĂ NR. 129","BUCUREŞTI SECTORUL 4",B,1560,18,0,0,18,48,1,0,49,79,1,0,80,119,2,0,121,131,5,0,136
179178,813,"ŞCOALA GIMNAZIALĂ NR. 129","BUCUREŞTI SECTORUL 4",B,1719,9,0,0,9,45,0,0,45,83,0,0,83,110,0,0,110,119,0,0,119
179178,814,"ŞCOALA GIMNAZIALĂ NR. 129","BUCUREŞTI SECTORUL 4",B,1697,19,1,0,20,49,9,0,58,75,14,0,89,111,20,1,132,120,21,1,142
179178,815,"LICEUL TEHNOLOGIC “MIRCEA VULCĂNESCU“","BUCUREŞTI SECTORUL 4",B,1424,14,1,0,15,37,3,0,40,51,5,0,56,69,6,0,75,73,8,0,81
179178,816,"LICEUL TEHNOLOGIC “MIRCEA VULCĂNESCU“","BUCUREŞTI SECTORUL 4",B,1409,10,0,0,10,38,2,0,40,61,4,0,65,87,4,0,91,90,4,0,94
179178,817,"ŞCOALA GIMNAZIALĂ “IONEL TEODOREANU“","BUCUREŞTI SECTORUL 4",B,1314,19,0,0,19,46,0,0,46,78,1,0,79,94,1,0,95,103,1,0,104
179178,818,"ŞCOALA GIMNAZIALĂ “IONEL TEODOREANU“","BUCUREŞTI SECTORUL 4",B,1405,13,2,0,15,44,2,0,46,63,2,0,65,72,4,0,76,89,6,0,95
179178,819,"ŞCOALA GIMNAZIALĂ “IONEL TEODOREANU“","BUCUREŞTI SECTORUL 4",B,1560,15,0,0,15,41,0,0,41,70,1,0,71,95,2,0,97,102,2,0,104
179178,820,"ŞCOALA GIMNAZIALĂ “IONEL TEODOREANU“","BUCUREŞTI SECTORUL 4",B,1766,21,3,0,24,52,5,0,57,75,7,0,82,83,7,0,90,95,7,0,102
179178,821,"ŞCOALA GIMNAZIALĂ “IONEL TEODOREANU“","BUCUREŞTI SECTORUL 4",B,1693,17,0,1,18,39,1,1,41,58,1,1,60,77,1,1,79,79,1,1,81
179178,822,"ŞCOALA GIMNAZIALĂ “IONEL TEODOREANU“","BUCUREŞTI SECTORUL 4",B,1536,20,0,0,20,60,1,0,61,73,2,0,75,93,2,0,95,93,2,0,95
179178,823,"ŞCOALA GIMNAZIALĂ NR. 99","BUCUREŞTI SECTORUL 4",B,1621,11,1,0,12,36,5,0,41,61,8,0,69,93,10,1,104,99,10,1,110
179178,824,"ŞCOALA GIMNAZIALĂ NR. 99","BUCUREŞTI SECTORUL 4",B,1856,20,4,0,24,59,4,0,63,81,8,0,89,121,8,0,129,125,8,0,133
179178,825,"ŞCOALA GIMNAZIALĂ NR. 99","BUCUREŞTI SECTORUL 4",B,1564,10,0,0,10,34,1,0,35,50,2,0,52,62,3,0,65,69,5,0,74
179178,826,"ŞCOALA GIMNAZIALĂ NR. 99","BUCUREŞTI SECTORUL 4",B,1794,5,0,0,5,28,3,0,31,40,5,0,45,58,5,0,63,63,5,0,68
179178,827,"ŞCOALA GIMNAZIALĂ NR. 165","BUCUREŞTI SECTORUL 4",B,1392,9,0,0,9,33,1,0,34,49,3,0,52,72,6,0,78,79,6,0,85
179178,828,"ŞCOALA GIMNAZIALĂ NR. 165","BUCUREŞTI SECTORUL 4",B,1894,15,0,0,15,31,0,0,31,73,1,0,74,80,4,0,84,87,4,0,91
179178,829,"ŞCOALA GIMNAZIALĂ NR. 165","BUCUREŞTI SECTORUL 4",B,1663,8,0,0,8,19,0,0,19,24,0,0,24,41,0,0,41,47,0,0,47
179178,830,"ŞCOALA GIMNAZIALĂ NR. 165","BUCUREŞTI SECTORUL 4",B,1923,16,2,0,18,67,2,0,69,89,3,1,93,99,3,1,103,107,3,1,111
179178,831,"ŞCOALA GIMNAZIALĂ NR.165","BUCUREŞTI SECTORUL 4",B,1641,16,0,0,16,29,1,0,30,53,2,0,55,62,2,0,64,66,2,0,68
179178,832,"GRĂDINIŢA  “ÎNŞIR’TE MĂRGĂRITE“","BUCUREŞTI SECTORUL 4",B,1352,8,0,0,8,36,0,0,36,54,0,0,54,62,0,0,62,80,0,0,80
179178,833,"GRĂDINIŢA  “ÎNŞIR’TE MĂRGĂRITE“","BUCUREŞTI SECTORUL 4",B,1310,13,0,0,13,30,1,0,31,46,2,0,48,68,2,0,70,75,3,0,78
179187,834,"ȘCOALA GIMNAZIALĂ NR.134","BUCUREŞTI SECTORUL 5",B,1827,14,0,0,14,32,1,0,33,44,1,0,45,69,2,0,71,72,2,0,74
179187,835,"ȘCOALA GIMNAZIALĂ NR.134","BUCUREŞTI SECTORUL 5",B,1775,11,0,0,11,24,0,0,24,30,1,0,31,44,1,0,45,48,1,0,49
179187,836,"ȘCOALA GIMNAZIALĂ NR.134","BUCUREŞTI SECTORUL 5",B,1421,2,0,0,2,15,1,0,16,23,2,0,25,31,2,0,33,39,3,0,42
179187,837,"ȘCOALA GIMNAZIALĂ NR.134","BUCUREŞTI SECTORUL 5",B,1400,7,0,0,7,22,0,0,22,25,0,0,25,38,0,0,38,42,0,0,42
179187,838,"ȘCOALA GIMNAZIALĂ NR.134","BUCUREŞTI SECTORUL 5",B,1530,17,3,0,20,38,6,0,44,54,11,0,65,76,11,0,87,85,11,0,96
179187,839,"ȘCOALA GIMNAZIALĂ NR.134","BUCUREŞTI SECTORUL 5",B,1583,11,0,0,11,45,0,0,45,58,0,0,58,75,0,0,75,78,0,0,78
179187,840,"ȘCOALA GIMNAZIALĂ NR.134","BUCUREŞTI SECTORUL 5",B,1935,13,1,0,14,21,1,0,22,38,2,0,40,61,3,0,64,73,3,0,76
179187,841,"ȘCOALA GIMNAZIALĂ NR.134","BUCUREŞTI SECTORUL 5",B,1754,4,0,0,4,18,0,0,18,28,2,0,30,45,2,0,47,47,2,0,49
179187,842,"ȘCOALA GIMNAZIALĂ NR.134","BUCUREŞTI SECTORUL 5",B,1156,3,0,0,3,4,0,0,4,11,0,0,11,21,0,0,21,26,0,0,26
179187,843,"ȘCOALA GIMNAZIALĂ NR.134","BUCUREŞTI SECTORUL 5",B,1805,9,0,0,9,27,0,0,27,32,0,0,32,40,0,0,40,41,0,0,41
179187,844,"ȘCOALA GIMNAZIALĂ NR.134","BUCUREŞTI SECTORUL 5",B,1566,15,1,0,16,25,1,0,26,41,1,0,42,52,1,0,53,57,1,0,58
179187,845,"COLEGIUL TEHNIC ENERGETIC","BUCUREŞTI SECTORUL 5",B,1275,18,5,0,23,37,9,0,46,59,10,0,69,71,12,0,83,80,13,0,93
179187,846,"COLEGIUL TEHNIC ENERGETIC","BUCUREŞTI SECTORUL 5",B,1389,11,0,0,11,53,2,0,55,90,2,0,92,110,4,0,114,118,7,0,125
179187,847,"COLEGIUL TEHNIC ENERGETIC","BUCUREŞTI SECTORUL 5",B,1026,6,0,0,6,26,0,0,26,52,1,0,53,58,1,0,59,61,2,0,63
179187,848,"COLEGIUL TEHNIC ENERGETIC","BUCUREŞTI SECTORUL 5",B,1054,7,1,0,8,33,1,0,34,55,1,0,56,76,1,0,77,82,1,0,83
179187,849,"ȘCOALA GIMNAZIALĂ NR.136","BUCUREŞTI SECTORUL 5",B,1969,7,2,0,9,28,3,0,31,49,6,0,55,52,13,0,65,59,13,0,72
179187,850,"ȘCOALA GIMNAZIALĂ NR.136","BUCUREŞTI SECTORUL 5",B,1281,9,0,0,9,17,0,0,17,23,0,0,23,28,0,0,28,30,0,0,30
179187,851,"ȘCOALA GIMNAZIALĂ NR.136","BUCUREŞTI SECTORUL 5",B,1904,10,0,0,10,16,0,0,16,24,1,0,25,38,2,0,40,41,3,0,44
179187,852,"ȘCOALA GIMNAZIALĂ NR.136","BUCUREŞTI SECTORUL 5",B,1318,8,0,0,8,16,0,0,16,22,0,0,22,36,0,0,36,42,1,0,43
179187,853,"ȘCOALA GIMNAZIALĂ NR.136","BUCUREŞTI SECTORUL 5",B,1571,10,1,0,11,21,3,0,24,37,3,0,40,56,3,0,59,63,3,0,66
179187,854,"ȘCOALA GIMNAZIALĂ NR.136","BUCUREŞTI SECTORUL 5",B,1507,12,0,0,12,26,0,0,26,41,0,0,41,51,0,0,51,61,2,0,63
179187,855,"ȘCOALA GIMNAZIALĂ NR.136","BUCUREŞTI SECTORUL 5",B,1466,5,0,0,5,26,0,0,26,41,1,0,42,52,1,0,53,55,6,0,61
179187,856,"ȘCOALA GIMNAZIALĂ NR.2","BUCUREŞTI SECTORUL 5",B,1244,8,0,0,8,26,0,0,26,47,0,0,47,55,0,0,55,61,1,0,62
179187,857,"ȘCOALA GIMNAZIALĂ NR.2","BUCUREŞTI SECTORUL 5",B,1423,7,3,0,10,19,3,0,22,25,3,0,28,40,3,0,43,47,3,0,50
179187,858,"ȘCOALA GIMNAZIALĂ NR.2","BUCUREŞTI SECTORUL 5",B,1234,7,1,0,8,28,2,0,30,45,4,0,49,56,4,0,60,61,4,0,65
179187,859,"ȘCOALA GIMNAZIALĂ NR.2","BUCUREŞTI SECTORUL 5",B,1017,2,0,0,2,17,0,0,17,29,0,0,29,40,0,0,40,50,0,0,50
179187,860,"ȘCOALA GIMNAZIALĂ NR.2","BUCUREŞTI SECTORUL 5",B,1427,11,3,0,14,31,8,0,39,51,8,0,59,62,8,0,70,72,8,0,80
179187,861,"ȘCOALA GIMNAZIALĂ NR.188","BUCUREŞTI SECTORUL 5",B,962,10,0,0,10,30,0,0,30,48,1,0,49,68,2,0,70,71,2,0,73
179187,862,"ȘCOALA GIMNAZIALĂ NR.188","BUCUREŞTI SECTORUL 5",B,1294,9,1,0,10,30,2,0,32,43,5,0,48,58,9,0,67,69,9,0,78
179187,863,"ȘCOALA GIMNAZIALĂ NR.188","BUCUREŞTI SECTORUL 5",B,927,5,5,0,10,22,5,0,27,31,5,0,36,50,5,0,55,57,5,0,62
179187,864,"ȘCOALA GIMNAZIALĂ NR.188","BUCUREŞTI SECTORUL 5",B,1041,7,3,0,10,25,3,0,28,44,4,0,48,56,4,0,60,61,5,0,66
179187,865,"ȘCOALA GIMNAZIALĂ NR.188","BUCUREŞTI SECTORUL 5",B,811,4,0,0,4,20,0,0,20,31,2,0,33,50,3,0,53,57,3,0,60
179187,866,"ȘCOALA GIMNAZIALĂ ”LUCEAFĂRUL”","BUCUREŞTI SECTORUL 5",B,1167,5,5,0,10,30,10,0,40,57,19,0,76,66,29,0,95,67,31,0,98
179187,867,"ȘCOALA GIMNAZIALĂ ”LUCEAFĂRUL”","BUCUREŞTI SECTORUL 5",B,1159,17,4,0,21,40,5,0,45,60,7,0,67,66,7,0,73,73,7,0,80
179187,868,"ȘCOALA GIMNAZIALĂ ”LUCEAFĂRUL”","BUCUREŞTI SECTORUL 5",B,1067,10,3,0,13,25,3,0,28,35,12,0,47,41,12,0,53,44,12,0,56
179187,869,"ȘCOALA GIMNAZIALĂ ”LUCEAFĂRUL”","BUCUREŞTI SECTORUL 5",B,1308,12,0,0,12,45,0,0,45,57,0,0,57,62,0,0,62,67,0,0,67
179187,870,"ȘCOALA GIMNAZIALĂ ”LUCEAFĂRUL”","BUCUREŞTI SECTORUL 5",B,1317,3,2,0,5,21,2,0,23,33,2,0,35,57,2,0,59,62,2,0,64
179187,871,"ȘCOALA GIMNAZIALĂ ”LUCEAFĂRUL”","BUCUREŞTI SECTORUL 5",B,1452,9,0,0,9,33,0,0,33,46,4,0,50,64,5,0,69,64,5,0,69
179187,872,"ȘCOALA GIMNAZIALĂ ”LUCEAFĂRUL”","BUCUREŞTI SECTORUL 5",B,1128,11,0,0,11,37,1,0,38,60,2,0,62,65,4,0,69,75,4,0,79
179187,873,"ȘCOALA GIMNAZIALĂ NR.135","BUCUREŞTI SECTORUL 5",B,1007,12,0,0,12,32,2,0,34,41,4,0,45,56,6,0,62,61,7,0,68
179187,874,"ȘCOALA GIMNAZIALĂ NR.135","BUCUREŞTI SECTORUL 5",B,1323,15,3,0,18,39,4,0,43,50,6,0,56,74,8,0,82,77,8,0,85
179187,875,"ȘCOALA GIMNAZIALĂ NR.135","BUCUREŞTI SECTORUL 5",B,1294,6,0,0,6,24,1,0,25,33,1,0,34,48,1,0,49,54,3,0,57
179187,876,"ȘCOALA GIMNAZIALĂ NR.135","BUCUREŞTI SECTORUL 5",B,1733,14,2,0,16,45,3,0,48,73,7,0,80,92,7,0,99,112,8,0,120
179187,877,"ȘCOALA GIMNAZIALĂ NR.127","BUCUREŞTI SECTORUL 5",B,1117,1,2,0,3,21,4,0,25,32,4,0,36,45,5,0,50,50,7,0,57
179187,878,"ȘCOALA GIMNAZIALĂ NR.127","BUCUREŞTI SECTORUL 5",B,1117,4,0,0,4,15,0,0,15,23,0,0,23,27,0,0,27,32,0,0,32
179187,879,"ȘCOALA GIMNAZIALĂ NR.127","BUCUREŞTI SECTORUL 5",B,1450,3,0,0,3,19,0,0,19,34,0,0,34,51,0,0,51,56,0,0,56
179187,880,"ȘCOALA GIMNAZIALĂ NR.127","BUCUREŞTI SECTORUL 5",B,1200,2,1,0,3,8,4,0,12,16,4,0,20,32,7,0,39,34,7,0,41
179187,881,"ȘCOALA GIMNAZIALĂ NR.127","BUCUREŞTI SECTORUL 5",B,1179,3,0,0,3,15,0,0,15,18,0,0,18,28,0,0,28,35,0,0,35
179187,882,"ȘCOALA GIMNAZIALĂ NR.127","BUCUREŞTI SECTORUL 5",B,1203,6,0,0,6,16,0,0,16,25,6,0,31,32,6,0,38,32,6,0,38
179187,883,"ȘCOALA GIMNAZIALĂ NR.127","BUCUREŞTI SECTORUL 5",B,1427,0,0,0,0,1,0,0,1,1,0,0,1,6,0,0,6,7,0,0,7
179187,884,"ȘCOALA GIMNAZIALĂ NR.127","BUCUREŞTI SECTORUL 5",B,1879,3,0,0,3,19,0,0,19,27,0,0,27,36,1,0,37,40,1,0,41
179187,885,"ȘCOALA GIMNAZIALĂ NR.127","BUCUREŞTI SECTORUL 5",B,1794,12,3,0,15,37,3,0,40,58,4,0,62,62,4,0,66,70,4,0,74
179187,886,"ȘCOALA GIMNAZIALĂ NR.127","BUCUREŞTI SECTORUL 5",B,2120,14,1,0,15,35,1,0,36,44,1,0,45,57,1,0,58,66,4,0,70
179187,887,"ȘCOALA GIMNAZIALĂ NR.127","BUCUREŞTI SECTORUL 5",B,1801,10,0,0,10,33,0,0,33,59,0,0,59,76,2,0,78,80,3,0,83
179187,888,"ȘCOALA GIMNAZIALĂ NR.127","BUCUREŞTI SECTORUL 5",B,1594,7,0,0,7,28,2,0,30,45,2,0,47,69,2,0,71,76,2,0,78
179187,889,"GRĂDINIȚA ”PARADISUL VERDE”","BUCUREŞTI SECTORUL 5",B,1732,1,0,0,1,3,0,15,18,15,0,15,30,18,0,15,33,19,0,15,34
179187,890,"GRĂDINIȚA ”PARADISUL VERDE”","BUCUREŞTI SECTORUL 5",B,1456,4,0,0,4,22,2,0,24,25,2,0,27,40,2,0,42,40,3,0,43
179187,891,"GRĂDINIȚA ”PARADISUL VERDE”","BUCUREŞTI SECTORUL 5",B,1292,3,0,0,3,13,0,0,13,22,0,0,22,25,0,0,25,27,6,0,33
179187,892,"GRĂDINIȚA ”PARADISUL VERDE”","BUCUREŞTI SECTORUL 5",B,1585,6,0,0,6,22,0,0,22,47,0,0,47,68,0,0,68,71,0,0,71
179187,893,"ȘCOALA GIMNAZIALĂ ”GEORGE CĂLINESCU”","BUCUREŞTI SECTORUL 5",B,1399,6,2,0,8,30,2,0,32,35,2,0,37,52,4,0,56,56,5,0,61
179187,894,"ȘCOALA GIMNAZIALĂ ”GEORGE CĂLINESCU”","BUCUREŞTI SECTORUL 5",B,1222,9,0,0,9,24,3,0,27,39,3,0,42,63,3,0,66,66,3,0,69
179187,895,"ȘCOALA GIMNAZIALĂ ”GEORGE CĂLINESCU”","BUCUREŞTI SECTORUL 5",B,1522,9,0,0,9,18,0,0,18,32,0,0,32,60,5,0,65,60,5,0,65
179187,896,"ȘCOALA GIMNAZIALĂ ”GEORGE CĂLINESCU”","BUCUREŞTI SECTORUL 5",B,1629,10,0,0,10,26,0,0,26,36,5,0,41,45,7,0,52,52,7,0,59
179187,897,"ȘCOALA GIMNAZIALĂ ”GEORGE CĂLINESCU”","BUCUREŞTI SECTORUL 5",B,1649,5,0,0,5,25,1,0,26,41,2,0,43,58,6,0,64,63,6,0,69
179187,898,"GRĂDINIȚA NR.244","BUCUREŞTI SECTORUL 5",B,1631,5,0,0,5,18,0,0,18,32,0,0,32,43,4,0,47,50,4,0,54
179187,899,"GRĂDINIȚA NR.244","BUCUREŞTI SECTORUL 5",B,1698,11,8,0,19,31,8,0,39,52,11,0,63,77,11,0,88,78,11,0,89
179187,900,"ȘCOALA GIMNAZIALĂ ”PETRACHE POENARU”","BUCUREŞTI SECTORUL 5",B,1240,5,4,0,9,22,4,0,26,27,4,0,31,36,5,0,41,37,8,0,45
179187,901,"ȘCOALA GIMNAZIALĂ ”PETRACHE POENARU”","BUCUREŞTI SECTORUL 5",B,2066,11,2,0,13,29,2,0,31,37,5,0,42,56,9,0,65,62,10,0,72
179187,902,"ȘCOALA GIMNAZIALĂ ”PETRACHE POENARU”","BUCUREŞTI SECTORUL 5",B,1591,12,1,0,13,20,1,0,21,49,4,0,53,61,4,0,65,63,4,0,67
179187,903,"ȘCOALA GIMNAZIALĂ ”PETRACHE POENARU”","BUCUREŞTI SECTORUL 5",B,1305,13,0,0,13,26,0,0,26,45,0,0,45,56,0,0,56,64,1,0,65
179187,904,"ȘCOALA GIMNAZIALĂ ”PETRACHE POENARU”","BUCUREŞTI SECTORUL 5",B,1612,0,0,0,0,13,1,0,14,16,1,0,17,41,5,0,46,42,5,0,47
179187,905,"ȘCOALA GIMNAZIALĂ ”PETRACHE POENARU”","BUCUREŞTI SECTORUL 5",B,1522,11,1,0,12,25,6,0,31,35,8,0,43,44,9,0,53,48,9,0,57
179187,906,"ȘCOALA GIMNAZIALĂ ”PETRACHE POENARU”","BUCUREŞTI SECTORUL 5",B,1299,3,0,0,3,9,0,0,9,19,0,0,19,29,0,0,29,31,0,0,31
179187,907,"ȘCOALA GIMNAZIALĂ ”PRINCIPESA MARGARETA”","BUCUREŞTI SECTORUL 5",B,1014,7,0,0,7,28,1,0,29,46,2,0,48,59,3,0,62,63,3,0,66
179187,908,"ȘCOALA GIMNAZIALĂ ”PRINCIPESA MARGARETA”","BUCUREŞTI SECTORUL 5",B,1231,4,0,0,4,37,3,0,40,37,5,0,42,45,5,0,50,51,5,0,56
179187,909,"ȘCOALA GIMNAZIALĂ ”PRINCIPESA MARGARETA”","BUCUREŞTI SECTORUL 5",B,1727,2,1,0,3,27,3,0,30,37,4,0,41,46,4,0,50,51,4,0,55
179187,910,"ȘCOALA GIMNAZIALĂ ”PRINCIPESA MARGARETA”","BUCUREŞTI SECTORUL 5",B,1167,11,3,0,14,38,4,0,42,58,5,0,63,70,5,0,75,76,5,0,81
179187,911,"GRĂDINIȚA NR.168","BUCUREŞTI SECTORUL 5",B,1119,1,5,0,6,15,7,0,22,27,7,35,69,33,9,35,77,36,9,35,80
179187,912,"GRĂDINIȚA NR.168","BUCUREŞTI SECTORUL 5",B,906,10,3,0,13,24,5,0,29,44,5,0,49,58,6,0,64,61,9,0,70
179187,913,"CLUBUL COPIILOR SECTOR 5","BUCUREŞTI SECTORUL 5",B,1342,7,1,0,8,28,1,0,29,47,5,0,52,63,13,0,76,70,23,0,93
179187,914,"CLUBUL COPIILOR SECTOR 5","BUCUREŞTI SECTORUL 5",B,1358,11,0,0,11,46,1,0,47,60,2,0,62,74,5,0,79,79,12,0,91
179187,915,"ȘCOALA GIMNAZIALĂ NR.280","BUCUREŞTI SECTORUL 5",B,1409,7,0,0,7,28,6,0,34,40,9,0,49,62,11,0,73,71,13,0,84
179187,916,"ȘCOALA GIMNAZIALĂ NR.280","BUCUREŞTI SECTORUL 5",B,1146,10,0,0,10,33,5,0,38,43,5,0,48,62,7,0,69,70,7,0,77
179187,917,"ȘCOALA GIMNAZIALĂ NR.280","BUCUREŞTI SECTORUL 5",B,1035,8,5,0,13,24,7,0,31,31,9,0,40,40,9,0,49,49,9,0,58
179187,918,"ȘCOALA GIMNAZIALĂ NR.280","BUCUREŞTI SECTORUL 5",B,1104,2,3,0,5,14,3,0,17,32,3,0,35,36,3,0,39,38,3,0,41
179187,919,"ȘCOALA GIMNAZIALĂ NR.280","BUCUREŞTI SECTORUL 5",B,945,11,1,0,12,24,1,0,25,46,3,0,49,59,6,0,65,62,7,0,69
179187,920,"ȘCOALA GIMNAZIALĂ NR.280","BUCUREŞTI SECTORUL 5",B,1315,17,4,0,21,38,5,0,43,54,5,0,59,59,8,0,67,64,9,0,73
179187,921,"ȘCOALA GIMNAZIALĂ NR.280","BUCUREŞTI SECTORUL 5",B,1243,8,0,0,8,31,3,0,34,46,3,0,49,65,3,0,68,69,3,0,72
179187,922,"ȘCOALA GIMNAZIALĂ NR.280","BUCUREŞTI SECTORUL 5",B,1115,8,0,0,8,28,1,0,29,49,3,0,52,64,4,0,68,74,4,0,78
179187,923,"ȘCOALA GIMNAZIALĂ ”GRIGORE TOCILESCU”","BUCUREŞTI SECTORUL 5",B,1279,10,0,0,10,32,0,0,32,43,0,0,43,56,0,0,56,60,1,0,61
179187,924,"ȘCOALA GIMNAZIALĂ ”GRIGORE TOCILESCU”","BUCUREŞTI SECTORUL 5",B,1287,15,5,0,20,37,6,0,43,63,9,0,72,83,11,0,94,87,13,0,100
179187,925,"ȘCOALA GIMNAZIALĂ ”GRIGORE TOCILESCU”","BUCUREŞTI SECTORUL 5",B,1259,8,2,0,10,28,4,0,32,59,9,0,68,71,11,0,82,78,11,0,89
179187,926,"GRĂDINIȚA NR.205","BUCUREŞTI SECTORUL 5",B,1386,10,1,0,11,43,1,0,44,70,1,0,71,101,1,0,102,115,1,0,116
179187,927,"GRĂDINIȚA NR.205","BUCUREŞTI SECTORUL 5",B,1133,16,5,0,21,49,7,0,56,62,11,0,73,73,13,0,86,76,19,0,95
179187,928,"GRĂDINIȚA NR.205","BUCUREŞTI SECTORUL 5",B,1328,12,1,0,13,40,9,0,49,64,10,0,74,69,11,0,80,75,11,0,86
179187,929,"GRĂDINIȚA NR.205","BUCUREŞTI SECTORUL 5",B,1053,7,5,0,12,16,5,0,21,49,6,0,55,57,8,0,65,64,8,0,72
179187,930,"GRĂDINIȚA NR.205","BUCUREŞTI SECTORUL 5",B,1177,8,5,0,13,38,6,0,44,55,7,0,62,73,9,0,82,79,9,0,88
179187,931,"LICEUL TEORETIC ”DIMITRIE BOLINTINEANU”","BUCUREŞTI SECTORUL 5",B,1086,6,2,0,8,39,2,0,41,52,2,0,54,75,2,0,77,78,2,0,80
179187,932,"LICEUL TEORETIC ”DIMITRIE BOLINTINEANU”","BUCUREŞTI SECTORUL 5",B,966,7,0,0,7,34,2,0,36,43,3,0,46,65,4,0,69,70,4,0,74
179187,933,"LICEUL TEORETIC ”DIMITRIE BOLINTINEANU”","BUCUREŞTI SECTORUL 5",B,1133,12,0,0,12,29,0,0,29,44,1,0,45,52,1,0,53,58,2,0,60
179187,934,"LICEUL TEORETIC ”DIMITRIE BOLINTINEANU”","BUCUREŞTI SECTORUL 5",B,1312,13,1,0,14,35,1,0,36,53,7,0,60,75,10,0,85,83,11,0,94
179187,935,"LICEUL TEORETIC ”DIMITRIE BOLINTINEANU”","BUCUREŞTI SECTORUL 5",B,1257,11,1,0,12,45,3,0,48,61,10,0,71,78,25,0,103,85,29,0,114
179187,936,"LICEUL TEORETIC ”DIMITRIE BOLINTINEANU”","BUCUREŞTI SECTORUL 5",B,1452,12,4,0,16,30,8,0,38,47,9,0,56,60,13,0,73,66,14,0,80
179187,937,"LICEUL TEORETIC ”DIMITRIE BOLINTINEANU”","BUCUREŞTI SECTORUL 5",B,1252,10,3,0,13,34,7,0,41,52,9,0,61,73,10,0,83,80,10,0,90
179187,938,"LICEUL TEORETIC ”DIMITRIE BOLINTINEANU”","BUCUREŞTI SECTORUL 5",B,1267,6,3,0,9,25,7,0,32,33,8,0,41,52,8,0,60,58,9,0,67
179187,939,"LICEUL TEORETIC ”DIMITRIE BOLINTINEANU”","BUCUREŞTI SECTORUL 5",B,919,8,1,0,9,25,4,0,29,49,5,0,54,51,5,1,57,55,5,1,61
179187,940,"FACULTATEA DE DREPT","BUCUREŞTI SECTORUL 5",B,647,6,8,0,14,21,21,0,42,31,46,0,77,43,53,0,96,51,56,0,107
179187,941,"FACULTATEA DE DREPT","BUCUREŞTI SECTORUL 5",B,626,6,2,0,8,17,2,0,19,26,6,0,32,49,11,0,60,50,12,0,62
179187,942,"FACULTATEA DE DREPT","BUCUREŞTI SECTORUL 5",B,600,7,0,0,7,30,10,0,40,49,13,0,62,58,17,0,75,62,20,0,82
179187,943,"COLEGIUL NAȚIONAL ”GHEORGHE LAZĂR”","BUCUREŞTI SECTORUL 5",B,715,1,0,0,1,22,2,0,24,46,7,0,53,68,7,0,75,73,13,0,86
179187,944,"COLEGIUL NAȚIONAL ”GHEORGHE LAZĂR”","BUCUREŞTI SECTORUL 5",B,905,4,3,0,7,28,7,0,35,51,12,0,63,60,21,0,81,63,25,0,88
179187,945,"COLEGIUL NAȚIONAL ”GHEORGHE LAZĂR”","BUCUREŞTI SECTORUL 5",B,584,5,3,0,8,13,5,0,18,21,10,0,31,24,14,0,38,28,14,0,42
179187,946,"COLEGIUL NAȚIONAL ”GHEORGHE LAZĂR”","BUCUREŞTI SECTORUL 5",B,748,3,5,0,8,30,5,0,35,45,7,0,52,52,8,0,60,56,11,0,67
179187,947,"COLEGIUL NAȚIONAL ”GHEORGHE LAZĂR”","BUCUREŞTI SECTORUL 5",B,628,3,1,0,4,21,4,0,25,36,8,0,44,48,20,0,68,54,21,0,75
179187,948,"GRĂDINȚA NR.178","BUCUREŞTI SECTORUL 5",B,1833,9,3,0,12,42,6,0,48,63,6,0,69,86,8,0,94,91,8,0,99
179187,949,"GRĂDINȚA NR.178","BUCUREŞTI SECTORUL 5",B,965,5,0,0,5,12,0,0,12,18,5,0,23,29,5,0,34,35,6,0,41
179187,950,"GRĂDINȚA NR.178","BUCUREŞTI SECTORUL 5",B,1923,9,2,0,11,31,3,1,35,53,3,1,57,65,3,1,69,76,3,1,80
179187,951,"LICEUL TEORETIC ""ION BARBU""","BUCUREŞTI SECTORUL 5",B,1200,8,0,0,8,25,4,0,29,34,9,0,43,49,12,0,61,56,14,0,70
179187,952,"LICEUL TEORETIC ""ION BARBU""","BUCUREŞTI SECTORUL 5",B,1362,7,1,0,8,17,2,0,19,27,2,0,29,41,6,0,47,46,9,0,55
179187,953,"LICEUL TEORETIC ""ION BARBU""","BUCUREŞTI SECTORUL 5",B,949,10,0,0,10,26,0,0,26,36,0,0,36,45,3,0,48,54,3,0,57
179187,954,"LICEUL TEORETIC ""ION BARBU""","BUCUREŞTI SECTORUL 5",B,1077,15,0,0,15,40,0,0,40,65,1,0,66,82,2,0,84,88,2,0,90
179187,955,"LICEUL TEORETIC ""ION BARBU""","BUCUREŞTI SECTORUL 5",B,1211,14,0,0,14,45,2,0,47,73,4,0,77,85,5,0,90,92,5,0,97
179187,956,"LICEUL TEORETIC ""ION BARBU""","BUCUREŞTI SECTORUL 5",B,1837,18,0,0,18,43,0,0,43,80,0,0,80,108,0,0,108,117,0,0,117
179187,957,"LICEUL TEORETIC ""ION BARBU""","BUCUREŞTI SECTORUL 5",B,988,7,4,0,11,26,4,0,30,39,4,0,43,59,4,0,63,66,4,0,70
179187,958,"LICEUL TEORETIC ""ION BARBU""","BUCUREŞTI SECTORUL 5",B,829,5,0,0,5,21,3,0,24,37,4,0,41,55,4,0,59,59,4,0,63
179187,959,"LICEUL TEORETIC ""ION BARBU""","BUCUREŞTI SECTORUL 5",B,1286,6,0,0,6,24,0,0,24,44,2,0,46,60,3,1,64,72,3,1,76
179187,960,"ȘCOALA GIMNAZIALĂ NR.115","BUCUREŞTI SECTORUL 5",B,1433,9,0,0,9,24,6,0,30,41,11,0,52,59,18,0,77,74,19,0,93
179187,961,"ȘCOALA GIMNAZIALĂ NR.115","BUCUREŞTI SECTORUL 5",B,1194,10,5,0,15,32,8,0,40,54,12,0,66,72,18,0,90,78,19,0,97
179187,962,"ȘCOALA GIMNAZIALĂ NR.115","BUCUREŞTI SECTORUL 5",B,1378,12,0,0,12,28,0,1,29,42,0,5,47,60,7,0,67,65,7,0,72
179187,963,"ȘCOALA GIMNAZIALĂ NR.115","BUCUREŞTI SECTORUL 5",B,1165,9,0,0,9,34,0,0,34,49,3,0,52,62,3,0,65,65,3,0,68
179187,964,"ȘCOALA GIMNAZIALĂ NR.115","BUCUREŞTI SECTORUL 5",B,1128,9,3,0,12,28,4,0,32,44,4,0,48,53,4,0,57,58,4,0,62
179187,965,"ȘCOALA GIMNAZIALĂ NR.115","BUCUREŞTI SECTORUL 5",B,1196,10,3,0,13,26,4,0,30,40,4,0,44,53,4,0,57,53,4,0,57
179187,966,"ȘCOALA GIMNAZIALĂ ”I. G. DUCA”","BUCUREŞTI SECTORUL 5",B,1096,15,3,0,18,51,13,0,64,91,22,0,113,107,36,0,143,114,46,0,160
179187,967,"ȘCOALA GIMNAZIALĂ ”I. G. DUCA”","BUCUREŞTI SECTORUL 5",B,966,9,0,0,9,40,0,0,40,64,0,0,64,76,2,40,118,81,2,40,123
179187,968,"ȘCOALA GIMNAZIALĂ ”I. G. DUCA”","BUCUREŞTI SECTORUL 5",B,1077,8,0,0,8,49,0,0,49,69,1,0,70,88,2,0,90,91,2,0,93
179187,969,"ȘCOALA GIMNAZIALĂ ”I. G. DUCA”","BUCUREŞTI SECTORUL 5",B,899,6,0,0,6,27,2,0,29,41,2,0,43,61,2,0,63,64,2,0,66
179187,970,"ȘCOALA GIMNAZIALĂ ”I. G. DUCA”","BUCUREŞTI SECTORUL 5",B,1019,15,0,0,15,40,0,1,41,60,2,1,63,71,6,1,78,78,6,1,85
179187,971,"ȘCOALA GIMNAZIALĂ NR.150","BUCUREŞTI SECTORUL 5",B,705,11,0,0,11,22,0,0,22,31,5,0,36,46,6,0,52,53,6,0,59
179187,972,"ȘCOALA GIMNAZIALĂ NR.150","BUCUREŞTI SECTORUL 5",B,686,6,0,0,6,26,5,0,31,40,10,0,50,49,17,0,66,53,17,0,70
179187,973,"ȘCOALA GIMNAZIALĂ NR.150","BUCUREŞTI SECTORUL 5",B,739,6,1,0,7,29,2,0,31,42,4,0,46,56,5,0,61,65,5,0,70
179187,974,"ȘCOALA GIMNAZIALĂ NR.150","BUCUREŞTI SECTORUL 5",B,695,3,0,0,3,24,1,0,25,38,1,0,39,45,1,0,46,54,2,0,56
179187,975,"ȘCOALA GIMNAZIALĂ NR.150","BUCUREŞTI SECTORUL 5",B,700,1,0,0,1,17,4,0,21,30,4,0,34,50,4,0,54,63,5,0,68
179187,976,"ȘCOALA GIMNAZIALĂ NR.150","BUCUREŞTI SECTORUL 5",B,775,3,0,0,3,12,0,0,12,22,0,0,22,37,2,0,39,48,2,0,50
179187,977,"ȘCOALA GIMNAZIALĂ NR.128","BUCUREŞTI SECTORUL 5",B,824,1,3,0,4,13,8,0,21,21,8,0,29,31,10,0,41,34,11,0,45
179187,978,"ȘCOALA GIMNAZIALĂ NR.128","BUCUREŞTI SECTORUL 5",B,786,1,0,0,1,8,0,0,8,13,0,0,13,21,0,0,21,26,0,0,26
179187,979,"ȘCOALA GIMNAZIALĂ NR.128","BUCUREŞTI SECTORUL 5",B,782,4,0,0,4,14,3,0,17,29,3,0,32,31,3,0,34,38,3,0,41
179187,980,"ȘCOALA GIMNAZIALĂ NR.128","BUCUREŞTI SECTORUL 5",B,728,12,1,0,13,24,3,0,27,44,6,0,50,54,7,0,61,54,7,0,61
179187,981,"GRĂDINIȚA NR.268","BUCUREŞTI SECTORUL 5",B,712,6,0,0,6,43,0,0,43,69,0,0,69,80,0,0,80,87,0,0,87
179187,982,"GRĂDINIȚA NR.268","BUCUREŞTI SECTORUL 5",B,1229,27,0,0,27,80,5,0,85,106,7,0,113,123,11,0,134,131,15,23,169
179187,983,"GRĂDINIȚA NR.268","BUCUREŞTI SECTORUL 5",B,847,7,0,0,7,35,1,0,36,57,1,0,58,79,1,0,80,85,2,0,87
179187,984,"ȘCOALA GIMNAZIALĂ NR.125","BUCUREŞTI SECTORUL 5",B,1640,12,1,0,13,33,1,0,34,58,3,0,61,80,5,0,85,81,5,0,86
179187,985,"ȘCOALA GIMNAZIALĂ NR.125","BUCUREŞTI SECTORUL 5",B,1769,10,0,0,10,25,0,0,25,36,0,0,36,55,0,0,55,68,0,0,68
179187,986,"ȘCOALA GIMNAZIALĂ NR.125","BUCUREŞTI SECTORUL 5",B,1492,9,1,0,10,23,5,0,28,38,5,0,43,43,5,0,48,50,6,0,56
179187,987,"ȘCOALA GIMNAZIALĂ NR.131","BUCUREŞTI SECTORUL 5",B,1448,9,4,0,13,24,7,0,31,34,8,0,42,39,11,0,50,43,14,0,57
179187,988,"ȘCOALA GIMNAZIALĂ NR.131","BUCUREŞTI SECTORUL 5",B,1632,3,0,0,3,28,0,0,28,35,0,0,35,42,0,0,42,42,0,0,42
179187,989,"ȘCOALA GIMNAZIALĂ NR.131","BUCUREŞTI SECTORUL 5",B,1375,7,0,0,7,18,0,0,18,29,0,0,29,35,0,0,35,38,0,0,38
179187,990,"ȘCOALA GIMNAZIALĂ NR.131","BUCUREŞTI SECTORUL 5",B,1817,10,0,0,10,31,0,0,31,41,7,0,48,61,7,0,68,66,7,0,73
179187,991,"ȘCOALA GIMNAZIALĂ NR.131","BUCUREŞTI SECTORUL 5",B,1485,17,0,0,17,43,0,0,43,51,0,0,51,58,0,0,58,64,0,0,64
179187,992,"ȘCOALA GIMNAZIALĂ NR.131","BUCUREŞTI SECTORUL 5",B,1804,18,1,0,19,54,1,0,55,70,3,0,73,89,4,0,93,99,4,0,103
179187,993,"ȘCOALA GIMNAZIALĂ NR.126","BUCUREŞTI SECTORUL 5",B,1695,15,5,0,20,37,6,0,43,62,11,0,73,83,14,0,97,99,14,0,113
179187,994,"ȘCOALA GIMNAZIALĂ NR.126","BUCUREŞTI SECTORUL 5",B,1379,20,0,0,20,49,0,0,49,82,3,0,85,93,5,0,98,95,6,0,101
179187,995,"ȘCOALA GIMNAZIALĂ NR.126","BUCUREŞTI SECTORUL 5",B,1315,11,0,0,11,45,0,0,45,63,5,0,68,81,5,0,86,90,5,0,95
179187,996,"ȘCOALA GIMNAZIALĂ NR.126","BUCUREŞTI SECTORUL 5",B,1683,9,0,0,9,21,2,0,23,40,2,0,42,50,3,0,53,52,3,0,55
179187,997,"ȘCOALA GIMNAZIALĂ NR.126","BUCUREŞTI SECTORUL 5",B,1185,8,0,0,8,26,0,0,26,29,0,0,29,38,1,0,39,41,1,0,42
179187,998,"ȘCOALA GIMNAZIALĂ NR.126","BUCUREŞTI SECTORUL 5",B,1087,4,5,0,9,15,5,0,20,30,5,0,35,44,5,0,49,45,6,0,51
179187,999,"ȘCOALA GIMNAZIALĂ NR.126","BUCUREŞTI SECTORUL 5",B,1298,5,4,0,9,10,4,0,14,32,5,0,37,45,5,0,50,53,6,0,59
179187,1000,"ȘCOALA GIMNAZIALĂ ”MIRCEA SÂNTIMBREANU”","BUCUREŞTI SECTORUL 5",B,1013,6,0,0,6,30,2,0,32,38,2,0,40,43,2,0,45,61,2,0,63
179187,1001,"ȘCOALA GIMNAZIALĂ ”MIRCEA SÂNTIMBREANU”","BUCUREŞTI SECTORUL 5",B,997,5,0,0,5,12,0,0,12,19,0,0,19,27,5,0,32,33,5,0,38
179187,1002,"ȘCOALA GIMNAZIALĂ ”MIRCEA SÂNTIMBREANU”","BUCUREŞTI SECTORUL 5",B,923,5,0,0,5,34,0,0,34,43,0,0,43,68,0,0,68,71,0,0,71
179187,1003,"ȘCOALA GIMNAZIALĂ ”MIRCEA SÂNTIMBREANU”","BUCUREŞTI SECTORUL 5",B,989,15,0,0,15,40,4,0,44,51,5,0,56,68,5,0,73,74,5,0,79
179187,1004,"ȘCOALA GIMNAZIALĂ ”MIRCEA SÂNTIMBREANU”","BUCUREŞTI SECTORUL 5",B,1005,8,0,0,8,25,0,0,25,38,0,0,38,51,0,0,51,60,1,0,61
179187,1005,"GRĂDINIȚA NR.35","BUCUREŞTI SECTORUL 5",B,1175,6,1,0,7,31,2,0,33,44,3,0,47,57,9,0,66,70,10,0,80
179187,1006,"GRĂDINIȚA NR.35","BUCUREŞTI SECTORUL 5",B,1187,16,1,0,17,36,1,0,37,55,1,0,56,70,5,0,75,70,5,0,75
179187,1007,"GRĂDINIȚA NR.35","BUCUREŞTI SECTORUL 5",B,989,7,0,0,7,27,2,0,29,29,2,0,31,37,3,0,40,38,3,0,41
179187,1008,"GRĂDINIȚA NR.35","BUCUREŞTI SECTORUL 5",B,1037,8,0,0,8,26,3,0,29,36,3,0,39,53,5,0,58,62,5,0,67
179187,1009,"GRĂDINIȚA NR.35","BUCUREŞTI SECTORUL 5",B,1099,14,0,0,14,33,1,0,34,49,2,0,51,69,3,0,72,72,3,0,75
179187,1010,"GRĂDINIȚA NR.35","BUCUREŞTI SECTORUL 5",B,1083,7,0,0,7,12,0,0,12,22,0,0,22,40,0,0,40,45,0,0,45
179187,1011,"GRĂDINIȚA NR.35","BUCUREŞTI SECTORUL 5",B,1183,5,0,0,5,32,1,0,33,54,1,0,55,69,3,0,72,80,3,0,83
179187,1012,"GRĂDINIȚA ”FLOAREA-SOARELUI”","BUCUREŞTI SECTORUL 5",B,1184,4,1,0,5,24,2,0,26,36,5,0,41,45,5,0,50,53,6,0,59
179187,1013,"GRĂDINIȚA ”FLOAREA-SOARELUI”","BUCUREŞTI SECTORUL 5",B,1083,7,0,0,7,14,0,0,14,27,0,0,27,29,0,0,29,36,0,0,36
179187,1014,"ȘCOALA GIMNAZIALĂ NR.144","BUCUREŞTI SECTORUL 5",B,1872,17,8,0,25,42,11,0,53,53,15,0,68,83,18,0,101,98,18,0,116
179187,1015,"ȘCOALA GIMNAZIALĂ NR.144","BUCUREŞTI SECTORUL 5",B,1563,13,0,0,13,36,0,0,36,64,0,0,64,79,0,0,79,86,1,0,87
179187,1016,"ȘCOALA GIMNAZIALĂ NR.144","BUCUREŞTI SECTORUL 5",B,1524,8,1,0,9,29,1,0,30,48,1,0,49,62,1,0,63,67,1,0,68
179187,1017,"ȘCOALA GIMNAZIALĂ NR.143","BUCUREŞTI SECTORUL 5",B,1081,4,0,0,4,26,0,0,26,40,0,0,40,51,2,0,53,52,2,0,54
179187,1018,"ȘCOALA GIMNAZIALĂ NR.143","BUCUREŞTI SECTORUL 5",B,1219,7,1,0,8,14,6,0,20,25,9,0,34,39,10,0,49,45,10,0,55
179187,1019,"ȘCOALA GIMNAZIALĂ NR.143","BUCUREŞTI SECTORUL 5",B,1141,8,7,0,15,23,8,0,31,34,13,0,47,46,15,0,61,54,15,0,69
179187,1020,"ȘCOALA GIMNAZIALĂ NR.143","BUCUREŞTI SECTORUL 5",B,1160,11,0,0,11,22,0,0,22,43,0,0,43,59,0,0,59,72,0,0,72
179187,1021,"ȘCOALA GIMNAZIALĂ NR.143","BUCUREŞTI SECTORUL 5",B,1021,7,1,0,8,33,2,0,35,45,3,0,48,61,4,0,65,64,6,0,70
179187,1022,"ȘCOALA GIMNAZIALĂ NR.143","BUCUREŞTI SECTORUL 5",B,1283,7,0,0,7,17,0,0,17,38,0,0,38,57,3,0,60,69,3,0,72
179187,1023,"ȘCOALA GIMNAZIALĂ NR.143","BUCUREŞTI SECTORUL 5",B,1092,8,0,0,8,26,0,0,26,47,0,0,47,70,1,0,71,74,1,0,75
179187,1024,"ȘCOALA GIMNAZIALĂ NR.143","BUCUREŞTI SECTORUL 5",B,1109,5,0,0,5,30,0,0,30,53,1,0,54,76,3,0,79,81,3,0,84
179187,1025,"ȘCOALA GIMNAZIALĂ NR.143","BUCUREŞTI SECTORUL 5",B,1285,7,0,0,7,20,1,0,21,29,3,0,32,46,3,0,49,53,3,0,56
179187,1026,"ȘCOALA GIMNAZIALĂ NR.143","BUCUREŞTI SECTORUL 5",B,1146,8,0,0,8,17,1,0,18,32,1,0,33,48,1,0,49,53,1,0,54
179187,1027,"ȘCOALA GIMNAZIALĂ NR.143","BUCUREŞTI SECTORUL 5",B,1196,5,0,0,5,20,0,0,20,40,0,0,40,47,0,0,47,58,0,0,58
179187,1028,"ȘCOALA GIMNAZIALĂ NR.143","BUCUREŞTI SECTORUL 5",B,967,2,3,0,5,13,3,0,16,24,3,0,27,29,3,0,32,31,3,0,34
179187,1029,"ȘCOALA GIMNAZIALĂ NR.143","BUCUREŞTI SECTORUL 5",B,1157,4,0,0,4,21,1,0,22,25,1,0,26,33,3,0,36,38,4,0,42
179187,1030,"ȘCOALA GIMNAZIALĂ NR.143","BUCUREŞTI SECTORUL 5",B,1036,15,0,0,15,33,2,0,35,43,2,0,45,58,5,0,63,76,5,0,81
179196,1031,"SERVICIUL STARE CIVILĂ SECTOR 6","BUCUREŞTI SECTORUL 6",B,1138,5,4,0,9,24,6,0,30,43,6,0,49,55,6,0,61,62,6,0,68
179196,1032,"SERVICIUL STARE CIVILĂ SECTOR 6","BUCUREŞTI SECTORUL 6",B,1242,17,0,0,17,39,2,0,41,51,8,0,59,76,10,0,86,87,13,0,100
179196,1033,"ŞCOALA GIMNAZIALĂ NR.311","BUCUREŞTI SECTORUL 6",B,1548,14,5,0,19,50,13,0,63,68,21,0,89,82,27,0,109,89,28,0,117
179196,1034,"ŞCOALA GIMNAZIALĂ NR.311","BUCUREŞTI SECTORUL 6",B,1411,14,3,0,17,37,4,0,41,65,6,0,71,87,9,0,96,96,11,0,107
179196,1035,"ŞCOALA GIMNAZIALĂ NR.311","BUCUREŞTI SECTORUL 6",B,1516,24,1,0,25,72,2,0,74,103,2,0,105,124,6,0,130,137,6,0,143
179196,1036,"ŞCOALA GIMNAZIALĂ NR.311","BUCUREŞTI SECTORUL 6",B,1531,17,1,0,18,69,4,0,73,97,6,0,103,125,6,0,131,138,6,0,144
179196,1037,"ŞCOALA GIMNAZIALĂ NR.311","BUCUREŞTI SECTORUL 6",B,1278,4,1,0,5,35,1,0,36,55,3,0,58,71,3,0,74,81,3,0,84
179196,1038,"ŞCOALA GIMNAZIALĂ NR.311","BUCUREŞTI SECTORUL 6",B,1172,11,6,0,17,35,8,0,43,59,11,0,70,85,12,0,97,90,12,0,102
179196,1039,"ŞCOALA GIMNAZIALĂ NR.59","BUCUREŞTI SECTORUL 6",B,964,14,0,0,14,52,2,0,54,73,2,0,75,90,6,0,96,105,6,0,111
179196,1040,"ŞCOALA GIMNAZIALĂ NR.59","BUCUREŞTI SECTORUL 6",B,1233,19,0,2,21,48,0,5,53,77,9,0,86,102,9,0,111,110,9,0,119
179196,1041,"ŞCOALA GIMNAZIALĂ NR.59","BUCUREŞTI SECTORUL 6",B,1247,25,2,0,27,49,3,0,52,74,5,0,79,99,9,0,108,105,13,0,118
179196,1042,"ŞCOALA GIMNAZIALĂ NR.59","BUCUREŞTI SECTORUL 6",B,1481,17,1,0,18,43,1,0,44,72,1,0,73,105,2,0,107,110,4,0,114
179196,1043,"ŞCOALA GIMNAZIALĂ NR.59","BUCUREŞTI SECTORUL 6",B,1217,16,0,0,16,52,0,0,52,79,0,0,79,93,0,0,93,103,0,0,103
179196,1044,"ŞCOALA GIMNAZIALĂ NR.59","BUCUREŞTI SECTORUL 6",B,1295,8,0,0,8,19,1,0,20,48,2,0,50,83,7,0,90,93,7,0,100
179196,1045,"ŞCOALA GIMNAZIALĂ ""ADRIAN PĂUNESCU""","BUCUREŞTI SECTORUL 6",B,1254,20,1,0,21,56,2,0,58,82,6,0,88,106,7,0,113,124,7,0,131
179196,1046,"ŞCOALA GIMNAZIALĂ ""ADRIAN PĂUNESCU""","BUCUREŞTI SECTORUL 6",B,1375,22,4,0,26,60,8,0,68,84,11,0,95,109,17,0,126,112,19,0,131
179196,1047,"ŞCOALA GIMNAZIALĂ ""ADRIAN PĂUNESCU""","BUCUREŞTI SECTORUL 6",B,837,3,2,0,5,27,13,0,40,37,15,0,52,50,20,0,70,56,22,0,78
179196,1048,"ŞCOALA GIMNAZIALĂ ""ADRIAN PĂUNESCU""","BUCUREŞTI SECTORUL 6",B,1349,18,0,0,18,63,0,0,63,88,1,0,89,111,3,0,114,119,3,0,122
179196,1049,"ŞCOALA GIMNAZIALĂ ""ADRIAN PĂUNESCU""","BUCUREŞTI SECTORUL 6",B,1356,16,1,0,17,63,1,0,64,93,1,0,94,119,4,0,123,132,4,0,136
179196,1050,"ŞCOALA GIMNAZIALĂ ""ADRIAN PĂUNESCU""","BUCUREŞTI SECTORUL 6",B,1268,7,1,0,8,36,1,0,37,48,1,0,49,66,1,0,67,73,1,0,74
179196,1051,"ŞCOALA GIMNAZIALĂ NR.197","BUCUREŞTI SECTORUL 6",B,1557,15,0,0,15,61,2,0,63,98,2,0,100,138,4,0,142,143,5,0,148
179196,1052,"ŞCOALA GIMNAZIALĂ NR.197","BUCUREŞTI SECTORUL 6",B,1072,14,2,0,16,50,4,0,54,68,4,0,72,81,5,0,86,88,6,0,94
179196,1053,"ŞCOALA GIMNAZIALĂ NR.197","BUCUREŞTI SECTORUL 6",B,998,12,3,0,15,46,7,0,53,72,9,0,81,95,21,0,116,104,22,0,126
179196,1054,"ŞCOALA GIMNAZIALĂ NR.197","BUCUREŞTI SECTORUL 6",B,1364,19,3,0,22,75,4,0,79,118,4,0,122,147,4,0,151,153,4,0,157
179196,1055,"ŞCOALA GIMNAZIALĂ NR.197","BUCUREŞTI SECTORUL 6",B,1135,12,2,0,14,41,3,1,45,63,3,1,67,80,5,1,86,86,5,1,92
179196,1056,"ŞCOALA GIMNAZIALĂ NR.197","BUCUREŞTI SECTORUL 6",B,1071,8,0,0,8,53,0,0,53,85,0,0,85,108,1,0,109,111,4,0,115
179196,1057,"ŞCOALA GIMNAZIALĂ NR.197","BUCUREŞTI SECTORUL 6",B,938,8,0,0,8,34,1,0,35,52,2,0,54,67,3,0,70,73,5,0,78
179196,1058,"A.D.P.D.U. SECTOR 6","BUCUREŞTI SECTORUL 6",B,1208,19,4,0,23,69,4,0,73,95,6,0,101,130,7,0,137,141,8,0,149
179196,1059,"ŞCOALA GIMNAZIALĂ NR.193","BUCUREŞTI SECTORUL 6",B,1079,13,2,0,15,52,5,0,57,63,11,0,74,77,13,0,90,89,13,0,102
179196,1060,"ŞCOALA GIMNAZIALĂ NR.193","BUCUREŞTI SECTORUL 6",B,1107,11,0,0,11,45,4,0,49,60,5,0,65,72,5,0,77,81,7,0,88
179196,1061,"ŞCOALA GIMNAZIALĂ NR.193","BUCUREŞTI SECTORUL 6",B,984,8,2,0,10,37,5,0,42,58,11,0,69,75,16,0,91,76,18,0,94
179196,1062,"ŞCOALA GIMNAZIALĂ NR.193","BUCUREŞTI SECTORUL 6",B,1221,5,4,0,9,49,5,0,54,75,6,0,81,105,6,0,111,113,6,0,119
179196,1063,"COLEGIUL NAŢIONAL ""GRIGORE MOISIL""","BUCUREŞTI SECTORUL 6",B,1257,17,2,0,19,47,5,0,52,85,11,0,96,107,18,0,125,113,18,0,131
179196,1064,"COLEGIUL NAŢIONAL ""GRIGORE MOISIL""","BUCUREŞTI SECTORUL 6",B,1362,16,1,0,17,57,5,0,62,77,8,0,85,98,10,0,108,106,10,0,116
179196,1065,"COLEGIUL NAŢIONAL ""GRIGORE MOISIL""","BUCUREŞTI SECTORUL 6",B,1227,7,0,0,7,39,1,0,40,57,1,0,58,75,3,0,78,77,3,0,80
179196,1066,"COLEGIUL NAŢIONAL ""GRIGORE MOISIL""","BUCUREŞTI SECTORUL 6",B,1109,10,3,0,13,45,4,0,49,65,5,0,70,95,5,0,100,104,5,0,109
179196,1067,"ŞCOALA GIMNAZIALĂ NR.164","BUCUREŞTI SECTORUL 6",B,1045,12,4,0,16,53,10,1,64,71,20,1,92,90,25,1,116,94,27,1,122
179196,1068,"ŞCOALA GIMNAZIALĂ NR.164","BUCUREŞTI SECTORUL 6",B,1140,21,5,0,26,64,6,1,71,93,8,1,102,109,9,1,119,113,9,1,123
179196,1069,"ŞCOALA GIMNAZIALĂ NR.164","BUCUREŞTI SECTORUL 6",B,1018,7,0,0,7,48,0,0,48,69,1,0,70,86,4,0,90,93,6,0,99
179196,1070,"COLEGIUL TEHNIC ""GHEORGHE ASACHI""","BUCUREŞTI SECTORUL 6",B,1399,26,1,0,27,28,2,0,30,36,6,0,42,95,10,0,105,107,10,0,117
179196,1071,"COLEGIUL TEHNIC ""GHEORGHE ASACHI""","BUCUREŞTI SECTORUL 6",B,1159,4,1,0,5,28,7,0,35,64,9,0,73,76,10,0,86,87,11,0,98
179196,1072,"COLEGIUL TEHNIC ""GHEORGHE ASACHI""","BUCUREŞTI SECTORUL 6",B,1113,10,0,14,24,61,1,14,76,76,1,14,91,89,1,14,104,92,1,14,107
179196,1073,"COLEGIUL TEHNIC ""GHEORGHE ASACHI""","BUCUREŞTI SECTORUL 6",B,1195,21,0,0,21,66,0,0,66,89,0,0,89,103,0,0,103,116,0,0,116
179196,1074,"LICEUL TEHNOLOGIC ""ANTIM IVIREANU""","BUCUREŞTI SECTORUL 6",B,1235,17,6,0,23,64,13,0,77,83,15,0,98,88,19,0,107,96,22,0,118
179196,1075,"LICEUL TEHNOLOGIC ""ANTIM IVIREANU""","BUCUREŞTI SECTORUL 6",B,1112,15,0,0,15,43,4,0,47,69,10,0,79,84,11,0,95,89,11,0,100
179196,1076,"LICEUL TEHNOLOGIC ""ANTIM IVIREANU""","BUCUREŞTI SECTORUL 6",B,1186,13,3,0,16,67,3,0,70,92,5,0,97,115,5,0,120,127,5,0,132
179196,1077,"LICEUL TEHNOLOGIC ""ANTIM IVIREANU""","BUCUREŞTI SECTORUL 6",B,1196,13,0,0,13,35,3,0,38,51,3,0,54,67,3,0,70,77,3,0,80
179196,1078,"LICEUL TEHNOLOGIC ""ANTIM IVIREANU""","BUCUREŞTI SECTORUL 6",B,1044,19,1,0,20,38,2,0,40,56,5,0,61,76,5,0,81,80,5,0,85
179196,1079,"LICEUL TEHNOLOGIC ""ANTIM IVIREANU""","BUCUREŞTI SECTORUL 6",B,1205,12,3,0,15,38,4,0,42,58,4,0,62,76,6,0,82,83,7,0,90
179196,1080,"LICEUL TEHNOLOGIC ""ANTIM IVIREANU""","BUCUREŞTI SECTORUL 6",B,1531,14,2,0,16,45,2,0,47,68,2,0,70,85,2,0,87,98,2,0,100
179196,1081,"ŞCOALA GIMNAZIALĂ NR.169 CORPI","BUCUREŞTI SECTORUL 6",B,1153,16,1,0,17,60,3,0,63,87,5,0,92,102,9,0,111,114,12,0,126
179196,1082,"ŞCOALA GIMNAZIALĂ NR.169 CORPI","BUCUREŞTI SECTORUL 6",B,1134,10,1,0,11,48,6,0,54,65,8,0,73,87,12,0,99,97,13,0,110
179196,1083,"ŞCOALA GIMNAZIALĂ NR.169 CORPI","BUCUREŞTI SECTORUL 6",B,1315,6,0,0,6,50,0,0,50,75,0,0,75,97,0,0,97,104,2,0,106
179196,1084,"ŞCOALA GIMNAZIALĂ NR.169 CORPI","BUCUREŞTI SECTORUL 6",B,1311,2,0,0,2,31,2,0,33,61,2,0,63,79,4,0,83,90,4,0,94
179196,1085,"ŞCOALA GIMNAZIALĂ NR.169 CORPI","BUCUREŞTI SECTORUL 6",B,1273,13,0,0,13,52,0,0,52,77,0,0,77,96,0,0,96,101,6,0,107
179196,1086,"ŞCOALA GIMNAZIALĂ NR.169 CORPII","BUCUREŞTI SECTORUL 6",B,1424,21,0,0,21,57,0,0,57,99,1,0,100,124,7,0,131,138,10,0,148
179196,1087,"ŞCOALA GIMNAZIALĂ NR.169 CORPII","BUCUREŞTI SECTORUL 6",B,1262,21,0,0,21,68,3,0,71,90,3,0,93,107,3,0,110,113,5,0,118
179196,1088,"ŞCOALA GIMNAZIALĂ NR.169 CORPII","BUCUREŞTI SECTORUL 6",B,1198,13,0,0,13,33,1,0,34,42,1,0,43,54,3,0,57,57,3,0,60
179196,1089,"ŞCOALA GIMNAZIALĂ NR.169 CORPII","BUCUREŞTI SECTORUL 6",B,1175,17,5,0,22,56,6,0,62,74,6,0,80,94,6,0,100,98,6,0,104
179196,1090,"COLEGIUL NAŢIONAL ""ELENA CUZA""","BUCUREŞTI SECTORUL 6",B,1241,13,0,0,13,61,9,0,70,86,14,0,100,107,18,0,125,112,21,0,133
179196,1091,"COLEGIUL NAŢIONAL ""ELENA CUZA""","BUCUREŞTI SECTORUL 6",B,1064,15,0,0,15,57,0,0,57,77,0,0,77,102,2,0,104,112,3,0,115
179196,1092,"COLEGIUL NAŢIONAL ""ELENA CUZA""","BUCUREŞTI SECTORUL 6",B,1153,19,0,0,19,55,0,0,55,78,1,0,79,89,1,0,90,93,1,0,94
179196,1093,"COLEGIUL NAŢIONAL ""ELENA CUZA""","BUCUREŞTI SECTORUL 6",B,957,11,0,0,11,47,0,0,47,64,0,0,64,83,0,0,83,85,0,0,85
179196,1094,"LICEUL TEORETIC ""EUGEN LOVINESCU""","BUCUREŞTI SECTORUL 6",B,1451,13,1,0,14,50,6,0,56,77,9,0,86,103,14,0,117,126,18,0,144
179196,1095,"LICEUL TEORETIC ""EUGEN LOVINESCU""","BUCUREŞTI SECTORUL 6",B,1282,14,2,0,16,53,3,0,56,84,5,0,89,106,5,0,111,115,5,0,120
179196,1096,"LICEUL TEORETIC ""EUGEN LOVINESCU""","BUCUREŞTI SECTORUL 6",B,1574,15,1,0,16,57,2,0,59,100,4,0,104,130,4,0,134,145,6,0,151
179196,1097,"LICEUL TEORETIC ""EUGEN LOVINESCU""","BUCUREŞTI SECTORUL 6",B,1482,19,0,0,19,81,0,0,81,86,0,0,86,104,0,0,104,120,0,0,120
179196,1098,"LICEUL TEORETIC ""EUGEN LOVINESCU""","BUCUREŞTI SECTORUL 6",B,1406,30,2,0,32,64,3,0,67,90,4,0,94,127,4,0,131,133,4,0,137
179196,1099,"LICEUL TEORETIC ""EUGEN LOVINESCU""","BUCUREŞTI SECTORUL 6",B,1240,9,0,0,9,45,5,0,50,66,7,0,73,84,8,0,92,93,10,0,103
179196,1100,"LICEUL TEORETIC ""EUGEN LOVINESCU""","BUCUREŞTI SECTORUL 6",B,1185,5,0,0,5,45,0,0,45,69,1,0,70,86,1,0,87,91,1,0,92
179196,1101,"LICEUL TEORETIC ""EUGEN LOVINESCU""","BUCUREŞTI SECTORUL 6",B,1254,10,0,0,10,46,3,0,49,71,3,0,74,83,3,0,86,96,3,0,99
179196,1102,"LICEUL TEORETIC ""EUGEN LOVINESCU""","BUCUREŞTI SECTORUL 6",B,867,6,1,0,7,38,1,0,39,52,1,0,53,61,1,0,62,65,1,0,66
179196,1103,"ŞCOALA GIMNAZIALĂ NR.279","BUCUREŞTI SECTORUL 6",B,1467,15,3,0,18,38,5,0,43,47,5,0,52,78,10,0,88,80,12,0,92
179196,1104,"ŞCOALA GIMNAZIALĂ NR.279","BUCUREŞTI SECTORUL 6",B,1564,15,0,0,15,49,4,0,53,78,7,0,85,99,9,0,108,110,12,0,122
179196,1105,"ŞCOALA GIMNAZIALĂ NR.279","BUCUREŞTI SECTORUL 6",B,1797,12,1,0,13,41,2,0,43,70,4,0,74,95,5,0,100,100,5,0,105
179196,1106,"ŞCOALA GIMNAZIALĂ NR.279","BUCUREŞTI SECTORUL 6",B,1585,21,0,0,21,57,2,0,59,84,2,0,86,116,2,0,118,129,2,0,131
179196,1107,"ŞCOALA GIMNAZIALĂ NR.279","BUCUREŞTI SECTORUL 6",B,1430,15,0,0,15,54,5,0,59,80,5,0,85,116,7,0,123,125,7,0,132
179196,1108,"ŞCOALA GIMNAZIALĂ SPECIALĂ ""CONSTANTIN PĂUNESCU""","BUCUREŞTI SECTORUL 6",B,1746,17,0,0,17,62,4,0,66,88,5,0,93,119,9,0,128,137,10,0,147
179196,1109,"ŞCOALA GIMNAZIALĂ SPECIALĂ ""CONSTANTIN PĂUNESCU""","BUCUREŞTI SECTORUL 6",B,1538,8,1,0,9,60,1,0,61,85,1,0,86,116,3,0,119,129,3,0,132
179196,1110,"ŞCOALA GIMNAZIALĂ SPECIALĂ PENTRU DEFICIENŢI DE AUZ ""SF. MARIA""","BUCUREŞTI SECTORUL 6",B,1940,12,0,0,12,62,1,0,63,90,9,0,99,116,12,0,128,122,12,0,134
179196,1111,"ŞCOALA GIMNAZIALĂ SPECIALĂ PENTRU DEFICIENŢI DE AUZ ""SF. MARIA""","BUCUREŞTI SECTORUL 6",B,2046,12,0,0,12,46,1,0,47,75,2,0,77,106,3,0,109,118,6,0,124
179196,1112,"ŞCOALA GIMNAZIALĂ SPECIALĂ PENTRU DEFICIENŢI DE AUZ ""SF. MARIA""","BUCUREŞTI SECTORUL 6",B,1720,16,1,0,17,52,2,0,54,81,2,0,83,103,3,0,106,111,3,0,114
179196,1113,"ŞCOALA GIMNAZIALĂ ""SF. ANDREI""","BUCUREŞTI SECTORUL 6",B,1335,11,0,0,11,43,7,0,50,61,7,0,68,78,8,0,86,89,10,0,99
179196,1114,"ŞCOALA GIMNAZIALĂ ""SF. ANDREI""","BUCUREŞTI SECTORUL 6",B,1601,18,3,0,21,59,9,0,68,88,12,0,100,106,13,0,119,116,21,0,137
179196,1115,"ŞCOALA GIMNAZIALĂ ""SF. ANDREI""","BUCUREŞTI SECTORUL 6",B,1405,29,0,0,29,71,0,0,71,106,0,0,106,150,0,0,150,150,0,0,150
179196,1116,"ŞCOALA GIMNAZIALĂ ""SF. ANDREI""","BUCUREŞTI SECTORUL 6",B,1583,22,3,0,25,67,6,0,73,92,7,0,99,115,9,0,124,123,9,0,132
179196,1117,"ŞCOALA GIMNAZIALĂ ""SF. ANDREI""","BUCUREŞTI SECTORUL 6",B,1769,12,0,0,12,44,0,0,44,68,0,1,69,100,0,1,101,110,0,1,111
179196,1118,"ŞCOALA GIMNAZIALĂ ""SF. ANDREI""","BUCUREŞTI SECTORUL 6",B,1439,16,0,0,16,33,0,0,33,59,1,0,60,90,1,0,91,97,1,0,98
179196,1119,"ŞCOALA GIMNAZIALĂ ""SF. ANDREI""","BUCUREŞTI SECTORUL 6",B,1465,18,1,0,19,61,2,0,63,90,3,0,93,128,3,0,131,134,4,0,138
179196,1120,"ŞCOALA GIMNAZIALĂ ""SF. ANDREI""","BUCUREŞTI SECTORUL 6",B,1256,9,0,0,9,39,0,0,39,53,0,0,53,86,0,0,86,90,0,0,90
179196,1121,"ŞCOALA GIMNAZIALĂ ""SF. ANDREI""","BUCUREŞTI SECTORUL 6",B,1864,20,4,0,24,40,4,0,44,75,9,0,84,95,11,0,106,118,14,0,132
179196,1122,"ŞCOALA GIMNAZIALĂ ""SF. ANDREI""","BUCUREŞTI SECTORUL 6",B,1425,6,1,0,7,20,1,0,21,40,2,0,42,57,2,0,59,69,2,0,71
179196,1123,"ŞCOALA GIMNAZIALĂ NR.206","BUCUREŞTI SECTORUL 6",B,1377,10,2,0,12,53,5,0,58,69,14,0,83,88,15,0,103,100,17,0,117
179196,1124,"ŞCOALA GIMNAZIALĂ NR.206","BUCUREŞTI SECTORUL 6",B,1417,13,0,0,13,49,0,0,49,70,0,0,70,89,6,0,95,94,6,0,100
179196,1125,"ŞCOALA GIMNAZIALĂ NR.206","BUCUREŞTI SECTORUL 6",B,1471,11,0,0,11,44,1,0,45,70,1,0,71,92,1,0,93,96,1,0,97
179196,1126,"ŞCOALA GIMNAZIALĂ NR.206","BUCUREŞTI SECTORUL 6",B,1307,7,3,0,10,45,6,0,51,68,8,0,76,94,8,0,102,105,8,0,113
179196,1127,"ŞCOALA GIMNAZIALĂ NR.206","BUCUREŞTI SECTORUL 6",B,1454,11,2,0,13,40,4,3,47,61,5,3,69,81,5,3,89,90,5,3,98
179196,1128,"ŞCOALA GIMNAZIALĂ NR.206","BUCUREŞTI SECTORUL 6",B,1521,18,4,0,22,66,5,0,71,104,5,0,109,127,5,0,132,134,5,0,139
179196,1129,"ŞCOALA GIMNAZIALĂ ""SF. CONSTANTIN ŞI ELENA""","BUCUREŞTI SECTORUL 6",B,1236,8,1,0,9,34,1,0,35,44,1,0,45,61,2,0,63,66,2,0,68
179196,1130,"ŞCOALA GIMNAZIALĂ ""SF. CONSTANTIN ŞI ELENA""","BUCUREŞTI SECTORUL 6",B,1540,15,5,0,20,38,14,0,52,59,20,0,79,87,23,0,110,92,25,0,117
179196,1131,"ŞCOALA GIMNAZIALĂ ""SF. CONSTANTIN ŞI ELENA""","BUCUREŞTI SECTORUL 6",B,1162,14,1,0,15,44,1,0,45,60,3,0,63,73,5,0,78,78,5,0,83
179196,1132,"ŞCOALA GIMNAZIALĂ ""SF. CONSTANTIN ŞI ELENA""","BUCUREŞTI SECTORUL 6",B,1322,5,5,0,10,37,6,0,43,58,6,0,64,65,7,0,72,70,7,0,77
179196,1133,"ŞCOALA GIMNAZIALĂ ""SF. CONSTANTIN ŞI ELENA""","BUCUREŞTI SECTORUL 6",B,1540,10,0,0,10,64,5,0,69,90,5,0,95,115,7,0,122,124,7,0,131
179196,1134,"ŞCOALA GIMNAZIALĂ ""SF. CONSTANTIN ŞI ELENA""","BUCUREŞTI SECTORUL 6",B,977,3,3,0,6,13,3,0,16,22,3,0,25,27,4,0,31,31,4,0,35
179196,1135,"SCOALA GIMNAZIALA SFINTII CONSTANTIN SI ELENA","BUCUREŞTI SECTORUL 6",B,1758,6,0,0,6,38,0,0,38,59,0,0,59,78,2,0,80,86,4,0,90
179196,1136,"SCOALA GIMNAZIALA SFINTII CONSTANTIN SI ELENA","BUCUREŞTI SECTORUL 6",B,1702,7,0,0,7,51,2,0,53,71,2,0,73,89,2,0,91,102,2,0,104
179196,1137,"ŞCOALA GIMNAZIALĂ NR.309","BUCUREŞTI SECTORUL 6",B,1563,14,3,0,17,51,15,0,66,71,26,0,97,95,39,0,134,112,40,0,152
179196,1138,"ŞCOALA GIMNAZIALĂ NR.309","BUCUREŞTI SECTORUL 6",B,1545,17,1,0,18,48,4,0,52,74,4,0,78,105,12,0,117,112,13,0,125
179196,1139,"ŞCOALA GIMNAZIALĂ NR.309","BUCUREŞTI SECTORUL 6",B,1489,14,0,0,14,43,0,0,43,59,0,0,59,90,4,0,94,98,4,0,102
179196,1140,"ŞCOALA GIMNAZIALĂ NR.309","BUCUREŞTI SECTORUL 6",B,1649,16,3,0,19,47,5,0,52,66,5,0,71,77,7,0,84,90,15,0,105
179196,1141,"ŞCOALA GIMNAZIALĂ NR.309","BUCUREŞTI SECTORUL 6",B,1309,10,2,0,12,35,3,0,38,55,4,0,59,67,4,0,71,82,4,0,86
179196,1142,"ŞCOALA GIMNAZIALĂ NR.309","BUCUREŞTI SECTORUL 6",B,1635,15,3,0,18,55,4,0,59,72,4,0,76,91,4,0,95,100,6,0,106
179196,1143,"ŞCOALA GIMNAZIALĂ ""ION DUMITRIU""","BUCUREŞTI SECTORUL 6",B,1270,9,0,0,9,27,4,0,31,49,6,0,55,65,13,0,78,73,13,0,86
179196,1144,"ŞCOALA GIMNAZIALĂ ""ION DUMITRIU""","BUCUREŞTI SECTORUL 6",B,1570,11,0,0,11,37,1,0,38,53,2,0,55,82,6,0,88,86,9,0,95
179196,1145,"ŞCOALA GIMNAZIALĂ ""ION DUMITRIU""","BUCUREŞTI SECTORUL 6",B,1217,9,1,0,10,24,2,0,26,39,5,0,44,53,6,0,59,57,8,0,65
179196,1146,"ŞCOALA GIMNAZIALĂ ""ION DUMITRIU""","BUCUREŞTI SECTORUL 6",B,1698,19,1,0,20,46,5,0,51,64,6,0,70,92,8,0,100,98,8,0,106
179196,1147,"ŞCOALA GIMNAZIALĂ ""ION DUMITRIU""","BUCUREŞTI SECTORUL 6",B,1373,9,1,0,10,31,1,0,32,58,1,0,59,71,3,0,74,78,4,0,82
179196,1148,"ŞCOALA GIMNAZIALĂ ""ION DUMITRIU""","BUCUREŞTI SECTORUL 6",B,1617,17,0,0,17,47,0,0,47,64,3,1,68,79,5,1,85,92,5,1,98
179196,1149,"ŞCOALA GIMNAZIALĂ ""ION DUMITRIU""","BUCUREŞTI SECTORUL 6",B,1340,7,1,0,8,23,1,0,24,33,1,0,34,52,2,0,54,61,3,0,64
179196,1150,"ŞCOALA GIMNAZIALĂ ""ION DUMITRIU""","BUCUREŞTI SECTORUL 6",B,1489,14,2,0,16,45,2,0,47,64,2,0,66,85,2,0,87,91,2,0,93
179196,1151,"ŞCOALA GIMNAZIALĂ ""ION DUMITRIU""","BUCUREŞTI SECTORUL 6",B,1646,9,1,0,10,45,1,0,46,71,3,0,74,99,3,0,102,115,3,0,118
179196,1152,"ŞCOALA GIMNAZIALĂ ""ION DUMITRIU""","BUCUREŞTI SECTORUL 6",B,1611,2,0,0,2,16,0,0,16,23,2,0,25,36,3,0,39,44,3,0,47
179196,1153,"CENTRUL EUROPEAN SECTOR 6","BUCUREŞTI SECTORUL 6",B,1963,17,11,0,28,46,16,0,62,89,19,0,108,128,21,0,149,137,24,0,161
179196,1154,"LICEUL TEHNOLOGIC ""PETRU PONI""","BUCUREŞTI SECTORUL 6",B,1667,11,2,0,13,23,3,0,26,34,10,0,44,48,14,0,62,56,19,0,75
179196,1155,"LICEUL TEHNOLOGIC ""PETRU PONI""","BUCUREŞTI SECTORUL 6",B,2060,12,0,0,12,28,5,0,33,57,7,0,64,81,11,0,92,94,14,0,108
179196,1156,"ŞCOALA GIMNAZIALĂ ""SFÂNTA TREIME""","BUCUREŞTI SECTORUL 6",B,1734,10,0,0,10,26,3,0,29,47,5,0,52,75,14,0,89,82,14,0,96
179196,1157,"ŞCOALA GIMNAZIALĂ ""SFÂNTA TREIME""","BUCUREŞTI SECTORUL 6",B,1871,8,0,0,8,34,0,8,42,56,6,8,70,80,7,8,95,89,7,8,104
179196,1158,"ŞCOALA GIMNAZIALĂ ""SFÂNTA TREIME""","BUCUREŞTI SECTORUL 6",B,1709,19,3,0,22,44,6,0,50,63,6,0,69,84,7,0,91,89,7,0,96
179196,1159,"ŞCOALA GIMNAZIALĂ ""SFÂNTA TREIME""","BUCUREŞTI SECTORUL 6",B,1880,15,5,1,21,38,10,1,49,72,14,1,87,94,20,1,115,94,21,1,116
179196,1160,"ŞCOALA GIMNAZIALĂ ""SFÂNTA TREIME""","BUCUREŞTI SECTORUL 6",B,1566,18,1,0,19,56,1,0,57,70,4,0,74,83,6,0,89,93,6,0,99
179196,1161,"ŞCOALA GIMNAZIALĂ ""SFÂNTA TREIME""","BUCUREŞTI SECTORUL 6",B,1552,13,0,0,13,42,0,0,42,48,0,0,48,58,0,0,58,61,0,0,61
179196,1162,"ŞCOALA GIMNAZIALĂ ""SFÂNTA TREIME""","BUCUREŞTI SECTORUL 6",B,1644,14,0,0,14,54,5,0,59,81,5,3,89,95,8,3,106,110,8,3,121
179196,1163,"ŞCOALA GIMNAZIALĂ NR.198","BUCUREŞTI SECTORUL 6",B,1830,18,2,0,20,38,7,0,45,57,18,0,75,76,20,0,96,83,22,0,105
179196,1164,"ŞCOALA GIMNAZIALĂ NR.198","BUCUREŞTI SECTORUL 6",B,1719,14,1,0,15,46,8,0,54,66,12,0,78,87,18,0,105,94,18,0,112
179196,1165,"ŞCOALA GIMNAZIALĂ NR.198","BUCUREŞTI SECTORUL 6",B,1485,15,0,0,15,52,7,0,59,64,8,0,72,98,12,0,110,107,14,0,121
179196,1166,"ŞCOALA GIMNAZIALĂ NR.198","BUCUREŞTI SECTORUL 6",B,1459,16,0,0,16,56,0,0,56,79,0,0,79,114,0,0,114,122,0,0,122
179196,1167,"ŞCOALA GIMNAZIALĂ NR.198","BUCUREŞTI SECTORUL 6",B,1759,19,1,0,20,48,4,0,52,74,8,0,82,94,8,0,102,100,10,0,110
179196,1168,"ŞCOALA GIMNAZIALĂ NR.198","BUCUREŞTI SECTORUL 6",B,1563,7,1,0,8,34,7,0,41,59,17,0,76,70,22,0,92,84,22,0,106
179196,1169,"ŞCOALA GIMNAZIALĂ ""CONSTANTIN BRÂNCUŞI""","BUCUREŞTI SECTORUL 6",B,1410,5,0,0,5,43,0,0,43,62,0,0,62,80,0,0,80,86,0,0,86
179196,1170,"ŞCOALA GIMNAZIALĂ ""CONSTANTIN BRÂNCUŞI""","BUCUREŞTI SECTORUL 6",B,1379,20,3,0,23,50,5,0,55,69,8,0,77,92,9,0,101,102,10,0,112
179196,1171,"ŞCOALA GIMNAZIALĂ ""CONSTANTIN BRÂNCUŞI""","BUCUREŞTI SECTORUL 6",B,1405,18,0,0,18,56,2,0,58,81,4,0,85,105,6,0,111,107,10,0,117
179196,1172,"ŞCOALA GIMNAZIALĂ ""CONSTANTIN BRÂNCUŞI""","BUCUREŞTI SECTORUL 6",B,1188,11,0,0,11,42,0,0,42,70,1,2,73,89,5,2,96,91,5,2,98
179196,1173,"ŞCOALA GIMNAZIALĂ ""CONSTANTIN BRÂNCUŞI""","BUCUREŞTI SECTORUL 6",B,1508,18,0,0,18,62,3,0,65,74,3,0,77,100,3,0,103,111,4,0,115
179196,1174,"ŞCOALA GIMNAZIALĂ ""CONSTANTIN BRÂNCUŞI""","BUCUREŞTI SECTORUL 6",B,925,12,0,0,12,44,0,0,44,68,1,0,69,84,1,0,85,91,2,0,93
179196,1175,"ŞCOALA GIMNAZIALĂ ""CONSTANTIN BRÂNCUŞI""","BUCUREŞTI SECTORUL 6",B,981,17,0,0,17,49,1,0,50,60,2,0,62,77,2,0,79,82,2,0,84
179196,1176,"ŞCOALA GIMNAZIALĂ ""REGELE MIHAI I""","BUCUREŞTI SECTORUL 6",B,1479,15,5,0,20,41,11,0,52,65,18,0,83,93,25,0,118,106,30,0,136
179196,1177,"ŞCOALA GIMNAZIALĂ ""REGELE MIHAI I""","BUCUREŞTI SECTORUL 6",B,1276,6,1,0,7,25,1,0,26,36,1,0,37,53,3,0,56,56,4,0,60
179196,1178,"ŞCOALA GIMNAZIALĂ ""REGELE MIHAI I""","BUCUREŞTI SECTORUL 6",B,804,1,0,0,1,20,0,0,20,28,2,0,30,36,5,0,41,41,9,0,50
179196,1179,"ŞCOALA GIMNAZIALĂ ""REGELE MIHAI I""","BUCUREŞTI SECTORUL 6",B,1047,8,2,0,10,31,2,0,33,45,2,0,47,71,2,0,73,75,2,0,77
179196,1180,"ŞCOALA GIMNAZIALĂ NR.156","BUCUREŞTI SECTORUL 6",B,1703,8,2,0,10,54,18,0,72,82,24,0,106,95,31,0,126,107,35,0,142
179196,1181,"ŞCOALA GIMNAZIALĂ NR.156","BUCUREŞTI SECTORUL 6",B,1801,21,0,0,21,67,6,0,73,94,9,0,103,117,12,0,129,123,12,0,135
179196,1182,"ŞCOALA GIMNAZIALĂ NR.156","BUCUREŞTI SECTORUL 6",B,1592,17,1,0,18,65,4,0,69,91,7,0,98,119,9,0,128,129,15,0,144
179196,1183,"ŞCOALA GIMNAZIALĂ NR.156","BUCUREŞTI SECTORUL 6",B,1424,8,3,0,11,34,5,0,39,57,7,0,64,79,7,0,86,89,9,0,98
179196,1184,"ŞCOALA GIMNAZIALĂ NR.156","BUCUREŞTI SECTORUL 6",B,1316,13,4,0,17,47,7,0,54,68,7,0,75,84,8,0,92,97,10,0,107
179196,1185,"ŞCOALA GIMNAZIALĂ NR.156","BUCUREŞTI SECTORUL 6",B,1390,16,4,0,20,68,12,0,80,97,15,0,112,116,16,0,132,123,16,0,139
179196,1186,"ŞCOALA GIMNAZIALĂ NR.156","BUCUREŞTI SECTORUL 6",B,1813,8,6,0,14,53,8,0,61,77,8,0,85,102,8,0,110,108,8,0,116
179196,1187,"ŞCOALA GIMNAZIALĂ NR.156","BUCUREŞTI SECTORUL 6",B,1518,15,0,0,15,39,0,0,39,65,0,0,65,90,0,0,90,100,0,0,100
179196,1188,"ŞCOALA GIMNAZIALĂ NR.156","BUCUREŞTI SECTORUL 6",B,1477,6,0,0,6,29,1,0,30,46,4,0,50,62,4,0,66,65,4,0,69
179196,1189,"ŞCOALA GIMNAZIALĂ NR.156","BUCUREŞTI SECTORUL 6",B,1861,5,3,0,8,30,6,0,36,48,9,0,57,68,11,0,79,71,11,0,82
179196,1190,"LICEUL TEHNOLOGIC ""COSTIN C. KIRIŢESCU""","BUCUREŞTI SECTORUL 6",B,1196,12,1,0,13,37,2,0,39,53,5,0,58,66,7,0,73,72,7,0,79
179196,1191,"LICEUL TEHNOLOGIC ""COSTIN C. KIRIŢESCU""","BUCUREŞTI SECTORUL 6",B,1443,14,0,0,14,50,2,0,52,71,4,0,75,84,6,0,90,87,6,0,93
179196,1192,"LICEUL TEHNOLOGIC ""COSTIN C. KIRIŢESCU""","BUCUREŞTI SECTORUL 6",B,1320,16,0,0,16,58,9,0,67,73,9,0,82,89,10,0,99,98,11,0,109
179196,1193,"LICEUL TEHNOLOGIC ""COSTIN C. KIRIŢESCU""","BUCUREŞTI SECTORUL 6",B,1362,7,1,0,8,35,3,0,38,51,5,0,56,64,5,0,69,71,5,0,76
179196,1194,"LICEUL TEHNOLOGIC ""COSTIN C. KIRIŢESCU""","BUCUREŞTI SECTORUL 6",B,1472,5,1,0,6,21,2,0,23,38,3,0,41,52,3,0,55,56,3,0,59
179196,1195,"LICEUL TEHNOLOGIC ""COSTIN C. KIRIŢESCU""","BUCUREŞTI SECTORUL 6",B,1091,14,2,1,17,35,3,1,39,63,4,1,68,85,6,1,92,93,6,1,100
179196,1196,"LICEUL TEHNOLOGIC ""COSTIN C. KIRIŢESCU""","BUCUREŞTI SECTORUL 6",B,1220,12,2,0,14,53,2,0,55,76,3,0,79,96,4,0,100,107,4,0,111
179196,1197,"LICEUL TEHNOLOGIC ""COSTIN C. KIRIŢESCU""","BUCUREŞTI SECTORUL 6",B,1127,13,0,0,13,38,0,0,38,57,0,0,57,67,0,0,67,78,0,0,78
179196,1198,"LICEUL TEHNOLOGIC ""COSTIN C. KIRIŢESCU""","BUCUREŞTI SECTORUL 6",B,1666,17,5,0,22,37,6,0,43,63,6,0,69,84,10,0,94,89,10,0,99
179196,1199,"LICEUL TEHNOLOGIC ""COSTIN C. KIRIŢESCU""","BUCUREŞTI SECTORUL 6",B,1799,13,1,0,14,51,1,0,52,73,1,0,74,91,4,0,95,102,4,0,106
179196,1200,"LICEUL TEHNOLOGIC ""COSTIN C. KIRIŢESCU""","BUCUREŞTI SECTORUL 6",B,1848,10,2,0,12,29,2,0,31,52,3,0,55,66,3,0,69,77,4,0,81
179196,1201,"ŞCOALA GIMNAZIALĂ NR.142","BUCUREŞTI SECTORUL 6",B,1213,11,1,0,12,24,7,0,31,38,11,0,49,55,18,0,73,57,27,0,84
179196,1202,"ŞCOALA GIMNAZIALĂ NR.142","BUCUREŞTI SECTORUL 6",B,1406,10,0,0,10,42,4,0,46,64,6,0,70,90,6,0,96,97,7,0,104
179196,1203,"ŞCOALA GIMNAZIALĂ NR.142","BUCUREŞTI SECTORUL 6",B,1601,11,0,0,11,72,1,0,73,88,7,0,95,111,7,0,118,130,8,0,138
179196,1204,"ŞCOALA GIMNAZIALĂ NR.142","BUCUREŞTI SECTORUL 6",B,1569,12,0,0,12,36,1,0,37,61,1,0,62,87,3,0,90,96,4,0,100
179196,1205,"ŞCOALA GIMNAZIALĂ NR.142","BUCUREŞTI SECTORUL 6",B,1319,6,0,0,6,32,3,0,35,47,3,0,50,75,4,0,79,82,6,0,88
179196,1206,"ŞCOALA GIMNAZIALĂ NR.142","BUCUREŞTI SECTORUL 6",B,1779,15,0,0,15,41,1,0,42,60,2,0,62,76,3,0,79,83,7,0,90
179196,1207,"ŞCOALA GIMNAZIALĂ NR.142","BUCUREŞTI SECTORUL 6",B,1525,14,1,0,15,32,3,0,35,52,3,0,55,71,4,0,75,79,4,0,83
179196,1208,"ŞCOALA GIMNAZIALĂ NR.142","BUCUREŞTI SECTORUL 6",B,1352,11,0,0,11,50,0,0,50,70,0,0,70,85,0,0,85,91,1,0,92
179196,1209,"ŞCOALA GIMNAZIALĂ NR.142","BUCUREŞTI SECTORUL 6",B,1443,12,3,0,15,46,4,0,50,72,5,0,77,97,5,0,102,103,5,0,108
179196,1210,"ŞCOALA GIMNAZIALĂ NR.117","BUCUREŞTI SECTORUL 6",B,1857,13,1,0,14,55,3,0,58,80,5,0,85,107,6,0,113,113,6,0,119
179196,1211,"ŞCOALA GIMNAZIALĂ NR.117","BUCUREŞTI SECTORUL 6",B,1519,10,3,0,13,41,7,0,48,63,13,0,76,84,16,0,100,92,17,0,109
179196,1212,"ŞCOALA GIMNAZIALĂ NR.117","BUCUREŞTI SECTORUL 6",B,1548,10,3,0,13,42,8,0,50,63,14,0,77,81,20,0,101,87,20,0,107
179196,1213,"ŞCOALA GIMNAZIALĂ NR.117","BUCUREŞTI SECTORUL 6",B,1750,16,3,0,19,61,10,0,71,92,16,0,108,119,18,0,137,127,19,0,146
179196,1214,"ŞCOALA GIMNAZIALĂ NR.117","BUCUREŞTI SECTORUL 6",B,1634,15,4,0,19,33,8,0,41,55,15,1,71,68,18,1,87,72,18,1,91
179196,1215,"ŞCOALA GIMNAZIALĂ NR.117","BUCUREŞTI SECTORUL 6",B,1303,8,4,0,12,19,4,0,23,37,4,0,41,48,7,0,55,54,8,0,62
179196,1216,"ŞCOALA GIMNAZIALĂ NR.117","BUCUREŞTI SECTORUL 6",B,1165,14,0,0,14,46,3,0,49,69,5,0,74,87,5,0,92,92,5,0,97
179196,1217,"LICEUL TEORETIC ""TUDOR VLADIMIRESCU""","BUCUREŞTI SECTORUL 6",B,1418,22,2,0,24,62,6,0,68,88,18,0,106,116,28,0,144,131,35,0,166
179196,1218,"LICEUL TEORETIC ""TUDOR VLADIMIRESCU""","BUCUREŞTI SECTORUL 6",B,1095,13,0,0,13,27,3,0,30,45,4,0,49,68,7,0,75,76,14,0,90
179196,1219,"LICEUL TEORETIC ""TUDOR VLADIMIRESCU""","BUCUREŞTI SECTORUL 6",B,1428,11,3,0,14,54,5,0,59,71,9,0,80,88,10,0,98,102,13,0,115
179196,1220,"LICEUL TEORETIC ""TUDOR VLADIMIRESCU""","BUCUREŞTI SECTORUL 6",B,957,11,0,0,11,34,1,0,35,58,3,0,61,77,7,0,84,80,9,0,89
179196,1221,"LICEUL TEORETIC ""TUDOR VLADIMIRESCU""","BUCUREŞTI SECTORUL 6",B,1406,12,4,0,16,52,11,0,63,70,17,0,87,86,17,0,103,100,17,0,117
179196,1222,"CLUBUL SPORTIV SCOLAR NR. 5","BUCUREŞTI SECTORUL 6",B,2033,7,0,0,7,57,8,0,65,76,9,0,85,97,9,0,106,106,9,55,170
179196,1223,"COLEGIUL UCECOM ""SPIRU HARET""","BUCUREŞTI SECTORUL 6",B,1769,1,8,0,9,12,19,0,31,24,48,0,72,36,67,0,103,39,74,0,113
179196,1224,"ŞCOALA GIMNAZIALĂ NR.168","BUCUREŞTI SECTORUL 6",B,1905,4,0,0,4,32,0,0,32,50,0,0,50,77,1,19,97,87,1,19,107
179196,1225,"ŞCOALA GIMNAZIALĂ NR.168","BUCUREŞTI SECTORUL 6",B,1617,13,2,0,15,44,7,0,51,58,13,0,71,91,18,0,109,102,23,0,125
179196,1226,"ŞCOALA GIMNAZIALĂ NR.168","BUCUREŞTI SECTORUL 6",B,1278,7,0,0,7,21,2,0,23,36,5,0,41,46,5,0,51,49,8,0,57
179196,1227,"ŞCOALA GIMNAZIALĂ NR.168","BUCUREŞTI SECTORUL 6",B,1360,12,1,0,13,39,1,0,40,57,1,0,58,81,1,0,82,88,1,0,89
179196,1228,"ŞCOALA GIMNAZIALĂ NR.168","BUCUREŞTI SECTORUL 6",B,1511,3,1,0,4,16,3,0,19,33,5,0,38,47,10,0,57,60,10,0,70
179196,1229,"COLEGIUL TEHNIC ""CAROL I""","BUCUREŞTI SECTORUL 6",B,1646,4,3,0,7,19,9,0,28,50,16,0,66,62,21,0,83,76,24,0,100
179196,1230,"COLEGIUL TEHNIC ""CAROL I""","BUCUREŞTI SECTORUL 6",B,1721,5,3,0,8,41,4,0,45,62,4,0,66,79,7,0,86,91,7,0,98
179196,1231,"COLEGIUL TEHNIC ""CAROL I""","BUCUREŞTI SECTORUL 6",B,1824,10,0,0,10,37,1,0,38,55,2,0,57,65,4,0,69,77,4,0,81
179196,1232,"COLEGIUL TEHNIC ""CAROL I""","BUCUREŞTI SECTORUL 6",B,1415,13,0,0,13,40,0,0,40,55,0,0,55,78,0,0,78,89,4,0,93
179196,1233,"COLEGIUL TEHNIC ""CAROL I""","BUCUREŞTI SECTORUL 6",B,1258,8,0,0,8,33,0,0,33,46,0,0,46,65,0,0,65,71,3,0,74
179196,1234,"COLEGIUL TEHNIC ""CAROL I""","BUCUREŞTI SECTORUL 6",B,1202,11,0,0,11,34,0,0,34,49,0,0,49,70,0,0,70,75,0,0,75
179196,1235,"COLEGIUL TEHNIC ""CAROL I""","BUCUREŞTI SECTORUL 6",B,1392,7,0,0,7,41,0,1,42,56,0,1,57,73,0,1,74,83,0,1,84
179196,1236,"COLEGIUL TEHNIC ""CAROL I""","BUCUREŞTI SECTORUL 6",B,1385,19,0,0,19,45,2,0,47,64,2,0,66,72,3,0,75,78,3,0,81
179196,1237,"ŞCOALA GIMNAZIALĂ NR.163","BUCUREŞTI SECTORUL 6",B,1717,16,1,0,17,43,3,0,46,62,4,0,66,89,11,0,100,98,12,0,110
179196,1238,"ŞCOALA GIMNAZIALĂ NR.163","BUCUREŞTI SECTORUL 6",B,1631,11,0,0,11,31,3,0,34,55,4,0,59,65,4,0,69,68,5,0,73
179196,1239,"ŞCOALA GIMNAZIALĂ NR.163","BUCUREŞTI SECTORUL 6",B,1224,9,2,0,11,33,5,0,38,50,8,0,58,68,9,0,77,70,10,0,80
179196,1240,"ŞCOALA GIMNAZIALĂ NR.163","BUCUREŞTI SECTORUL 6",B,1141,5,0,0,5,22,4,0,26,38,4,0,42,52,4,0,56,56,5,0,61
179196,1241,"ŞCOALA GIMNAZIALĂ NR.163","BUCUREŞTI SECTORUL 6",B,1305,14,2,0,16,32,4,0,36,45,4,0,49,60,4,0,64,72,4,0,76
179196,1242,"ŞCOALA GIMNAZIALĂ NR.163","BUCUREŞTI SECTORUL 6",B,1262,11,0,0,11,31,0,0,31,51,1,0,52,66,1,0,67,67,1,0,68
179196,1243,"ŞCOALA GIMNAZIALĂ NR.163","BUCUREŞTI SECTORUL 6",B,1431,13,3,0,16,53,3,0,56,73,3,0,76,94,3,0,97,101,3,0,104
179196,1244,"ŞCOALA GIMNAZIALĂ NR.163","BUCUREŞTI SECTORUL 6",B,1178,7,0,0,7,34,0,0,34,49,0,0,49,60,1,0,61,64,1,0,65
179196,1245,"ŞCOALA GIMNAZIALĂ NR.163","BUCUREŞTI SECTORUL 6",B,1249,9,3,0,12,43,3,0,46,67,3,0,70,78,3,0,81,85,3,0,88
179196,1246,"LICEUL TEORETIC ""MARIN PREDA""","BUCUREŞTI SECTORUL 6",B,1899,13,2,0,15,47,2,0,49,82,3,0,85,111,3,0,114,124,3,0,127
179196,1247,"LICEUL TEORETIC ""MARIN PREDA""","BUCUREŞTI SECTORUL 6",B,1346,16,0,0,16,52,7,0,59,66,8,0,74,87,11,0,98,95,13,0,108
179196,1248,"LICEUL TEORETIC ""MARIN PREDA""","BUCUREŞTI SECTORUL 6",B,1010,11,0,0,11,34,0,0,34,45,1,0,46,73,5,0,78,80,7,0,87
179196,1249,"LICEUL TEORETIC ""MARIN PREDA""","BUCUREŞTI SECTORUL 6",B,1486,16,4,0,20,62,5,0,67,81,6,0,87,107,6,0,113,110,6,0,116
179196,1250,"ŞCOALA GIMNAZIALĂ NR.167","BUCUREŞTI SECTORUL 6",B,1408,4,1,0,5,13,4,0,17,32,10,0,42,45,15,0,60,52,15,0,67
179196,1251,"ŞCOALA GIMNAZIALĂ NR.167","BUCUREŞTI SECTORUL 6",B,1565,8,0,0,8,36,2,0,38,51,3,0,54,74,5,0,79,78,5,0,83
179196,1252,"ŞCOALA GIMNAZIALĂ NR.167","BUCUREŞTI SECTORUL 6",B,1222,11,0,0,11,38,1,1,40,64,7,1,72,93,9,1,103,100,10,1,111
179196,1253,"ŞCOALA GIMNAZIALĂ NR.167","BUCUREŞTI SECTORUL 6",B,1120,4,0,0,4,19,0,0,19,36,0,0,36,45,3,0,48,51,3,0,54
179196,1254,"ŞCOALA GIMNAZIALĂ NR.167","BUCUREŞTI SECTORUL 6",B,1651,16,0,0,16,43,0,0,43,72,5,0,77,81,6,0,87,83,8,0,91
179196,1255,"ŞCOALA GIMNAZIALĂ NR.167","BUCUREŞTI SECTORUL 6",B,1580,8,0,0,8,43,0,0,43,73,0,0,73,106,0,0,106,110,0,0,110
179196,1256,"ŞCOALA GIMNAZIALĂ NR.167","BUCUREŞTI SECTORUL 6",B,1104,12,0,0,12,29,0,0,29,44,0,0,44,53,0,0,53,61,0,0,61
179196,1257,"ŞCOALA GIMNAZIALĂ NR.167","BUCUREŞTI SECTORUL 6",B,1198,11,0,0,11,19,0,0,19,36,0,1,37,55,0,1,56,57,0,1,58
179196,1258,"ŞCOALA GIMNAZIALĂ NR.167","BUCUREŞTI SECTORUL 6",B,1380,18,0,0,18,34,0,0,34,52,0,0,52,76,2,0,78,89,2,0,91
179196,1259,"ŞCOALA GIMNAZIALĂ NR.162","BUCUREŞTI SECTORUL 6",B,1076,9,0,0,9,23,0,0,23,31,0,0,31,39,0,0,39,41,0,0,41
179196,1260,"ŞCOALA GIMNAZIALĂ NR.162","BUCUREŞTI SECTORUL 6",B,1361,19,3,0,22,40,3,0,43,54,3,0,57,66,5,0,71,74,5,0,79
179196,1261,"ŞCOALA GIMNAZIALĂ NR.153","BUCUREŞTI SECTORUL 6",B,1951,12,1,0,13,28,1,0,29,40,1,0,41,53,3,0,56,67,4,0,71
179196,1262,"ŞCOALA GIMNAZIALĂ NR.153","BUCUREŞTI SECTORUL 6",B,1549,13,0,0,13,29,0,0,29,46,1,0,47,59,1,0,60,70,4,0,74
179196,1263,"ŞCOALA GIMNAZIALĂ NR.161","BUCUREŞTI SECTORUL 6",B,1034,4,4,0,8,11,4,0,15,14,4,0,18,19,5,0,24,21,5,0,26
179196,1264,"SCOALA NR. 161","BUCUREŞTI SECTORUL 6",B,1156,8,0,0,8,20,0,0,20,28,0,0,28,36,0,0,36,42,0,0,42
20304,1,"ŞCOALA GIMNAZIALĂ NR. 9",BACĂU,BC,1254,6,0,0,6,24,0,0,24,43,7,0,50,56,7,0,63,61,7,0,68
20304,2,"ŞCOALA GIMNAZIALĂ NR. 9",BACĂU,BC,1108,9,0,0,9,19,3,0,22,40,9,0,49,59,12,0,71,61,12,0,73
20304,3,"ȘCOALA GIMNAZIALĂ ,,GEORGETA MIRCEA CANCICOV”",BACĂU,BC,1559,7,0,0,7,15,1,0,16,25,4,0,29,35,6,0,41,40,6,0,46
20304,4,"ȘCOALA GIMNAZIALĂ ,,GEORGETA MIRCEA CANCICOV”",BACĂU,BC,1552,14,3,0,17,33,3,0,36,50,3,0,53,64,3,0,67,68,3,0,71
20304,5,"DIRECȚIA DE ASISTENTĂ SOCIALĂ",BACĂU,BC,1392,14,4,0,18,30,7,0,37,44,7,0,51,53,8,0,61,57,9,0,66
20304,6,"GRĂDINIȚA CU PROGRAM PRELUNGIT ,,CRAI NOU""",BACĂU,BC,1098,5,1,0,6,21,1,0,22,28,1,0,29,36,4,0,40,39,4,0,43
20304,7,"GRĂDINIȚA CU PROGRAM PRELUNGIT ,,CRAI NOU""",BACĂU,BC,1096,12,0,0,12,30,0,0,30,39,10,0,49,50,11,0,61,53,11,0,64
20304,8,"ȘCOALA GIMNAZIALĂ ,,MIHAIL SADOVEANU""",BACĂU,BC,1430,12,0,0,12,28,0,0,28,41,1,0,42,51,1,0,52,52,3,0,55
20304,9,"ȘCOALA GIMNAZIALĂ ,,MIHAIL SADOVEANU""",BACĂU,BC,1423,5,0,0,5,24,0,0,24,31,0,0,31,43,6,0,49,48,6,0,54
20304,10,"ȘCOALA GIMNAZIALĂ ,,MIHAIL SADOVEANU""",BACĂU,BC,1409,3,1,0,4,18,4,0,22,32,4,0,36,37,5,0,42,41,7,0,48
20304,11,"ȘCOALA GIMNAZIALĂ ,,MIHAIL SADOVEANU""",BACĂU,BC,1421,8,0,0,8,19,3,0,22,25,4,0,29,40,4,0,44,47,6,0,53
20304,12,"ȘCOALA GIMNAZIALĂ ,,GEORGETAMIRCEA CANCICOV,,",BACĂU,BC,1492,16,0,0,16,35,0,0,35,55,5,0,60,70,5,0,75,85,5,0,90
20304,13,"ȘCOALA GIMNAZIALĂ ”GEORGETAMIRCEA CANCICOV”",BACĂU,BC,1477,10,0,0,10,37,4,0,41,61,5,0,66,70,5,0,75,82,6,0,88
20304,14,"GRĂDINIŢA CU PROGRAM NORMAL NR. 4",BACĂU,BC,1206,5,0,0,5,22,0,0,22,32,0,0,32,37,0,0,37,39,0,0,39
20304,15,"GRĂDINIŢA CU PROGRAM NORMAL NR. 4",BACĂU,BC,1225,4,0,0,4,24,5,0,29,32,5,0,37,47,5,1,53,51,8,1,60
20304,16,"ȘCOALA GIMNAZIALĂ ,,MIHAI DRĂGAN,,",BACĂU,BC,1143,7,2,0,9,35,4,0,39,44,6,0,50,66,7,0,73,78,9,0,87
20304,17,"ȘCOALA GIMNAZIALĂ ,,MIHAI DRĂGAN,,",BACĂU,BC,1269,9,0,0,9,37,0,0,37,55,1,0,56,73,1,0,74,75,1,0,76
20304,18,"ȘCOALA GIMNAZIALĂ ,,MIHAI DRĂGAN,,",BACĂU,BC,1984,19,0,0,19,50,0,0,50,68,0,0,68,79,0,0,79,84,0,0,84
20304,19,"GRADINIȚA CU PROGRAM PRELUNGIT ,,RAZA DE SOARE,,",BACĂU,BC,1048,12,4,0,16,35,4,0,39,45,4,0,49,58,4,0,62,60,4,0,64
20304,20,"GRADINIȚA CU PROGRAM PRELUNGIT ,,RAZA DE SOARE,,",BACĂU,BC,1467,21,0,0,21,45,6,0,51,56,6,0,62,73,7,0,80,80,7,0,87
20304,21,"ADMINISTRAȚIA FINANȚELOR PUBLICE BACĂU",BACĂU,BC,1027,10,0,0,10,25,2,0,27,40,4,0,44,46,4,0,50,49,4,0,53
20304,22,"COLEGIUL NAŢIONAL ,,GHEORGHE VRÂNCEANU,,",BACĂU,BC,1426,10,0,0,10,50,0,0,50,69,9,0,78,80,10,0,90,84,10,0,94
20304,23,"COLEGIUL NAŢIONAL ,,GHEORGHE VRÂNCEANU,,",BACĂU,BC,890,10,0,0,10,28,0,0,28,34,2,0,36,46,3,0,49,51,3,0,54
20304,24,"ŞCOALA GIMNAZIALĂ ,,ALEXANDRU IOAN CUZA,,",BACĂU,BC,1256,18,0,0,18,67,1,0,68,94,4,0,98,115,4,0,119,116,6,0,122
20304,25,"COLEGIUL NAŢIONAL ,,FERDIAND I,,",BACĂU,BC,1274,9,0,0,9,21,0,0,21,31,2,0,33,49,3,0,52,70,3,0,73
20304,26,"COLEGIUL NAŢIONAL ,,FERDIAND I,,",BACĂU,BC,981,10,0,0,10,30,0,0,30,36,2,0,38,69,3,0,72,51,3,0,54
20304,27,"COLEGIUL NAŢIONAL ,,FERDIAND I,,",BACĂU,BC,1536,12,0,0,12,51,1,0,52,77,1,0,78,89,1,0,90,94,1,0,95
20304,28,"DIRECŢIA PENTRU AGRICULTURĂ BACĂU",BACĂU,BC,1527,13,0,0,13,26,0,0,26,40,0,0,40,56,0,0,56,63,4,0,67
20304,29,"GRADINITA CU PROGRAM PRELUNGIT NR.29",BACĂU,BC,1252,15,1,0,16,48,2,0,50,58,2,0,60,62,2,0,64,68,3,0,71
20304,30,"GRADINITA CU PROGRAM PRELUNGIT NR.29",BACĂU,BC,1069,5,0,0,5,27,0,0,27,45,0,0,45,55,0,0,55,60,0,0,60
20304,31,"GRADINITA CU PROGRAM PRELUNGIT NR.29",BACĂU,BC,1135,8,0,0,8,37,0,0,37,52,0,0,52,71,5,0,76,73,5,0,78
20304,32,"GRĂDINIŢA CU PROGRAM NORMAL NR.26",BACĂU,BC,1258,14,5,0,19,24,5,0,29,37,8,0,45,52,9,0,61,58,10,0,68
20304,33,"GRĂDINIŢA CU PROGRAM NORMAL NR.26",BACĂU,BC,1620,14,0,0,14,51,0,0,51,84,0,0,84,104,0,0,104,114,1,0,115
20304,34,"ȘCOALA GIMNAZIALĂ ”ION CREANGĂ”",BACĂU,BC,1393,14,1,0,15,32,2,0,34,46,2,0,48,53,4,0,57,59,9,0,68
20304,35,"ȘCOALA GIMNAZIALĂ ”ION CREANGĂ”",BACĂU,BC,1445,11,0,0,11,34,0,0,34,52,0,0,52,61,0,0,61,63,0,0,63
20304,36,"ȘCOALA GIMNAZIALĂ ”ION CREANGĂ”",BACĂU,BC,1277,10,2,0,12,30,2,0,32,38,2,0,40,49,3,0,52,54,3,0,57
20304,37,"COLEGIUL TEHNIC DE COMUNICAȚII ""NICOLAE VASILESCU-KARPEN""",BACĂU,BC,1382,14,1,0,15,48,3,0,51,66,6,0,72,78,9,0,87,89,9,0,98
20304,38,"COLEGIUL TEHNIC DE COMUNICAȚII ""NICOLAE VASILESCU-KARPEN""",BACĂU,BC,1787,20,5,0,25,54,5,0,59,75,5,0,80,96,5,0,101,107,5,0,112
20304,39,"COLEGIUL TEHNIC DE COMUNICAȚII ""NICOLAE VASILESCU-KARPEN""",BACĂU,BC,1955,4,3,0,7,13,3,0,16,27,3,0,30,33,3,0,36,37,3,0,40
20304,40,"COLEGIUL TEHNIC DE COMUNICAȚII ""NICOLAE VASILESCU-KARPEN""",BACĂU,BC,1679,10,0,0,10,47,3,0,50,59,3,0,62,81,3,0,84,84,3,0,87
20304,41,"COLEGIUL TEHNIC ""ANGHEL SALIGNY"" - CORPUL F",BACĂU,BC,1382,10,0,0,10,29,1,0,30,40,3,0,43,55,3,0,58,58,6,0,64
20304,42,"COLEGIUL TEHNIC ""ANGHEL SALIGNY"" - CORPUL F",BACĂU,BC,1313,8,0,0,8,39,3,0,42,53,4,0,57,60,4,0,64,65,7,0,72
20304,43,"COLEGIUL ''MIHAI EMINESCU""",BACĂU,BC,1123,16,3,0,19,48,4,0,52,78,4,34,116,91,5,34,130,95,5,34,134
20304,44,"COLEGIUL ''MIHAI EMINESCU""",BACĂU,BC,1463,14,2,0,16,43,2,0,45,62,2,0,64,76,4,0,80,80,5,0,85
20304,45,"SCOALA GIMNAZIALĂ ”ALEXANDRU CEL BUN”",BACĂU,BC,1296,19,0,0,19,67,2,1,70,90,8,1,99,108,11,1,120,116,11,1,128
20304,46,"GRĂDINIŢA CU PROGRAM PRELUNGIT NR.12",BACĂU,BC,1021,20,0,1,21,57,1,1,59,78,2,1,81,88,2,1,91,92,2,1,95
20304,47,"COLEGIUL NATIONAL ”VASILE ALECSANDRI”",BACĂU,BC,915,7,2,0,9,42,3,0,45,64,3,1,68,81,4,1,86,85,4,1,90
20304,48,"COLEGIUL NATIONAL ”VASILE ALECSANDRI”",BACĂU,BC,883,11,0,0,11,39,1,0,40,55,7,0,62,67,7,0,74,69,7,0,76
20304,49,"COLEGIUL NAȚIONAL DE ARTĂ ”GEORGE APOSTU”",BACĂU,BC,785,8,6,0,14,33,6,0,39,52,6,0,58,62,9,0,71,65,11,0,76
20304,50,"COLEGIUL NAȚIONAL PEDAGOGIC ”ŞTEFAN CEL MARE”",BACĂU,BC,1373,7,2,0,9,44,4,0,48,65,6,0,71,85,9,0,94,89,10,0,99
20304,51,"COLEGIUL NAȚIONAL PEDAGOGIC ”ŞTEFAN CEL MARE”",BACĂU,BC,1462,19,2,0,21,47,2,6,55,67,2,6,75,76,3,6,85,84,3,97,184
20304,52,"ŞCOALA GIMNAZIALĂ ”GEORGE BACOVIA”",BACĂU,BC,1292,15,0,0,15,53,3,0,56,61,3,0,64,74,8,0,82,79,9,0,88
20304,53,"ŞCOALA GIMNAZIALĂ ”GEORGE BACOVIA”",BACĂU,BC,1319,19,1,0,20,61,1,0,62,86,1,0,87,108,1,0,109,114,1,0,115
20304,54,"GRĂDINIŢA CU PROGRAM PRELUNGIT NR.28",BACĂU,BC,1087,21,0,0,21,66,1,1,68,88,1,1,90,99,7,1,107,101,7,1,109
20304,55,"GRĂDINIŢA CU PROGRAM PRELUNGIT NR.28",BACĂU,BC,1219,11,4,0,15,44,4,0,48,62,4,0,66,76,4,0,80,81,4,0,85
20304,56,"GRĂDINIŢA CU PROGRAM PRELUNGIT NR.28",BACĂU,BC,1274,11,0,0,11,30,0,0,30,41,0,0,41,53,0,0,53,53,0,0,53
20304,57,"ŞCOALA GIMNAZIALĂ ”DOMNIȚA MARIA”",BACĂU,BC,1520,16,0,0,16,41,0,0,41,61,0,0,61,77,0,0,77,78,1,0,79
20304,58,"ŞCOALA GIMNAZIALĂ ”DOMNIȚA MARIA”",BACĂU,BC,1280,11,2,0,13,30,2,0,32,37,2,0,39,56,3,0,59,64,3,0,67
20304,59,"ŞCOALA GIMNAZIALĂ ”DOMNIȚA MARIA”",BACĂU,BC,1448,22,0,0,22,55,0,0,55,73,0,0,73,88,5,0,93,96,5,0,101
20304,60,"ŞCOALA GIMNAZIALĂ ”DOMNIȚA MARIA”",BACĂU,BC,1373,12,0,0,12,33,2,0,35,49,6,0,55,66,7,0,73,70,8,0,78
20304,61,"ŞCOALA GIMNAZIALĂ ”DOMNIȚA MARIA”",BACĂU,BC,1555,10,0,0,10,33,1,0,34,63,5,0,68,91,5,0,96,98,5,0,103
20304,62,"ȘCOALA GIMNAZIALĂ ""DR.ALEXANDRU ŞAFRAN""",BACĂU,BC,1561,20,1,0,21,44,5,0,49,56,6,0,62,73,6,1,80,77,6,1,84
20304,63,"ȘCOALA GIMNAZIALĂ ""DR.ALEXANDRU ŞAFRAN""",BACĂU,BC,1778,14,0,0,14,50,1,0,51,71,1,0,72,91,2,0,93,94,2,0,96
20304,64,"GRADINITA CU PROGRAM PRELUNGIT NR.24",BACĂU,BC,1411,22,8,0,30,40,9,0,49,52,10,0,62,70,10,0,80,89,10,0,99
20304,65,"COLEGIUL „GRIGORE ANTIPA”",BACĂU,BC,1431,7,0,0,7,35,0,0,35,48,1,0,49,62,2,0,64,66,2,0,68
20304,66,"COLEGIUL TEHNIC ”DUMITRU MANGERON” (FOST GRUP ȘCOLAR INDUSTRIAL ”LETEA”)",BACĂU,BC,1700,21,0,0,21,45,0,0,45,65,3,0,68,86,6,0,92,91,7,0,98
20304,67,"ŞCOALA GIMNAZIALĂ NR.10",BACĂU,BC,1347,15,2,0,17,64,2,0,66,85,2,0,87,99,2,0,101,104,2,0,106
20304,68,"ȘCOALA GIMNAZIALĂ NR.10",BACĂU,BC,1250,17,2,0,19,52,3,0,55,80,5,1,86,95,11,2,108,101,11,2,114
20304,69,"ȘCOALA GIMNAZIALĂ NR.10",BACĂU,BC,795,14,2,0,16,38,3,0,41,51,3,0,54,62,3,0,65,68,3,0,71
20304,70,"COLEGIUL ,,GRIGORE ANTIPA"" BACAU",BACĂU,BC,1452,10,6,0,16,31,8,0,39,50,9,0,59,67,9,0,76,71,9,0,80
20304,71,"COLEGIUL TEHNIC ”DUMITRU MANGERON”",BACĂU,BC,1635,4,1,0,5,10,5,0,15,30,11,0,41,42,14,0,56,44,14,0,58
20304,72,"COLEGIUL TEHNIC ”DUMITRU MANGERON”",BACĂU,BC,1805,8,0,0,8,30,0,0,30,34,0,0,34,41,0,0,41,43,0,0,43
20304,73,"ŞCOALA PRIMARĂ NR.1",BACĂU,BC,1911,5,0,0,5,17,3,0,20,28,4,0,32,37,4,0,41,45,5,0,50
20304,74,"ŞCOALA PRIMARĂ NR.1",BACĂU,BC,1689,5,5,0,10,15,5,0,20,30,7,0,37,39,7,0,46,39,7,0,46
20304,75,"SCOALA GIMNAZIALĂ ''OCTAVIAN VOICU""",BACĂU,BC,1142,7,3,0,10,24,5,0,29,38,6,0,44,50,7,0,57,53,8,0,61
20304,76,"SCOALA GIMNAZIALĂ ''OCTAVIAN VOICU""",BACĂU,BC,1066,5,0,0,5,24,0,0,24,37,0,0,37,51,1,0,52,54,1,0,55
20304,77,"SCOALA GIMNAZIALĂ ''OCTAVIAN VOICU""",BACĂU,BC,1241,2,0,0,2,12,0,0,12,27,0,0,27,34,0,0,34,37,0,0,37
20304,78,"SCOALA GIMNAZIALĂ ''OCTAVIAN VOICU""",BACĂU,BC,1249,15,4,0,19,31,4,0,35,47,4,0,51,56,4,0,60,58,4,0,62
20304,79,"GRĂDINIŢA CU PROGRAM PRELUNGIT ”DUMBRAVA MINUNATĂ”",BACĂU,BC,1259,16,0,0,16,36,5,0,41,48,6,0,54,72,6,0,78,75,7,0,82
20304,80,"GRĂDINIŢA CU PROGRAM PRELUNGIT ”DUMBRAVA MINUNATĂ”",BACĂU,BC,1146,7,0,0,7,20,0,0,20,29,0,0,29,40,0,0,40,44,0,0,44
20304,81,"GRĂDINIŢA CU PROGRAM PRELUNGIT NR.31",BACĂU,BC,1098,12,0,0,12,32,0,0,32,50,0,0,50,62,2,0,64,71,2,0,73
20304,82,"ŞCOALA GIMNAZIALĂ ”NICOLAE IORGA”",BACĂU,BC,1337,12,1,0,13,31,2,0,33,51,2,0,53,70,4,0,74,76,4,0,80
20304,83,"ŞCOALA GIMNAZIALĂ ”NICOLAE IORGA”",BACĂU,BC,1155,13,0,0,13,23,0,0,23,33,3,0,36,43,3,0,46,45,3,0,48
20304,84,"ŞCOALA GIMNAZIALĂ ”NICOLAE IORGA”",BACĂU,BC,1382,14,2,0,16,25,2,0,27,36,2,0,38,57,4,0,61,69,4,0,73
20304,85,"ŞCOALA GIMNAZIALĂ ”NICOLAE IORGA”",BACĂU,BC,1474,10,0,0,10,29,0,0,29,46,4,0,50,57,4,0,61,64,5,0,69
20304,86,"COLEGIUL TEHNIC ”DUMITRU MANGERON” (FOSTUL GRUP ŞCOLAR IND. LETEA)",BACĂU,BC,1600,14,3,0,17,42,6,0,48,63,6,0,69,77,6,0,83,81,6,0,87
20304,87,"COLEGIUL TEHNIC ”DUMITRU MANGERON” (FOSTUL GRUP ŞCOLAR IND. LETEA)",BACĂU,BC,1724,10,4,0,14,40,5,0,45,52,5,0,57,66,6,0,72,69,8,0,77
20304,88,"GRĂDINIŢA CU PROGRAM PRELUNGIT NR.21 (CORPUL I)",BACĂU,BC,840,12,0,0,12,47,0,0,47,65,1,0,66,77,2,0,79,82,2,0,84
20304,89,"UNIVERSITATEA ”VASILE ALECSANDRI” - CORPUL A",BACĂU,BC,1014,4,0,0,4,29,3,0,32,39,8,0,47,51,11,0,62,55,13,0,68
20304,90,"UNIVERSITATEA ”VASILE ALECSANDRI” - CORPUL A",BACĂU,BC,878,9,0,0,9,31,0,0,31,41,4,0,45,49,5,0,54,51,5,0,56
20304,91,"GRĂDNIŢA CU PROGRAM PRELUNGIT NR.30",BACĂU,BC,1098,14,0,0,14,36,0,0,36,50,0,0,50,63,3,0,66,63,3,0,66
20304,92,"GRĂDNIŢA CU PROGRAM PRELUNGIT NR.30",BACĂU,BC,1004,17,2,0,19,42,3,0,45,59,3,0,62,74,5,0,79,76,5,0,81
20304,93,"ŞCOALA GIMNAZIALĂ ”ION LUCA”",BACĂU,BC,965,9,3,0,12,23,4,0,27,30,4,0,34,37,4,0,41,42,5,0,47
20304,94,"ŞCOALA GIMNAZIALĂ ”ION LUCA”",BACĂU,BC,1406,11,2,0,13,29,2,0,31,48,2,0,50,64,9,0,73,66,9,0,75
20304,95,"ŞCOALA GIMNAZIALĂ ”ION LUCA”",BACĂU,BC,1318,17,4,0,21,30,5,0,35,40,5,0,45,53,5,0,58,56,5,0,61
20304,96,"ŞCOALA GIMNAZIALĂ ”ION LUCA”",BACĂU,BC,1147,11,0,0,11,37,0,0,37,46,0,0,46,64,1,0,65,69,7,0,76
20304,97,"GRĂDINIŢA CU PROGRAM PRELUNGIT NR.27",BACĂU,BC,1286,16,0,0,16,37,2,0,39,47,2,0,49,64,3,0,67,66,3,0,69
20304,98,"GRĂDINIŢA CU PROGRAM PRELUNGIT NR.27",BACĂU,BC,1371,12,4,0,16,46,5,0,51,70,5,0,75,79,5,0,84,83,5,0,88
20304,99,"ŞCOALAGIMNAZIALĂ ”ALECU RUSSO”",BACĂU,BC,1793,14,0,0,14,29,0,0,29,49,3,0,52,64,3,0,67,68,3,0,71
20304,100,"ȘCOALA GIMNAZIALĂ ”ALECU RUSSO”",BACĂU,BC,1691,17,0,0,17,38,7,0,45,59,7,0,66,80,7,0,87,83,7,0,90
20304,101,"ŞCOALA GIMNAZIALĂ ”ALECU RUSSO”",BACĂU,BC,1357,4,4,0,8,21,5,0,26,34,6,0,40,37,6,0,43,38,6,0,44
20304,102,"BAZINUL OLIMPIC BACĂU",BACĂU,BC,1753,11,0,0,11,52,0,0,52,74,0,0,74,87,2,0,89,95,2,0,97
20304,103,"BAZINUL OLIMPIC BACĂU",BACĂU,BC,1832,10,0,0,10,19,2,0,21,23,2,0,25,31,2,0,33,32,2,0,34
20304,104,"UNIVERSITATEA ”GEORGE BACOVIA”",BACĂU,BC,904,13,2,0,15,26,3,0,29,44,4,0,48,54,4,0,58,56,4,0,60
20304,105,"UNIVERSITATEA ,,GEORGE BACOVIA""",BACĂU,BC,1479,6,3,0,9,23,3,0,26,35,4,0,39,40,5,0,45,44,5,0,49
20304,106,"CĂMINUL PENTRU PERSOANE VÂRSTNICE BACĂU",BACĂU,BC,1374,22,13,0,35,63,35,0,98,90,45,0,135,109,50,0,159,119,51,0,170
20304,107,"ŞCOALA GIMNAZIALĂ ”MIRON COSTIN”",BACĂU,BC,1255,16,3,0,19,40,6,0,46,55,7,0,62,67,9,0,76,68,9,0,77
20304,108,"ŞCOALA GIMNAZIALĂ ”MIRON COSTIN”",BACĂU,BC,1413,15,0,0,15,39,0,0,39,53,0,0,53,74,3,0,77,76,3,0,79
20304,109,"ŞCOALA GIMNAZIALĂ ”MIRON COSTIN”",BACĂU,BC,1357,17,2,0,19,52,3,0,55,83,3,0,86,102,3,0,105,107,3,0,110
20304,110,"GRĂDINIŢA CU PROGRAM PRELUNGIT NR.23",BACĂU,BC,1115,11,5,0,16,33,6,0,39,39,6,0,45,51,6,0,57,54,6,0,60
20304,111,"GRĂDINIŢA CU PROGRAM PRELUNGIT NR.23",BACĂU,BC,1289,11,5,0,16,34,5,0,39,54,5,0,59,71,5,0,76,78,5,0,83
20304,112,"GRĂDINIŢA CU PROGRAM PRELUNGIT NR.33",BACĂU,BC,1341,11,0,0,11,45,1,0,46,59,2,0,61,86,5,0,91,95,5,0,100
20304,113,"LICEUL CU PROGRAM SPORTIV",BACĂU,BC,1091,11,0,0,11,49,1,0,50,62,2,0,64,78,6,0,84,82,10,0,92
20304,114,"LICEUL CU PROGRAM SPORTIV",BACĂU,BC,1307,21,4,0,25,59,7,0,66,76,10,0,86,97,11,0,108,100,17,0,117
20304,115,"LICEUL CU PROGRAM SPORTIV",BACĂU,BC,1159,16,0,0,16,44,0,0,44,55,2,0,57,77,2,0,79,85,3,0,88
20304,116,"ŞCOALA GIMNAZIALĂ ”COSTANTIN PLATON”",BACĂU,BC,1495,17,1,0,18,56,5,0,61,81,5,0,86,91,8,1,100,95,8,1,104
20304,117,"ŞCOALA GIMNAZIALĂ ”COSTANTIN PLATON”",BACĂU,BC,1406,30,2,0,32,92,2,0,94,115,3,0,118,133,3,0,136,134,3,0,137
20304,118,"ŞCOALA GIMNAZIALĂ ”COSTANTIN PLATON”",BACĂU,BC,1486,14,4,0,18,33,5,0,38,70,5,0,75,111,7,0,118,121,7,0,128
20304,119,"COLEGIUL ECONOMIC ”ION GHICA”",BACĂU,BC,1111,13,0,0,13,32,4,0,36,50,4,0,54,57,7,0,64,64,9,0,73
20304,120,"COLEGIUL ECONOMIC ”ION GHICA”",BACĂU,BC,1116,7,0,0,7,20,1,0,21,32,1,0,33,41,1,0,42,45,1,0,46
20304,121,"LICEUL TEHNOLOGIC ”PETRU RAREȘ”",BACĂU,BC,1531,17,1,0,18,35,3,0,38,49,4,0,53,68,8,0,76,74,10,0,84
20304,122,"LICEUL TEHNOLOGIC ”PETRU RAREȘ”",BACĂU,BC,1291,19,0,0,19,29,0,0,29,31,1,0,32,50,1,0,51,54,2,0,56
20304,123,"ŞCOALA GIMNAZIALĂ ”NICU ENEA”",BACĂU,BC,1302,5,0,0,5,21,0,0,21,35,0,0,35,43,0,0,43,49,1,0,50
20304,124,"ȘCOALA GIMNAZIALĂ ”NICU ENEA”",BACĂU,BC,1292,9,0,0,9,18,0,0,18,29,0,0,29,43,0,0,43,56,0,0,56
20304,125,"ȘCOALA GIMNAZIALĂ ”NICU ENEA”",BACĂU,BC,1350,9,0,0,9,14,4,0,18,30,5,0,35,43,6,0,49,47,6,0,53
20885,126,"LICEUL SPIRU HARET",MOINEŞTI,BC,940,17,4,0,21,36,8,0,44,43,12,0,55,56,12,0,68,56,14,0,70
20885,127,"LICEUL SPIRU HARET",MOINEŞTI,BC,1060,11,2,0,13,37,4,0,41,50,5,0,55,73,8,0,81,78,8,0,86
20885,128,"SALA DE SPORT A LICEULUI SPIRU HARET",MOINEŞTI,BC,1288,16,1,0,17,39,2,0,41,51,5,0,56,65,6,0,71,73,6,0,79
20885,129,"ŞCOALA ŞTEFAN LUCHIAN",MOINEŞTI,BC,1205,23,0,0,23,50,4,0,54,66,8,0,74,84,8,88,180,85,9,88,182
20885,130,"ŞCOALA ŞTEFAN LUCHIAN",MOINEŞTI,BC,1158,9,1,0,10,24,3,0,27,48,7,0,55,54,7,0,61,54,7,0,61
20885,131,"BIBLIOTECA MUNICIPALA",MOINEŞTI,BC,1283,16,0,0,16,43,3,0,46,58,3,0,61,69,4,0,73,71,5,0,76
20885,132,"ŞCOALA GEORGE ENESCU",MOINEŞTI,BC,1616,17,2,0,19,43,6,0,49,60,6,1,67,86,7,1,94,97,7,1,105
20885,133,"ŞCOALA GEORGE ENESCU",MOINEŞTI,BC,1311,12,0,0,12,28,0,0,28,45,0,0,45,52,0,0,52,53,0,0,53
20885,134,"ŞCOALA GEORGE ENESCU",MOINEŞTI,BC,1220,27,0,0,27,52,1,0,53,68,2,71,141,90,3,71,164,100,3,71,174
20885,135,"CLUBUL ELEVILOR",MOINEŞTI,BC,1363,25,0,0,25,47,0,0,47,57,0,0,57,70,0,0,70,76,0,0,76
20885,136,"ŞCOALA TRISTAN TZARA",MOINEŞTI,BC,1277,20,0,0,20,45,2,0,47,59,2,0,61,73,3,9,85,79,3,22,104
20885,137,"ŞCOALA TRISTAN TZARA",MOINEŞTI,BC,1352,9,0,0,9,30,2,0,32,51,2,0,53,59,2,0,61,66,2,5,73
20885,138,"CLĂDIRE ŞCOALA LUNCA",MOINEŞTI,BC,1149,11,2,0,13,29,2,0,31,40,2,0,42,50,2,0,52,58,4,0,62
20885,139,"ŞCOALA ALEXANDRU SEVER",MOINEŞTI,BC,658,4,0,0,4,17,2,0,19,25,3,0,28,27,3,0,30,27,3,0,30
20885,140,"ŞCOALA ALEXANDRU SEVER",MOINEŞTI,BC,1076,7,0,0,7,25,0,0,25,28,2,0,30,32,2,0,34,33,2,0,35
20885,141,"ŞCOALA ALEXANDRU SEVER HANGANI",MOINEŞTI,BC,1158,2,0,0,2,18,1,0,19,29,1,0,30,31,7,0,38,35,7,0,42
20885,142,"CLĂDIRE ŞCOALA GĂZĂRIE",MOINEŞTI,BC,1030,15,4,0,19,25,6,0,31,42,6,0,48,59,6,0,65,65,6,0,71
20572,143,"COLEGIUL NAŢIONAL ""GRIGORE C.MOISIL""",ONEŞTI,BC,1394,18,0,0,18,56,4,0,60,70,5,0,75,99,6,0,105,105,6,0,111
20572,144,"COLEGIUL NAŢIONAL ""GRIGORE C.MOISIL""",ONEŞTI,BC,1136,4,0,0,4,35,0,0,35,54,3,0,57,69,6,0,75,70,6,0,76
20572,145,"COLEGIUL NAŢIONAL ""GRIGORE C.MOISIL""",ONEŞTI,BC,969,18,6,0,24,57,7,0,64,64,9,0,73,76,10,0,86,79,10,0,89
20572,146,"ȘCOALA GIMNAZIALĂ ""SFÂNTUL VOIEVOD ȘTEFAN CEL MARE"" (FOSTA NR.9)",ONEŞTI,BC,1274,19,4,0,23,67,4,0,71,82,7,0,89,104,10,0,114,105,10,0,115
20572,147,"ȘCOALA GIMNAZIALĂ ""SFÂNTUL VOIEVOD ȘTEFAN CEL MARE""(FOSTA NR.9)",ONEŞTI,BC,1372,16,0,0,16,47,3,0,50,69,3,0,72,91,4,0,95,95,4,0,99
20572,148,"ȘCOALA GIMNAZIALĂ ""EMIL RACOVIȚĂ"" (FOSTA NR.10)",ONEŞTI,BC,1186,15,4,0,19,44,6,0,50,59,7,1,67,64,7,1,72,65,7,1,73
20572,149,"ȘCOALA GIMNAZIALĂ""EMIL RACOVIȚĂ"" (FOSTA NR.10)",ONEŞTI,BC,1310,20,0,0,20,32,0,0,32,46,0,0,46,56,0,0,56,61,0,0,61
20572,150,"ȘCOALA GIMNAZIALĂ""EMIL RACOVIȚĂ"" (FOSTA NR.10)",ONEŞTI,BC,1035,12,2,0,14,34,6,0,40,57,7,0,64,70,7,0,77,74,10,0,84
20572,151,"LICEUL TEHNOLOGIC (FOSTA NR.7)",ONEŞTI,BC,1266,15,8,0,23,30,11,0,41,46,11,0,57,51,12,0,63,51,12,0,63
20572,152,"LICEUL TEHNOLOGIC (FOSTA NR.7)",ONEŞTI,BC,1183,9,0,0,9,28,0,0,28,39,0,0,39,44,0,0,44,49,0,0,49
20572,153,"LICEUL TEHNOLOGIC (FOSTA NR.7)",ONEŞTI,BC,1211,4,4,0,8,29,5,0,34,41,8,0,49,58,9,0,67,59,9,0,68
20572,154,"LICEUL TEHNOLOGIC (FOSTA NR.7)",ONEŞTI,BC,1211,6,7,0,13,22,9,0,31,37,9,0,46,51,10,0,61,52,10,0,62
20572,155,"ŞCOALA GIMNAZIALĂ ""GHIŢĂ MOCANU"" (FOSTĂ NR.5)",ONEŞTI,BC,1202,7,0,0,7,26,1,0,27,42,1,0,43,53,1,0,54,58,2,0,60
20572,156,"ŞCOALA GIMNAZIALĂ ""GHIŢĂ MOCANU"" (FOSTĂ NR.5)",ONEŞTI,BC,837,4,5,0,9,23,6,0,29,29,6,0,35,34,7,0,41,46,9,0,55
20572,157,"ȘCOALA GIMNAZIALĂ ""GHIȚĂ MOCANU"" (FOSTĂ NR.5)",ONEŞTI,BC,1484,25,0,0,25,65,5,0,70,95,8,0,103,120,8,0,128,120,8,0,128
20572,158,"ȘCOALA GIMNAZIALĂ ""GHIȚĂ MOCANU"" (FOSTĂ NR.5)",ONEŞTI,BC,1581,18,5,0,23,53,7,0,60,69,7,0,76,80,8,0,88,83,8,0,91
20572,159,"ȘCOALA GIMNAZIALĂ NR.1",ONEŞTI,BC,1017,19,1,0,20,55,1,0,56,76,1,0,77,85,2,0,87,91,2,0,93
20572,160,"ȘCOALA GIMNAZIALĂ NR.1",ONEŞTI,BC,1362,17,0,0,17,35,3,0,38,54,6,0,60,59,10,0,69,67,14,0,81
20572,161,"ȘCOALA GIMNAZIALĂ NR.1",ONEŞTI,BC,1339,19,0,0,19,41,0,0,41,50,0,0,50,66,1,0,67,75,7,0,82
20572,162,"COLEGIUL SPORTIV ""NADIA COMĂNECI""",ONEŞTI,BC,1080,17,3,0,20,55,4,0,59,73,6,0,79,94,6,0,100,97,6,0,103
20572,163,"COLEGIUL SPORTIV ""NADIA COMĂNECI""",ONEŞTI,BC,1174,8,0,0,8,44,2,0,46,58,2,0,60,73,3,0,76,80,3,0,83
20572,164,"COLEGIUL SPORTIV ""NADIA COMĂNECI""",ONEŞTI,BC,1466,9,0,0,9,39,0,0,39,56,0,0,56,70,7,0,77,73,7,0,80
20572,165,"COLEGIU NAŢIONAL ""DIMITRIE CANTEMIR""",ONEŞTI,BC,1230,7,1,0,8,18,8,0,26,28,8,0,36,40,8,0,48,53,9,0,62
20572,166,"COLEGIU NAŢIONAL ""DIMITRIE CANTEMIR""",ONEŞTI,BC,1439,17,0,0,17,31,0,0,31,48,2,0,50,61,2,0,63,72,2,0,74
20572,167,"COLEGIU NAŢIONAL ""DIMITRIE CANTEMIR""",ONEŞTI,BC,1244,9,0,0,9,26,0,0,26,37,0,0,37,49,0,0,49,56,0,0,56
20572,168,"COLEGIUL TEHNIC ""PETRU PONI""",ONEŞTI,BC,958,6,0,0,6,20,0,0,20,30,0,0,30,37,0,0,37,46,1,0,47
20572,169,"COLEGIUL TEHNIC ""PETRU PONI""",ONEŞTI,BC,935,11,0,0,11,30,2,0,32,33,2,0,35,40,2,0,42,43,4,0,47
20572,170,"ȘCOALA GIMNAZIALĂ ""GEORGE CĂLINESCU"" (FOSTĂ NR.8)",ONEŞTI,BC,1499,11,1,0,12,34,3,0,37,44,5,0,49,52,5,0,57,60,5,0,65
20572,171,"ȘCOALA GIMNAZIALĂ ""GEORGE CĂLINESCU"" (FOSTĂ NR.8)",ONEŞTI,BC,1353,5,2,0,7,26,2,0,28,34,3,0,37,50,3,0,53,54,3,0,57
20572,172,"COLEGIUL TEHNIC ""GHEORGHE ASACHI""",ONEŞTI,BC,1382,9,0,0,9,22,0,0,22,36,0,0,36,42,1,0,43,50,6,0,56
20572,173,"COLEGIUL TEHNIC ""GHEORGHE ASACHI""",ONEŞTI,BC,1258,9,0,0,9,26,0,0,26,33,1,0,34,42,1,0,43,47,1,0,48
20572,174,"LICEUL TEHNOLOGIC (TCR)",ONEŞTI,BC,923,4,0,0,4,11,0,0,11,25,1,0,26,27,3,0,30,36,4,0,40
20572,175,"SERA BORZEŞTI",ONEŞTI,BC,829,1,0,0,1,4,0,0,4,11,0,0,11,14,0,0,14,14,0,0,14
20590,176,"CENTRUL SOCIAL SLOBOZIA",SLOBOZIA,BC,1068,6,0,0,6,7,3,0,10,13,3,0,16,21,4,0,25,38,4,0,42
20572,177,"GRĂDINIŢA ""SFÂNTUL PAUL""",ONEŞTI,BC,1360,13,0,0,13,42,1,0,43,44,1,0,45,54,2,0,56,59,2,0,61
20572,178,"GRĂDINIŢA ""SFÂNTUL PAUL""",ONEŞTI,BC,1313,8,0,0,8,21,2,0,23,31,3,0,34,44,5,0,49,46,7,0,53
20787,179,"PRIMĂRIA ORAŞ BUHUŞI",BUHUŞI,BC,1338,21,6,0,27,52,12,0,64,70,12,0,82,83,12,0,95,87,12,0,99
20787,180,"COLEGIUL TEHNIC ION BORCEA",BUHUŞI,BC,1432,24,0,0,24,52,1,0,53,61,1,0,62,73,3,0,76,79,3,0,82
20787,181,"COLEGIUL TEHNIC ION BORCEA",BUHUŞI,BC,1346,17,4,0,21,35,4,16,55,55,6,16,77,67,6,16,89,74,6,16,96
20787,182,"CASA DE CULTURĂ",BUHUŞI,BC,1563,34,5,0,39,70,7,0,77,101,13,0,114,109,13,0,122,115,13,0,128
20787,183,"ŞCOALA GIMNAZIALĂ M.EMINESCU",BUHUŞI,BC,1578,20,1,0,21,34,2,0,36,53,2,0,55,71,2,0,73,78,2,0,80
20787,184,"BIBLIOTECA ORĂŞENEASCĂ GEORGE BACOVIA",BUHUŞI,BC,1409,16,0,0,16,55,2,0,57,73,2,5,80,92,4,5,101,98,5,5,108
20787,185,"ŞCOALA GIMNAZIALĂ NR.2",BUHUŞI,BC,1632,12,0,0,12,33,0,0,33,46,0,0,46,60,0,0,60,64,0,0,64
20787,186,"COMPLEXUL DE SERVICII COMUNITARE",BUHUŞI,BC,1752,13,1,0,14,23,3,0,26,32,4,0,36,45,4,0,49,49,4,0,53
20787,187,"ŞCOALA GIMNAZIALĂ ŞTEFAN CEL MARE",BUHUŞI,BC,1917,11,4,0,15,26,5,0,31,38,5,0,43,53,6,0,59,53,6,0,59
20787,188,"ŞCOALA GIMNAZIALĂ MIHAI ANDREI",BUHUŞI,BC,1722,4,2,0,6,18,2,0,20,29,5,0,34,42,5,0,47,42,5,0,47
20787,189,"SALA POLIVALENTĂ MOLDOVA",BUHUŞI,BC,1797,13,0,0,13,24,0,0,24,33,0,0,33,47,0,0,47,55,0,0,55
20787,190,"ŞCOALA GIMNAZIALĂ",BUHUŞI,BC,1357,6,1,0,7,12,4,0,16,17,6,0,23,26,6,0,32,28,6,0,34
20830,191,"CENTRUL 5",COMĂNEŞTI,BC,1101,6,4,0,10,19,7,0,26,38,8,0,46,49,11,0,60,55,14,0,69
20830,192,"ŞCOALA CIPRIAN PORUMBESCU",COMĂNEŞTI,BC,1304,21,5,0,26,40,5,0,45,59,5,0,64,77,7,0,84,81,7,0,88
20830,193,"ȘCOALA CIPRIAN PORUMBESCU",COMĂNEŞTI,BC,1281,9,1,0,10,23,9,0,32,29,9,69,107,42,9,69,120,48,10,69,127
20830,194,"SCOALA CIPRIAN PORUMBESCU",COMĂNEŞTI,BC,503,3,0,0,3,3,1,0,4,7,2,0,9,7,4,0,11,7,5,0,12
20830,195,"BIBLIOTECA ORAŞULUI COMĂNEȘTI",COMĂNEŞTI,BC,1471,22,2,0,24,57,3,0,60,90,6,0,96,119,14,0,133,121,14,0,135
20830,196,"SCOALA LIVIU REBREANU",COMĂNEŞTI,BC,1636,9,0,0,9,42,0,0,42,74,1,0,75,98,10,0,108,114,11,0,125
20830,197,"ŞCOALA LIVIU REBREANU",COMĂNEŞTI,BC,1024,7,0,0,7,22,2,0,24,36,2,0,38,48,2,0,50,49,2,0,51
20830,198,"ŞCOALA LIVIU REBREANU",COMĂNEŞTI,BC,641,9,1,0,10,19,1,0,20,26,2,0,28,34,6,0,40,36,6,0,42
20830,199,"PRIMĂRIA ORAȘULUI COMĂNEȘTI",COMĂNEŞTI,BC,1428,13,0,0,13,30,0,0,30,41,0,0,41,53,3,0,56,57,3,0,60
20830,200,"ŞCOALA ŞUPAN",COMĂNEŞTI,BC,1487,8,5,0,13,16,5,0,21,28,8,0,36,35,8,0,43,36,8,0,44
20830,201,"ŞCOALA LĂLOAIA",COMĂNEŞTI,BC,1206,7,5,0,12,24,7,0,31,35,7,0,42,46,7,0,53,51,8,0,59
20830,202,"ŞCOALA NR.5 BIS SUBLĂLOAIA",COMĂNEŞTI,BC,1500,6,0,0,6,14,0,0,14,24,2,0,26,34,3,0,37,42,4,0,46
20830,203,"ŞCOALA COSTACHI S.CIOCAN LĂLOAIA",COMĂNEŞTI,BC,747,2,0,0,2,10,0,0,10,13,0,0,13,19,3,0,22,23,4,0,27
20830,204,"ŞCOALA NR.3 LEORDA",COMĂNEŞTI,BC,1326,12,6,0,18,14,7,2,23,29,7,2,38,48,7,3,58,50,8,3,61
20830,205,"ŞCOALA DIMITRIE GHICA ZĂVOI",COMĂNEŞTI,BC,1267,8,7,0,15,29,7,0,36,46,7,0,53,60,7,0,67,63,7,0,70
20830,206,"ŞCOALA VERMEŞTI",COMĂNEŞTI,BC,1088,6,4,0,10,8,4,0,12,19,4,0,23,25,12,0,37,25,12,0,37
20830,207,"CLĂDIRE ŞIPOTENI (FOSTĂ ȘCOALĂ ȘIPOTENI)",COMĂNEŞTI,BC,639,3,0,0,3,4,0,0,4,6,0,0,6,11,2,0,13,14,2,0,16
22175,208,"ŞCOALA NR.2 DĂRMĂNEȘTI",DĂRMĂNEŞTI,BC,1362,12,0,0,12,25,2,0,27,32,2,0,34,36,2,0,38,37,2,0,39
22175,209,"LICEULTEHNOLOGIC DĂRMĂNEȘTI",DĂRMĂNEŞTI,BC,1548,5,4,0,9,40,4,0,44,59,4,0,63,65,5,0,70,66,6,0,72
22175,210,"CENTRUL CULTURAL NEMIRA",DĂRMĂNEŞTI,BC,776,3,0,0,3,6,7,0,13,17,7,0,24,25,7,0,32,30,7,0,37
22175,211,"SCOALA NR.2",DĂRMĂNEŞTI,BC,978,7,0,0,7,18,0,0,18,28,0,0,28,34,0,0,34,36,0,0,36
22175,212,"ŞCOALA NR.3 DĂRMĂNEȘTI",DĂRMĂNEŞTI,BC,715,6,2,0,8,11,4,0,15,16,5,0,21,23,5,0,28,23,5,0,28
22175,213,"ŞCOALA NR.3 DĂRMĂNEȘTI",DĂRMĂNEŞTI,BC,1015,1,0,0,1,2,0,0,2,3,0,0,3,5,0,0,5,5,0,0,5
22193,214,"SCOALA LAPOȘ",LĂPOŞ,BC,806,3,0,0,3,6,2,0,8,9,2,0,11,12,2,0,14,15,2,0,17
22219,215,"ŞCOALA CU CLASELEI-VIIIPLOPU",PLOPU,BC,1247,3,0,0,3,10,2,22,34,21,5,22,48,33,5,22,60,35,5,22,62
22175,216,"GRĂDINIŢA SĂLĂTRUC",DĂRMĂNEŞTI,BC,644,2,2,0,4,9,3,0,12,17,5,0,22,25,8,0,33,25,8,0,33
22175,217,"ŞCOALACU CLASELE L-IV PĂGUBENI",DĂRMĂNEŞTI,BC,311,1,0,0,1,3,1,0,4,5,1,0,6,5,1,0,6,8,1,0,9
22175,218,"PRIMĂRIA DĂRMĂNEȘTI",DĂRMĂNEŞTI,BC,1312,5,0,0,5,23,2,0,25,38,5,0,43,58,7,0,65,63,7,0,70
22175,219,"SCOALA CU CLASELEI-IV DĂRMĂNEASCA",DĂRMĂNEŞTI,BC,700,3,3,0,6,10,4,0,14,17,6,0,23,18,7,0,25,19,8,0,27
20938,220,"SCOALA GIMNAZIALA NR. 3",CERDAC,BC,1098,2,0,0,2,9,2,0,11,20,4,0,24,24,4,0,28,36,5,0,41
20929,221,"SCOALA NR. 1 SLĂNIC",SLĂNIC-MOLDOVA,BC,1546,19,20,0,39,47,70,0,117,75,126,0,201,98,154,0,252,98,154,0,252
20947,222,"SCOALA NR. 2 CIRESOAIA",CIREŞOAIA,BC,1487,1,0,0,1,7,0,0,7,11,2,0,13,19,5,0,24,20,5,0,25
20974,223,"SCOALA GENERALA NR. 1","TÎRGU OCNA",BC,1363,15,3,0,18,31,7,82,120,41,9,82,132,56,11,82,149,61,11,82,154
20974,224,"CLUBUL ELEVILOR","TÎRGU OCNA",BC,1396,18,4,0,22,41,24,0,65,60,37,0,97,86,48,0,134,92,49,0,141
20974,225,"COLEGIUL NATIONAL COSTACHE NEGRI","TÎRGU OCNA",BC,1476,18,0,0,18,44,38,0,82,60,57,0,117,80,68,0,148,82,68,0,150
20974,226,"SCOALA GENERALA NR. 2","TÎRGU OCNA",BC,1547,21,0,0,21,44,8,0,52,57,8,0,65,82,10,0,92,86,10,0,96
20974,227,"SCOALA GENERALA NR. 3","TÎRGU OCNA",BC,1061,7,0,0,7,17,0,0,17,25,0,0,25,34,0,0,34,37,0,0,37
20974,228,"SCOALA GENERALA NR. 4","TÎRGU OCNA",BC,1206,5,2,0,7,16,47,37,100,24,74,37,135,28,74,37,139,39,74,37,150
20983,229,"SCOALA GENERALA NR. 5",POIENI,BC,788,5,0,0,5,7,0,0,7,9,0,0,9,9,0,0,9,11,0,0,11
20992,230,"SCOALA GENERALA NR. 6",VÎLCELE,BC,1015,5,0,0,5,9,0,0,9,13,5,0,18,17,5,0,22,20,5,0,25
20974,231,"SCOALA GENERALA NR. 3-SALA DE SPORT","TÎRGU OCNA",BC,893,1,0,0,1,10,6,0,16,21,6,0,27,28,7,0,35,29,7,0,36
21016,232,"CONSILIUL LOCAL AGĂŞ",AGĂŞ,BC,1017,14,5,0,19,25,7,0,32,39,10,0,49,42,11,0,53,45,11,0,56
21043,233,"ŞCOALA CU CLASELE I-IV COTUMBA",COTUMBA,BC,1127,10,0,0,10,28,2,0,30,34,4,0,38,41,4,0,45,41,4,0,45
21089,234,"ŞCOALA GENERALĂ SULŢA",SULŢA,BC,831,5,1,0,6,22,5,0,27,32,5,0,37,38,5,0,43,39,5,0,44
21034,235,"CĂMINUL CULTURAL COŞNEA",COŞNEA,BC,363,0,0,0,0,0,0,0,0,1,0,0,1,1,0,0,1,3,0,0,3
21070,236,"ŞCOALA GENERALĂ PRELUCI",PRELUCI,BC,978,11,0,0,11,29,0,0,29,77,3,0,80,84,3,0,87,84,3,0,87
21061,237,"ŞCOALA GENERALĂ GOIOASA",GOIOASA,BC,696,1,0,0,1,3,0,0,3,3,0,0,3,6,1,0,7,6,1,0,7
21105,238,"ŞCOALA NR.1 ARDEOANI",ARDEOANI,BC,1305,7,0,0,7,10,0,0,10,16,0,0,16,17,2,13,32,20,2,13,35
21114,239,"ŞCOALA LEONTINEŞTI",LEONTINEŞTI,BC,688,11,8,0,19,17,8,0,25,22,9,0,31,26,9,0,35,30,9,2,41
21132,240,"ŞCOALA GENERALA CU CLASELE I-VIII ASAU",ASĂU,BC,878,3,0,0,3,15,0,0,15,21,0,0,21,37,0,0,37,41,0,0,41
21132,241,"ŞCOALA GENERALĂ CU CLASELE I-VIII ASAU",ASĂU,BC,916,8,1,0,9,16,1,0,17,22,3,0,25,25,4,0,29,30,4,0,34
21169,242,"ŞCOALA CU CLASELEI-IV LUNCA ASĂU","LUNCA ASĂU",BC,646,19,1,0,20,47,2,0,49,56,2,0,58,68,2,0,70,71,2,0,73
21187,243,"ŞCOALA CU CLASELEI-IV STRAJA",STRAJA,BC,992,5,0,0,5,10,0,0,10,18,1,0,19,24,1,0,25,24,1,0,25
21150,244,"ŞCOALA CU CLASELEI-IV CIOBĂNUŞ",CIOBĂNUŞ,BC,443,5,0,0,5,9,0,0,9,12,0,0,12,14,2,0,16,18,5,0,23
21141,245,"ŞCOALA GENERALĂCU CLASELEI-VIII APA-ASĂU","APA ASĂU",BC,676,0,0,0,0,3,0,0,3,4,0,0,4,6,0,0,6,6,0,0,6
21141,246,"ŞCOALA GENERALĂCU CLASELE I-VIII APA-ASĂU","APA ASĂU",BC,598,2,0,0,2,6,0,0,6,9,2,0,11,15,2,0,17,20,2,0,22
21178,247,"ŞCOALA CU CLASELE I-IV PĂLTINIŞ",PĂLTINIŞ,BC,528,11,2,0,13,25,2,0,27,25,2,0,27,35,4,0,39,36,4,0,40
21203,248,"PRIMĂRIA BALCANI",BALCANI,BC,1146,11,2,0,13,19,3,0,22,34,5,0,39,44,5,13,62,45,5,13,63
21212,249,"GRĂDINIŢA FRUMOASA",FRUMOASA,BC,1041,3,0,0,3,10,4,0,14,11,4,0,15,16,4,0,20,20,7,0,27
21212,250,"GRĂDINIŢA FRUMOASA",FRUMOASA,BC,1434,5,0,0,5,9,0,0,9,10,1,0,11,15,4,0,19,17,4,0,21
21212,251,"GRĂDINIŢA FRUMOASA",FRUMOASA,BC,542,3,0,0,3,14,0,0,14,19,0,0,19,19,2,0,21,19,2,0,21
21230,252,"GRADINITA NR.2 SCHITU-FRUMOASA","SCHITU FRUMOASA",BC,652,9,2,0,11,11,2,0,13,13,5,0,18,16,5,0,21,19,6,0,25
21230,253,"ŞCOALA GIMNAZIALASCHITU-FRUMOASA","SCHITU FRUMOASA",BC,942,2,2,0,4,5,3,0,8,5,3,0,8,9,4,0,13,9,4,0,13
21221,254,"ŞCOALA GIMNAZIALALUDAŞI",LUDAŞI,BC,797,4,2,0,6,8,2,0,10,12,2,0,14,18,4,0,22,18,4,4,26
21258,255,"CĂMINUL CULTURAL BEREŞTI-BISTRIŢA",BEREŞTI-BISTRIŢA,BC,930,10,1,0,11,25,5,0,30,29,7,0,36,40,8,7,55,45,9,7,61
21329,256,"SCOALA CU CLASELE I-IV PĂDURENI",PĂDURENI,BC,370,2,0,0,2,6,0,0,6,11,0,0,11,22,0,0,22,23,3,5,31
21285,257,"ŞCOALA CU CLASELE I-IV CLIMEŞTI",CLIMEŞTI,BC,251,2,2,0,4,6,2,0,8,10,4,0,14,21,4,0,25,21,6,0,27
21267,258,"ŞCOALA CU CLASELE I-IV BRAD",BRAD,BC,143,7,2,0,9,11,5,0,16,16,5,0,21,16,5,0,21,19,5,0,24
21347,259,"ŞCOALA CU CLASELEI-VIII BEREŞTI-TAZLĂU",BEREŞTI-TAZLĂU,BC,970,6,2,0,8,16,2,0,18,22,2,0,24,28,2,0,30,28,3,0,31
21356,260,"ŞCOALA GENERALĂ BOŞOTENI",BOŞOTENI,BC,363,2,0,0,2,6,0,0,6,9,2,0,11,12,2,0,14,13,2,0,15
21365,261,"ŞCOALA GENERALĂ ENĂCHEŞTI",ENĂCHEŞTI,BC,641,4,1,0,5,9,4,0,13,14,5,0,19,18,5,44,67,19,6,44,69
21374,262,"ŞCOALA GENERALĂ PRISACA",PRISACA,BC,412,5,0,0,5,12,2,0,14,15,2,0,17,20,2,0,22,20,2,0,22
21383,263,"ŞCOALA GENERALĂ ROMÂNEŞTI",ROMÂNEŞTI,BC,353,5,2,0,7,12,4,0,16,17,4,0,21,24,4,0,28,24,6,11,41
21392,264,"ŞCOALA GENERALĂ TESCANI",TESCANI,BC,631,12,3,0,15,16,4,0,20,22,4,0,26,22,6,0,28,25,6,0,31
21409,265,"ŞCOALA GENERALĂ TURLUIANU",TURLUIANU,BC,1059,10,0,0,10,15,0,0,15,20,0,0,20,23,0,0,23,24,0,0,24
21427,266,"ŞCOALA CU CLASELE I-VIII ALEXANDRU CEL BUN BERZUNŢI",BERZUNŢI,BC,1411,5,0,0,5,8,0,0,8,15,4,0,19,19,5,0,24,21,6,0,27
21427,267,"ŞCOALA CU CLASELE I-IV NR. 2 BERZUNŢI",BERZUNŢI,BC,680,7,6,0,13,10,7,0,17,15,7,0,22,17,7,0,24,18,7,0,25
21445,268,"SCOALA CU CLASELE I-IV NR. 1 DRAGOMIR",DRAGOMIR,BC,962,8,0,0,8,12,1,0,13,16,1,0,17,21,2,0,23,21,2,0,23
21445,269,"ŞCOALA CU CLASELE I-VIII NR.2 DRAGOMIR",DRAGOMIR,BC,690,5,4,0,9,18,4,0,22,30,5,0,35,70,5,0,75,70,5,0,75
21436,270,"SCOALA CU CLASELE I-IV BUDA",BUDA,BC,457,1,0,0,1,4,1,0,5,12,3,0,15,26,6,0,32,26,6,0,32
21463,271,"PRIMĂRIA BÎRSĂNEŞTI",BÎRSĂNEŞTI,BC,1479,4,0,0,4,8,0,0,8,11,0,0,11,20,0,0,20,22,0,0,22
21472,272,"ŞCOALA GIMNAZIALĂ ALBELE",ALBELE,BC,540,1,0,0,1,2,0,0,2,7,0,1,8,11,2,1,14,11,2,1,14
21481,273,"ŞCOALA GIMNAZIALĂ BRĂTEŞTI",BRĂTEŞTI,BC,908,4,1,0,5,4,2,0,6,5,2,0,7,11,2,0,13,12,2,0,14
21490,274,"ŞCOALA GIMNAZIALĂ CARACLĂU",CARACLĂU,BC,937,13,0,0,13,27,1,0,28,29,3,0,32,36,4,0,40,39,4,0,43
21515,275,"ŞCOALA CU CLASELE I-VIII NR.1 BLĂGEŞTI",BLĂGEŞTI,BC,970,5,0,0,5,6,0,0,6,9,0,0,9,13,0,0,13,13,0,0,13
21515,276,"ŞCOALA CU CLASELE .I-VIII NR.1 BLĂGEŞTI",BLĂGEŞTI,BC,955,4,1,0,5,7,3,0,10,10,3,0,13,12,6,0,18,13,6,0,19
21524,277,"ŞCOALA CU CLASELE I-VIII NR.1 BUDA",BUDA,BC,1559,15,2,0,17,44,4,0,48,70,6,0,76,90,8,0,98,96,8,0,104
21551,278,"ŞCOALA CU CLASELE.I-VIII NR.1 VALEA LUI ION","VALEA LUI ION",BC,1151,9,1,0,10,12,2,0,14,23,2,0,25,26,2,0,28,26,2,0,28
21542,279,"ŞCOALA CU CLASELE I-IVŢÎRDENII MARI","ŢÎRDENII MARI",BC,598,0,0,0,0,2,1,0,3,4,3,0,7,4,3,0,7,7,3,0,10
21533,280,"ŞCOALA CU CLASELE I-IV POIANA NEGUSTORULUI","POIANA NEGUSTORULUI",BC,533,1,4,0,5,7,5,0,12,16,5,0,21,39,5,0,44,41,5,0,46
21579,281,"ŞCOALA GIMNAZIALĂ BOGDĂNEŞTI",BOGDĂNEŞTI,BC,926,3,0,0,3,5,0,0,5,7,0,0,7,8,0,0,8,11,0,0,11
21579,282,"ŞCOALA GIMNAZIALĂ BOGDĂNEŞTI",BOGDĂNEŞTI,BC,884,7,0,0,7,10,0,0,10,13,4,0,17,16,4,0,20,19,4,0,23
21588,283,"GRĂDINIŢA FILIPEŞTI",FILIPEŞTI,BC,511,2,0,0,2,5,2,0,7,7,2,0,9,11,3,0,14,11,3,0,14
21604,284,"PRIMĂRIA BRUSTUROASA",BRUSTUROASA,BC,1294,1,0,0,1,19,7,0,26,29,8,0,37,31,10,0,41,31,10,0,41
21631,285,"ŞCOALA PRIMARĂ CAMENCA",CAMENCA,BC,774,5,2,0,7,11,2,0,13,17,2,0,19,21,2,0,23,22,2,0,24
21604,286,"ŞCOALA PRIMARĂ CUCHINIŞ",BRUSTUROASA,BC,629,1,0,0,1,2,0,0,2,5,0,0,5,5,0,0,5,5,0,0,5
20705,287,"ŞCOALA GIMNAZIALĂ BUCIUMI",BUCIUMI,BC,1182,9,7,0,16,29,9,0,38,40,10,0,50,58,12,0,70,60,14,0,74
20732,288,"ŞCOALA GIMNAZIALĂ RĂCĂUŢI",RĂCĂUŢI,BC,1235,13,2,0,15,36,2,0,38,65,2,0,67,140,6,0,146,140,7,0,147
21677,289,"ŞCOALA CU CLASELE I-VIII BUHOCI",BUHOCI,BC,1421,12,0,0,12,22,1,0,23,27,2,0,29,29,2,0,31,29,4,0,33
21686,290,"SCOALA CU CLASELE I-VIII BIJGHIR",BIJGHIR,BC,1088,6,0,0,6,8,1,0,9,14,1,0,15,23,2,0,25,29,2,0,31
21686,291,"SCOALA CU CLASELE I-VIII BIJGHIR",BIJGHIR,BC,939,1,0,0,1,3,0,0,3,7,0,0,7,19,1,0,20,20,1,0,21
21702,292,"ŞCOALA CU CLASELE I-IV COTENI",COTENI,BC,623,0,1,0,1,3,1,0,4,4,1,0,5,4,1,0,5,7,1,0,8
21739,293,"ŞCOALA GIMNAZIALĂ N.PÂSLARU CAŞIN",CAŞIN,BC,1380,3,0,0,3,12,0,0,12,21,2,0,23,27,2,0,29,30,3,0,33
21739,294,"ŞCOALA GIMNAZIALĂ N.PÂSLARU CAŞIN",CAŞIN,BC,1252,1,0,0,1,6,0,0,6,10,0,0,10,15,0,0,15,17,0,0,17
21748,295,"GRĂDINIŢA CURIŢA",CURIŢA,BC,630,1,1,0,2,2,1,0,3,8,2,0,10,10,2,0,12,12,2,0,14
21766,296,"SCOALA GIMNAZIALA CAIUTI",CĂIUŢI,BC,1345,6,4,0,10,14,7,0,21,21,7,0,28,22,7,0,29,24,7,0,31
21828,297,"ŞCOALA POPENI",POPENI,BC,667,2,0,0,2,5,1,0,6,9,1,0,10,17,1,0,18,17,1,0,18
21775,298,"ŞCOALA BLIDARI",BLIDARI,BC,591,0,2,0,2,9,3,0,12,11,3,0,14,15,4,0,19,17,4,0,21
21837,299,"ŞCOALA PRALEA",PRALEA,BC,739,0,1,0,1,2,10,0,12,2,10,0,12,12,5,0,17,12,5,0,17
21784,300,"ŞCOALA BOIŞTEA",BOIŞTEA,BC,147,1,2,0,3,2,3,0,5,2,4,0,6,3,4,0,7,3,4,0,7
21800,301,"ŞCOALA HELTIU",HELTIU,BC,314,1,1,0,2,1,1,0,2,4,2,0,6,4,2,0,6,6,2,0,8
21846,302,"ŞCOALA VRÂNCENI",VRÎNCENI,BC,305,0,0,0,0,0,1,0,1,0,3,0,3,4,3,0,7,4,3,0,7
21819,303,"SCOALA PRIMARA MARCESTI",MĂRCEŞTI,BC,115,0,2,0,2,0,3,0,3,0,5,0,5,0,7,0,7,0,9,0,9
21864,304,"ŞCOALA NR.1 CLEJA",CLEJA,BC,771,10,3,0,13,13,5,0,18,19,8,0,27,23,10,0,33,23,11,0,34
21864,305,"SCOALA NR.1 CLEJA",CLEJA,BC,1527,22,2,0,24,30,3,0,33,34,3,0,37,44,3,0,47,46,3,0,49
21864,306,"ŞCOALA NR.2 CLEJA",CLEJA,BC,1449,3,0,0,3,8,0,0,8,11,0,0,11,16,0,0,16,19,0,0,19
21873,307,"ŞCOALA SOMUŞCA",SOMUŞCA,BC,1187,2,0,0,2,4,0,0,4,6,0,0,6,6,0,0,6,9,0,0,9
21882,308,"ŞCOALA VALEA MICĂ","VALEA MICĂ",BC,570,6,1,0,7,7,1,0,8,8,1,0,9,12,2,0,14,15,2,0,17
21908,309,"ŞCOALA GIMNAZIALĂ COLONEŞTI",COLONEŞTI,BC,1098,14,2,0,16,15,2,0,17,16,5,0,21,20,5,0,25,23,5,0,28
21944,310,"ŞCOALA GIMNAZIALĂ SPRIA",SPRIA,BC,273,4,0,0,4,8,0,0,8,9,0,0,9,9,2,0,11,9,4,0,13
21935,311,"ŞCOALA PRIMARĂ SATU NOU","SATU NOU",BC,272,5,2,0,7,8,2,0,10,13,2,0,15,13,2,0,15,13,2,0,15
21980,312,"CĂMIN CULTURAL CORBASCA",CORBASCA,BC,618,12,0,0,12,17,0,0,17,22,1,0,23,27,1,0,28,27,1,0,28
22031,313,"ŞCOALA CU CLASELE I -IV SCARISOARA",SCĂRIŞOARA,BC,640,5,1,0,6,6,4,0,10,7,4,0,11,13,4,0,17,16,5,0,21
22004,314,"ŞCOALA CU CLASELE I-VIII MARVILA",MARVILA,BC,474,3,1,0,4,8,2,0,10,10,2,0,12,13,2,0,15,13,2,0,15
22040,315,"ŞCOALA CU CLASELE.I-IV VÎLCELE",VÎLCELE,BC,494,5,0,0,5,5,0,0,5,5,0,0,5,10,0,0,10,10,0,0,10
21999,316,"ŞCOALA CU CLASELE.I-VIII BĂCIOIU",BĂCIOIU,BC,1541,11,0,0,11,35,1,0,36,61,1,0,62,79,1,0,80,83,1,0,84
22022,317,"ŞCOALA CU CLASELE .I-IV ROGOAZA",ROGOAZA,BC,260,8,1,0,9,11,2,0,13,12,2,0,14,15,2,0,17,18,2,0,20
22068,318,PRIMĂRIACOŢOFĂNEŞTI,COŢOFĂNEŞTI,BC,996,15,0,0,15,29,0,0,29,40,2,0,42,49,2,0,51,51,3,0,54
22095,319,"ŞCOALA CU CLASELE I-VIII BORŞANI",BORŞANI,BC,589,4,2,0,6,9,6,0,15,17,6,0,23,19,9,2,30,20,11,2,33
22077,320,"ŞCOALA CU CLASELE I-IV BÎLCA",BÎLCA,BC,593,9,2,0,11,27,4,0,31,31,5,0,36,41,6,0,47,44,7,0,51
22102,321,"ŞCOALA CU CLASELE I-IV TĂMĂSOAIA",TĂMĂŞOAIA,BC,369,6,3,0,9,36,4,0,40,67,6,0,73,73,6,0,79,73,7,0,80
22120,322,"ŞCOALA GENERALĂ CU CLASELE I-IV DĂMIENEŞTI",DĂMIENEŞTI,BC,454,4,1,0,5,5,1,0,6,6,1,0,7,9,2,0,11,9,2,0,11
22139,323,"ŞCOALA GENERALĂCU CLASELE I-VIII CĂLUGĂRENI",CĂLUGĂRENI,BC,793,6,0,0,6,7,0,0,7,19,2,0,21,23,2,0,25,26,2,0,28
22148,324,"ŞCOALA GENERALĂ CU CASELE I-IV DRĂGEŞTI",DRĂGEŞTI,BC,221,5,0,0,5,7,1,0,8,10,1,0,11,13,1,0,14,13,1,0,14
22246,325,"GRADINITA DEALU MORII","DEALU MORII",BC,901,4,0,0,4,9,1,0,10,15,2,0,17,19,3,0,22,21,3,0,24
22326,326,"ŞCOALA CU CLASELE I-IV CĂUIA",CĂUIA,BC,536,7,0,0,7,13,3,0,16,14,5,19,38,19,5,19,43,20,7,19,46
22362,327,"ŞCOALA CU CLASELE I-VIII NEGULEŞTI",NEGULEŞTI,BC,472,1,3,0,4,2,3,0,5,7,3,0,10,10,3,0,13,10,3,0,13
22371,328,"ŞCOALA TĂVĂDĂRĂŞTI",TĂVĂDĂREŞTI,BC,308,4,1,0,5,13,2,0,15,15,2,0,17,18,13,3,34,18,3,13,34
22399,329,"SCOALA SCARLAT LONGHINDOFTEANA",DOFTEANA,BC,1308,15,0,0,15,32,0,0,32,39,0,0,39,55,1,3,59,58,1,3,62
22399,330,"SCOALA SCARLAT LONGHIN DOFTEANA",DOFTEANA,BC,1286,5,4,0,9,17,7,0,24,30,7,0,37,38,8,5,51,42,8,5,55
22424,331,"ŞCOALA GENERALA CU CLASELE I-VIII HĂGHIAC",HĂGHIAC,BC,1245,5,0,0,5,17,3,0,20,24,3,0,27,36,3,11,50,40,4,11,55
22406,332,"ȘCOALA CU CLASELE I-IV BOGATA",BOGATA,BC,714,6,2,0,8,13,4,0,17,21,4,0,25,24,5,0,29,25,5,0,30
22415,333,"SCOALA GENERALA CU CLASELEI-VIII CUCUIETI",CUCUIEŢI,BC,915,13,0,0,13,20,3,0,23,22,3,0,25,25,3,0,28,25,3,0,28
22415,334,"SCOALA GENERALA CU CLASELEI-VIII CUCUIETI",CUCUIEŢI,BC,1035,4,3,0,7,17,3,0,20,21,3,0,24,27,3,0,30,30,3,0,33
22433,335,"ŞCOALA GENERALA CU CLASELE I-VIII LARGA",LARGA,BC,1050,15,0,0,15,36,1,0,37,45,2,0,47,65,2,0,67,73,2,0,75
22451,336,"ŞCOALA GENERALA CU CLASELE I-IV ŞTEFAN VODĂ","ŞTEFAN VODĂ",BC,939,11,1,0,12,20,1,0,21,26,2,0,28,34,3,3,40,42,6,3,51
22442,337,"ŞCOALA GENERALA CUCLASELE I-IV SEACA",SEACA,BC,377,8,3,0,11,13,3,0,16,13,3,0,16,18,4,0,22,18,4,0,22
22479,338,"ŞCOALA GIMNAZIALA NR.1 FARAOANI",FARAOANI,BC,1346,8,0,0,8,13,1,0,14,15,1,0,16,18,5,0,23,26,5,0,31
22479,339,"ŞCOALA GIMNAZIALA NR.1 FARAOANI",FARAOANI,BC,1154,15,0,0,15,23,0,0,23,28,0,0,28,33,0,0,33,34,0,0,34
22479,340,"ŞCOALA GIMNAZIALA NR.2 FARAOANI",FARAOANI,BC,1003,5,0,0,5,6,0,0,6,8,0,0,8,13,1,0,14,14,3,0,17
22479,341,"ŞCOALA GIMNAZIALA NR.2 FARAOANI",FARAOANI,BC,908,6,1,0,7,8,2,0,10,10,2,0,12,14,2,0,16,15,2,0,17
22497,342,"PRIMĂRIA FILIPENI",FILIPENI,BC,553,6,1,0,7,11,2,0,13,14,2,0,16,23,3,21,47,23,3,21,47
22530,343,"ŞCOALA CU CLASELE I-IV MĂRĂŞTI",MĂRĂŞTI,BC,584,7,0,0,7,9,0,0,9,18,3,0,21,22,6,0,28,22,6,0,28
22521,344,"ŞCOALA CU CLASELE I-IV FRUNTEŞTI",FRUNTEŞTI,BC,622,4,4,0,8,10,4,0,14,11,4,0,15,14,4,0,18,18,6,0,24
22585,345,"ŞCOALA FILIPEŞTI",FILIPEŞTI,BC,808,6,1,0,7,10,1,0,11,13,9,0,22,23,9,0,32,27,9,0,36
22638,346,"ŞCOALA GALBENI",GALBENI,BC,717,4,0,0,4,5,1,0,6,14,3,0,17,17,10,0,27,17,11,0,28
22601,347,"ŞCOALA CÎRLIGI",CÎRLIGI,BC,936,3,1,0,4,11,3,0,14,13,4,0,17,17,6,0,23,18,6,0,24
22656,348,"ŞCOALA ONIŞCANI",ONIŞCANI,BC,397,1,0,0,1,4,2,0,6,7,2,0,9,10,2,0,12,10,2,0,12
22594,349,"ŞCOALA BOANŢA",BOANŢA,BC,270,1,1,0,2,4,3,0,7,4,4,0,8,7,6,0,13,7,6,0,13
22647,350,"ŞCOALA HÎRLEŞTI",HÎRLEŞTI,BC,636,2,1,0,3,10,1,0,11,13,2,0,15,19,2,0,21,20,4,0,24
22674,351,"PRIMĂRIA GĂICEANA",GĂICEANA,BC,743,9,2,0,11,12,5,0,17,18,5,0,23,19,5,0,24,19,5,0,24
22683,352,"ŞCOALA ARINI",ARINI,BC,984,3,0,0,3,3,0,0,3,5,0,0,5,17,0,0,17,25,1,0,26
22692,353,"ŞCOALA HUŢU",HUŢU,BC,471,2,0,0,2,2,2,0,4,3,2,0,5,6,6,0,12,6,6,0,12
22727,354,"PRIMĂRIA FĂGET",FĂGET,BC,1100,0,0,0,0,9,0,0,9,11,0,0,11,13,1,0,14,15,1,0,16
22772,355,"ŞCOALA GENERALA CU CLASELE I-VIII TĂRHĂUŞI",TĂRHĂUŞI,BC,654,0,0,0,0,1,0,0,1,3,0,0,3,3,0,0,3,5,0,0,5
22754,356,"ŞCOALA GENERALA CU CLASELE I-VIII GHIMEŞ",GHIMEŞ,BC,874,1,0,0,1,1,0,0,1,4,0,0,4,5,1,0,6,6,1,0,7
22745,357,"ŞCOALA GENERALA CU CLASELE I-IV FĂGETUL DE SUS","FĂGETU DE SUS",BC,201,1,1,0,2,3,2,0,5,5,2,0,7,6,5,0,11,7,7,0,14
22736,358,"ŞCOALA GENERALA CU CLASELE I-VIII BOLOVĂNIŞ",BOLOVĂNIŞ,BC,742,3,1,0,4,6,1,0,7,6,1,0,7,7,4,0,11,8,4,0,12
22763,359,"ŞCOALA GENERALA CU CLASELE I-IV RĂCHITIŞ",RĂCHITIŞ,BC,184,0,0,0,0,2,0,0,2,3,0,0,3,3,0,0,3,5,0,0,5
25736,360,"ŞCOALA GENERALA CU CLASELE I-VIII ION STRAT GIOSENI",GIOSENI,BC,1080,2,2,0,4,5,2,0,7,12,2,0,14,15,2,0,17,15,2,0,17
25736,361,"ŞCOALA GENERALA CU CLASELE I-VIII ION STRAT GIOSENI",GIOSENI,BC,1041,4,1,0,5,6,3,0,9,9,4,0,13,11,5,0,16,11,5,0,16
25736,362,"SCOALA GENERALA CU CLASELEI-VIIIION STRAT GIOSENI",GIOSENI,BC,1043,4,1,0,5,6,1,0,7,11,1,0,12,15,1,0,16,16,1,0,17
22790,363,"ŞCOALA CU CL.I-VIII GÎRLENII DE SUS","GÎRLENII DE SUS",BC,1450,0,0,0,0,4,3,0,7,7,6,0,13,14,6,0,20,14,6,0,20
22807,364,"ŞCOALA CU CL.I-VIII GÎRLENI",GÎRLENI,BC,1041,5,0,0,5,13,1,0,14,15,3,0,18,17,3,0,20,17,3,0,20
22807,365,"ŞCOALA CU CL.I-VIII GÎRLENI",GÎRLENI,BC,950,5,0,0,5,9,0,0,9,13,0,0,13,15,0,0,15,15,0,0,15
22816,366,"ŞCOALA CU CL.I-VIII LESPEZI",LESPEZI,BC,1011,3,1,0,4,3,1,0,4,4,1,0,5,8,1,0,9,8,3,0,11
22816,367,"ŞCOALA CU CL.I-VIII LESPEZI",LESPEZI,BC,1214,4,0,0,4,6,0,0,6,7,0,0,7,9,0,0,9,13,0,0,13
22843,368,"CĂMINUL CULTURAL GLĂVĂNEŞTI",GLĂVĂNEŞTI,BC,1438,8,0,0,8,12,1,0,13,22,2,0,24,27,2,0,29,28,2,12,42
22852,369,"CĂMINUL CULTURAL FRUMUŞELU",FRUMUŞELU,BC,1054,2,0,0,2,5,0,0,5,6,0,0,6,11,0,0,11,12,1,0,13
22861,370,"SCOALA MUNCELU",MUNCELU,BC,195,1,0,0,1,2,1,0,3,3,1,0,4,5,1,0,6,5,1,0,6
20616,371,"PRIMĂRIA GURA VĂII","GURA VĂII",BC,1257,9,0,0,9,15,0,0,15,15,0,0,15,20,0,0,20,20,2,0,22
20616,372,"GRĂDINIŢA PĂTRĂŞCANI","GURA VĂII",BC,311,4,0,0,4,5,1,0,6,10,1,0,11,13,1,0,14,15,1,0,16
20643,373,"CASA PRAZNICALĂBISERICAORTODOXĂ SF.TREIME - MOTOCEŞTI",MOTOCEŞTI,BC,117,4,2,0,6,4,2,0,6,13,2,0,15,16,5,0,21,16,5,0,21
20661,374,"ŞCOALA TEMELIA",TEMELIA,BC,760,3,0,0,3,8,1,0,9,13,1,0,14,14,1,0,15,15,2,4,21
20652,375,"ŞCOALA PĂLTINATA",PĂLTINATA,BC,377,1,1,0,2,3,3,0,6,7,3,0,10,12,4,9,25,14,4,9,27
20634,376,"SCOALA GENERALA CU CLASELE I-VIIIDUMBRAVA",DUMBRAVA,BC,990,1,0,0,1,9,1,0,10,14,1,0,15,14,1,0,15,15,1,0,16
20625,377,"ŞCOALA CAPĂTA",CAPĂTA,BC,284,2,0,0,2,5,0,0,5,8,0,0,8,11,0,0,11,11,0,0,11
22905,378,"ŞCOALA GIMNAZIALĂ HELEGIU",HELEGIU,BC,960,3,0,0,3,6,2,0,8,8,2,0,10,9,2,0,11,11,2,0,13
22914,379,"ŞCOALA GIMNAZIALĂ BRĂTILA 2",BRĂTILA,BC,669,7,4,0,11,8,5,0,13,9,5,0,14,9,6,0,15,9,7,0,16
22914,380,"SCOALA CU CLASELE I-VIII BRATILA 1",BRĂTILA,BC,865,5,0,0,5,13,0,0,13,17,0,0,17,18,2,0,20,20,2,0,22
22923,381,"SCOALA GIMNAZIALA DELENI",DELENI,BC,1382,3,1,0,4,4,1,0,5,5,1,0,6,15,2,0,17,15,2,0,17
22932,382,"ŞCOALA GIMNAZIALĂ NR.1 DRĂGUGEŞTI",DRĂGUGEŞTI,BC,1245,2,0,0,2,3,0,0,3,7,0,0,7,8,0,0,8,11,1,0,12
22932,383,"ŞCOALA PRIMARĂ NR.2 DRĂGUGEŞTI",DRĂGUGEŞTI,BC,365,2,0,0,2,4,0,0,4,7,2,0,9,8,2,0,10,8,2,0,10
20322,384,"CĂMINUL CULTURAL HEMEIUŞ",HEMEIUŞ,BC,1435,10,2,0,12,38,3,0,41,46,5,0,51,52,5,0,57,57,8,0,65
20322,385,"ŞCOALA GENERALA GRIGORE TĂBĂCARU HEMEIUŞ",HEMEIUŞ,BC,799,8,1,0,9,22,1,0,23,30,1,0,31,37,2,0,39,38,2,0,40
20340,386,"SCOALA GENERALA ION SIMIONESCU, LILIECI",LILIECI,BC,1460,2,0,0,2,14,0,0,14,19,0,0,19,30,4,0,34,30,4,0,34
20340,387,"ŞCOALA GENERALA ION SIMIONESCU LILIECI",LILIECI,BC,1118,9,2,0,11,18,3,0,21,27,6,0,33,34,6,0,40,38,6,0,44
22950,388,"PRIMĂRIA HORGEŞTI",HORGEŞTI,BC,1393,4,0,0,4,14,2,0,16,25,2,0,27,32,2,0,34,33,2,0,35
23029,389,"ŞCOALA SOHODOR",SOHODOR,BC,963,4,0,0,4,13,1,0,14,28,2,0,30,36,3,0,39,42,5,0,47
23010,390,"ŞCOALA RECEA",RECEA,BC,659,11,2,0,13,15,3,0,18,17,5,0,22,19,7,0,26,21,7,0,28
22996,391,"ŞCOALA RĂCĂTĂU",RĂCĂTĂU-RĂZEŞI,BC,895,6,4,0,10,11,4,0,15,14,4,0,18,14,4,0,18,14,4,0,18
23056,392,"PRIMĂRIA HURUIEŞTI",HURUIEŞTI,BC,586,9,3,0,12,10,3,0,13,15,5,0,20,17,5,0,22,22,9,0,31
23109,393,"FOSTUL LOCAL AL ŞCOLII PERCHIU",PERCHIU,BC,126,1,2,0,3,2,2,0,4,3,3,0,6,6,3,0,9,6,3,0,9
23118,394,"FOSTUL LOCAL AL ŞCOLII PRADAIŞ",PRĂDAIŞ,BC,261,6,5,0,11,11,6,0,17,13,6,0,19,15,7,0,22,16,7,0,23
23065,395,"FOSTUL LOCAL AL ŞCOLII CAPOTEŞTI",CĂPOTEŞTI,BC,173,2,6,0,8,5,7,0,12,5,11,0,16,7,11,0,18,8,11,0,19
23092,396,"LOCALUL ŞCOLII OCHENI",OCHENI,BC,294,1,1,0,2,4,1,0,5,4,1,0,5,8,1,0,9,8,1,0,9
23074,397,"FOSTUL LOCAL AL ŞCOLII FLOREŞTI",FLOREŞTI,BC,136,1,1,0,2,2,1,0,3,4,1,0,5,6,1,0,7,6,2,0,8
23083,398,"LOCALUL ŞCOLII FUNDOAIA",FUNDOAIA,BC,333,0,0,0,0,4,0,0,4,5,0,0,5,10,1,0,11,10,4,0,14
21310,399,"ŞCOALA CL.I-VIII ITEŞTI",ITEŞTI,BC,698,4,1,0,5,8,2,0,10,13,4,0,17,13,5,0,18,14,5,0,19
21294,400,"ŞCOALA DUMBRAVA",DUMBRAVA,BC,364,3,2,0,5,4,4,0,8,5,4,0,9,9,4,0,13,9,4,0,13
21276,401,"CĂMINUL CULTURAL CIUMAŞI",CIUMAŞI,BC,146,3,4,0,7,5,6,0,11,6,6,0,12,7,6,0,13,8,6,0,14
23136,402,"ŞCOALA CONSTANTIN MOSCUIZV.BERHECIULUI","IZVORU BERHECIULUI",BC,650,2,0,0,2,6,1,0,7,10,1,0,11,12,1,0,13,13,1,0,14
23145,403,"ŞCOALA GENERALĂ ANTOHEŞTI",ANTOHEŞTI,BC,309,0,1,0,1,2,1,0,3,4,2,0,6,10,2,0,12,11,2,0,13
23172,404,"ŞCOALA GENERALĂ OBÎRŞIA",OBÎRŞIA,BC,322,6,3,0,9,9,3,0,12,10,3,0,13,12,3,0,15,12,3,0,15
20368,405,"ŞCOALA COORDONATOARE LETEA VECHE","LETEA VECHE",BC,1406,13,0,0,13,28,0,0,28,36,0,0,36,40,6,0,46,45,6,0,51
20368,406,"SCOALA COORDONATOARE LETEA VECHE","LETEA VECHE",BC,1568,16,0,0,16,37,0,0,37,55,0,0,55,76,0,0,76,79,0,0,79
20377,407,"ŞCOALA HOLT",HOLT,BC,1449,8,6,0,14,12,7,0,19,25,7,0,32,35,7,0,42,42,9,0,51
20386,408,"ŞCOALA RADOMIREŞTI",RADOMIREŞTI,BC,335,2,0,0,2,3,0,0,3,4,0,0,4,6,3,0,9,7,3,0,10
20395,409,"ŞCOALA RUŞI CIUTEA",RUŞI-CIUTEA,BC,584,0,2,0,2,9,2,0,11,20,3,0,23,28,6,0,34,36,7,0,43
20402,410,"ŞCOALA SIRETU",SIRETU,BC,455,3,0,0,3,4,1,0,5,6,1,0,7,11,2,0,13,15,5,0,20
23216,411,"ŞCOALA CU CLASELE I-VIII M.EMINESCU LIPOVA",LIPOVA,BC,513,8,3,0,11,11,3,0,14,15,3,0,18,15,5,2,22,15,9,2,26
23252,412,"ŞCOALA CU CLASELE I-IV VALEA HOGEI","VALEA HOGEI",BC,226,3,0,0,3,10,0,0,10,11,1,0,12,11,3,0,14,14,3,0,17
23234,413,"ŞCOALA CU CLASELE I-VIII SATU NOU","SATU NOU",BC,388,6,0,0,6,9,0,0,9,10,0,0,10,16,0,0,16,16,0,0,16
23243,414,"ŞCOALA CU CLASELE I-IV VALEA CASELOR","VALEA CASELOR",BC,370,20,1,0,21,44,2,0,46,63,3,0,66,96,6,0,102,111,10,0,121
23225,415,"ŞCOALA CU CLASELE I-VIII MÎLOSU",MÎLOSU,BC,747,7,1,0,8,9,1,0,10,12,3,0,15,17,3,0,20,17,3,0,20
23298,416,"ŞCOALA GIMNAZIALĂ NR.1 LIVEZI",LIVEZI,BC,778,1,0,0,1,4,0,0,4,7,2,0,9,11,2,0,13,11,2,0,13
23314,417,"ŞCOALA PRIMARĂ ORĂŞA",ORĂŞA,BC,706,5,0,0,5,9,0,0,9,10,0,0,10,13,0,0,13,13,0,0,13
23332,418,"ŞCOALA PRIMARĂ PRĂJOAIA",PRAJOAIA,BC,784,1,0,0,1,2,0,0,2,3,0,0,3,4,0,0,4,7,0,0,7
23341,419,"ŞCOALA PRIMARĂ SCĂRIGA",SCĂRIGA,BC,450,0,1,0,1,3,1,0,4,4,1,0,5,5,3,0,8,7,3,0,10
23323,420,"ŞCOALA GIMNAZIALĂ POIANA",POIANA,BC,742,4,0,0,4,6,4,0,10,9,6,0,15,14,8,0,22,15,8,0,23
23305,421,"ŞCOALA PRIMARĂ BĂLĂNEASA",BĂLĂNEASA,BC,922,0,0,0,0,0,0,0,0,3,0,0,3,7,0,0,7,9,0,0,9
23369,422,"ŞCOALA CU CLASELE I-VIII LUIZI CĂLUGĂRA",LUIZI-CĂLUGĂRA,BC,1242,6,1,0,7,17,4,0,21,18,5,0,23,20,5,0,25,26,5,0,31
23369,423,"ŞCOALA CU CLASELEI-VIII LUIZI CĂLUGĂRA",LUIZI-CĂLUGĂRA,BC,1227,3,0,0,3,5,0,0,5,9,0,0,9,15,0,0,15,16,0,0,16
23378,424,"ŞCOALA CU CLASELE I-VIII OSEBIŢI",OSEBIŢI,BC,878,5,0,0,5,8,0,0,8,9,0,0,9,10,0,0,10,11,0,0,11
23378,425,"ŞCOALA CU CLASELE I-VIII OSEBIŢI",OSEBIŢI,BC,892,4,0,0,4,7,1,0,8,10,1,0,11,13,1,0,14,14,1,0,15
23396,426,"CAMINUL CULTURAL MAGIRESTI",MĂGIREŞTI,BC,1494,14,0,0,14,31,0,0,31,40,0,1,41,45,0,1,46,55,1,1,57
23412,427,"ŞCOALA CU CLASELE.I-IV STĂNEŞTI (CORP NOU)",STĂNEŞTI,BC,505,3,0,0,3,5,0,0,5,9,0,0,9,11,1,0,12,14,1,0,15
23430,428,"ŞCOALA CU CLASELE I-VIII VALEA ARINILOR","VALEA ARINILOR",BC,993,5,4,0,9,16,6,0,22,16,6,0,22,25,6,0,31,25,8,0,33
23403,429,"SCOALA CU CLASELEI-IV PRAJESTII",PRĂJEŞTI,BC,506,10,3,0,13,18,3,0,21,22,6,0,28,23,6,0,29,25,8,0,33
20420,430,"ŞCOALA NR.2 MĂGURA-SALA 1",MĂGURA,BC,902,6,0,0,6,14,0,0,14,19,1,0,20,22,2,0,24,22,2,0,24
20420,431,"SCOALA NR.2 SAT MAGURA - SALA 2",MĂGURA,BC,602,3,2,0,5,12,2,0,14,19,2,0,21,24,4,0,28,27,4,0,31
20420,432,"ŞCOALA GENERALA NR.1 EMIL BRĂIESCU MĂGURA",MĂGURA,BC,1735,8,0,0,8,17,1,0,18,24,2,0,26,35,3,0,38,41,4,0,45
20439,433,"ŞCOALA GENERALĂ CRIHAN",CRIHAN,BC,1086,2,0,0,2,2,0,0,2,5,1,0,6,7,3,0,10,7,6,0,13
23458,434,"CĂMINUL CULTURAL SATUL MĂNĂSTIREA CAŞIN","MĂNĂSTIREA CAŞIN",BC,1586,8,2,0,10,18,2,0,20,25,5,0,30,34,9,0,43,35,11,0,46
23476,435,"CĂMINUL CULTURAL SATUL MĂNĂSTIREA CAŞIN",PÎRVULEŞTI,BC,612,1,0,0,1,1,0,0,1,2,0,0,2,2,0,0,2,2,0,0,2
23485,436,"ŞCOALA GENERALA.NR.2 MĂNĂSTIREA CAŞIN",SCUTARU,BC,1646,10,0,0,10,17,3,0,20,25,3,0,28,35,3,0,38,35,3,0,38
23467,437,"ŞCOALA LUPEŞTI",LUPEŞTI,BC,629,8,2,0,10,11,2,0,13,12,2,0,14,12,2,0,14,13,3,0,16
20475,438,"ŞCOALA CU CLASELE I-VIII MĂRGINENI",MĂRGINENI,BC,1171,6,0,0,6,16,2,0,18,20,2,0,22,24,4,0,28,27,4,0,31
20475,439,"ŞCOALA CU CLASELE I-VIII MĂRGINENI",MĂRGINENI,BC,1207,6,3,0,9,13,3,0,16,15,3,0,18,19,3,0,22,20,3,0,23
20475,440,"ŞCOALA CU CLASELE I-VIII MĂRGINENI",MĂRGINENI,BC,1094,9,0,0,9,16,0,0,16,21,0,0,21,26,0,0,26,28,0,0,28
20484,441,"ŞCOALA CU CLASELE I-VIII BARAŢI",BARAŢI,BC,1719,13,2,0,15,19,2,0,21,33,9,0,42,44,10,0,54,48,12,0,60
20536,442,"ŞCOALA CU CLASELE I-VIII TREBEŞ",TREBEŞ,BC,714,3,0,0,3,3,0,0,3,12,0,0,12,15,0,0,15,18,0,0,18
20545,443,"ŞCOALA CU CLASELEI - IV VALEA BUDULUI","VALEA BUDULUI",BC,410,3,2,0,5,7,2,0,9,12,3,0,15,20,3,0,23,21,3,0,24
20509,444,"ŞCOALA CU CLASELE I - IV PĂDURENI",PĂDURENI,BC,313,2,3,0,5,3,3,0,6,5,3,0,8,10,4,0,14,10,4,0,14
20493,445,"ŞCOALA CU CLASELE I-VIII LUNCANI",LUNCANI,BC,1024,1,0,0,1,10,3,0,13,15,5,0,20,19,6,0,25,19,6,0,25
20518,446,"ŞCOALA CU CLASELE I - IV PODIȘ",PODIŞ,BC,535,5,1,0,6,6,6,0,12,6,6,0,12,7,7,0,14,11,9,0,20
23500,447,"PRIMĂRIA MOTOŞENI",MOTOŞENI,BC,851,4,1,0,5,9,3,0,12,17,7,0,24,19,8,0,27,20,8,0,28
23635,448,"ŞCOALA SATUL ŢEPOAIA",ŢEPOAIA,BC,436,0,0,0,0,5,0,0,5,5,0,0,5,6,0,0,6,9,0,0,9
23546,449,"ŞCOALA SATUL COCIU",COCIU,BC,253,2,0,0,2,3,0,0,3,5,2,0,7,5,2,0,7,5,2,0,7
23591,450,"ŞCOALA SATUL POIANA",POIANA,BC,270,8,0,0,8,9,1,0,10,13,2,0,15,17,5,0,22,17,5,0,22
23564,451,"ŞCOALA SATUL FÎNTÎNELE",FÎNTÎNELE,BC,545,3,2,0,5,5,3,0,8,7,3,0,10,8,3,0,11,10,4,0,14
23626,452,"ŞCOALA SATUL ŞENDREŞTI",ŞENDREŞTI,BC,303,4,0,0,4,8,0,0,8,10,0,0,10,15,2,0,17,17,4,0,21
23653,453,"ŞCOALA COSTACHE NEGRI SATUL NEGRI",NEGRI,BC,1081,5,0,0,5,10,0,0,10,15,4,0,19,29,7,0,36,32,8,0,40
23699,454,"ŞCOALA ION IONESCU DE LA BRADSATUL POIANA-NEGRI",POIANA,BC,1191,8,0,0,8,20,0,0,20,28,0,0,28,39,0,0,39,49,1,0,50
23724,455,"SCOALA NICOLAE BALCESCU","NICOLAE BĂLCESCU",BC,1207,4,0,0,4,5,0,0,5,11,0,0,11,13,0,0,13,16,0,0,16
23724,456,"SCOALA NICOLAE BALCESCU","NICOLAE BĂLCESCU",BC,1517,2,0,0,2,2,0,0,2,8,0,0,8,10,0,0,10,10,0,0,10
23724,457,"SCOALA NICOLAE BALCESCU","NICOLAE BĂLCESCU",BC,1566,3,0,0,3,6,0,0,6,9,0,0,9,10,1,0,11,10,1,0,11
23751,458,"ŞCOALA SATUL GALBENI",GALBENI,BC,1201,5,2,0,7,10,2,0,12,14,3,0,17,18,5,0,23,24,6,0,30
23788,459,"GRADINITA NR.1 VALEA SEACA","VALEA SEACĂ",BC,800,3,0,0,3,6,0,0,6,8,0,0,8,8,0,0,8,8,0,0,8
23788,460,"GRADINITA NR.1 VALEA SEACA","VALEA SEACĂ",BC,984,2,0,0,2,4,0,0,4,6,0,0,6,9,0,0,9,9,0,0,9
23788,461,"GRADINITA NR.1 VALEA SEACA","VALEA SEACĂ",BC,686,2,0,0,2,4,1,0,5,7,1,0,8,11,1,0,12,12,1,0,13
23760,462,"ŞCOALA SATUL LĂRGUŢA",LĂRGUŢA,BC,180,0,0,0,0,1,0,0,1,6,3,0,9,9,3,0,12,9,3,0,12
25442,463,"ŞCOALA CU CLASELE I-IV ODOBEŞTI",ODOBEŞTI,BC,379,7,5,0,12,13,6,0,19,15,6,0,21,18,8,0,26,18,8,0,26
25451,464,"ŞCOALA CU CLASELE I-VIII TISA SILVESTRI",TISA-SILVESTRI,BC,879,13,4,0,17,30,6,0,36,45,10,0,55,64,17,0,81,67,17,0,84
25415,465,"ŞCOALA CU CLASELE I-VIII CIUTUREŞTI",CIUTUREŞTI,BC,653,5,2,0,7,9,4,0,13,11,4,0,15,12,4,0,16,14,5,0,19
23804,466,"SCOALA GIMNAZIALA, COMUNA OITUZ",OITUZ,BC,520,9,0,0,9,11,2,0,13,14,2,0,16,23,2,0,25,27,3,0,30
23804,467,"SCOALA GIMNAZIALA NR. 1 OITUZ",OITUZ,BC,1371,3,0,0,3,14,1,0,15,17,1,0,18,23,1,0,24,23,1,0,24
23804,468,"GRADINITA NR. 1 OITUZ",OITUZ,BC,1510,3,0,0,3,7,0,0,7,11,0,0,11,14,1,0,15,16,1,0,17
23804,469,"GRADINITA NR. 2 OITUZ",OITUZ,BC,927,0,0,0,0,3,0,0,3,3,3,0,6,7,4,0,11,15,4,0,19
23804,470,"GRADINITA NR.3 OITUZ",OITUZ,BC,1048,3,0,0,3,5,0,0,5,10,0,0,10,17,0,0,17,17,0,0,17
23840,471,"GRĂDINIŢA MARGINEA",MARGINEA,BC,608,3,0,0,3,9,0,0,9,11,0,0,11,14,0,0,14,15,0,0,15
23813,472,"GRĂDINIŢA CĂLCÂI",CĂLCÎI,BC,385,4,0,0,4,6,0,0,6,7,0,0,7,10,0,0,10,10,0,0,10
23822,473,"ŞCOALA GIMNAZIALA FERESTRAU",FERESTRĂU-OITUZ,BC,880,5,0,0,5,10,0,0,10,11,2,0,13,13,2,0,15,13,2,0,15
23831,474,"AŞEZĂMÂNT FILANTROPIC ""SFÂNTUL VOIEVOD ŞTEFAN CEL MARE"" HÎRJA",HÎRJA,BC,260,6,9,0,15,19,28,0,47,25,39,0,64,26,44,17,87,28,44,17,89
23859,475,"SCOALA POIANA-SĂRATĂ","POIANA SĂRATĂ",BC,220,4,0,0,4,8,1,0,9,16,4,0,20,16,5,0,21,16,6,0,22
23877,476,"CĂMINUL CULTURAL SATUL ONCEŞTI",ONCEŞTI,BC,758,5,1,0,6,5,1,0,6,8,4,0,12,10,4,0,14,13,6,0,19
23920,477,"SALA DE FESTIVITĂŢI SATUL TARNIŢA",TARNIŢA,BC,528,8,0,0,8,9,2,0,11,16,2,0,18,19,4,0,23,20,6,0,26
23957,478,"ŞCOALA CU CLASELE I-VIII SATUL ORBENI",ORBENI,BC,925,10,2,0,12,22,2,0,24,26,3,0,29,31,5,0,36,36,5,0,41
23957,479,"ŞCOALA PRIMARĂ NR.2 SATUL ORBENI",ORBENI,BC,678,8,2,0,10,13,2,0,15,16,3,0,19,16,4,0,20,17,5,0,22
23966,480,"ŞCOALA GIMNAZIALA NR. 1 SATUL SCURTA",SCURTA,BC,1397,4,1,0,5,13,3,0,16,16,9,0,25,22,14,0,36,22,14,0,36
23984,481,"PRIMĂRIA PALANCA",PALANCA,BC,1274,8,1,0,9,26,3,0,29,34,4,0,38,40,5,0,45,46,6,0,52
24007,482,"CĂMINUL CULTURAL SATUL CIUGHEŞ",CIUGHEŞ,BC,1481,16,0,0,16,22,2,0,24,31,2,0,33,34,2,0,36,38,2,0,40
23993,483,"ŞCOALA SATUL CĂDĂRĂŞTI",CĂDĂREŞTI,BC,90,3,1,0,4,3,1,0,4,4,1,0,5,4,1,0,5,4,1,0,5
24043,484,"PRIMARIA COMUNEI PARAVA (SALA DE FESTIVITATI)",PARAVA,BC,731,6,0,0,6,8,0,0,8,9,1,0,10,10,1,0,11,10,1,2,13
24052,485,"ŞCOALA GIMNAZIALĂ SATUL DRĂGUŞANI",DRĂGUŞANI,BC,703,0,0,0,0,2,2,0,4,2,2,0,4,6,4,0,10,8,4,0,12
24061,486,"ŞCOALA GIMNAZIALĂ SATUL RĂDOAIA",RĂDOAIA,BC,960,5,2,0,7,16,3,0,19,46,4,1,51,57,4,1,62,64,6,1,71
24070,487,"ŞCOALA PRIMARĂ SATUL TEIUŞ",TEIUŞ,BC,210,2,1,0,3,2,1,0,3,3,1,0,4,7,3,0,10,7,3,0,10
24098,488,"LICEUL TEHNOLOGIC ""G.J.CANCICOV"" PARINCEA",PARINCEA,BC,749,7,1,0,8,13,3,0,16,33,5,0,38,35,6,0,41,36,6,0,42
23038,489,"ŞCOALA VĂLENI",VĂLENI,BC,450,0,0,0,0,6,0,0,6,6,0,0,6,8,0,0,8,8,0,0,8
24178,490,"ŞCOALA VLADNIC",VLADNIC,BC,693,6,3,0,9,8,5,0,13,12,5,0,17,17,5,0,22,17,7,0,24
24132,491,"ŞCOALA NĂNEŞTI",NĂNEŞTI,BC,592,1,2,0,3,3,2,0,5,7,2,0,9,7,3,0,10,11,4,0,15
24150,492,"ŞCOALA POIENI",POIENI,BC,237,2,0,0,2,2,2,0,4,3,5,0,8,4,6,0,10,9,8,0,17
24179,493,"ŞCOALAMILEŞTII DE JOS","MILEŞTII DE JOS",BC,227,4,1,0,5,5,1,0,6,7,1,0,8,8,2,0,10,11,2,0,13
24347,494,"ŞCOALA SATUL PÎRJOL",PÂRJOL,BC,727,12,7,0,19,18,8,0,26,20,9,0,29,21,10,23,54,24,10,23,57
24418,495,"ŞCOALA SATUL TARIŢA",TĂRÎŢA,BC,842,1,0,0,1,5,2,0,7,8,4,0,12,14,4,0,18,17,4,0,21
24356,496,"ŞCOALA SATUL BĂHNĂŞENI",BĂHNĂŞENI,BC,708,5,3,0,8,11,3,0,14,14,3,0,17,16,3,0,19,17,3,0,20
24365,497,"ŞCOALA SATUL BĂRNEŞTI",BĂRNEŞTI,BC,189,4,2,0,6,7,4,0,11,7,5,0,12,9,5,0,14,11,6,0,17
24374,498,"ŞCOALA SATUL BĂSEŞTI",BĂSĂŞTI,BC,517,2,0,0,2,4,0,0,4,10,1,0,11,20,2,0,22,21,2,0,23
24392,499,"ŞCOALA SATUL HĂINEALA",HÂINEALA,BC,225,2,2,0,4,2,3,0,5,2,3,0,5,5,4,0,9,7,4,0,11
24383,500,"ŞCOALA SATUL CÎMPENI",CÎMPENI,BC,511,6,0,0,6,8,0,0,8,13,0,14,27,24,0,14,38,25,0,14,39
24409,501,"GRĂDINIŢA PUSTIANA",PUSTIANA,BC,687,6,0,0,6,10,0,0,10,13,2,0,15,16,2,0,18,16,7,0,23
24409,502,"ŞCOALA CU CLASELE .I-VIII PUSTIANA",PUSTIANA,BC,893,2,1,0,3,6,1,0,7,9,3,0,12,11,4,0,15,13,5,0,18
24196,503,"ŞCOALA NR.1 PÎNCEŞTI",PÎNCEŞTI,BC,1169,5,4,0,9,17,8,0,25,41,8,0,49,50,12,0,62,52,12,0,64
24212,504,"ŞCOALA SATUL DIENEŢ",DIENEŢ,BC,540,7,0,0,7,7,0,0,7,7,0,0,7,10,2,0,12,10,2,0,12
24258,505,"ŞCOALA GENERALĂ SATUL PETREŞTI",PETREŞTI,BC,661,6,4,0,10,17,6,0,23,22,7,0,29,28,8,0,36,31,8,0,39
24267,506,"ŞCOALA GENERALĂ SATUL SOCI",SOCI,BC,639,2,3,0,5,10,4,0,14,14,4,0,18,18,4,0,22,18,4,0,22
24221,507,"ŞCOALA GENERALĂ SATUL FULGERIŞ",FULGERIŞ,BC,401,1,6,0,7,9,6,0,15,13,6,0,19,17,6,0,23,17,7,0,24
24310,508,"GRĂDINIŢA CU PROGRAM NORMAL SATUL PÎRÎU BOGHII","PÎRÎU BOGHII",BC,370,5,3,0,8,12,4,0,16,12,4,0,16,13,4,0,17,13,4,0,17
24285,509,"ŞCOALA GIMNAZIALĂDUMITRU MĂRTINAŞ SATUL PÎRGĂREŞTI",PÎRGĂREŞTI,BC,828,0,0,0,0,0,0,0,0,6,0,0,6,8,0,0,8,10,0,0,10
24329,510,"ŞCOALA GIMNAZIALĂ VASILE GH.RADU SATUL SATU NOU","SATU NOU",BC,1360,3,1,0,4,4,1,0,5,6,1,0,7,9,1,0,10,10,3,0,13
24301,511,"ŞCOALA GIMNAZIALĂ CONSTANTIN MUŞAT SATUL NICOREŞTI",NICOREŞTI,BC,828,4,0,0,4,5,2,0,7,6,2,0,8,6,2,0,8,6,2,0,8
24294,512,"GRĂDINIŢA CU PROGRAM NORMAL BAHNA",BAHNA,BC,482,2,0,0,2,8,0,0,8,10,0,0,10,12,1,0,13,12,1,0,13
24436,513,"PRIMĂRIA PLOPANA",PLOPANA,BC,766,6,0,0,6,10,1,0,11,18,1,0,19,24,2,0,26,25,2,0,27
24463,514,"ŞCOALA CU CLASELE I-IV SATUL FUNDU TUTOVEI","FUNDU TUTOVEI",BC,468,4,2,0,6,6,3,0,9,24,7,0,31,31,9,0,40,32,9,0,41
24472,515,"ŞCOALA CU CLASELE I-IV SATUL IŢCANI",IŢCANI,BC,618,5,0,0,5,5,1,0,6,10,3,0,13,17,3,0,20,17,3,0,20
24481,516,"ŞCOALA CU CLASELE I-VIII SATUL RUSENII-RĂZEŞI","RUSENII RĂZEŞI",BC,318,1,0,0,1,3,0,0,3,4,3,0,7,4,5,0,9,5,5,0,10
24506,517,"ŞCOALA CU CLASELE I-IV SATUL STRĂMINOASA",STRĂMINOASA,BC,341,4,3,0,7,6,3,0,9,8,5,0,13,9,7,0,16,10,7,0,17
24533,518,"CĂMINUL CULTURAL PODU TURCULUI","PODU TURCULUI",BC,1828,20,3,0,23,43,7,0,50,51,7,0,58,66,9,0,75,70,10,0,80
24533,519,"ȘCOALA GENERALĂ NR. 3 PODU TURCULUI","PODU TURCULUI",BC,524,28,0,0,28,64,1,0,65,91,1,0,92,97,1,0,98,97,1,0,98
24551,520,"CĂMINUL CULTURAL SATUL CĂBEŞTI",CĂBEŞTI,BC,746,5,2,0,7,9,5,0,14,20,5,0,25,23,7,0,30,23,7,0,30
24597,521,"ŞCOALA GENERALĂ SATUL LEHANCEA",LEHANCEA,BC,530,5,2,0,7,6,2,0,8,17,6,0,23,17,6,0,23,17,6,0,23
24622,522,"ŞCOALA GENERALĂ SATUL SÎRBI",SÎRBI,BC,373,8,0,0,8,14,0,0,14,18,0,0,18,22,0,0,22,24,0,0,24
24640,523,"ŞCOALA SATUL PODURI",PODURI,BC,1200,14,3,1,18,22,3,1,26,27,4,1,32,34,8,1,43,37,8,1,46
24640,524,"ŞCOALA SATUL PODURI",PODURI,BC,1011,14,3,0,17,26,6,0,32,28,6,0,34,34,8,0,42,36,8,0,44
24702,525,"ŞCOALA SATUL VALEA ŞOSII","VALEA ŞOŞII",BC,962,11,0,0,11,19,0,0,19,24,1,0,25,31,1,0,32,33,1,7,41
24695,526,"ŞCOALA SATUL PROHOZEŞTI",PROHOZEŞTI,BC,802,13,0,0,13,22,2,0,24,30,3,0,33,36,3,0,39,39,3,0,42
24659,527,"ŞCOALA SATUL BUCŞEŞTI",BUCŞEŞTI,BC,1333,11,2,0,13,22,3,0,25,27,3,0,30,37,4,0,41,40,4,0,44
24668,528,"ŞCOALA SATUL CERNU",CERNU,BC,1193,8,0,0,8,14,1,0,15,24,3,0,27,29,6,0,35,31,8,0,39
25914,529,"SCOALA GIMNAZIALA GHEORGHE AVRAMESCU PRAJESTI-SALA DE SPORT",PRĂJEŞTI,BC,986,1,0,0,1,7,1,0,8,11,1,0,12,22,2,0,24,24,3,0,27
25914,530,"SCOALA GIMNAZIALA GHEORGHE AVRAMESCU PRĂJEŞTI - SALA CANCELARIEI",PRĂJEŞTI,BC,940,2,0,0,2,7,0,0,7,13,0,0,13,18,0,0,18,20,2,0,22
24720,531,"ŞCOALA NR.1 IOAN BORCEA RACOVA",RACOVA,BC,1300,8,0,0,8,20,3,0,23,23,3,0,26,34,7,0,41,36,8,0,44
24720,532,"ŞCOALA NR.2 RACOVA-ŞES",RACOVA,BC,605,3,0,0,3,5,0,0,5,14,1,0,15,18,2,0,20,18,3,0,21
24739,533,"ŞCOALA SATUL GURA VĂII","GURA VĂII",BC,1039,1,0,0,1,5,3,0,8,8,3,0,11,16,4,0,20,19,4,0,23
24775,534,"CASA DE CULTURĂ NICOLAE STROE SATUL RĂCĂCIUNI",RĂCĂCIUNI,BC,1542,8,0,0,8,19,2,0,21,22,2,0,24,29,3,0,32,29,5,0,34
24775,535,"GRĂDINIŢA NR.2 SATUL RĂCĂCIUNI",RĂCĂCIUNI,BC,1323,7,2,0,9,16,3,0,19,18,3,0,21,25,3,0,28,34,3,0,37
24800,536,"ŞCOALA CU CLASELE I-VIII SATUL GHEORGHE DOJA","GHEORGHE DOJA",BC,932,1,0,0,1,4,1,0,5,7,1,0,8,7,1,0,8,9,2,0,11
24819,537,"ŞCOALA CU CLASELE I-VIII SATUL GÎŞTENI",GÎŞTENI,BC,745,2,16,0,18,8,73,0,81,10,73,0,83,11,73,19,103,11,74,19,104
24793,538,"ŞCOALA CU CLASELE I-VIII SATUL FUNDU RĂCĂCIUNI","FUNDU RĂCĂCIUNI",BC,1512,26,4,0,30,32,4,0,36,37,4,0,41,37,5,0,42,42,5,0,47
24784,539,"ŞCOALA CU CLASELE I-IV SATUL CIUCANI",CIUCANI,BC,476,5,0,0,5,5,0,0,5,5,0,0,5,6,0,0,6,6,0,0,6
24846,540,"CĂMINUL CULTURAL SATUL RĂCHITOASA",RĂCHITOASA,BC,1131,7,0,0,7,10,0,0,10,13,1,0,14,17,2,73,92,17,2,73,92
24926,541,"ŞCOALA CU CLASELE .I-IV SATUL FUNDĂTURA-RĂCHITOASA","FUNDĂTURA RĂCHITOASA",BC,227,2,3,0,5,2,5,0,7,4,6,0,10,10,6,0,16,12,6,0,18
24908,542,"ŞCOALA CU CLASELE.I-VIII SATUL DUMBRAVA",DUMBRAVA,BC,532,5,3,0,8,10,3,0,13,10,3,0,13,10,3,0,13,10,3,0,13
24882,543,"ŞCOALA CU CLASELE.I-VIII SATUL BURDUSACI",BURDUSACI,BC,711,5,3,0,8,8,3,0,11,14,4,0,18,15,4,0,19,15,4,0,19
24855,544,"ŞCOALA CU CLASELE.I-IV SATUL BARCANA",BARCANA,BC,523,1,3,0,4,5,4,0,9,7,4,0,11,11,5,0,16,13,5,0,18
24873,545,"ŞCOALA CU CLASELE .I-VIII SATUL BUDA",BUDA,BC,541,3,0,0,3,3,6,0,9,8,9,0,17,8,9,0,17,8,9,0,17
25004,546,"ŞCOALA GIMNAZIALĂ NR.1 SATUL ROŞIORI",ROŞIORI,BC,1014,7,5,0,12,8,5,0,13,9,5,0,14,12,5,0,17,13,5,0,18
25031,547,"ŞCOALA PRIMARĂ SATUL POIENI",POIENI,BC,286,3,3,0,6,5,5,0,10,8,6,0,14,9,6,0,15,9,6,0,15
25040,548,"ŞCOALA PRIMARĂ SATUL VALEA MARE","VALEA MARE",BC,473,4,3,0,7,9,3,0,12,10,3,0,13,11,3,0,14,13,3,0,16
25077,549,"LICEUL JACQUES MENACHEN ELIAS SASCUT",SASCUT,BC,1342,16,5,0,21,27,6,0,33,31,10,0,41,49,12,0,61,61,12,0,73
25077,550,"LICEUL JACQUES MENACHEN ELIAS SASCUT",SASCUT,BC,1269,15,1,0,16,20,2,0,22,25,2,0,27,33,2,0,35,42,3,0,45
25086,551,"SCOALA GENERALA CU CLASELE I-IV BERESTI",BEREŞTI,BC,1150,14,9,0,23,26,9,0,35,64,16,0,80,123,20,0,143,174,20,0,194
25095,552,"SCOALA CU CLASELE I-IV SATUL CONTESTI",CONŢEŞTI,BC,454,6,17,5,28,10,17,5,32,11,17,5,33,14,17,5,36,14,12,5,31
25102,553,"SCOALA CU CLASELE I-VIIINR 1 PANCESTI",PĂNCEŞTI,BC,933,18,0,0,18,43,0,0,43,60,0,0,60,72,0,0,72,76,0,0,76
25102,554,"SCOALA CU CLASELE I-VIII NR 1 PANCESTI",PĂNCEŞTI,BC,1279,33,0,0,33,57,3,0,60,59,3,0,62,67,3,0,70,69,3,0,72
25111,555,"SCOALA CU CLASELE I-VIII SATUL SASCUT-SAT",SASCUT-SAT,BC,908,8,1,0,9,22,3,0,25,27,5,0,32,32,6,10,48,34,6,10,50
25111,556,"SCOALA CU CLASELE I-VIII SATUL SASCUT-SAT",SASCUT-SAT,BC,783,3,2,0,5,11,4,0,15,14,4,0,18,24,4,7,35,24,4,7,35
25157,557,"ŞOALA GENERALĂCU CLASELE I-VIII SĂNDULENI",SĂNDULENI,BC,1609,2,0,0,2,6,0,0,6,10,2,0,12,15,3,0,18,17,3,0,20
25219,558,"ŞCOALA GENERALA CU CLASELE I-VIII VERŞEŞTI",VERŞEŞTI,BC,676,1,0,0,1,4,0,0,4,12,0,0,12,18,0,0,18,18,0,0,18
25175,559,"ŞCOALA GENERALĂ CU CLASELE I-VIII COMAN",COMAN,BC,1078,1,0,0,1,4,1,0,5,6,1,0,7,6,1,0,7,6,1,0,7
25193,560,"ŞCOALA GENERALĂ CU CLASELE I-IV STUFU",STUFU,BC,303,2,0,0,2,4,0,0,4,7,0,0,7,9,0,0,9,14,0,0,14
23779,561,"SCOALA NR. 1 SĂRATA",SĂRATA,BC,591,6,2,0,8,11,3,0,14,12,5,0,17,17,5,0,22,19,5,0,24
23779,562,"SCOALA NR. 2 SĂRATA",SĂRATA,BC,814,7,2,0,9,13,4,0,17,20,8,0,28,31,9,2,42,31,9,2,42
23779,563,"SCOALA NR. 3 SĂRATA",SĂRATA,BC,395,0,3,0,3,14,3,0,17,18,3,0,21,20,3,0,23,20,3,0,23
25237,564,"ŞCOALA I.S.STURZA SATUL SĂUCEŞTI",SĂUCEŞTI,BC,1091,18,2,0,20,28,4,0,32,44,5,0,49,55,6,0,61,56,7,0,63
25237,565,"ŞCOALA I.S.STURZA SATUL SĂUCEŞTI",SĂUCEŞTI,BC,948,5,0,0,5,14,0,0,14,28,2,0,30,32,2,0,34,37,2,0,39
25264,566,"ŞCOALA SATUL SCHINENI",SCHINENI,BC,673,7,1,0,8,11,1,0,12,15,4,0,19,21,5,0,26,22,5,0,27
25273,567,"ŞCOALA SATUL SIRETU",SIRETU,BC,650,11,9,0,20,21,10,0,31,24,13,0,37,30,13,0,43,30,13,0,43
25282,568,"ŞCOALA SATUL ŞERBEŞTI",ŞERBEŞTI,BC,477,6,2,0,8,16,3,0,19,26,3,0,29,32,5,0,37,32,5,0,37
25246,569,"ŞCOALA SATUL BOGDAN VODĂ","BOGDAN VODĂ",BC,555,12,3,0,15,15,4,0,19,17,4,0,21,22,7,0,29,24,7,0,31
25308,570,"ŞCOALA CU CLASELE I-VIII SATUL SCORŢENI",SCORŢENI,BC,1265,4,2,0,6,4,2,0,6,7,2,0,9,10,3,0,13,12,3,0,15
25335,571,"CAMIN CULTURAL GRIGORENI",GRIGORENI,BC,684,2,0,0,2,4,1,0,5,6,3,0,9,12,3,0,15,16,3,0,19
25326,572,"CAMIN CULTURAL FLORESTI",FLOREŞTI,BC,554,2,2,0,4,2,4,0,6,5,4,0,9,6,4,0,10,10,5,0,15
25371,573,"ŞCOALA GIMNAZIALĂ SATUL SECUIENI",SECUIENI,BC,1109,2,1,0,3,7,4,0,11,11,5,0,16,16,5,0,21,19,6,0,25
25424,574,"ŞCOALA SATUL FUNDENI",FUNDENI,BC,292,1,0,0,1,3,0,0,3,5,0,0,5,10,2,0,12,10,2,0,12
25406,575,"ŞCOALA SATUL CHITICENI",CHITICENI,BC,150,7,2,0,9,15,2,0,17,17,8,0,25,17,8,0,25,18,8,0,26
25433,576,"ŞCOALA SATUL GLODIŞOARELE",GLODIŞOARELE,BC,218,0,0,0,0,1,0,0,1,1,0,0,1,3,0,0,3,4,0,0,4
25497,577,"ŞCOALA CU CLASELE I-VIII SATUL SOLONŢ",SOLONŢ,BC,1226,11,0,0,11,23,2,0,25,36,2,0,38,38,2,1,41,48,2,1,51
25512,578,"CABINET MEDICAL",SĂRATA,BC,686,4,0,0,4,13,0,0,13,14,0,0,14,14,0,6,20,17,2,6,25
25503,579,"ŞCOALA CU CLASELE I-VIII SATUL CUCUIEȚI",CUCUIEŢI,BC,1044,4,0,0,4,7,4,0,11,10,5,0,15,19,5,24,48,23,6,24,53
25530,580,"PRIMĂRIA STĂNIŞEŞTI",STĂNIŞEŞTI,BC,811,5,1,0,6,22,8,0,30,24,9,8,41,32,10,8,50,32,10,8,50
25567,581,"MODUL TIP BIROU (CONTAINER MODULAR)",BENEŞTI,BC,372,2,3,0,5,5,4,0,9,5,4,5,14,8,4,5,17,8,4,5,17
25576,582,"SCOALA SATUL CRĂIEŞTI",CRĂIEŞTI,BC,366,0,0,0,0,0,0,0,0,1,0,0,1,2,2,0,4,2,2,0,4
25594,583,"SCOALASLOBOZIANR. 2",SLOBOZIA,BC,476,0,0,0,0,3,3,0,6,3,3,0,6,5,4,0,9,7,6,0,13
25594,584,"ŞCOALA 1 SATUL SLOBOZIA",SLOBOZIA,BC,746,2,3,0,5,3,5,0,8,4,9,0,13,4,10,5,19,4,10,5,19
25601,585,"ŞCOALA SATUL SLOBOZIA NOUĂ","SLOBOZIA NOUĂ",BC,561,3,2,0,5,3,3,7,13,9,9,7,25,13,9,7,29,15,9,7,31
25638,586,"ŞCOALA GENERALĂ SATUL STRUGARI",STRUGARI,BC,846,11,1,0,12,24,1,0,25,26,1,0,27,29,1,0,30,33,1,0,34
25683,587,"ŞCOALA GENERALĂ SATUL RĂCHITIŞ",RĂCHITIŞU,BC,337,4,4,0,8,7,5,0,12,7,5,6,18,9,6,6,21,9,6,6,21
25674,588,"ŞCOALA GENERALĂ SATUL PETRICICA",PETRICICA,BC,588,2,0,0,2,3,0,0,3,6,0,0,6,9,0,0,9,11,5,0,16
25684,589,"SCOALA GENERALA CETATUIA",CETĂŢUIA,BC,221,4,1,0,5,8,1,2,11,14,4,2,20,16,4,2,22,23,4,2,29
20689,590,"GRĂDINIŢA CU PROGRAM NORMAL SATUL ŞTEFAN CEL MARE","ŞTEFAN CEL MARE",BC,754,3,0,0,3,3,0,0,3,5,0,0,5,8,0,0,8,8,0,0,8
20689,591,"GRĂDINIŢA CU PROGRAM NORMAL SATUL STEFAN CEL MARE","ŞTEFAN CEL MARE",BC,489,4,0,0,4,45,1,0,46,46,1,0,47,46,2,0,48,46,2,0,48
20723,592,"BIBLIOTECA COMUNALĂ SATUL NEGOIEŞTI",NEGOIEŞTI,BC,723,5,4,0,9,8,6,0,14,13,8,0,21,25,8,0,33,29,8,0,37
20750,593,"GRĂDINIŢA CU PROGRAM NORMAL SATUL VIIŞOARA",VIIŞOARA,BC,507,5,1,0,6,6,1,0,7,10,1,0,11,12,1,0,13,12,1,0,13
20714,594,"GRĂDINIŢA CU PROGRAM NORMAL SATUL GUTINAŞ",GUTINAŞ,BC,342,7,1,0,8,10,2,0,12,11,2,0,13,15,4,0,19,16,4,0,20
20741,595,"GRĂDINIŢA CU PROGRAM NORMAL SATUL RĂDEANA",RĂDEANA,BC,1199,6,2,0,8,9,3,0,12,13,3,0,16,16,3,0,19,16,3,0,19
25709,596,"CENTRUL EDUCAŢIONAL ÎNV.DUMITRU NEDIŢĂ TAMAŞI",TAMAŞI,BC,1261,3,0,0,3,20,1,0,21,32,1,0,33,45,1,0,46,52,1,0,53
25718,597,"ŞCOALA CU CLASELE I-VIII SATUL CHETRIŞ",CHETRIŞ,BC,635,4,2,0,6,6,6,0,12,13,6,0,19,15,7,0,22,16,7,0,23
25727,598,"ŞCOALA CU CLASELE I-IV SATUL FURNICARI",FURNICARI,BC,532,1,0,0,1,6,3,0,9,10,3,0,13,15,3,0,18,16,4,0,20
25754,599,"PRIMĂRIA TĂTĂRĂŞTI",TĂTĂRĂŞTI,BC,381,3,2,0,5,4,2,0,6,5,2,0,7,6,2,0,8,7,2,0,9
25772,600,"ŞCOALA GIMNAZIALA SATUL CORNII DE SUS","CORNII DE SUS",BC,728,5,1,0,6,10,2,0,12,10,3,0,13,13,3,0,16,14,3,0,17
25807,601,"ŞCOALA PRIMARA SATUL GIURGENI",GIURGENI,BC,198,0,1,0,1,1,1,0,2,2,2,0,4,4,4,0,8,5,4,0,9
25781,602,"ŞCOALA PRIMARA SATUL DRĂGEŞTI",DRĂGEŞTI,BC,299,2,0,0,2,4,1,0,5,4,5,0,9,7,6,0,13,11,9,0,20
25790,603,"ŞCOALA PRIMARA SATUL GHERDANA",GHERDANA,BC,289,0,0,0,0,1,0,0,1,1,0,0,1,2,0,0,2,4,0,0,4
25852,604,"GRĂDINIŢA CU PROGRAMNORMAL SATUL VIIŞOARA",VIIŞOARA,BC,928,5,6,0,11,12,6,0,18,16,6,0,22,20,7,0,27,22,7,0,29
25834,605,"GRĂDINIŢA CU PROGRAM NORMAL TG.TROTUŞ","TÎRGU TROTUŞ",BC,927,2,1,0,3,10,4,0,14,14,4,0,18,18,4,0,22,19,4,0,23
25834,606,"GRĂDINIŢA CU PROGRAM NORMAL TG.TROTUŞ","TÎRGU TROTUŞ",BC,905,5,0,0,5,12,0,0,12,20,0,0,20,23,0,0,23,24,0,0,24
25843,607,"GRĂDINIŢA CU PROGRAM NORMAL SATUL TUTA",TUTA,BC,824,7,0,0,7,12,0,0,12,19,0,0,19,19,0,0,19,20,0,0,20
25843,608,"GRĂDINIŢA CU PROGRAM NORMAL SATUL TUTA",TUTA,BC,944,4,0,0,4,9,0,0,9,19,0,0,19,23,6,0,29,31,7,0,38
25870,609,"ŞCOALA CU CLASELE I-VIII SATUL TRAIAN",TRAIAN,BC,1439,6,1,0,7,11,7,0,18,23,10,0,33,32,13,0,45,38,13,0,51
25889,610,"ŞCOALA CU CLASELE I-IV SATUL BOGDĂNEŞTI",BOGDĂNEŞTI,BC,460,0,0,0,0,2,0,0,2,3,0,0,3,4,2,0,6,4,2,0,6
25923,611,"ŞCOALA CU CLASELE I-IV SATUL ZĂPODIA",ZĂPODIA,BC,519,5,1,0,6,8,2,0,10,9,7,0,16,9,8,0,17,9,8,0,17
25898,612,"ŞCOALA CU CLASELE I-IV SATUL HERTIOANA DE JOS","HERTIOANA DE JOS",BC,147,0,0,0,0,1,0,0,1,3,1,0,4,3,1,0,4,3,1,0,4
25941,613,"CĂMINUL CULTURAL UNGURENI",UNGURENI,BC,774,14,9,0,23,34,11,0,45,43,12,0,55,44,14,0,58,45,14,0,59
26001,614,SCOALAVIFORENI,VIFORENI,BC,377,1,2,0,3,8,5,0,13,13,6,0,19,17,8,0,25,20,8,0,28
25950,615,"ŞCOALA SATUL BĂRTĂŞEŞTI",BĂRTĂŞEŞTI,BC,294,9,1,0,10,21,9,0,30,34,9,0,43,41,9,0,50,41,9,0,50
25987,616,"CĂMINUL CULTURAL SATUL BOTEŞTI",BOTEŞTI,BC,679,3,3,0,6,6,3,0,9,16,4,0,20,25,5,0,30,25,5,0,30
25969,617,"SCOALA BIBIRESTI II",BIBIREŞTI,BC,769,6,2,0,8,12,4,0,16,20,4,0,24,28,4,0,32,31,4,0,35
26038,618,"SALA DE CEREMONII",URECHEŞTI,BC,1410,7,1,0,8,17,2,0,19,26,3,0,29,30,3,0,33,32,3,0,35
26047,619,"CĂMINUL CULTURAL SATUL CORNĂŢEL",CORNĂŢEL,BC,696,2,0,0,2,7,0,0,7,7,0,0,7,13,2,0,15,15,2,0,17
26074,620,"GRĂDINIŢA SATUL SLOBOZIA",SLOBOZIA,BC,458,2,2,0,4,6,3,0,9,18,7,0,25,20,8,0,28,21,8,0,29
26056,621,"ŞCOALA GENERALA CU CASELE I-IV SATUL LUNCA DOCHIEI","LUNCA DOCHIEI",BC,274,3,1,0,4,4,1,0,5,6,1,0,7,9,4,0,13,9,4,0,13
26065,622,"ŞCOALA GENERALACU CLASELEI-IV SATUL SATU NOU","SATU NOU",BC,262,1,0,0,1,3,0,0,3,4,0,0,4,8,0,0,8,10,0,0,10
26092,623,"ŞCOALA GIMNAZIALĂ NR.1 VALEA SEACĂ","VALEA SEACĂ",BC,927,16,6,0,22,28,6,0,34,42,11,0,53,55,11,0,66,61,13,0,74
26092,624,"ŞCOALA PRIMARĂ NR.2 VALEA SEACĂ","VALEA SEACĂ",BC,661,7,1,0,8,22,3,0,25,29,5,0,34,41,13,0,54,41,13,0,54
26092,625,"ŞCOALA PRIMARĂ NR.3 VALEA SEACĂ","VALEA SEACĂ",BC,737,6,4,0,10,14,5,0,19,22,5,0,27,32,7,0,39,36,7,0,43
26109,626,"ŞCOALA PRIMARĂ CUCOVA",CUCOVA,BC,556,4,5,0,9,6,6,0,12,8,6,0,14,14,8,0,22,15,9,0,24
26270,627,"SCOALA VULTURENI",VULTURENI,BC,411,1,0,0,1,5,0,0,5,7,0,0,7,10,0,0,10,11,0,0,11
26127,628,"SOCIETATEA AREAL SA",LICHITIŞENI,BC,437,1,2,0,3,2,2,0,4,7,3,0,10,12,3,0,15,12,3,0,15
26172,629,"CENTRUL EDUCAŢIONAL COMUNITAR GODINEŞTII DE JOS","GODINEŞTII DE JOS",BC,303,0,0,0,0,10,3,0,13,12,5,0,17,12,5,0,17,12,5,0,17
26190,630,"ŞCOALA MEDELENI",MEDELENI,BC,147,2,0,0,2,2,3,0,5,3,3,0,6,5,4,0,9,5,4,0,9
26163,631,"ŞCOALA GHILĂVEŞTI",GHILĂVEŞTI,BC,224,5,0,0,5,5,0,0,5,5,0,0,5,5,0,0,5,6,0,0,6
26298,632,"ŞCOALA MIHAI EMINESCU ZEMEŞ",ZEMEŞ,BC,1090,7,0,0,7,14,1,0,15,17,1,0,18,23,1,0,24,27,1,0,28
26298,633,"ŞCOALA STEFAN CEL MARE ZEMEŞ",ZEMEŞ,BC,1206,23,1,0,24,47,2,0,49,67,3,0,70,75,3,25,103,79,3,25,107
26305,634,"ŞCOALA ION CREANGĂ ZEMEŞ",BOLĂTĂU,BC,873,5,1,0,6,15,2,0,17,21,3,0,24,25,3,0,28,25,3,0,28
26298,635,"ŞCOALA ŞTEFAN CEL MARE ZEMEŞ",ZEMEŞ,BC,724,6,0,0,6,25,0,0,25,40,0,0,40,46,0,0,46,48,0,10,58
26573,1,"COLEGIUL ECONOMIC” PARTENIE COSMA ”",ORADEA,BH,639,9,4,0,13,20,5,0,25,30,6,0,36,43,12,0,55,48,13,0,61
26573,2,"ȘCOALA GIMNAZIALĂ "" LUCREŢIA SUCIU """,ORADEA,BH,1241,17,1,0,18,49,1,0,50,54,4,0,58,71,12,0,83,76,13,52,141
26573,3,"LICEUL TEHNOLOGIC SANITAR ”VASILE VOICULESCU”",ORADEA,BH,1332,18,1,0,19,47,2,0,49,71,3,0,74,93,5,0,98,114,9,0,123
26573,4,"LICEUL TEHNOLOGIC SANITAR“VASILE VOICULESCU”",ORADEA,BH,1421,17,6,0,23,38,8,0,46,70,9,0,79,89,10,0,99,115,13,0,128
26573,5,"GRĂDINIŢA CU PROGRAM PRELUNGIT NR.22",ORADEA,BH,1455,9,3,0,12,29,8,0,37,49,9,0,58,62,11,0,73,71,13,0,84
26573,6,"GRĂDINIŢA CU PROGRAM PRELUNGIT NR.22",ORADEA,BH,1527,10,2,0,12,41,4,0,45,64,6,0,70,92,6,0,98,110,6,0,116
26573,7,"CREȘA NR. 2 ” PICIORUȘE VESELE ”",ORADEA,BH,773,1,3,0,4,13,6,0,19,30,7,0,37,50,7,0,57,55,7,0,62
26573,8,"GRĂDINIȚA CU PROGRAM PRELUNGIT NR. 22",ORADEA,BH,1203,4,0,0,4,21,2,0,23,39,2,0,41,59,3,1,63,72,3,1,76
26573,9,"CREŞA NR.2”PICIORUŞE VESELE”",ORADEA,BH,1264,10,0,0,10,40,1,1,42,58,3,0,61,76,5,0,81,83,5,0,88
26573,10,"ŞCOALA GIMNAZIALĂ ""IOAN SLAVICI""",ORADEA,BH,1444,15,3,0,18,52,7,0,59,81,8,0,89,125,11,0,136,154,11,0,165
26573,11,"ŞCOALA GIMNAZIALĂ ""IOAN SLAVICI""",ORADEA,BH,1587,14,0,0,14,41,0,0,41,58,0,0,58,101,2,0,103,152,3,0,155
26573,12,"ŞCOALA GIMNAZIALĂ ""IOAN SLAVICI""",ORADEA,BH,1308,42,0,0,42,94,1,0,95,136,4,0,140,175,7,0,182,206,9,0,215
26573,13,"ŞCOALA GIMNAZIALĂ ""IOAN SLAVICI""",ORADEA,BH,1449,19,0,0,19,40,0,0,40,67,1,0,68,83,1,0,84,108,1,0,109
26573,14,"ŞCOALA GIMNAZIALĂ ""IOAN SLAVICI""",ORADEA,BH,786,25,1,0,26,48,1,0,49,61,2,0,63,102,4,1,107,124,5,1,130
26573,15,"GRĂDINIŢA CU PROGRAM PRELUNGIT NR.25",ORADEA,BH,727,9,1,0,10,26,2,0,28,43,2,0,45,60,3,0,63,65,5,0,70
26573,16,"GRĂDINIŢA CU PROGRAM PRELUNGIT NR.25",ORADEA,BH,1122,7,3,0,10,24,4,0,28,33,4,0,37,50,7,0,57,58,7,0,65
26573,17,"ŞCOALA GIMNAZIALĂ ""DIMITRIE CANTEMIR""",ORADEA,BH,728,4,8,0,12,31,10,0,41,57,16,0,73,67,18,0,85,70,23,0,93
26573,18,"ŞCOALA GIMNAZIALĂ ""DIMITRIE CANTEMIR""",ORADEA,BH,1076,20,3,0,23,50,3,0,53,67,5,0,72,94,6,0,100,117,6,0,123
26573,19,"ŞCOALA GIMNAZIALĂ ""DIMITRIE CANTEMIR""",ORADEA,BH,1516,16,7,0,23,46,8,0,54,61,8,0,69,89,8,0,97,109,8,0,117
26573,20,"GRĂDINIŢA CU PROGRAM PRELUNGIT NR.24",ORADEA,BH,1431,28,1,0,29,76,6,0,82,106,6,0,112,129,6,0,135,138,6,0,144
26573,21,"LICEUL TEORETIC”ONISIFOR GHIBU”",ORADEA,BH,1380,13,5,0,18,57,6,0,63,59,13,0,72,80,24,0,104,101,25,0,126
26573,22,"GRĂDINIȚA CU PROGRAM PRELUNGIT NR. 56",ORADEA,BH,1168,15,4,0,19,42,10,0,52,71,15,0,86,105,21,1,127,117,22,1,140
26573,23,"GRĂDINIȚA CU PROGRAM PRELUNGIT NR. 56",ORADEA,BH,1840,38,3,0,41,98,5,0,103,151,9,0,160,199,13,0,212,230,16,0,246
26573,24,"GRĂDINIȚA CU PROGRAM PRELUNGIT NR. 56",ORADEA,BH,1699,25,5,0,30,71,7,0,78,101,7,0,108,127,11,0,138,135,11,0,146
26573,25,"GRĂDINIȚA CU PROGRAM PRELUNGIT NR. 56",ORADEA,BH,1825,24,4,0,28,65,5,0,70,103,5,0,108,138,7,2,147,158,8,2,168
26573,26,"GRĂDINIȚA CU PROGRAM PRELUNGIT NR. 56",ORADEA,BH,1860,18,3,0,21,72,3,0,75,109,4,0,113,140,5,0,145,159,6,0,165
26573,27,"LICEUL TEORETIC ""ONISIFOR GHIBU""",ORADEA,BH,1500,24,1,0,25,70,1,0,71,87,6,0,93,133,6,0,139,145,6,0,151
26573,28,"LICEUL TEORETIC ""ONISIFOR GHIBU""",ORADEA,BH,1820,26,1,0,27,45,5,0,50,97,9,0,106,129,11,0,140,137,12,0,149
26573,29,"LICEUL TEORETIC ""ONISIFOR GHIBU""",ORADEA,BH,1660,8,2,0,10,45,9,0,54,73,18,0,91,103,28,0,131,119,34,0,153
26573,30,"LICEUL TEORETIC ""ONISIFOR GHIBU""",ORADEA,BH,1518,11,6,0,17,61,15,0,76,83,20,0,103,109,27,0,136,124,33,0,157
26573,31,"GRĂDINIŢA CU PROGRAM NORMAL NR.2",ORADEA,BH,1739,42,2,0,44,67,4,0,71,132,13,0,145,160,17,0,177,180,21,0,201
26573,32,"GRĂDINIŢA CU PROGRAM PRELUNGIT NR. 28",ORADEA,BH,1496,19,6,0,25,73,10,0,83,115,15,0,130,125,17,0,142,145,26,0,171
26573,33,"CREȘA NR. 3 ”SCUFIȚA ROȘIE”",ORADEA,BH,1507,27,0,0,27,56,6,0,62,91,8,0,99,123,13,0,136,135,13,0,148
26573,34,"CREȘA NR.13”LIZUCA ȘI PATROCLE”",ORADEA,BH,1523,16,0,0,16,63,2,0,65,94,8,0,102,131,15,0,146,148,18,0,166
26573,35,"CREȘA NR.13”LIZUCA ȘI PATROCLE”",ORADEA,BH,1505,14,1,0,15,41,3,0,44,79,7,0,86,109,9,0,118,126,9,0,135
26573,36,"ŞCOALA GIMNAZIALĂ""DIMITRIE CANTEMIR""",ORADEA,BH,1778,30,0,0,30,79,5,0,84,119,13,0,132,165,22,0,187,184,24,0,208
26573,37,"ŞCOALA GIMNAZIALĂ""DIMITRIE CANTEMIR""",ORADEA,BH,1459,27,0,0,27,51,1,0,52,67,3,0,70,101,5,0,106,116,5,0,121
26573,38,"GRĂDINIŢA CU PROGRAM PRELUNGIT NR.46",ORADEA,BH,763,7,2,0,9,30,2,0,32,44,2,0,46,61,3,0,64,69,4,0,73
26573,39,"GRĂDINIŢA CU PROGRAM PRELUNGIT NR.46",ORADEA,BH,1185,11,0,0,11,37,1,0,38,52,3,0,55,73,4,0,77,84,4,0,88
26573,40,"ŞCOALA GIMNAZIALĂ ""NICOLAE BĂLCESCU""",ORADEA,BH,1143,11,3,0,14,32,4,0,36,51,5,0,56,72,7,0,79,76,10,0,86
26573,41,"ŞCOALA GIMNAZIALĂ ""NICOLAE BĂLCESCU""",ORADEA,BH,1122,10,4,0,14,19,5,0,24,32,5,0,37,53,5,0,58,61,5,0,66
26573,42,"ŞCOALA GIMNAZIALĂ",ORADEA,BH,709,5,0,0,5,14,0,0,14,23,0,0,23,27,0,0,27,27,1,0,28
26573,43,"GRĂDINIŢA CU PROGRAM PRELUNGIT NR.53",ORADEA,BH,878,7,4,0,11,25,6,0,31,34,6,0,40,44,6,0,50,50,6,0,56
26573,44,"GRĂDINIŢA CU PROGRAM PRELUNGIT NR.53",ORADEA,BH,856,8,0,0,8,26,0,0,26,44,0,0,44,65,0,0,65,66,0,0,66
26573,45,"GRĂDINIŢA CU PROGRAM PRELUNGIT NR.52",ORADEA,BH,855,7,0,0,7,17,1,0,18,28,2,0,30,42,2,0,44,46,2,0,48
26573,46,"GRĂDINIŢA CU PROGRAM PRELUNGIT NR.52",ORADEA,BH,1377,7,0,0,7,29,0,0,29,50,0,0,50,71,1,0,72,86,1,0,87
26573,47,"GRĂDINIŢA CU PROGRAM PRELUNGIT NR.52",ORADEA,BH,1068,10,0,0,10,29,0,0,29,36,3,0,39,62,3,0,65,69,5,0,74
26573,48,"ŞCOALA GIMNAZIALĂ NR.16",ORADEA,BH,1089,11,1,0,12,37,3,0,40,52,7,0,59,68,8,0,76,73,10,0,83
26573,49,"ŞCOALA GIMNAZIALĂ NR.16",ORADEA,BH,871,8,0,0,8,17,0,0,17,26,1,0,27,38,1,0,39,43,1,0,44
26573,50,"ŞCOALA GIMNAZIALĂ NR.16",ORADEA,BH,1021,20,1,0,21,42,2,0,44,61,3,0,64,81,3,0,84,90,4,0,94
26573,51,"ŞCOALA GIMNAZIALĂ NR.16",ORADEA,BH,1462,14,4,0,18,46,6,0,52,71,10,0,81,90,11,0,101,104,13,0,117
26573,52,"LICEUL TEORETIC ""LUCIAN BLAGA""",ORADEA,BH,1267,13,4,0,17,44,8,0,52,65,9,0,74,116,13,0,129,116,13,0,129
26573,53,"LICEUL TEORETIC ""LUCIAN BLAGA""",ORADEA,BH,1617,24,7,0,31,68,7,0,75,92,8,0,100,113,12,0,125,117,13,0,130
26573,54,"LICEUL TEORETIC ""LUCIAN BLAGA""",ORADEA,BH,1356,26,1,0,27,81,3,0,84,119,7,0,126,141,8,0,149,148,9,0,157
26573,55,"LICEUL TEORETIC ""LUCIAN BLAGA""",ORADEA,BH,1463,13,6,0,19,49,6,0,55,67,6,0,73,95,7,0,102,109,7,0,116
26573,56,"GRĂDINIŢA CU PROGRAM NORMAL NR.17",ORADEA,BH,1633,26,0,0,26,85,2,0,87,130,2,0,132,148,3,0,151,162,5,0,167
26573,57,"GRĂDINIŢA CU PROGRAM PRELUNGIT NR.20",ORADEA,BH,1431,18,8,0,26,40,8,0,48,66,9,0,75,73,10,0,83,83,15,0,98
26573,58,"LICEUL ORTODOX ""EPISCOP ROMAN CIOROGARIU""",ORADEA,BH,845,10,5,0,15,23,6,0,29,37,8,0,45,43,15,0,58,48,16,0,64
26573,59,"LICEUL ORTODOX ""EPISCOP ROMAN CIOROGARIU""",ORADEA,BH,875,5,0,0,5,35,0,0,35,50,0,0,50,71,0,0,71,76,0,0,76
26573,60,"LICEUL ORTODOX ""EPISCOP ROMAN CIOROGARIU""",ORADEA,BH,924,3,0,0,3,18,4,0,22,24,5,0,29,40,6,0,46,47,6,0,53
26573,61,"LICEUL ORTODOX ""EPISCOP ROMAN CIOROGARIU""",ORADEA,BH,1264,9,0,0,9,33,0,0,33,52,1,0,53,80,1,0,81,88,1,0,89
26573,62,"LICEUL ORTODOX ""EPISCOP ROMAN CIOROGARIU""",ORADEA,BH,1466,10,1,0,11,49,2,0,51,82,4,0,86,104,5,0,109,113,6,0,119
26573,63,"LICEUL ORTODOX ""EPISCOP ROMAN CIOROGARIU""",ORADEA,BH,1320,16,4,0,20,39,4,0,43,78,4,0,82,95,4,0,99,101,4,0,105
26573,64,"GRĂDINIŢA CU PROGRAM PRELUNGIT NR. 54",ORADEA,BH,1025,21,3,0,24,59,5,0,64,81,5,0,86,96,10,0,106,101,11,0,112
26573,65,"GRĂDINIŢA CU PROGRAM PRELUNGIT NR. 54",ORADEA,BH,1046,12,0,0,12,43,0,0,43,63,2,0,65,80,4,0,84,86,5,0,91
26573,66,"ŞCOALA GIMNAZIALĂ ""DACIA""",ORADEA,BH,1239,15,1,0,16,42,1,0,43,77,3,0,80,88,8,0,96,99,10,0,109
26573,67,"ŞCOALA GIMNAZIALĂ ""DACIA""",ORADEA,BH,1472,18,0,0,18,48,1,0,49,71,3,0,74,115,4,0,119,139,6,0,145
26573,68,"ŞCOALA GIMNAZIALĂ ""DACIA""",ORADEA,BH,1109,13,1,0,14,32,1,0,33,47,5,0,52,80,5,0,85,86,5,0,91
26573,69,"GRĂDINIŢA CU PROGRAM PRELUNGIT NR. 45",ORADEA,BH,1070,14,4,0,18,44,4,0,48,49,5,0,54,63,7,0,70,72,7,0,79
26573,70,"GRĂDINIŢA CU PROGRAM PRELUNGIT NR. 45",ORADEA,BH,1391,18,1,0,19,61,4,0,65,90,5,0,95,118,6,0,124,122,7,0,129
26573,71,"GRĂDINIŢA CU PROGRAM PRELUNGIT NR. 45",ORADEA,BH,1466,15,0,0,15,36,0,0,36,54,0,0,54,70,2,0,72,77,2,0,79
26573,72,"GRĂDINIŢA CU PROGRAM PRELUNGIT NR. 45",ORADEA,BH,1188,11,0,0,11,46,1,0,47,62,1,0,63,87,2,0,89,97,4,0,101
26573,73,"LICEUL DE ARTE",ORADEA,BH,1747,16,5,0,21,56,5,0,61,84,6,0,90,112,8,0,120,133,8,0,141
26573,74,"LICEUL DE ARTE",ORADEA,BH,1528,26,1,0,27,66,4,0,70,89,7,0,96,114,9,0,123,132,10,0,142
26573,75,"LICEUL DE ARTE",ORADEA,BH,1611,19,0,0,19,70,9,0,79,90,12,0,102,119,12,0,131,127,13,0,140
26573,76,"LICEUL DE ARTE",ORADEA,BH,1383,10,1,0,11,49,2,0,51,77,2,0,79,109,4,0,113,114,4,0,118
26573,77,"LICEUL DE ARTE",ORADEA,BH,1387,14,0,0,14,46,0,0,46,75,1,1,77,98,1,1,100,103,1,1,105
26573,78,"LICEUL DE ARTE",ORADEA,BH,1484,11,4,0,15,40,4,0,44,75,4,0,79,100,4,0,104,112,4,0,116
26573,79,ORĂŞELULCOPIILOR,ORADEA,BH,1586,17,0,0,17,53,4,0,57,76,4,0,80,99,16,4,119,115,22,4,141
26573,80,"GRĂDINIŢA CU PROGRAM NORMAL NR. 15",ORADEA,BH,1900,9,0,0,9,32,10,10,52,39,10,10,59,68,10,10,88,72,13,10,95
26573,81,"ŞCOALA GIMNAZIALĂ""JUHASZ GYULA""",ORADEA,BH,1018,6,0,0,6,32,2,0,34,54,4,0,58,66,4,0,70,76,4,0,80
26573,82,"ŞCOALA GIMNAZIALĂ""JUHASZ GYULA""",ORADEA,BH,1096,3,0,0,3,23,0,0,23,34,6,0,40,45,7,0,52,51,7,0,58
26573,83,"GRĂDINIȚA CU PROGRAM PRELUNGIT NR.42",ORADEA,BH,1593,13,0,0,13,49,7,0,56,81,7,0,88,112,11,0,123,123,12,0,135
26573,84,"GRĂDINIȚA CU PROGRAM PRELUNGIT NR.42",ORADEA,BH,893,10,2,0,12,28,2,0,30,45,2,0,47,71,2,0,73,86,4,0,90
26573,85,"GRĂDINIȚA CU PROGRAM PRELUNGIT NR.42",ORADEA,BH,1470,10,0,0,10,31,0,0,31,47,0,0,47,63,2,0,65,77,5,0,82
26573,86,"ŞCOALA GIMNAZIALĂ""OCTAVIAN GOGA""",ORADEA,BH,1394,16,1,0,17,39,2,0,41,54,8,0,62,92,11,0,103,104,12,0,116
26573,87,"ŞCOALA GIMNAZIALĂ""OCTAVIAN GOGA""",ORADEA,BH,1427,11,5,0,16,47,8,0,55,74,8,0,82,122,10,0,132,135,10,0,145
26573,88,"COLEGIUL TEHNIC ""CONSTANTIN BRÂNCUȘI""",ORADEA,BH,1585,21,2,0,23,45,4,0,49,65,5,0,70,79,9,0,88,103,11,0,114
26573,89,"COLEGIUL TEHNIC ""CONSTANTIN BRÂNCUȘI""",ORADEA,BH,1602,9,0,0,9,23,2,0,25,67,2,0,69,101,2,0,103,108,4,0,112
26573,90,"COLEGIUL TEHNIC ""TRAIAN VUIA""",ORADEA,BH,1001,14,0,0,14,35,6,0,41,48,6,0,54,63,6,0,69,72,6,0,78
26573,91,"GRĂDINIŢA CU PROGRAM PRELUNGITNR. 55",ORADEA,BH,1150,25,3,0,28,58,4,0,62,94,7,0,101,114,10,0,124,121,10,0,131
26573,92,"FUNDAŢIA DE SCLEROZĂ MULTIPLĂ",ORADEA,BH,1323,14,5,0,19,58,7,0,65,83,7,0,90,114,9,0,123,121,10,0,131
26573,93,"FUNDAŢIA DE SCLEROZĂ MULTIPLĂ",ORADEA,BH,1287,12,6,0,18,43,6,0,49,60,6,0,66,83,6,0,89,89,6,0,95
26573,94,"GRĂDINIŢA CU PROGRAM PRELUNGITNR. 35",ORADEA,BH,1169,13,1,0,14,40,3,0,43,59,4,0,63,69,5,0,74,73,6,0,79
26573,95,"GRĂDINIŢA CU PROGRAM PRELUNGITNR. 35",ORADEA,BH,1033,5,1,0,6,34,2,0,36,74,2,0,76,90,2,0,92,92,2,0,94
26573,96,"CENTRUL DE ÎNGRIJIRE DE ZI",ORADEA,BH,1324,11,1,0,12,44,2,0,46,63,4,0,67,85,6,0,91,98,6,0,104
26573,97,"CENTRUL DE ÎNGRIJIRE DE ZI",ORADEA,BH,1222,16,2,0,18,25,3,0,28,55,3,0,58,91,4,0,95,99,4,0,103
26573,98,"CENTRU ŞCOLAR PENTRU EDUCAŢIE INCLUZIVĂ ""ORIZONT""",ORADEA,BH,1397,14,4,0,18,33,4,0,37,52,6,0,58,75,9,0,84,85,9,0,94
26573,99,"ŞCOALA GIMNAZIALĂ NR. 11",ORADEA,BH,1111,15,5,0,20,48,9,0,57,61,17,0,78,93,17,0,110,96,19,0,115
26573,100,"ŞCOALA GIMNAZIALĂ NR. 11",ORADEA,BH,1553,21,0,0,21,48,4,0,52,67,5,0,72,90,5,0,95,113,6,0,119
26573,101,"ŞCOALA GIMNAZIALĂ NR. 11",ORADEA,BH,1225,17,2,0,19,39,2,0,41,58,3,0,61,88,5,0,93,101,5,0,106
26573,102,"ŞCOALA GIMNAZIALĂ NR. 11",ORADEA,BH,1047,8,1,0,9,28,1,0,29,45,1,0,46,54,1,0,55,61,2,0,63
26573,103,"ŞCOALA GIMNAZIALĂ NR. 11",ORADEA,BH,1499,21,4,0,25,38,6,0,44,69,7,0,76,106,8,0,114,122,8,0,130
26573,104,"ŞCOALA GIMNAZIALĂ NR. 11",ORADEA,BH,1332,11,0,0,11,51,0,0,51,73,0,0,73,108,0,0,108,117,0,0,117
26573,105,"ŞCOALA GIMNAZIALĂ NR. 11",ORADEA,BH,821,10,0,0,10,24,0,0,24,45,0,0,45,57,0,0,57,69,0,0,69
26573,106,"ŞCOALA GIMNAZIALĂ NR. 11",ORADEA,BH,1378,21,0,0,21,52,0,0,52,76,0,0,76,101,1,0,102,117,2,0,119
26573,107,"GRĂDINIŢA CU PROGRAM PRELUNGIT NR. 41",ORADEA,BH,1780,25,2,0,27,65,3,0,68,95,4,0,99,116,4,0,120,137,4,0,141
26573,108,"GRĂDINIŢA CU PROGRAM PRELUNGIT NR. 41",ORADEA,BH,1721,22,0,0,22,69,3,0,72,87,7,0,94,122,9,0,131,130,11,0,141
26573,109,"ŞCOALA GIMNAZIALĂ""ION BOGDAN""",ORADEA,BH,1875,38,2,0,40,118,3,0,121,180,3,0,183,250,3,0,253,290,6,0,296
26573,110,"ŞCOALA GIMNAZIALĂ""ION BOGDAN""",ORADEA,BH,1927,50,1,0,51,128,4,0,132,178,7,0,185,241,14,0,255,263,17,0,280
26573,111,"GRĂDINIȚA ”WALDORF ” ( FOSTĂ ŞCOALA GIMNAZIALĂ ""DACIA"")",ORADEA,BH,1247,27,1,0,28,60,2,0,62,97,3,0,100,131,5,49,185,137,5,49,191
26573,112,"GRĂDINIȚA ”WALDORF ” ( FOSTĂ ŞCOALA GIMNAZIALĂ ""DACIA"")",ORADEA,BH,1583,15,0,0,15,62,1,0,63,96,3,0,99,126,4,0,130,137,4,1,142
26573,113,"GRĂDINIȚA CU PROGRAM PRELUNGIT NR. 23",ORADEA,BH,1088,11,3,0,14,35,4,0,39,49,5,104,158,70,9,104,183,86,10,104,200
26573,114,"GRĂDINIȚA CU PROGRAM PRELUNGIT NR. 23",ORADEA,BH,1811,30,4,0,34,69,8,0,77,119,14,0,133,165,18,0,183,179,20,0,199
26573,115,"GRĂDINIŢA CU PROGRAM NORMAL NR. 16",ORADEA,BH,1858,58,22,0,80,106,65,0,171,148,66,0,214,173,69,13,255,197,73,13,283
26573,116,"UNIVERSITATEA DINORADEA FACULTATEA DE TEXTILE-PIELĂRIE",ORADEA,BH,1133,16,0,0,16,38,1,0,39,50,1,0,51,80,4,0,84,98,6,0,104
26573,117,"UNIVERSITATEA DINORADEA FACULTATEA DE TEXTILE-PIELĂRIE",ORADEA,BH,1037,10,3,0,13,28,5,0,33,63,8,0,71,74,9,0,83,81,9,0,90
26573,118,"LICEUL DE ARTE",ORADEA,BH,1059,10,0,0,10,42,1,0,43,71,4,16,91,90,6,16,112,100,8,16,124
26573,119,"PALATUL COPIILOR ŞI ELEVILOR",ORADEA,BH,1519,13,0,0,13,49,4,0,53,83,10,17,110,116,11,17,144,126,11,17,154
26573,120,"COLEGIUL NAŢIONAL ""MIHAI EMINESCU""",ORADEA,BH,1122,11,0,0,11,35,3,0,38,40,3,0,43,56,5,0,61,65,6,0,71
26573,121,"ŞCOALA GIMNAZIALĂ ""SZACSVAY IMRE""",ORADEA,BH,1376,16,3,0,19,60,3,0,63,89,5,0,94,115,5,0,120,127,5,0,132
26573,122,"LICEUL TEORETIC ""ADY ENDRE""",ORADEA,BH,1322,12,1,0,13,35,7,165,207,62,9,165,236,83,15,165,263,96,20,165,281
26573,123,"LICEUL REFORMAT ""LORANTFFY ZSUZSANNA""",ORADEA,BH,1501,18,1,0,19,53,20,0,73,79,25,211,315,102,29,213,344,112,33,213,358
26573,124,"COLEGIUL NAŢIONAL ""EMANUIL GOJDU""",ORADEA,BH,1226,10,0,0,10,36,0,0,36,55,2,0,57,88,5,0,93,92,5,0,97
26573,125,"COLEGIUL NAŢIONAL ""EMANUIL GOJDU""",ORADEA,BH,822,14,5,0,19,32,7,0,39,42,13,0,55,72,14,1,87,75,16,1,92
26573,126,"LICEUL TEORETIC”AUREL LAZĂR”",ORADEA,BH,1102,6,0,0,6,28,6,0,34,37,15,0,52,46,18,0,64,55,21,0,76
26573,127,"LICEUL GRECO-CATOLIC ”IULIU MANIU”",ORADEA,BH,1112,13,0,0,13,26,1,0,27,38,12,0,50,49,12,0,61,59,13,0,72
26573,128,"LICEUL GRECO-CATOLIC ”IULIU MANIU”",ORADEA,BH,1102,14,6,0,20,26,10,0,36,31,11,0,42,42,11,0,53,49,13,0,62
26573,129,"COLEGIUL NAŢIONAL ""IOSIF VULCAN""",ORADEA,BH,835,6,1,0,7,25,3,0,28,34,4,0,38,43,4,0,47,45,4,0,49
26573,130,"COLEGIUL NAŢIONAL ""IOSIF VULCAN""",ORADEA,BH,980,6,0,0,6,14,1,0,15,24,3,0,27,36,6,0,42,49,6,0,55
26573,131,"LICEUL TEORETIC GERMAN ""FRIEDRICH SCHILLER""",ORADEA,BH,912,16,0,0,16,32,9,0,41,46,9,0,55,60,9,0,69,67,9,0,76
26573,132,"LICEUL TEORETIC GERMAN ""FRIEDRICH SCHILLER""",ORADEA,BH,1550,9,4,0,13,29,4,0,33,52,5,0,57,75,5,0,80,89,5,0,94
26573,133,"LICEUL TEORETIC GERMAN ""FRIEDRICH SCHILLER""",ORADEA,BH,1013,6,7,0,13,26,10,0,36,48,12,0,60,70,13,0,83,78,14,0,92
26573,134,"LICEUL TEORETIC GERMAN ""FRIEDRICH SCHILLER""",ORADEA,BH,1015,17,4,0,21,40,5,0,45,53,7,0,60,75,9,0,84,90,9,0,99
26573,135,"COLEGIUL NAȚIONAL ""IOSIF VULCAN""",ORADEA,BH,1719,14,3,0,17,70,4,0,74,96,17,0,113,118,25,0,143,153,30,0,183
26573,136,"COLEGIUL NAȚIONAL ""IOSIF VULCAN""",ORADEA,BH,1310,13,9,0,22,58,14,0,72,72,14,0,86,109,15,0,124,120,15,0,135
26573,137,"COLEGIUL NAȚIONAL ""IOSIF VULCAN""",ORADEA,BH,1151,15,4,0,19,42,5,0,47,76,6,0,82,102,7,0,109,120,7,0,127
26573,138,"COLEGIUL NAȚIONAL ""IOSIF VULCAN""",ORADEA,BH,1044,13,0,0,13,39,0,0,39,57,0,0,57,67,2,0,69,69,2,0,71
26573,139,"ŞCOALA GIMNAZIALĂ ""AVRAM IANCU""",ORADEA,BH,1132,23,0,0,23,58,0,0,58,94,1,0,95,133,1,0,134,142,1,0,143
26573,140,"ŞCOALA GIMNAZIALĂ ""AVRAM IANCU""",ORADEA,BH,1042,29,8,0,37,45,8,0,53,70,10,0,80,100,12,0,112,106,14,0,120
26573,141,"GRĂDINIŢA CU PROGRAM PRELUNGIT NR. 44",ORADEA,BH,1566,48,4,0,52,106,7,0,113,141,11,0,152,195,18,0,213,210,23,0,233
26573,142,"GRĂDINIŢA CU PROGRAM PRELUNGIT NR. 44",ORADEA,BH,1740,24,5,0,29,95,5,0,100,122,6,0,128,158,6,0,164,172,7,0,179
26573,143,"IMPRIMERIA DE VEST",ORADEA,BH,1863,24,4,0,28,77,6,0,83,123,10,0,133,174,11,0,185,195,12,0,207
26813,144,"PRIMĂRIA MUNICIPIULUI BEIUŞ",BEIUŞ,BH,1349,21,2,0,23,56,5,0,61,68,7,0,75,86,10,1,97,93,15,1,109
26813,145,"LICEUL PEDAGOGIC",BEIUŞ,BH,1294,15,5,0,20,43,10,0,53,63,14,0,77,90,15,0,105,110,18,0,128
26813,146,"GRĂDINIŢA CU PROGRAM PRELUNGIT",BEIUŞ,BH,1219,12,1,0,13,40,4,0,44,55,8,0,63,87,14,0,101,98,15,27,140
26813,147,"COLEGIUL TEHNIC ""IOAN CIORDAŞ""",BEIUŞ,BH,1227,14,3,0,17,46,6,0,52,70,6,0,76,86,6,0,92,97,6,0,103
26813,148,"ŞCOALA GIMNAZIALĂ ""NICOLAE POPOVICIU""",BEIUŞ,BH,1473,19,0,0,19,59,15,0,74,75,20,0,95,102,21,3,126,118,21,3,142
26813,149,"GRĂDINIŢA "" FLOARE DE COLŢ""",BEIUŞ,BH,1308,26,3,0,29,60,8,0,68,87,9,0,96,116,12,0,128,126,12,0,138
26813,150,"BLOC PARTER",BEIUŞ,BH,1171,24,0,0,24,47,3,0,50,57,6,0,63,97,8,0,105,113,9,0,122
26822,151,"CĂMINUL CULTURAL",DELANI,BH,295,4,0,0,4,4,0,0,4,6,0,0,6,12,0,0,12,16,0,0,16
26886,152,"COLEGIUL NAŢIONAL""OCTAVIANGOGA""",MARGHITA,BH,1542,13,2,1,16,26,2,1,29,38,5,1,44,47,6,1,54,51,6,1,58
26886,153,"COLEGIUL NAŢIONAL ""OCTAVIAN GOGA""",MARGHITA,BH,1481,13,1,0,14,26,1,0,27,33,1,0,34,46,1,0,47,50,1,0,51
26886,154,"COLEGIUL NAŢIONAL ""OCTAVIAN GOGA""",MARGHITA,BH,1325,12,0,0,12,26,0,0,26,35,0,0,35,49,0,0,49,53,0,0,53
26886,155,"COLEGIUL NAŢIONAL ""OCTAVIAN GOGA""",MARGHITA,BH,1228,12,0,0,12,24,3,0,27,52,5,0,57,67,7,0,74,77,7,0,84
26886,156,"COLEGIUL NAŢIONAL ""OCTAVIAN GOGA""",MARGHITA,BH,1345,16,0,0,16,33,0,0,33,48,1,0,49,65,2,0,67,67,2,0,69
26886,157,"PRIMĂRIA MUNICIPIULUI MARGHITA",MARGHITA,BH,1282,5,5,0,10,20,9,0,29,33,10,0,43,46,10,0,56,57,10,0,67
26886,158,"CLUBUL COPIILOR",MARGHITA,BH,1331,14,0,0,14,28,0,0,28,45,0,0,45,58,0,2,60,63,2,2,67
26886,159,"LICEUL TEORETIC ""HORVÁTHJÁNOS""",MARGHITA,BH,1381,15,3,0,18,42,5,0,47,59,5,0,64,76,7,2,85,85,8,2,95
26886,160,"GRĂDINIŢA CU PROGRAM PRELUNGIT NR.4",MARGHITA,BH,1074,7,3,0,10,15,3,0,18,19,3,0,22,23,3,0,26,23,4,0,27
26886,161,"GRĂDINIŢA CU PROGRAM PRELUNGIT NR.4",MARGHITA,BH,1338,8,0,0,8,24,0,0,24,31,0,0,31,47,0,0,47,51,1,0,52
26895,162,"ŞCOALA CU CLASELEI-VIII CHEŢ",CHEŢ,BH,914,5,2,0,7,11,2,0,13,21,2,0,23,40,3,0,43,42,3,0,45
26902,163,"ŞCOALA CU CLASELE I-VIII GHENETEA",GHENETEA,BH,593,2,1,0,3,6,2,0,8,10,4,0,14,16,5,0,21,17,6,0,23
26984,164,"FOSTUL MAGAZIN WAGNER",SALONTA,BH,1486,9,1,0,10,30,1,0,31,40,4,0,44,66,4,0,70,73,4,0,77
26984,165,"GRĂDINIȚA FLOAREA SOARELUI",SALONTA,BH,1555,6,1,0,7,18,1,0,19,33,2,0,35,53,2,0,55,59,2,0,61
26984,166,"LICEUL TEORETIC ARANY JANOS",SALONTA,BH,1163,6,3,0,9,22,3,0,25,32,3,0,35,36,6,11,53,43,6,11,60
26984,167,"GRĂDINIȚA CURCUBEU",SALONTA,BH,807,2,5,0,7,10,6,0,16,10,6,0,16,13,6,0,19,13,6,0,19
26984,168,"CASA DE CULTURĂZILAHY LAJOS",SALONTA,BH,1451,10,0,0,10,36,5,0,41,49,7,0,56,63,9,0,72,67,9,0,76
26984,169,"GRĂDINIȚA TOLDI",SALONTA,BH,1128,4,0,0,4,19,3,0,22,29,3,0,32,42,6,0,48,45,11,0,56
26984,170,"COLEGIUL NAȚIONALTEODOR NEŞ",SALONTA,BH,779,3,0,0,3,9,0,0,9,22,2,0,24,32,2,0,34,34,3,0,37
26984,171,"GRĂDINIȚA URSULEȚ",SALONTA,BH,1352,16,4,0,20,36,4,0,40,49,8,0,57,68,8,0,76,76,8,0,84
26984,172,"GRĂDINIȚA URSULEȚ",SALONTA,BH,609,3,0,0,3,9,0,0,9,18,0,0,18,30,0,0,30,34,0,0,34
26984,173,"CASA SFÂNTUL ANTON",SALONTA,BH,481,6,4,0,10,15,4,0,19,20,4,0,24,32,5,0,37,34,5,0,39
26984,174,"ȘCOALA GENERALĂ",SALONTA,BH,1118,12,0,0,12,30,0,0,30,42,0,0,42,55,2,0,57,60,3,0,63
26984,175,"GRĂDINIȚA FLUIERAȘUL FERMECAT",SALONTA,BH,1621,4,0,0,4,26,0,0,26,40,0,0,40,53,0,0,53,57,0,0,57
26984,176,"LICEUL TEHNOLOGIC NR.1",SALONTA,BH,825,12,2,0,14,14,2,0,16,17,2,0,19,28,2,0,30,33,2,0,35
26984,177,"GRĂDINIȚA PRICHINDEL",SALONTA,BH,826,4,0,0,4,9,0,0,9,18,1,0,19,21,3,0,24,30,3,0,33
26984,178,"ȘCOALA GENERALĂ FÜVESKERT",SALONTA,BH,774,5,2,0,7,15,2,0,17,33,3,0,36,44,3,0,47,48,4,0,52
26706,179,"PRIMĂRIA ALEȘD- SALA MARE",ALEŞD,BH,1314,20,0,0,20,47,8,0,55,69,8,0,77,100,11,44,155,123,11,44,178
26706,180,"LICEUL TEORETIC CONSTANTIN ȘERBAN",ALEŞD,BH,1457,17,1,0,18,65,8,0,73,99,11,0,110,119,11,0,130,128,13,0,141
26706,181,"COLEGIUL TEHNIC ALEXANDRU ROMAN",ALEŞD,BH,1529,28,2,0,30,51,3,0,54,74,8,0,82,99,10,0,109,106,12,0,118
26706,182,"GRĂDINIȚA CU PROGRAM NORMAL NR. 1",ALEŞD,BH,1208,18,0,0,18,63,1,0,64,78,5,0,83,102,7,0,109,127,7,0,134
26706,183,"CENTRUL MULTIFUNCȚIONAL",ALEŞD,BH,1041,1,0,0,1,14,0,0,14,31,0,0,31,82,2,0,84,135,4,0,139
26724,184,"ȘCOALA GIMNAZIALĂ NR. 1",PEŞTIŞ,BH,1119,33,5,0,38,68,7,0,75,100,9,0,109,129,13,0,142,140,15,0,155
26733,185,"GRĂDINIȚA CU PROGRAM NORMAL NR. 4",TINĂUD,BH,653,31,4,0,35,88,9,0,97,132,10,0,142,166,13,0,179,182,16,0,198
26715,186,"ȘCOALA PRIMARĂ NR. 2","PĂDUREA NEAGRĂ",BH,596,5,0,0,5,13,0,0,13,14,0,0,14,19,0,0,19,20,0,0,20
26939,187,"ŞCOALA GIMNAZIALĂ NR. 1 NUCET",NUCET,BH,1229,12,0,0,12,36,9,0,45,70,15,0,85,95,19,1,115,117,22,1,140
26948,188,"CĂMINUL CULTURAL BĂIŢA",BĂIŢA,BH,524,11,0,0,11,21,0,0,21,34,1,0,35,49,6,1,56,56,7,1,64
30933,189,"ŞCOALA GENERALĂ",CADEA,BH,932,932,1,0,933,1,0,0,1,2,0,0,2,5,0,0,5,5,0,0,5
30951,190,"ŞCOALA GENERALĂ",CUBULCUT,BH,696,0,0,0,0,0,0,0,0,2,0,0,2,2,0,0,2,2,0,0,2
30960,191,"ŞCOALA GENERALĂ",OLOSIG,BH,439,2,1,0,3,4,1,0,5,6,1,0,7,8,1,0,9,8,2,0,10
30979,192,"ŞCOALA GENERALĂ","SÂNNICOLAU DE MUNTE",BH,706,0,2,0,2,5,2,0,7,7,2,0,9,9,2,0,11,9,2,0,11
30924,193,"ȘCOALA CU CLASELE I-IV",SĂCUENI,BH,1144,8,1,0,9,14,2,0,16,16,2,0,18,27,2,0,29,27,2,0,29
30924,194,"GRĂDINIȚA ȘI ȘCOALA CU CLASELE I-IV",SĂCUENI,BH,1391,0,0,0,0,10,0,0,10,11,0,0,11,15,0,0,15,15,0,0,15
30924,195,"GRĂDINIȚĂ CU PROGRAM PRELUNGIT",SĂCUENI,BH,1213,3,0,0,3,9,3,0,12,17,3,0,20,30,3,0,33,36,4,0,40
30924,196,"GRĂDINIȚA DE LA LOCUL DE CASĂ",SĂCUENI,BH,925,2,0,0,2,13,0,0,13,15,3,0,18,20,4,0,24,20,4,0,24
30924,197,"CLĂDIREA MUZEULUI",SĂCUENI,BH,1486,10,0,0,10,19,0,0,19,28,2,0,30,37,2,0,39,41,4,0,45
30942,198,"CLUBUL TINERETULUI",CIOCAIA,BH,776,2,0,0,2,8,0,0,8,14,1,0,15,19,1,0,20,22,4,0,26
26859,199,"CASA DE CULTURĂ „MIRON POMPILIU” ŞTEI",ŞTEI,BH,1137,12,7,0,19,36,8,0,44,42,8,9,59,66,11,9,86,74,11,9,94
26859,200,"ŞCOALA GIMNAZIALĂ CU CLASELE I-VIII „MIRON POMPILIU” ŞTEI - ŞCOALA MICĂ",ŞTEI,BH,1014,21,2,0,23,51,3,0,54,66,3,0,69,84,3,100,187,88,3,100,191
26859,201,"COLEGIUL TEHNIC„UNIREA” ŞTEI",ŞTEI,BH,1267,28,2,0,30,48,2,0,50,70,4,0,74,85,4,0,89,102,5,0,107
26859,202,"COLEGIUL TEHNIC „UNIREA” ŞTEI - ŞCOALA DE ŞOFERI",ŞTEI,BH,1376,14,0,0,14,39,1,0,40,56,3,0,59,79,3,0,82,96,3,0,99
26859,203,"ŞCOALA GIMNAZIALĂ CU CLASELE I-VIII „MIRON POMPILIU” ŞTEI",ŞTEI,BH,1299,15,3,0,18,59,4,0,63,88,4,0,92,115,4,93,212,129,5,93,227
32036,204,"ŞCOALA GIMNAZIALĂ VALEA LUI MIHAI","VALEA LUI MIHAI",BH,1280,10,3,0,13,23,4,0,27,34,4,0,38,41,4,0,45,43,4,0,47
32036,205,"ŞCOALA GIMNAZIALĂ VALEA LUI MIHAI","VALEA LUI MIHAI",BH,1385,10,4,0,14,26,4,0,30,29,5,0,34,37,5,0,42,40,6,0,46
32036,206,"ŞCOALA GIMNAZIALĂ VALEA LUI MIHAI","VALEA LUI MIHAI",BH,1228,10,0,0,10,27,0,0,27,36,6,0,42,45,6,0,51,53,8,0,61
32036,207,"ŞCOALA GIMNAZIALĂ VALEA LUI MIHAI","VALEA LUI MIHAI",BH,1342,5,0,0,5,11,4,0,15,16,4,0,20,20,5,0,25,25,5,0,30
32036,208,"ŞCOALA GIMNAZIALĂ VALEA LUI MIHAI","VALEA LUI MIHAI",BH,1171,5,6,0,11,7,6,0,13,9,6,0,15,10,6,10,26,10,6,10,26
32036,209,"ŞCOALA GIMNAZIALĂ VALEA LUI MIHAI","VALEA LUI MIHAI",BH,1348,7,3,0,10,9,3,0,12,14,3,0,17,21,3,0,24,21,3,0,24
32036,210,"ŞCOALA GIMNAZIALĂ VALEA LUI MIHAI (GRĂDINIŢĂ)","VALEA LUI MIHAI",BH,1233,3,0,0,3,11,0,0,11,12,1,0,13,19,2,0,21,19,2,0,21
27016,211,"CASA DE CULTURĂ",VAŞCĂU,BH,1386,19,2,0,21,41,3,0,44,56,3,0,59,66,3,0,69,71,4,0,75
27025,212,"CĂMINUL CULTURAL",CÎMP,BH,195,4,2,0,6,6,2,0,8,8,3,0,11,11,4,0,15,12,4,0,16
27043,213,"CĂMINUL CULTURAL",COLEŞTI,BH,111,2,3,0,5,4,4,0,8,4,6,0,10,5,7,0,12,8,7,0,15
27052,214,"CĂMINUL CULTURAL","VĂRZARII DE JOS",BH,185,0,0,0,0,9,0,0,9,9,3,0,12,19,5,0,24,20,5,0,25
27061,215,"CĂMINUL CULTURAL","VĂRZARII DE SUS",BH,107,1,0,0,1,7,1,0,8,11,2,0,13,12,4,0,16,13,5,0,18
27034,216,ŞCOALAGENERALĂ,CÎMP-MOŢI,BH,44,0,0,0,0,2,0,0,2,2,0,0,2,2,0,0,2,2,0,0,2
27089,217,"PRIMĂRIA ABRAM",ABRAM,BH,777,10,1,0,11,14,1,0,15,24,1,0,25,27,1,0,28,34,1,0,35
27105,218,"CĂMIN CULTURAL",DIJIR,BH,239,3,2,0,5,5,4,0,9,9,6,0,15,13,7,0,20,14,11,0,25
27114,219,"CĂMIN CULTURAL",ITEU,BH,242,5,0,0,5,18,4,0,22,22,7,0,29,28,9,0,37,31,9,0,40
27141,220,"CĂMIN CULTURAL","SATU BARBĂ",BH,230,2,0,0,2,4,0,0,4,5,0,0,5,8,1,0,9,8,1,0,9
27123,221,"ȘCOALĂ PRIMARĂ","ITEU NOU",BH,121,1,0,0,1,2,0,0,2,11,0,0,11,12,0,0,12,12,0,0,12
27132,222,"ȘCOALĂ PRIMARĂ NR. 1",MARGINE,BH,410,2,1,0,3,14,3,0,17,20,4,0,24,25,4,2,31,33,8,2,43
27150,223,"ȘCOALĂ PRIMARĂ NR. 3",SUIUG,BH,467,2,0,0,2,7,2,0,9,8,4,0,12,13,6,0,19,19,6,0,25
27178,224,"ȘCOALA GENERALĂABRĂMUȚ",ABRĂMUŢ,BH,376,2,0,0,2,2,0,0,2,5,2,0,7,6,6,0,12,6,6,0,12
27187,225,"CĂMINUL CULTURAL CRESTUR",CRESTUR,BH,363,1,3,0,4,3,3,0,6,4,5,0,9,5,5,0,10,5,5,0,10
27196,226,"ȘCOALA GENERALĂ FĂNCICA",FĂNCICA,BH,275,3,0,0,3,4,0,0,4,4,0,0,4,9,0,0,9,10,0,0,10
27203,227,"GRĂDINIȚA CU PROGRAM NORMAL NR.1 PETREU",PETREU,BH,1415,3,0,0,3,11,1,0,12,18,3,0,21,29,5,0,34,32,5,0,37
26779,228,"CĂMIN CULTURAL",CHISTAG,BH,493,6,3,0,9,18,4,0,22,21,6,0,27,31,8,0,39,44,10,0,54
26751,229,"ȘCOALA GIMNAZIALĂ NR 1 AȘTILEU",AŞTILEU,BH,1280,13,0,0,13,31,1,0,32,48,3,0,51,60,3,0,63,71,3,0,74
26760,230,"ȘCOALA GIMNAZIALĂ NR 2 CĂLĂȚEA",CĂLĂŢEA,BH,297,13,0,0,13,32,4,5,41,53,5,5,63,63,5,5,73,69,5,5,79
26760,231,"BLOC CORNET",CĂLĂŢEA,BH,231,0,0,0,0,2,1,0,3,6,2,0,8,9,5,0,14,12,5,0,17
26788,232,"ȘCOALA PRIMARĂ NR 2 PEŞTERE",PEŞTERE,BH,693,17,4,0,21,45,6,0,51,56,7,0,63,70,7,0,77,83,7,0,90
27221,233,"PRIMĂRIA COMUNEI AUŞEU",AUŞEU,BH,785,15,3,0,18,35,4,0,39,43,5,0,48,56,5,0,61,62,5,0,67
27267,234,"ŞCOALA PRIMARĂ",GROŞI,BH,837,4,1,0,5,19,3,0,22,33,4,0,37,45,5,0,50,49,5,0,54
27276,235,"CĂMIN CULTURAL",LUNCŞOARA,BH,753,5,1,0,6,14,3,0,17,25,3,0,28,25,4,0,29,31,10,0,41
27294,236,"SALASPORT ȘCOALA","AVRAM IANCU",BH,1558,10,0,0,10,30,2,0,32,52,4,0,56,71,5,0,76,81,5,0,86
27301,237,"CĂMINUL CULTURAL",ANT,BH,161,0,1,0,1,2,1,0,3,3,2,0,5,5,2,0,7,5,5,0,10
27310,238,"ȘCOALA NOUĂ TĂMAȘDA",TĂMAŞDA,BH,911,8,1,0,9,17,1,0,18,37,2,0,39,62,3,0,65,69,6,0,75
27338,239,"CĂMINUL CULTURAL BALC",BALC,BH,1064,3,0,0,3,6,0,0,6,12,1,0,13,18,4,0,22,18,4,0,22
27347,240,"CĂMINUL CULTURAL ALMAŞU MARE","ALMAŞU MARE",BH,627,12,2,0,14,23,2,0,25,26,3,0,29,29,3,0,32,29,4,0,33
27356,241,"CĂMINUL CULTURAL ALMAŞU MIC","ALMAŞU MIC",BH,287,3,1,0,4,7,3,0,10,10,4,0,14,13,4,0,17,15,4,0,19
27374,242,"CĂMINUL CULTURALSĂLDĂBAGIU DE BARCĂU","SĂLDĂBAGIU DE BARCĂU",BH,436,3,0,0,3,8,2,0,10,11,2,0,13,15,5,0,20,17,6,0,23
27365,243,"CĂMINUL CULTURAL GHIDA",GHIDA,BH,125,1,2,0,3,2,3,0,5,11,6,0,17,16,8,0,24,16,8,0,24
27392,244,"ȘCOALA GIMNAZIALĂ NR.1 BATĂR",BATĂR,BH,1314,27,2,0,29,93,8,0,101,112,13,0,125,145,14,12,171,161,18,12,191
27409,245,"ȘCOALAGIMNAZIALĂ NR. 4 ARPĂȘEL",ARPĂŞEL,BH,736,4,2,0,6,7,2,0,9,8,2,0,10,14,2,0,16,15,2,0,17
27418,246,GRĂDINIȚATALPOȘ,TALPOŞ,BH,1314,80,3,0,83,154,14,0,168,194,15,0,209,239,17,0,256,251,18,0,269
27427,247,"GRĂDINIȚA CU PROGRAM NORMAL TĂUT",TĂUT,BH,753,27,12,0,39,81,18,0,99,108,21,0,129,153,30,9,192,161,30,9,200
27445,248,"ȘCOALA GENERALĂ CU CLASELE V-VIII GASPAR ANDRAS",BIHARIA,BH,1653,7,0,0,7,14,2,0,16,31,2,0,33,39,4,0,43,54,4,0,58
27445,249,"GRĂDINIȚA DE COPII BIHARIA",BIHARIA,BH,1554,10,1,0,11,27,2,0,29,35,2,0,37,51,4,0,55,56,4,0,60
27454,250,"ȘCOALA GENERALĂ CU CLASELE I-IV CAUACEU",CAUACEU,BH,641,1,0,0,1,1,0,0,1,7,0,0,7,11,0,0,11,15,0,0,15
27515,251,"ȘCOALA CU CLASELE I- IV, BOIANU-MARE","BOIANU MARE",BH,465,3,0,0,3,7,0,0,7,11,0,0,11,20,0,0,20,25,0,0,25
27542,252,"ȘCOALA CU CLASELE I- VIII ” ÎNVĂȚĂTOR GÂLGĂU IOSIF” PĂGAIA",PĂGAIA,BH,557,4,1,0,5,12,2,0,14,15,6,0,21,25,6,0,31,32,7,0,39
27579,253,"CĂMIN CULTURAL BOROD",BOROD,BH,1260,9,2,0,11,15,3,0,18,24,3,0,27,46,4,0,50,62,8,0,70
27588,254,"ŞCOALA CUCLASELE I-VIII",BOROZEL,BH,513,3,0,0,3,10,0,0,10,11,0,0,11,26,0,0,26,27,0,0,27
27597,255,"GRĂDINIȚA CETEA",CETEA,BH,185,0,0,0,0,6,5,0,11,9,7,0,16,11,7,0,18,11,8,0,19
27604,256,"ŞCOALA CUCLASELE I-IV",CORNIŢEL,BH,421,17,6,0,23,43,10,0,53,54,12,2,68,81,15,2,98,85,15,2,102
27622,257,"ȘCOALA CUCLASELE I-IV","VALEA MARE DE CRIŞ",BH,370,13,3,0,16,26,5,1,32,44,9,1,54,66,13,1,80,70,14,1,85
27613,258,"ȘCOALA CU CLASELE I-IV",ŞERANI,BH,103,0,2,0,2,1,2,0,3,6,5,0,11,8,5,0,13,8,6,0,14
27613,259,"ȘCOALACU CLASELE. I-VIII",ŞERANI,BH,230,1,4,0,5,2,4,0,6,3,4,0,7,3,6,0,9,7,6,0,13
27640,260,"LICEUL TECHNOLOGIC AGROINDUSTRIAL TAMASI ARON BORȘ",BORŞ,BH,1193,3,4,0,7,5,4,0,9,9,9,0,18,21,9,0,30,25,9,0,34
27677,261,"GRĂDINIȚA SÎNTION",SÂNTION,BH,1613,12,1,0,13,18,2,0,20,27,2,0,29,37,2,0,39,46,6,0,52
27659,262,"ȘCOALA GENERALĂ SANTĂUL MARE","SANTĂUL MARE",BH,325,0,2,0,2,1,5,0,6,5,5,0,10,7,7,14,28,9,8,14,31
27668,263,"ȘCOALA PRIMARĂ SANTĂUL MIC","SANTĂUL MIC",BH,475,5,0,0,5,9,0,0,9,24,9,0,33,26,9,0,35,33,10,0,43
27695,264,"CENTRUL DE INFORMARE TURISTICĂ BRATCA",BRATCA,BH,1218,32,3,0,35,98,11,0,109,100,17,10,127,132,19,11,162,150,23,11,184
27711,265,"CĂMINUL CULTURAL",BEZNEA,BH,1079,13,1,0,14,45,2,0,47,65,3,0,68,77,3,0,80,88,3,0,91
27702,266,"CĂMINUL CULTURAL",DAMIŞ,BH,458,2,5,0,7,4,7,0,11,9,9,0,18,11,9,0,20,18,11,0,29
27739,267,"CĂMINUL CULTURAL",PONOARĂ,BH,468,0,3,0,3,1,3,0,4,2,3,4,9,7,3,4,14,14,3,4,21
27720,268,"CĂMINUL CULTURAL",LORĂU,BH,365,6,2,0,8,12,3,0,15,20,3,2,25,22,3,2,27,25,3,2,30
27748,269,"CĂMINUL CULTURAL","VALEA CRIŞULUI",BH,364,8,0,0,8,18,0,0,18,30,1,0,31,39,3,0,42,40,3,0,43
27766,270,"CĂMINUL CULTURAL BRUSTURI",BRUSTURI,BH,946,6,2,0,8,21,5,0,26,28,8,0,36,35,9,0,44,51,17,0,68
27775,271,"ŞCOALA CUIEŞD",CUIEŞD,BH,386,0,0,0,0,2,2,0,4,3,2,0,5,5,2,0,7,9,2,0,11
27793,272,ŞCOALAORVIŞELE,ORVIŞELE,BH,321,6,5,0,11,10,7,0,17,17,8,0,25,25,9,0,34,30,10,0,40
27800,273,"CĂMINUL CULTURAL PĂULEȘTI",PĂULEŞTI,BH,250,3,0,0,3,6,0,0,6,8,0,0,8,12,6,0,18,12,10,0,22
27819,274,"CĂMINUL CULTURAL PICLEU",PICLEU,BH,729,4,3,0,7,8,4,0,12,18,9,2,29,34,10,2,46,44,12,2,58
27775,275,"ŞCOALAPRIMARĂ CUIEȘD",CUIEŞD,BH,269,3,1,0,4,6,2,0,8,7,2,0,9,11,3,0,14,13,3,0,16
27855,276,"CĂMINUL CULTURAL",BUDUREASA,BH,857,1,0,0,1,7,2,0,9,10,2,0,12,12,2,0,14,23,3,0,26
27855,277,"ȘCOALA I-IV BUDUREASA",BUDUREASA,BH,409,1,0,0,1,2,3,0,5,2,4,0,6,12,4,0,16,14,4,0,18
27864,278,"CĂMINUL CULTURAL",BURDA,BH,320,3,0,0,3,7,0,0,7,7,0,0,7,9,1,0,10,10,1,0,11
27873,279,"CĂMINUL CULTURAL",SACA,BH,176,5,0,0,5,8,0,0,8,9,2,0,11,17,3,0,20,19,3,0,22
27882,280,"CĂMINUL CULTURAL","SĂLIŞTE DE BEIUŞ",BH,208,0,0,0,0,1,0,0,1,5,0,0,5,7,0,0,7,8,0,0,8
27891,281,"CĂMINUL CULTURAL",TELEAC,BH,135,1,0,0,1,2,0,0,2,2,0,0,2,3,2,0,5,6,2,0,8
27917,282,"PRIMĂRIA BUDUSLĂU",BUDUSLĂU,BH,828,3,2,0,5,6,2,0,8,10,2,0,12,17,3,0,20,20,3,0,23
27926,283,"ŞCOALA GENERALĂ ALBIŞ",ALBIŞ,BH,793,3,2,0,5,8,2,0,10,13,2,0,15,18,3,0,21,20,4,0,24
27944,284,"PRIMĂRIA COMUNEI BULZ",BULZ,BH,696,3,0,0,3,19,0,0,19,23,1,0,24,39,4,0,43,41,5,0,46
27953,285,"ȘCOALA PRIMARĂ NR.3 MUNTENI",MUNTENI,BH,414,1,7,0,8,5,7,0,12,7,7,0,14,15,7,0,22,19,7,0,26
27962,286,"ȘCOALA GIMNAZIALĂ NR.2 REMEȚI",REMEŢI,BH,619,0,2,0,2,11,14,0,25,16,21,0,37,23,31,0,54,25,34,0,59
27980,287,"CĂMIN CULTURAL",BUNTEŞTI,BH,479,5,0,0,5,12,0,0,12,16,1,0,17,28,4,4,36,32,4,4,40
27999,288,GRĂDINIŢĂ,BRĂDET,BH,570,9,0,0,9,11,0,0,11,15,0,0,15,24,1,0,25,30,1,0,31
28004,289,"CĂMIN CULTURAL",DUMBRĂVANI,BH,244,1,0,0,1,6,0,0,6,6,0,0,6,9,0,0,9,13,0,0,13
28013,290,"ȘCOALA GIMNAZIALĂ FERICE",FERICE,BH,396,7,2,0,9,20,2,0,22,24,2,0,26,34,2,0,36,36,3,10,49
28022,291,"CĂMIN CULTURAL LELEȘTI",LELEŞTI,BH,332,4,3,0,7,6,3,0,9,13,3,0,16,20,4,7,31,26,4,7,37
28031,292,"ŞCOALA CU CLASELE I-VIII","POIENII DE JOS",BH,504,3,0,0,3,6,1,0,7,11,1,0,12,19,3,0,22,19,3,0,22
28040,293,"CĂMIN CULTURAL","POIENII DE SUS",BH,559,2,1,0,3,7,1,0,8,14,1,0,15,22,1,0,23,27,1,0,28
28059,294,"GRĂDINIŢA CU PROGRAM NORMAL",SĂUD,BH,354,3,0,0,3,23,0,0,23,35,2,0,37,41,3,4,48,48,3,4,55
28068,295,"ȘCOALA GIMNAZIALĂ NR.3",STÎNCEŞTI,BH,253,4,0,0,4,5,1,0,6,8,4,0,12,15,4,0,19,15,4,0,19
28086,296,"CĂMINUL CULTURAL",CĂBEŞTI,BH,740,11,0,0,11,16,1,0,17,21,3,0,24,24,3,0,27,30,4,0,34
28111,297,"ȘCOALA CU CLASELE. I-IV JOSANI",JOSANI,BH,392,3,1,0,4,8,3,0,11,11,3,0,14,14,4,0,18,19,5,0,24
28095,298,"CĂMINUL CULTURAL",GOILA,BH,152,5,2,0,7,8,2,0,10,11,2,0,13,11,2,0,13,14,3,0,17
28120,299,"CĂMINUL CULTURAL",SOHODOL,BH,243,4,2,0,6,6,3,0,9,9,4,0,13,10,5,0,15,10,6,0,16
28148,300,"PRIMĂRIA CĂPÎLNA",CĂPÎLNA,BH,256,5,4,0,9,26,9,0,35,42,19,0,61,57,33,0,90,63,35,15,113
28166,301,"ȘCOALA GENERALĂ",ROHANI,BH,88,7,3,0,10,10,6,0,16,16,7,0,23,17,7,0,24,17,8,0,25
28157,302,"ȘCOALA GENERALĂ",GINTA,BH,229,2,4,0,6,5,4,0,9,7,5,0,12,8,7,0,15,8,7,0,15
28184,303,"ȘCOALA GENERALĂ","SUPLACU DE TINCA",BH,326,2,3,0,5,3,4,0,7,5,4,0,9,9,4,0,13,12,5,0,17
28175,304,"GRĂDINIȚA SĂLDĂBAGIU MIC","SĂLDĂBAGIU MIC",BH,340,6,2,0,8,7,5,0,12,11,6,0,17,25,9,0,34,28,10,0,38
28200,305,"ȘCOALA PRIMARĂ NR.2 CĂRPINET",CĂRPINET,BH,442,8,1,0,9,17,5,0,22,27,5,0,32,33,10,0,43,38,13,0,51
28237,306,"CĂMIN CULTURAL CĂLUGĂRI",CĂLUGĂRI,BH,394,4,4,0,8,22,26,0,48,35,31,0,66,45,34,0,79,46,34,0,80
28219,307,"CĂMIN CULTURAL IZBUC",IZBUC,BH,407,3,1,0,4,7,1,0,8,9,1,0,10,13,3,0,16,16,3,0,19
28228,308,"GRĂDINIŢA CU PROGRAM NORMAL NR.4",LEHECENI,BH,311,3,1,0,4,7,1,0,8,13,5,0,18,22,5,0,27,22,6,0,28
28255,309,"CENTRUL DE AFACERI",CEFA,BH,1017,3,1,0,4,17,4,0,21,27,6,0,33,41,6,0,47,42,7,0,49
28264,310,GRĂDINIŢA,ATEAŞ,BH,158,0,0,0,0,3,0,0,3,4,0,0,4,5,4,0,9,7,5,0,12
28308,311,"CĂMIN CULTURAL",INAND,BH,735,10,4,0,14,14,5,0,19,27,7,0,34,34,7,0,41,36,9,0,45
28344,312,"PRIMĂRIA COMUNEI CEICA",CEICA,BH,766,11,1,0,12,49,2,0,51,64,2,1,67,84,3,1,88,97,5,1,103
28353,313,"ȘCOALA BUCIUM",BUCIUM,BH,175,3,0,0,3,11,1,0,12,20,1,0,21,33,4,0,37,47,5,0,52
28362,314,"ȘCOALA CEIȘOARA",CEIŞOARA,BH,462,8,0,0,8,13,0,0,13,22,0,0,22,32,0,0,32,47,5,0,52
28371,315,"ȘCOALA CORBEȘTI",CORBEŞTI,BH,376,2,1,0,3,7,3,0,10,13,5,0,18,26,5,0,31,31,7,0,38
28380,316,"ȘCOALA COTIGLET",COTIGLET,BH,324,5,7,0,12,17,8,0,25,33,8,0,41,60,13,0,73,72,13,0,85
28399,317,"CĂMIN CULTURALDUȘEȘTI",DUŞEŞTI,BH,420,17,2,0,19,41,5,0,46,55,7,0,62,68,12,0,80,84,13,0,97
28406,318,"ȘCOALA INCEȘTI",INCEŞTI,BH,293,5,1,0,6,9,3,0,12,21,5,0,26,34,10,0,44,47,16,0,63
28451,319,"ŞCOALA GENERALĂ",ŞIŞTEREA,BH,498,2,0,0,2,3,0,0,3,4,5,0,9,6,5,0,11,6,5,0,11
28460,320,"ŞCOALA GENERALĂ",ŞUŞTUROGI,BH,198,4,1,0,5,7,4,0,11,9,5,0,14,15,6,0,21,17,9,0,26
28424,321,"CĂMIN CULTURAL",CETARIU,BH,921,1,0,0,1,5,1,0,6,6,2,0,8,14,5,0,19,15,7,0,22
28479,322,"CĂMIN CULTURAL",TĂUTELEC,BH,195,1,0,0,1,4,0,0,4,5,1,0,6,5,1,0,6,5,1,0,6
28503,323,"ȘCOALA GIMNAZIALĂ ""BOCSKAI ISTVAN""",CHERECHIU,BH,577,1,0,0,1,1,0,0,1,1,0,0,1,4,0,0,4,4,0,0,4
28512,324,"ȘCOALA GIMNAZIALĂ "" BOCSKAI ISTVAN""",CHEŞEREU,BH,805,7,3,0,10,9,3,0,12,16,3,0,19,16,3,0,19,16,3,0,19
28521,325,"ȘCOALA GIMNAZIALĂ ""BOCSKAI ISTVAN""",TÎRGUŞOR,BH,443,3,0,0,3,5,2,0,7,7,5,0,12,11,5,0,16,11,5,0,16
28549,326,"ȘCOALA GIMNAZIALĂ CHIȘLAZ",CHIŞLAZ,BH,388,8,0,0,8,11,5,0,16,14,5,0,19,22,7,0,29,22,9,0,31
28558,327,"ȘCOALA PRIMARĂ CHIRALEU",CHIRALEU,BH,485,0,0,0,0,4,0,0,4,9,1,0,10,20,3,0,23,24,3,0,27
28576,328,"GRĂDINIȚA MIȘCA",MIŞCA,BH,767,12,0,0,12,23,0,0,23,32,3,0,35,50,4,0,54,51,5,0,56
28585,329,"ȘCOALA POCLUȘA DE BARCĂU","POCLUŞA DE BARCĂU",BH,309,3,1,0,4,4,2,0,6,5,3,0,8,5,3,0,8,7,3,0,10
28594,330,"CĂMINUL CULTURAL SĂRSIG",SĂRSIG,BH,251,2,2,0,4,4,2,0,6,4,2,0,6,7,2,0,9,10,2,0,12
28601,331,"FOSTA ȘCOALĂ PRIMARĂ SÎNLAZĂR",SÎNLAZĂR,BH,333,7,1,0,8,19,2,0,21,22,2,0,24,23,2,0,25,23,3,0,26
28674,332,"PRIMĂRIA COMUNEI CIUMEGHIU",CIUMEGHIU,BH,1487,5,1,0,6,9,1,0,10,16,2,0,18,23,3,0,26,25,3,0,28
28683,333,"GRĂDINIȚA DIN SATULBOIU",BOIU,BH,592,8,4,0,12,20,8,0,28,26,9,0,35,33,10,0,43,34,10,0,44
28692,334,"ȘCOALA GENERALĂ GHIORAC",GHIORAC,BH,1311,7,1,0,8,15,2,0,17,22,5,0,27,26,5,0,31,28,5,0,33
28718,335,"CĂMINUL CULTURAL CÎMPANI",CÎMPANI,BH,698,10,0,0,10,13,0,0,13,17,0,0,17,22,1,0,23,30,2,0,32
28727,336,"ŞCOALA PRIMARĂ FÎNAŢE",FÎNAŢE,BH,510,11,1,0,12,21,1,0,22,31,1,0,32,42,1,0,43,61,1,0,62
28736,337,"ŞCOALA PRIMARĂ HÎRSEŞTI",HÎRSEŞTI,BH,274,5,2,0,7,8,2,0,10,14,5,0,19,15,5,0,20,19,6,0,25
28745,338,"ŞCOALA PRIMARĂ SIGHIŞTEL",SIGHIŞTEL,BH,264,7,3,0,10,15,4,0,19,25,9,0,34,32,9,0,41,41,10,0,51
28754,339,"ŞCOALA PRIMARĂ VALEA DE SUS","VALEA DE SUS",BH,244,7,1,0,8,23,3,0,26,31,4,0,35,33,4,0,37,35,4,0,39
28772,340,"CĂMINUL CULTURAL","COCIUBA MARE",BH,741,6,2,0,8,23,4,0,27,34,6,0,40,36,9,0,45,38,10,0,48
28790,341,"CĂMINUL CULTURAL",CHEŞA,BH,462,5,1,0,6,23,8,0,31,32,8,0,40,38,10,12,60,42,13,12,67
28781,342,"CĂMINUL CULTURAL",CĂRĂSĂU,BH,594,9,0,0,9,38,0,0,38,55,5,36,96,72,6,36,114,81,9,36,126
28807,343,"GRĂDINIȚA PETID",PETID,BH,506,13,0,0,13,30,3,0,33,42,3,21,66,55,3,22,80,55,3,22,80
28834,344,"ȘCOALA GIMNAZIALĂ NR.2",BUCUROAIA,BH,270,9,1,0,10,26,6,0,32,36,6,0,42,44,7,0,51,50,12,0,62
28843,345,"CĂMIN CULTURAL",CHIJIC,BH,214,5,2,0,7,12,2,0,14,17,6,0,23,20,8,0,28,22,8,0,30
28870,346,"CĂMIN CULTURAL",SURDUC,BH,329,6,3,0,9,13,3,0,16,17,7,0,24,24,9,0,33,30,14,0,44
28825,347,"GRĂDINIȚĂ CU PROGRAM NORMAL NR.3",COPĂCEL,BH,336,20,7,0,27,31,15,0,46,60,21,0,81,72,22,0,94,77,25,0,102
28852,348,"ȘCOALA PRIMARĂ NR.4","POIANA TĂŞAD",BH,122,3,4,0,7,8,5,0,13,12,5,0,17,13,5,0,18,14,7,0,21
28861,349,"ȘCOALA PRIMARĂ NR.1",SĂRAND,BH,407,6,2,0,8,11,3,0,14,18,4,0,22,32,9,13,54,33,12,13,58
28898,350,"CĂMINUL CULTURAL","CRIŞTIORU DE JOS",BH,288,6,0,0,6,8,0,0,8,10,2,1,13,12,2,1,15,13,4,1,18
28914,351,"CĂMINUL CULTURAL","CRIŞTIORU DE SUS",BH,73,2,0,0,2,4,0,0,4,5,1,0,6,6,2,0,8,8,2,0,10
28923,352,"CĂMINUL CULTURAL",POIANA,BH,399,11,1,0,12,17,3,0,20,26,4,0,30,31,4,0,35,35,4,0,39
28932,353,"ȘCOALA GIMNAZIALĂ NR. 1 SĂLIȘTE DE VAȘCĂU","SĂLIŞTE DE VAŞCĂU",BH,334,3,0,0,3,6,0,0,6,12,0,0,12,17,0,0,17,17,1,0,18
28950,354,"ŞCOALA GIMNAZIALĂ NR.1 CURĂŢELE",CURĂŢELE,BH,657,4,0,0,4,6,0,0,6,10,0,0,10,18,4,0,22,21,5,0,26
28969,355,"ŞCOALA GENERALĂ CU CLASELE I-IV BEIUŞELE",BEIUŞELE,BH,367,2,0,0,2,8,2,0,10,8,2,0,10,11,3,0,14,18,4,0,22
28978,356,"ŞCOALA GENERALĂ CU CLASELE I-IV CRESUIA",CRESUIA,BH,362,2,1,0,3,4,1,0,5,7,3,0,10,12,3,0,15,13,3,0,16
28987,357,"CĂMIN CULTURAL NIMĂIEŞTI",NIMĂIEŞTI,BH,679,3,0,0,3,14,0,0,14,24,1,0,25,28,2,0,30,33,2,0,35
29010,358,"ŞCOALA GENERALĂ CU CLASELE I-VIIINR. 542",CURTUIŞENI,BH,1016,2,2,0,4,13,5,0,18,14,5,0,19,18,6,0,24,18,8,0,26
29010,359,"PRIMĂRIA CURTUIŞENI",CURTUIŞENI,BH,1265,4,5,0,9,10,5,0,15,14,5,0,19,14,5,0,19,14,6,0,20
29029,360,"ŞCOALA GENERALĂ CU CLASELE I-VIII NR. 24",VĂŞAD,BH,679,6,4,0,10,7,4,0,11,9,5,0,14,25,6,0,31,28,7,0,35
29047,361,"PRIMĂRIA DERNA",DERNA,BH,742,13,5,0,18,19,5,0,24,22,5,0,27,25,5,0,30,26,5,0,31
29056,362,"ȘCOALA GIMNAZIALĂ NR.2",DERNIŞOARA,BH,427,14,1,0,15,24,2,0,26,31,2,0,33,52,2,0,54,59,2,0,61
29065,363,"ȘCOALA PRIMARĂ NR.1",SACALASĂU,BH,432,1,0,0,1,9,1,0,10,14,3,0,17,17,8,0,25,20,8,0,28
29074,364,"ȘCOALA PRIMARĂ NR.2","SACALASĂU NOU",BH,223,0,0,0,0,0,2,0,2,2,2,0,4,2,2,0,4,2,2,0,4
29083,365,"GRĂDINIȚA CU PROGRAM NORMAL NR.3",TRIA,BH,247,8,3,0,11,17,3,0,20,18,3,0,21,18,4,0,22,18,4,0,22
29109,366,"PRIMĂRIA COMUNEI DIOSIG",DIOSIG,BH,989,1,1,0,2,10,5,0,15,15,7,0,22,21,10,0,31,21,10,0,31
29109,367,"ŞCOALAGIMNAZIALĂNR.1DIOSIG,",DIOSIG,BH,953,1,0,0,1,5,4,0,9,7,4,0,11,8,4,0,12,8,6,0,14
29109,368,"ŞCOALA GIMNAZIALĂ NR.1 DIOSIG",DIOSIG,BH,954,3,5,0,8,9,5,0,14,13,5,0,18,16,5,0,21,16,5,0,21
29109,369,"ŞCOALA GIMNAZIALĂ NR.1 DIOSIG",DIOSIG,BH,1308,15,1,0,16,26,2,0,28,46,4,0,50,65,6,0,71,71,9,0,80
29109,370,"ŞCOALA GIMNAZIALĂ NR.1 DIOSIG",DIOSIG,BH,1069,1,3,0,4,2,3,0,5,6,4,0,10,11,4,0,15,13,5,0,18
29109,371,"ŞCOALA GIMNAZIALĂ NR.1 DIOSIG",DIOSIG,BH,227,0,0,0,0,1,0,0,1,1,8,0,9,3,10,0,13,3,10,0,13
29163,372,"CĂMINUL CULTURAL DOBREŞTI",DOBREŞTI,BH,1528,50,1,0,51,82,5,0,87,105,8,0,113,136,14,0,150,144,17,13,174
29207,373,"CĂMINUL CULTURAL LUNCASPRIE",LUNCASPRIE,BH,794,27,0,0,27,48,0,0,48,58,2,0,60,94,6,0,100,103,7,0,110
29190,374,"CĂMINUL CULTURAL HIDIŞEL",HIDIŞEL,BH,552,8,2,0,10,20,4,0,24,37,6,0,43,42,7,0,49,52,7,0,59
29181,375,"CĂMINUL CULTURAL CRINCEŞTI",CRÎNCEŞTI,BH,340,8,2,0,10,33,3,0,36,45,5,0,50,57,6,0,63,65,6,0,71
29172,376,"CĂMINUL CULTURAL CORNIŞEŞTI",CORNIŞEŞTI,BH,172,5,0,0,5,9,3,0,12,12,4,0,16,22,7,0,29,25,7,0,32
29225,377,"ŞCOALAS04TOPA DE JOS","TOPA DE JOS",BH,151,2,0,0,2,8,0,0,8,10,3,0,13,13,4,0,17,15,4,0,19
29234,378,"CĂMINUL CULTURAL TOPA DE SUS","TOPA DE SUS",BH,484,12,2,0,14,25,5,10,40,34,6,10,50,42,9,10,61,46,10,10,66
29252,379,"PRIMARIA DRAGANESTI",DRĂGĂNEŞTI,BH,371,12,0,0,12,19,0,0,19,36,0,0,36,42,0,0,42,42,0,0,42
29261,380,"SCOALA PRIMARA BELEJENI",BELEJENI,BH,256,10,0,0,10,17,1,0,18,20,2,0,22,25,2,0,27,26,2,0,28
29270,381,"SCOALA MAGHIARAGRADINARI",GRĂDINARI,BH,387,3,1,0,4,4,1,0,5,5,1,0,6,10,1,0,11,14,1,0,15
29289,382,"SCOALA PRIMARA LIVADA","LIVADA BEIUŞULUI",BH,110,2,0,0,2,9,0,0,9,9,0,0,9,13,0,0,13,18,0,0,18
29298,383,"FOSTUL SFAT POPULARMIZIES",MIZIEŞ,BH,437,8,2,0,10,11,4,0,15,14,4,0,18,19,4,0,23,21,5,0,26
29305,384,"CAMINUL CULTURAL PANTASESTI",PĂNTĂŞEŞTI,BH,115,2,1,0,3,5,1,0,6,7,1,0,8,9,1,0,10,10,1,0,11
29314,385,SCOALASEBIS,ŞEBIŞ,BH,257,7,0,0,7,17,1,0,18,21,5,0,26,29,5,0,34,33,5,0,38
29323,386,"SCOALA PRIMARA TALPE",TALPE,BH,203,4,0,0,4,8,0,0,8,11,0,0,11,14,0,0,14,15,0,0,15
29332,387,"CAMINUL CULTURAL TIGANESTI","ŢIGĂNEŞTII DE BEIUŞ",BH,120,0,0,0,0,5,1,0,6,11,1,0,12,15,1,0,16,17,1,0,18
32219,388,"CAMINUL CULTURAL PACALESTI",PĂCĂLEŞTI,BH,169,2,0,0,2,12,0,0,12,16,0,0,16,16,0,0,16,19,0,0,19
29350,389,"PRIMĂRIA DRĂGEŞTI",DRĂGEŞTI,BH,279,2,0,0,2,9,0,0,9,18,3,0,21,22,3,0,25,22,3,0,25
29369,390,"CĂMINUL CULTURAL",DICĂNEŞTI,BH,220,2,4,0,6,6,5,0,11,8,6,0,14,18,8,0,26,23,9,0,32
29378,391,"ŞCOALA CU CLASELE I-IV",STRACOŞ,BH,176,3,1,0,4,4,1,0,5,10,2,0,12,10,3,0,13,12,4,0,16
29387,392,"ŞCOALA CU CLASELE I-VIII",TĂŞAD,BH,991,4,2,0,6,10,4,0,14,25,7,0,32,49,13,0,62,63,21,0,84
29396,393,"CĂMINUL CULTURAL TOPEŞTI",TOPEŞTI,BH,180,3,3,0,6,11,3,7,21,17,6,7,30,21,6,7,34,30,6,7,43
29412,394,"PRIMĂRIA FINIŞ",FINIŞ,BH,1353,10,0,0,10,22,1,0,23,38,1,0,39,61,2,2,65,73,2,2,77
29430,395,"GRĂDINIŢA FIZIŞ",FIZIŞ,BH,193,2,1,0,3,3,1,0,4,5,1,0,6,7,1,0,8,11,1,0,12
29449,396,"ŞCOALA GENERALĂ IOANIŞ",IOANIŞ,BH,584,6,1,0,7,12,1,0,13,18,1,0,19,34,2,0,36,40,3,0,43
29458,397,"GRĂDINIŢA ŞUNCUIŞ",ŞUNCUIŞ,BH,674,4,0,0,4,5,1,0,6,12,1,0,13,16,3,0,19,19,5,0,24
28291,398,"ŞCOALA CU CLASELE I.-VIII GEPIU",GEPIU,BH,1007,20,15,0,35,51,33,0,84,93,46,0,139,128,70,0,198,135,75,0,210
28282,399,"ŞCOALA CU CLASELE I.-IV BICACI",BICACI,BH,493,6,4,0,10,8,7,0,15,13,7,0,20,19,12,0,31,21,13,0,34
29476,400,"PRIMĂRIA GIRIŞU DE CRIŞ","GIRIŞU DE CRIŞ",BH,1271,15,3,0,18,28,3,0,31,41,4,0,45,63,9,0,72,69,10,0,79
29494,401,"GRĂDINIȚA TĂRIAN",TĂRIAN,BH,940,12,0,0,12,24,1,0,25,31,2,0,33,40,2,0,42,42,4,0,46
29494,402,"FOSTA BIBLIOTECĂ COMUNALĂ",TĂRIAN,BH,871,2,1,0,3,8,3,0,11,12,3,0,15,15,3,0,18,15,3,0,18
29528,403,"ȘCOALA GIMNAZIALĂ HIDIȘELU DE SUS","HIDIŞELU DE SUS",BH,869,33,4,0,37,54,5,0,59,74,6,0,80,94,11,0,105,111,14,24,149
29537,404,"ȘCOALA PRIMARĂ HIDIȘELU DE JOS","HIDIŞELU DE JOS",BH,484,5,0,0,5,8,1,0,9,10,1,0,11,21,6,0,27,29,6,0,35
29546,405,"ȘCOALA GIMNAZIALĂ MIERLĂU",MIERLĂU,BH,594,7,1,0,8,32,1,0,33,65,7,0,72,102,15,0,117,118,19,0,137
29555,406,"ȘCOALA PRIMARĂ SÎNTELEC",SÎNTELEC,BH,316,3,0,0,3,7,0,0,7,10,1,0,11,18,4,0,22,23,6,0,29
29564,407,"ȘCOALA PRIMARĂ ȘUMUGIU",ŞUMUGIU,BH,325,6,0,0,6,8,3,0,11,14,8,0,22,18,12,0,30,22,15,0,37
29582,408,"ȘCOALA GIMNAZIALĂ ""IOSIF VULCAN""",HOLOD,BH,390,22,5,0,27,55,13,0,68,73,17,17,107,86,18,17,121,88,18,17,123
29591,409,"CĂMIN CULTURAL",DUMBRAVA,BH,500,2,5,0,7,2,6,0,8,10,6,0,16,35,8,0,43,43,9,0,52
29608,410,"CĂMIN CULTURAL",DUMBRĂVIŢA,BH,146,7,5,0,12,17,5,0,22,19,5,0,24,21,9,0,30,24,9,0,33
29617,411,"CĂMIN CULTURAL",FOROSIG,BH,120,7,0,0,7,21,2,0,23,35,4,0,39,41,5,0,46,42,7,0,49
29626,412,"CĂMIN CULTURAL HODIȘ",HODIŞ,BH,134,8,1,0,9,17,7,0,24,20,7,0,27,22,10,10,42,26,15,10,51
29635,413,"ȘCOALA CU CLASELE I-IV LUPOAIA",LUPOAIA,BH,452,4,2,0,6,29,7,0,36,34,7,0,41,41,12,0,53,42,13,0,55
29644,414,"ȘCOALA CU CLASELE I-IV","VALEA MARE DE CODRU",BH,68,6,3,0,9,6,7,0,13,6,11,0,17,13,17,0,30,13,17,0,30
29653,415,GRĂDINIȚA,VINTERE,BH,601,19,6,0,25,71,12,0,83,87,18,0,105,114,21,0,135,116,24,0,140
29671,416,"GRĂDINIȚA DE COPII","HUSASĂU DE TINCA",BH,612,5,0,0,5,10,3,0,13,27,8,12,47,40,25,12,77,40,27,12,79
29680,417,"ȘCOALA CU CLASELEI-IV FONĂU",FONĂU,BH,160,21,5,0,26,48,6,0,54,53,7,0,60,61,7,0,68,63,8,0,71
29699,418,"ȘCOALA CU CLASELE I-IV MIERSIG",MIERSIG,BH,325,4,0,0,4,19,0,0,19,26,2,0,28,31,3,0,34,36,3,0,39
29706,419,"ȘCOALA CU CLASELE I-IV OȘAND",OŞAND,BH,374,10,2,0,12,32,4,0,36,46,11,3,60,64,15,3,82,67,15,3,85
29715,420,"ȘCOALA CU CLASELE I-IV SITITELEC",SITITELEC,BH,256,5,1,0,6,10,4,0,14,14,10,0,24,23,22,0,45,27,26,0,53
29733,421,"CĂMINUL CULTURAL INEU",INEU,BH,847,16,3,0,19,31,8,0,39,39,13,0,52,49,17,0,66,55,22,0,77
29733,422,"CĂMINUL CULTURAL INEU",INEU,BH,1082,10,2,0,12,25,2,0,27,42,7,0,49,73,7,0,80,77,7,0,84
29742,423,"ȘCOALA NR. 1 BOTEAN",BOTEAN,BH,523,5,2,0,7,12,2,0,14,16,2,0,18,25,3,0,28,30,3,0,33
29751,424,"CĂMINUL CULTURAL HUSASĂU DE CRIȘ","HUSASĂU DE CRIŞ",BH,978,15,3,0,18,62,6,0,68,85,7,0,92,117,14,0,131,133,15,0,148
29779,425,PRIMĂRIA,"LAZURI DE BEIUŞ",BH,288,0,1,0,1,4,1,0,5,4,2,0,6,7,2,0,9,11,5,0,16
29804,426,"CĂMIN CULTURAL",HINCHIRIŞ,BH,535,6,3,0,9,23,5,0,28,30,9,0,39,41,9,0,50,54,9,0,63
29797,427,"ȘCOALA CU CLASELE I-IV",CUSUIUŞ,BH,373,1,1,0,2,6,1,0,7,14,1,0,15,15,1,0,16,16,1,0,17
29788,428,"ȘCOALA CU CLASELE I-IV",BĂLENI,BH,168,2,1,0,3,4,1,0,5,5,4,0,9,8,6,0,14,11,6,0,17
29822,429,"CĂMIN CULTURAL LĂZĂRENI",LĂZĂRENI,BH,649,15,1,0,16,26,3,0,29,34,7,0,41,44,9,0,53,66,11,0,77
29859,430,"ȘCOALA PRIMARĂ",CĂRĂNDENI,BH,336,8,1,0,9,19,6,0,25,25,9,0,34,28,10,0,38,30,16,0,46
29868,431,"CĂMIN CULTURAL CĂRĂNZEL",CĂRĂNZEL,BH,78,5,7,0,12,18,10,0,28,21,14,3,38,27,24,3,54,30,29,3,62
29840,432,"CĂMIN CULTURAL","CALEA MARE",BH,500,9,2,0,11,18,4,0,22,22,6,0,28,44,7,0,51,49,7,0,56
29877,433,"CĂMIN CULTURAL",GEPIŞ,BH,542,12,0,0,12,23,2,0,25,42,2,0,44,82,4,0,86,88,4,0,92
29886,434,"CĂMIN CULTURAL",GRUILUNG,BH,94,1,0,0,1,5,0,0,5,6,1,0,7,6,1,0,7,7,1,0,8
29895,435,"CĂMIN CULTURAL",MIHELEU,BH,136,2,9,0,11,7,10,0,17,12,11,0,23,14,11,0,25,15,11,0,26
29911,436,"CĂMINUL CULTURAL LUGAȘU DE JOS","LUGAŞU DE JOS",BH,1289,35,3,0,38,90,10,0,100,136,14,0,150,190,19,45,254,210,22,45,277
29920,437,"CĂMINUL CULTURAL LUGAȘU DE SUS","LUGAŞU DE SUS",BH,674,8,0,0,8,27,4,0,31,40,7,0,47,72,9,0,81,91,9,0,100
29939,438,"CĂMINUL CULTURAL URVIND",URVIND,BH,752,6,0,0,6,13,0,0,13,18,0,0,18,22,0,0,22,25,0,0,25
29957,439,"CĂMINUL CULTURAL LUNCA",LUNCA,BH,779,16,0,0,16,23,2,0,25,29,2,0,31,33,2,0,35,43,2,0,45
29966,440,"CĂMINUL CULTURAL BRIHENI",BRIHENI,BH,251,19,3,0,22,41,9,0,50,52,11,0,63,63,12,0,75,67,12,0,79
29975,441,"CĂMINUL CULTURAL HOTĂREL",HOTĂREL,BH,243,10,1,0,11,18,7,4,29,27,8,4,39,35,11,4,50,44,13,4,61
29984,442,"CĂMINUL CULTURAL SEGHIŞTE",SEGHIŞTE,BH,474,5,2,0,7,8,2,0,10,10,2,0,12,13,2,0,15,15,2,0,17
29993,443,"CAMINUL CULTURAL SIRBESTI",SÎRBEŞTI,BH,229,4,0,0,4,6,0,0,6,9,0,0,9,13,3,0,16,13,3,0,16
30005,444,"CĂMINUL CULTURAL ŞUŞTIU",ŞUŞTIU,BH,364,4,0,0,4,10,0,0,10,13,1,0,14,26,5,0,31,27,5,0,32
30050,445,CĂMINULCULTURAL,MARŢIHAZ,BH,162,3,2,0,5,7,3,0,10,9,3,1,13,9,3,1,13,11,4,1,16
30023,446,"ȘCOALA CU CLASELEI.-VIII",MĂDĂRAŞ,BH,762,5,3,0,8,11,8,0,19,21,9,0,30,25,12,0,37,27,13,0,40
30032,447,"FOSTA ȘCOALĂ CU CLASELE I.-IV",HOMOROG,BH,575,9,1,0,10,16,2,0,18,18,3,0,21,23,4,0,27,31,6,0,37
30041,448,"ŞCOALA CU CLASELE I-VIII",IANOŞDA,BH,745,5,3,0,8,15,8,0,23,22,12,0,34,31,12,4,47,41,12,4,57
30078,449,"PRIMĂRIA MĂGEŞTI",MĂGEŞTI,BH,215,1,1,0,2,3,1,0,4,9,4,0,13,14,4,0,18,19,6,0,25
30087,450,"ŞCOALA GENERALĂ",BUTANI,BH,305,8,3,0,11,14,4,0,18,24,4,0,28,45,4,0,49,49,4,0,53
30130,451,"ŞCOALA GENERALĂ",ORTITEAG,BH,425,4,2,0,6,7,3,0,10,16,4,0,20,22,5,0,27,30,5,0,35
30096,452,"ŞCOALA GENERALĂ","CACUCIU NOU",BH,289,5,3,0,8,7,3,0,10,9,3,0,12,14,4,0,18,15,4,0,19
30121,453,"ŞCOALA GENERALĂ",JOSANI,BH,294,2,2,0,4,4,7,0,11,8,7,0,15,13,8,0,21,13,8,0,21
30112,454,"ŞCOALA GENERALĂ",GĂLĂŞENI,BH,219,1,0,0,1,6,0,0,6,11,0,0,11,22,5,0,27,23,5,0,28
30103,455,"CĂMIN CULTURAL",DOBRICIONEŞTI,BH,425,8,1,0,9,14,3,0,17,17,3,0,20,20,3,0,23,21,3,0,24
30158,456,"ȘCOALA GIMNAZIALĂNR 1 NOJORID STR. PRINCIPALĂ NR 185LOC. NOJORID",NOJORID,BH,1974,13,2,0,15,40,6,0,46,65,13,0,78,102,16,0,118,116,17,0,133
30167,457,"SCOALA CUCLASELE I-IV APATEU , LOC. APATEUNR 41",APATEU,BH,246,3,0,0,3,19,7,0,26,33,10,0,43,42,12,0,54,44,15,0,59
30176,458,"ȘCOALA CU CL. I-IVCHIȘIRID, LOC CHIȘIRID NR 168",CHIŞIRID,BH,193,7,5,0,12,12,19,3,34,17,25,3,45,20,39,3,62,24,41,3,68
30185,459,"ȘCOALA GIMNAZIALĂ NR 3LEȘ ,LOC. LEȘNR 36",LEŞ,BH,691,5,1,0,6,9,3,0,12,21,4,0,25,26,9,0,35,31,9,0,40
30194,460,"GRĂDINIȚA -LIVADA DE BIHORLOC. LIVADA DE BIHORNR. 228","LIVADA DE BIHOR",BH,1169,16,2,0,18,30,5,0,35,51,5,0,56,69,5,0,74,71,5,0,76
30201,461,"ȘCOALA CU CL.I-IVPĂUȘA , NR 37/B",PĂUŞA,BH,246,1,2,0,3,10,4,0,14,11,5,0,16,13,6,0,19,13,6,0,19
30210,462,"ȘCOALA CU CL. I-IVȘAUAIEU, LOC. ȘAUAIEU NR 101",ŞAUAIEU,BH,236,1,0,0,1,7,0,0,7,13,3,0,16,17,4,0,21,18,5,0,23
30238,463,"ŞCOALA GIMNAZIALĂNR. 1OLCEA",OLCEA,BH,455,5,0,0,5,11,1,0,12,13,1,0,14,25,6,0,31,27,7,0,34
30247,464,"ŞCOALA GIMNAZIALĂ NR. 2 CĂLACEA",CĂLACEA,BH,968,10,3,0,13,45,6,0,51,74,8,0,82,122,10,34,166,136,10,34,180
30256,465,"ŞCOALA PRIMARĂ NR. 1 HODIŞEL",HODIŞEL,BH,254,1,0,0,1,2,3,0,5,4,3,0,7,10,3,0,13,14,3,0,17
30265,466,"GRĂDINIŢA CU PROGRAM NORMAL NR. 4 UCURIŞ",UCURIŞ,BH,454,13,7,0,20,30,11,0,41,36,11,0,47,46,15,0,61,49,17,17,83
30283,467,"ȘCOALA GIMNAZIALA„AUREL POP” OȘORHEI",OŞORHEI,BH,1352,18,3,0,21,59,4,0,63,80,5,0,85,106,11,0,117,117,11,0,128
30283,468,"ȘCOALA GIMNAZIALA „AUREL POP” OȘORHEI",OŞORHEI,BH,1415,17,3,0,20,36,7,0,43,69,8,0,77,105,10,0,115,124,12,0,136
30292,469,"ȘCOALA PRIMARĂ NR.1 ALPAREA",ALPAREA,BH,847,11,2,0,13,34,4,0,38,56,16,0,72,69,18,0,87,94,19,0,113
30309,470,"ȘCOALA PRIMARĂ NR.2 CHERIU",CHERIU,BH,627,4,3,0,7,7,5,0,12,12,5,0,17,20,7,0,27,26,7,0,33
30318,471,"CĂMIN CULTURAL FELCHERIU",FELCHERIU,BH,275,5,5,0,10,8,10,0,18,16,10,0,26,23,18,0,41,25,18,0,43
30327,472,"CĂMIN CULTURAL FUGHIU",FUGHIU,BH,960,22,1,0,23,57,4,0,61,77,6,0,83,100,9,0,109,111,9,0,120
28433,473,"ȘCOALA CU CLASELE I-IV",PALEU,BH,1337,3,0,0,3,10,0,0,10,20,5,0,25,28,5,0,33,38,8,0,46
28488,474,"ȘCOALA CU CLASELE I-IV","UILEACU DE MUNTE",BH,412,1,3,0,4,3,5,0,8,7,5,0,12,11,6,0,17,14,7,0,21
28442,475,"ȘCOALA CU CLASELE I-IV","SĂLDĂBAGIU DE MUNTE",BH,753,2,0,0,2,15,0,0,15,21,3,0,24,25,3,0,28,25,3,0,28
30345,476,"ȘCOALA GIMNAZIALĂ NR.1 PIETROASA",PIETROASA,BH,654,13,2,0,15,17,2,0,19,22,3,0,25,33,4,0,37,42,4,0,46
30381,477,"ȘCOALA PRIMARĂ NR.1 GURANI",GURANI,BH,485,8,3,0,11,11,6,0,17,15,6,0,21,32,8,0,40,38,8,0,46
30363,478,"ȘCOALA PRIMARĂ NR.2 COCIUBA MICĂ","COCIUBA MICĂ",BH,366,2,0,0,2,3,0,0,3,6,0,0,6,8,1,0,9,9,1,0,10
30354,479,"ȘCOALA GIMAZIALĂ NR.2 CHIȘCĂU",CHIŞCĂU,BH,601,3,1,0,4,17,3,0,20,22,3,0,25,36,7,0,43,43,11,0,54
30372,480,"ȘCOALA PRIMARĂ NR.4 GIULEȘTI",GIULEŞTI,BH,134,0,0,0,0,1,3,0,4,1,3,0,4,4,4,0,8,5,4,0,9
30390,481,"ȘCOALA PRIMARĂ NR.3 MĂGURA",MĂGURA,BH,248,6,4,0,10,10,6,0,16,16,6,0,22,21,6,0,27,27,6,0,33
30407,482,"ȘCOALA PRIMARĂ NR.5 MOȚEȘTI",MOŢEŞTI,BH,74,1,0,0,1,2,0,0,2,5,1,0,6,10,4,0,14,15,4,0,19
30425,483,"CAMINUL CULTURAL POCOLA",POCOLA,BH,448,10,10,0,20,31,17,0,48,40,17,0,57,46,23,0,69,50,26,0,76
30434,484,"CAMINULCULTURAL FENERIȘ",FENERIŞ,BH,293,9,3,0,12,26,8,0,34,37,11,0,48,52,11,0,63,56,13,0,69
30443,485,"CAMIN CULTURAL PETRANI",PETRANI,BH,281,9,3,0,12,19,8,0,27,26,11,0,37,35,12,0,47,39,12,0,51
30461,486,"CAMIN CULTURAL SINMARTIN DE BEIUȘ","SÎNMARTIN DE BEIUŞ",BH,192,5,1,0,6,6,1,0,7,7,3,0,10,14,3,0,17,19,4,0,23
30504,487,"CĂMIN CULTURAL COȘDENI",COŞDENI,BH,442,37,3,0,40,82,5,0,87,95,9,0,104,111,11,0,122,127,12,0,139
30513,488,"CĂMIN CULTURAL HIDIȘ",HIDIŞ,BH,278,3,2,0,5,9,5,0,14,10,7,0,17,16,10,0,26,16,11,0,27
30540,489,"CĂMIN CULTURAL SPINUȘ DE POMEZEU","SPINUŞ DE POMEZEU",BH,178,6,1,0,7,9,2,0,11,16,4,0,20,27,5,0,32,30,5,0,35
30559,490,"CĂMIN CULTURAL VĂLANI DE POMEZEU","VĂLANI DE POMEZEU",BH,466,14,0,0,14,26,0,0,26,34,1,0,35,42,2,0,44,62,2,0,64
30531,491,"GRĂDINIȚA CU PROGRAM NORMAL NR.2 SITANI",SITANI,BH,370,4,0,0,4,10,0,0,10,27,4,0,31,43,6,0,49,60,6,0,66
30489,492,"ȘCOALA GIMNAZIALĂ NR.1 POMEZEU",POMEZEU,BH,114,1,0,0,1,3,4,0,7,7,5,0,12,8,6,0,14,8,6,0,14
30522,493,"ȘCOALA GENERALĂ LACU SĂRAT","LACU SĂRAT",BH,36,0,0,0,0,0,0,0,0,2,0,0,2,2,0,0,2,2,0,0,2
30498,494,"ȘCOALA PRIMARĂ NR.2 CÎMPANI","CÎMPANI DE POMEZEU",BH,349,7,2,0,9,23,5,0,28,38,5,0,43,42,6,0,48,50,10,0,60
30577,495,"LICEUL TEHNOLOGIC NR 1 POPESTI",POPEŞTI,BH,939,9,0,0,9,13,3,0,16,20,3,0,23,29,3,0,32,34,3,0,37
30577,496,"LICEUL TEHNOLOGIC NR 1 POPESTI",POPEŞTI,BH,939,20,0,0,20,32,0,0,32,47,0,0,47,49,0,0,49,54,0,0,54
30639,497,"ŞCOALA GENERALĂ VOIVOZI",VOIVOZI,BH,780,2,4,0,6,7,5,0,12,11,5,0,16,14,5,0,19,14,5,0,19
30639,498,"ŞCOALA GENERALĂ VOIVOZI",VOIVOZI,BH,631,2,3,0,5,4,3,0,7,13,3,0,16,16,5,0,21,17,5,0,22
30586,499,"ȘCOALA GENERALĂBISTRA",BISTRA,BH,838,3,0,0,3,6,0,0,6,15,0,0,15,19,0,0,19,19,0,0,19
30595,500,"LICEUL ,,JOSEF KOZACEK” BUDOI",BUDOI,BH,747,6,2,0,8,7,2,0,9,10,2,0,12,13,2,0,15,13,2,0,15
30602,501,"ȘCOALA GENERALĂ CUZAP",CUZAP,BH,944,7,2,0,9,11,2,0,13,15,2,0,17,26,5,0,31,29,5,0,34
30611,502,"ȘCOALA GENERALĂ VARVIZ",VARVIZ,BH,410,3,1,0,4,8,2,0,10,10,2,0,12,19,2,0,21,24,6,0,30
30620,503,"ȘCOALA GENERALĂ VĂRZARI",VĂRZARI,BH,257,1,0,0,1,3,0,0,3,4,1,0,5,11,1,0,12,11,2,0,13
30657,504,"CĂMINUL CULTURAL",RĂBĂGANI,BH,511,7,0,0,7,18,0,0,18,26,2,0,28,40,6,0,46,44,6,0,50
30666,505,"FOSTA ȘCOALĂ CU CLASELE I-IV ALBEȘTI",ALBEŞTI,BH,216,3,0,0,3,7,1,0,8,12,1,0,13,16,4,0,20,21,5,0,26
30693,506,"CĂMINUL CULTURAL","SALIŞTE DE POMEZEU",BH,87,3,0,0,3,6,0,0,6,7,2,0,9,8,2,0,10,14,8,0,22
30684,507,"CĂMINUL CULTURAL",SĂUCANI,BH,385,8,1,0,9,12,1,0,13,16,1,0,17,19,1,0,20,21,1,0,22
30700,508,"CĂMINUL CULTURAL",VĂRĂŞENI,BH,314,6,3,0,9,12,7,0,19,16,7,0,23,19,9,0,28,22,9,0,31
30675,509,"FOSTA GRĂDINIȚĂ CU PROGRAM NORMAL",BRĂTEŞTI,BH,101,8,6,0,14,16,7,0,23,24,8,0,32,27,8,0,35,29,10,0,39
30728,510,"ȘCOALA GIMNAZIALĂ NR 1",REMETEA,BH,663,13,3,0,16,19,3,0,22,26,9,0,35,34,11,0,45,37,11,0,48
30746,511,"ȘCOALA GIMNAZIALĂ NR 2",MEZIAD,BH,897,3,2,0,5,7,2,0,9,12,2,0,14,15,4,0,19,16,4,0,20
30737,512,"ȘCOALA PRIMARĂ NR. 2",DRĂGOTENI,BH,324,3,1,0,4,6,2,0,8,10,7,0,17,10,8,0,18,11,8,0,19
30755,513,"ȘCOALA PRIMARĂ NR. 1",PETREASA,BH,352,10,1,0,11,18,2,0,20,21,2,0,23,29,3,0,32,32,3,0,35
30764,514,"CĂMINUL CULTURAL ŞOIMUŞ",SOIMUŞ,BH,100,1,2,0,3,3,4,0,7,3,6,0,9,7,10,0,17,11,11,0,22
30782,515,"CĂMIN CULTURAL RIENI",RIENI,BH,451,5,0,0,5,7,0,0,7,10,0,0,10,15,2,0,17,17,2,0,19
30808,516,"CĂMIN CULTURAL GHIGHIȘENI",GHIGHIŞENI,BH,787,10,3,0,13,18,7,0,25,30,7,0,37,38,8,0,46,47,10,0,57
30835,517,"ȘCOALA PRIMARĂ NR.1 VALEA DE JOS","VALEA DE JOS",BH,472,3,0,0,3,5,1,0,6,10,1,0,11,20,1,0,21,21,1,0,22
30817,518,"CĂMIN CULTURAL PETRILENI",PETRILENI,BH,465,4,0,0,4,13,3,0,16,27,3,0,30,35,6,0,41,37,7,0,44
30826,519,"CĂMIN CULTURAL SUDRIGIU",SUDRIGIU,BH,277,8,0,0,8,11,2,0,13,18,4,0,22,21,6,0,27,24,6,0,30
30853,520,"CĂMINUL CULTURAL ROŞIA",ROŞIA,BH,1616,10,3,0,13,27,8,0,35,36,11,0,47,40,13,0,53,58,14,0,72
30862,521,"ŞCOALA CU CLASELE I-IV LAZURI",LAZURI,BH,321,7,0,0,7,9,1,0,10,9,1,0,10,17,1,0,18,23,2,0,25
29136,522,"ŞCOALA GIMNAZIALĂ ”JAKO ZSIGMOND”",ROŞIORI,BH,1159,4,2,0,6,16,3,0,19,28,5,0,33,61,9,6,76,67,9,6,82
29127,523,"ŞCOALA GIMNAZIALĂ NR.1","MIHAI BRAVU",BH,831,7,4,0,11,18,13,0,31,25,15,0,40,53,18,0,71,61,19,0,80
29145,524,"ŞCOALA PRIMARĂNR.1",VAIDA,BH,370,8,3,0,11,21,5,0,26,25,5,0,30,27,5,0,32,29,5,0,34
30880,525,"CĂMIN CULTURAL",SĂCĂDAT,BH,725,5,1,0,6,10,1,0,11,16,3,0,19,28,8,0,36,35,10,0,45
30906,526,"CĂMIN CULTURAL",SĂBOLCIU,BH,593,20,4,0,24,40,7,0,47,64,10,0,74,96,22,0,118,108,23,0,131
30899,527,"FOSTA ȘCOALĂ CU CLS.I-IV",BORŞA,BH,140,4,0,0,4,6,3,0,9,11,6,0,17,15,9,0,24,15,10,0,25
31002,528,"CĂMINUL CULTURAL",OTOMANI,BH,590,10,0,0,10,17,0,0,17,18,0,0,18,20,0,0,20,22,1,0,23
30997,529,"CĂMIN CULTUTRAL",SĂLACEA,BH,950,12,4,0,16,17,5,0,22,25,5,0,30,25,5,0,30,26,5,0,31
30997,530,"SCOALĂ GENERALĂ",SĂLACEA,BH,924,6,0,0,6,11,1,0,12,13,1,0,14,16,1,0,17,17,1,0,18
31020,531,"ȘCOALA GIMNAZIALĂ SZALARDI JANOS SĂLARD",SĂLARD,BH,1192,16,2,0,18,35,6,0,41,57,12,0,69,57,14,0,71,58,14,0,72
31020,532,"ȘCOALA GIMNAZIALĂ SZALARDI JANOS SĂLARD",SĂLARD,BH,1286,4,0,0,4,10,1,0,11,21,15,0,36,32,18,0,50,37,18,0,55
31039,533,"ȘCOALA PRIMARĂ NR.1",HODOŞ,BH,604,1,0,0,1,1,0,0,1,3,1,0,4,3,1,0,4,6,1,0,7
31048,534,"ȘCOALA PRIMARĂ NR. 2",SÎNTIMREU,BH,479,5,2,0,7,12,3,0,15,12,4,0,16,17,5,0,22,18,6,0,24
28647,535,"CASA DE NUNTĂ",SÂNIOB,BH,1065,1,1,0,2,1,1,0,2,1,1,0,2,2,2,0,4,2,2,0,4
28629,536,"ŞCOALA GENERALĂ",CIUHOI,BH,291,4,1,0,5,8,5,0,13,13,8,0,21,16,10,0,26,16,14,0,30
28638,537,"ŞCOALA GENERALĂ",CENALOŞ,BH,217,1,1,0,2,3,1,0,4,4,1,0,5,6,1,0,7,7,3,0,10
28656,538,"CĂMIN CULTURAL SFÂRNAȘ",SFÂRNAŞ,BH,208,4,1,0,5,14,1,0,15,26,3,0,29,31,8,0,39,33,8,0,41
28326,539,"CAMIN CULTURAL","SÂNNICOLAU ROMÂN",BH,944,18,1,0,19,30,6,0,36,48,13,0,61,65,15,0,80,74,15,0,89
28273,540,"SCOALA GENERALA",BERECHIU,BH,269,7,3,0,10,9,3,0,12,14,5,0,19,20,6,0,26,20,6,0,26
28317,541,GRADINITA,ROIT,BH,524,5,3,0,8,17,6,0,23,25,8,2,35,40,8,2,50,57,9,2,68
31066,542,"CAMINUL CULTURAL",SÎMBĂTA,BH,293,8,2,0,10,13,5,0,18,20,6,0,26,24,9,0,33,27,10,0,37
31075,543,"CAMINUL CULTURAL",COPĂCENI,BH,107,4,2,0,6,13,4,0,17,14,7,0,21,19,12,1,32,22,12,1,35
31084,544,"CAMINUL CULTURAL",OGEŞTI,BH,172,6,2,0,8,14,2,0,16,21,2,0,23,28,3,6,37,33,3,6,42
31100,545,"CAMINUL CULTURAL",ROTĂREŞTI,BH,113,6,4,0,10,11,4,0,15,14,9,0,23,17,14,4,35,24,16,4,44
31093,546,"CAMINUL CULTURAL",ROGOZ,BH,231,4,0,0,4,9,0,0,9,10,1,0,11,14,5,0,19,18,5,0,23
31119,547,"CAMINUL CULTURAL",ZĂVOIU,BH,196,6,3,0,9,7,5,0,12,8,6,0,14,16,14,0,30,16,14,0,30
26591,548,"GRĂDINIŢA SÂNMARTIN",SÎNMARTIN,BH,1581,29,3,0,32,88,9,0,97,125,21,0,146,164,37,0,201,199,38,0,237
26591,549,"SCOALA CU CLS. I-VIII",SÎNMARTIN,BH,1996,30,10,0,40,94,22,0,116,153,33,0,186,196,47,0,243,249,65,0,314
26608,550,"SCOALA CU CLASELE I-IV",BETFIA,BH,377,3,1,0,4,11,3,0,14,16,5,0,21,22,6,0,28,33,11,0,44
32143,551,"GRADINITA BAILE FELIX","BĂILE FELIX",BH,484,19,32,0,51,20,176,0,196,29,298,0,327,42,396,0,438,48,468,0,516
26617,552,"SC. GENERALA CU CLS.I-IV",CIHEI,BH,1159,24,4,0,28,79,19,0,98,130,34,0,164,170,42,0,212,209,55,0,264
26635,553,"SC. GENERALA CU CLS.I-IV",HAIEU,BH,1017,12,7,0,19,20,60,0,80,47,108,0,155,61,143,0,204,75,158,0,233
26644,554,"SC. GENERALA CU CLS.I-IV",RONTĂU,BH,940,7,0,0,7,15,0,0,15,38,2,0,40,53,3,0,56,57,4,0,61
26626,555,"SC. GENERALA CU CLS.I-VIII",CORDĂU,BH,1298,13,3,0,16,44,4,0,48,73,4,0,77,100,5,0,105,107,12,0,119
26662,556,"SCOALA GIMNAZIALA NR.1 SINTANDREI",SÎNTANDREI,BH,1451,3,2,0,5,28,9,0,37,42,13,0,55,55,17,0,72,66,18,0,84
26662,557,"SCOALA GIMNAZIALA NR.1 SINTANDREI",SÎNTANDREI,BH,1437,11,2,0,13,39,3,0,42,61,5,0,66,80,6,0,86,97,7,0,104
26662,558,"SCOALA GIMNAZIALA NR.1 SINTANDREI",SÎNTANDREI,BH,1790,24,4,0,28,47,12,0,59,69,18,0,87,104,21,0,125,122,21,0,143
26671,559,"CAMIN CULTURAL PALOTA",PALOTA,BH,590,4,3,0,7,5,4,0,9,14,4,0,18,20,4,0,24,24,6,0,30
31137,560,"CAMIN CULTURAL",SÎRBI,BH,836,22,7,0,29,58,14,0,72,86,19,0,105,110,32,0,142,127,35,0,162
31155,561,"CAMIN CULTURAL",BURZUC,BH,627,11,0,0,11,21,1,0,22,37,2,0,39,61,10,0,71,66,15,0,81
31146,562,"SCOALA GENERALA","ALMAŞU MIC",BH,85,3,2,0,5,4,5,0,9,4,5,0,9,6,5,0,11,8,7,0,15
31164,563,"SPAȚIU PENTRU ALEGERI GENERALE",CHIOAG,BH,118,2,3,0,5,5,3,0,8,7,4,0,11,10,4,0,14,10,4,0,14
31173,564,"SCOALA GENERALA",FEGERNIC,BH,280,5,4,0,9,9,5,0,14,11,5,0,16,11,5,0,16,12,5,0,17
31191,565,"SCOALA GENERALA",SARCĂU,BH,52,0,0,0,0,0,0,0,0,0,4,0,4,0,4,0,4,0,4,0,4
31217,566,"SCOALA GIMNAZIALA NR.1 SPINUS",SPINUŞ,BH,306,1,0,0,1,1,5,0,6,2,5,0,7,5,7,0,12,7,7,0,14
31244,567,"FOSTA SCOALA CU CLASELE I-IV NĂDAR",NĂDAR,BH,186,1,8,0,9,2,9,0,11,4,12,0,16,5,12,0,17,10,17,0,27
31226,568,"FOSTA SCOALA CU CLASELE I-IV CIULEȘTI",CIULEŞTI,BH,157,6,1,0,7,9,6,0,15,12,8,0,20,15,10,0,25,22,11,0,33
31253,569,"SCOALA PRIMARĂ NR.1 SĂLIŞTE",SĂLIŞTE,BH,200,3,1,0,4,4,2,0,6,5,4,0,9,9,5,0,14,9,5,0,14
31235,570,"FOSTA SCOALA CU CLASELE I-IV GURBEŞTI",GURBEŞTI,BH,103,0,0,0,0,3,0,0,3,6,1,0,7,9,1,0,10,9,1,0,10
31271,571,"LIC. TEHNOLOGIC NR1 SUPLACU DE BARCAU","SUPLACU DE BARCĂU",BH,986,2,4,0,6,18,6,0,24,18,6,0,24,18,6,0,24,19,7,0,26
31271,572,"FOST SEDIU PRIMARIE","SUPLACU DE BARCĂU",BH,1036,9,0,0,9,19,2,0,21,24,2,0,26,32,3,0,35,36,3,0,39
31280,573,"CAMIN CULTURAL",BORUMLACA,BH,758,2,2,0,4,9,2,0,11,15,2,0,17,18,2,0,20,19,2,0,21
31299,574,"SCOALA PRIMARA NR. 2",DOLEA,BH,128,1,0,0,1,1,0,0,1,3,0,0,3,3,0,0,3,3,0,0,3
31306,575,"SCOALA PRIMARA NR. 5",FOGLAŞ,BH,164,1,0,0,1,2,1,0,3,6,2,0,8,6,2,0,8,7,3,0,10
31315,576,"SCOALA PRIMARA NR. 3","VALEA CERULUI",BH,370,2,4,0,6,7,4,0,11,7,4,0,11,7,4,0,11,7,4,0,11
31324,577,"SCOALA PRIMARA NR. 4",VÎLCELELE,BH,204,6,4,0,10,7,4,0,11,9,4,0,13,10,6,0,16,11,6,0,17
31342,578,"GRĂDINIȚA CU PROGRAM NORMAL NR,3",ŞIMIAN,BH,234,3,3,0,6,8,3,0,11,10,3,0,13,11,3,0,14,11,3,0,14
31342,579,"ȘCOALA GIMNAZIALĂ ""KAZINCZY FERENC"" ȘIMIAN",ŞIMIAN,BH,1651,7,0,0,7,13,2,0,15,15,2,0,17,18,2,0,20,19,2,0,21
31342,580,"FOSTA ȘCOALĂ PRIMARĂ CU CLASELE I-IV",ŞIMIAN,BH,140,5,0,0,5,8,0,0,8,14,0,0,14,18,0,0,18,19,1,0,20
31351,581,"ȘCOALA PRIMARĂ CU NR,1",ŞILINDRU,BH,736,4,4,0,8,10,7,0,17,18,7,0,25,22,7,0,29,22,7,0,29
31360,582,"ȘCOALA PRIMARĂ NR,2",VOIVOZI,BH,325,9,3,0,12,13,6,0,19,15,6,0,21,15,7,0,22,16,7,0,23
31388,583,"PRIMARIA COMUNEI SINTEU",ŞINTEU,BH,967,5,1,0,6,8,2,0,10,15,2,0,17,20,3,0,23,25,3,0,28
31431,584,"SEDIUL PRIMĂRIEI ȘOIMI",ŞOIMI,BH,575,6,3,0,9,31,6,0,37,36,6,0,42,41,6,0,47,44,6,0,50
31486,585,"FOSTA ŞCOALĂ CU CLASELE I - IV","SÎNNICOLAU DE BEIUŞ",BH,97,1,4,0,5,1,5,0,6,4,5,0,9,7,5,0,12,9,6,0,15
31495,586,"FOSTA ȘCOALĂ CU CLASELE I - VIII",URSAD,BH,125,3,0,0,3,4,0,0,4,5,0,0,5,9,2,0,11,9,2,0,11
31477,587,"FOSTA ȘCOALĂ CU CLASELE I - IV","POCLUŞA DE BEIUŞ",BH,71,3,1,0,4,5,2,0,7,9,5,0,14,16,7,0,23,18,7,0,25
31459,588,"FOSTA ȘCOALĂ CU CLASELE I- IV",CODRU,BH,137,2,1,0,3,4,1,0,5,6,2,0,8,7,3,0,10,12,3,0,15
31440,589,"FOSTA ȘCOALĂ CU CLASELE I - IV",BORZ,BH,151,0,0,0,0,2,2,0,4,4,2,0,6,5,2,0,7,5,2,0,7
31501,590,"ŞCOALA CU CLASELE I - VIII","URVIŞ DE BEIUŞ",BH,503,3,0,0,3,14,2,0,16,22,3,0,25,45,4,0,49,51,7,0,58
31468,591,"FOSTA ȘCOALĂ CU CLASELE I- IV","DUMBRĂVIŢA DE CODRU",BH,265,7,3,0,10,10,4,0,14,16,5,0,21,21,5,0,26,26,6,0,32
31529,592,"LICEUL TEHNOLOGIC NR. 1 - ŞUNCUIUŞ",ŞUNCUIUŞ,BH,1285,9,0,0,9,25,4,0,29,46,4,50,100,73,7,50,130,77,13,50,140
31529,593,"SCOALA CU CLS. I+IV ""POJORATA""",ŞUNCUIUŞ,BH,100,3,4,0,7,4,4,0,8,4,4,0,8,4,4,0,8,4,4,0,8
31538,594,"SCOALA CU CLASELE I-VIII BALNACA",BĂLNACA,BH,779,2,0,0,2,7,0,0,7,9,6,0,15,13,6,0,19,22,8,0,30
31547,595,"CAMIN CULTURAL SAT BALNACA GROSI",BĂLNACA-GROŞI,BH,55,0,0,0,0,2,1,0,3,5,5,0,10,5,5,0,10,6,5,0,11
31556,596,"CAMIN CULTURAL CATUN CARMAZAN","ZECE HOTARE",BH,147,0,1,0,1,0,1,0,1,0,5,0,5,2,5,0,7,3,5,0,8
31556,597,"SCOALA CU CLASELE I-VIII ZECEHOTARE","ZECE HOTARE",BH,144,2,2,0,4,4,2,0,6,7,4,0,11,9,4,0,13,9,4,0,13
31574,598,"CĂMINUL CULTURAL",TARCEA,BH,739,4,3,0,7,12,5,0,17,18,7,0,25,25,8,0,33,25,8,0,33
31583,599,"CĂMINUL CULTURAL",ADONI,BH,617,1,0,0,1,2,0,0,2,4,0,0,4,6,0,0,6,7,0,0,7
31592,600,"CASA ROTH",GALOŞPETREU,BH,772,1,1,0,2,3,1,0,4,5,3,0,8,9,3,0,12,10,4,0,14
27481,601,"CĂMINUL CULTURAL","SATU NOU",BH,190,6,2,0,8,10,2,0,12,11,3,0,14,15,3,0,18,15,3,0,18
27490,602,"CĂMINUL CULTURAL",TĂMĂŞEU,BH,903,8,2,0,10,17,2,0,19,24,3,0,27,47,4,0,51,51,7,0,58
27463,603,"CĂMINUL CULTURAL",NIUVED,BH,194,3,1,0,4,5,1,0,6,5,1,0,6,9,3,0,12,10,4,0,14
27472,604,"ŞCOALA GENERALĂ",PARHIDA,BH,405,8,1,0,9,13,2,0,15,15,2,0,17,19,3,0,22,21,5,0,26
31618,605,"PRIMARIA TARCAIA",TĂRCAIA,BH,917,6,4,0,10,21,4,0,25,37,4,0,41,67,4,0,71,76,4,0,80
31636,606,"CAMIN CULTURAL",TĂRCĂIŢA,BH,336,9,5,0,14,12,8,0,20,14,8,0,22,27,9,0,36,39,9,0,48
31645,607,"CAMIN CULTURAL",TOTORENI,BH,231,4,1,0,5,10,2,0,12,10,3,0,13,20,5,0,25,20,5,0,25
31627,608,"SCOALA CU CLASELE I-IV",MIERAG,BH,167,2,0,0,2,6,0,0,6,9,0,0,9,15,2,0,17,19,3,0,22
31690,609,"ŞCOALA GIMNAZIALĂ NR.4 CIUTELEC",CIUTELEC,BH,547,4,4,0,8,12,7,0,19,16,7,24,47,18,8,24,50,23,8,24,55
31707,610,"SCOALA PRIMARA",POIANA,BH,206,0,0,0,0,0,0,0,0,0,0,0,0,2,1,0,3,7,1,0,8
31663,611,"SCOALA GIMNAZIALA",TĂUTEU,BH,921,2,0,0,2,7,0,0,7,9,0,0,9,13,0,0,13,17,0,0,17
31672,612,"SCOALA GIMNAZIALA",BOGEI,BH,1172,6,0,0,6,19,1,0,20,34,3,0,37,45,4,0,49,49,4,0,53
31681,613,"SCOALA GIMNAZIALA",CHIRIBIŞ,BH,637,2,0,0,2,7,0,1,8,13,0,1,14,20,0,1,21,24,0,1,25
31725,614,"CENTRUL CULTURAL MULTIFUNCTIONAL",TILEAGD,BH,1875,22,2,0,24,43,6,0,49,64,11,0,75,93,12,0,105,110,13,0,123
31725,615,"SCOALA CU CLS.I-IV",TILEAGD,BH,1394,21,3,0,24,48,5,0,53,70,6,8,84,87,7,8,102,98,8,9,115
31743,616,"SCOALA CU CLS.I-IV",CĂLĂTANI,BH,156,4,3,0,7,5,3,0,8,10,7,0,17,17,10,0,27,19,13,0,32
31734,617,"SCOALA CU CLS.I-IV",BĂLAIA,BH,525,5,0,0,5,13,1,0,14,18,1,0,19,37,2,0,39,47,2,0,49
31761,618,"CĂMIN CULTURAL",TILECUŞ,BH,676,27,4,0,31,42,10,0,52,51,12,0,63,75,13,0,88,87,19,0,106
31752,619,"CĂMIN CULTURAL",POŞOLOACA,BH,330,2,3,0,5,3,3,0,6,5,3,0,8,12,3,0,15,17,3,0,20
31770,620,"CĂMIN CULTURAL","UILEACU DE CRIŞ",BH,689,5,0,0,5,10,0,0,10,12,0,0,12,14,0,0,14,16,3,0,19
31798,621,"LICEUL TEORETIC N.JIGA",TINCA,BH,1339,12,0,0,12,30,0,0,30,67,5,0,72,95,9,0,104,102,9,0,111
31798,622,"SCOALA PRIMARA I-IV",TINCA,BH,1270,30,2,0,32,71,8,0,79,84,15,0,99,107,18,0,125,131,22,0,153
31798,623,"GRADINITA CU PROGRAM PRELUNGIT",TINCA,BH,1126,22,1,0,23,49,7,0,56,72,10,0,82,88,12,0,100,103,16,0,119
31823,624,"SCOALA GENERALA",GURBEDIU,BH,913,11,0,0,11,38,0,0,38,48,3,0,51,66,6,0,72,79,6,0,85
31814,625,"SCOALA PRIMARA I-IV","GIRIŞU NEGRU",BH,582,20,0,0,20,46,1,0,47,57,3,0,60,75,9,0,84,79,9,0,88
31832,626,"SCOALA GENERALA",RÎPA,BH,448,2,2,0,4,7,3,0,10,14,9,0,23,27,10,0,37,33,12,0,45
31805,627,"SCOALA PRIMARA I-IV",BELFIR,BH,479,1,0,0,1,4,0,0,4,9,0,0,9,12,0,0,12,15,2,0,17
29500,628,"ȘCOALA GIMNAZIALĂ TOBOLIU",TOBOLIU,BH,775,10,2,0,12,13,4,0,17,17,6,0,23,25,8,0,33,28,8,0,36
29485,629,"ȘCOALA GENERALĂ CHERESIG",CHERESIG,BH,930,5,0,0,5,8,5,0,13,24,5,0,29,45,8,13,66,53,9,13,75
31850,630,"CĂMINUL CULTURAL TULCA",TULCA,BH,1557,38,3,0,41,84,9,0,93,136,16,0,152,159,21,0,180,178,22,0,200
31850,631,"ȘCOALA CU CLASELE I-IV TULCA NOUĂ",TULCA,BH,234,3,2,0,5,9,2,0,11,14,3,0,17,25,3,0,28,27,3,0,30
31869,632,"CĂMINUL CULTURAL CĂUAȘD",CĂUAŞD,BH,374,12,3,0,15,30,7,0,37,39,12,0,51,51,12,0,63,53,12,0,65
31887,633,"CĂMIN CULTURAL",ŢEŢCHEA,BH,676,9,0,0,9,18,1,0,19,27,2,0,29,41,3,0,44,43,3,0,46
31903,634,"CĂMIN CULTURAL",SUBPIATRĂ,BH,486,1,1,0,2,14,6,0,20,28,7,1,36,41,9,1,51,45,9,1,55
31912,635,"CĂMIN CULTURAL",TELECHIU,BH,637,3,0,0,3,7,0,0,7,15,0,0,15,27,0,0,27,28,0,0,28
31896,636,"CĂMIN CULTURAL",HOTAR,BH,719,5,0,0,5,9,4,0,13,15,4,0,19,20,9,0,29,23,11,0,34
31949,637,"ŞCOALA PRIMARĂ NR.1",FORĂU,BH,664,2,0,0,2,17,2,0,19,22,3,0,25,34,5,10,49,36,5,10,51
31930,638,"ŞCOALA GIMNAZIALĂ NR.1","UILEACU DE BEIUŞ",BH,507,2,0,0,2,7,0,0,7,8,0,0,8,16,2,0,18,22,4,0,26
31958,639,"GRĂDINIŢA CU PROGRAM NORMAL NR.3",PRISACA,BH,369,1,0,0,1,5,1,0,6,8,2,0,10,9,2,0,11,20,4,0,24
31967,640,"GRĂDINIŢA CU PROGRAM NORMAL NR.4","VĂLANII DE BEIUŞ",BH,207,2,1,0,3,4,3,0,7,9,3,0,12,14,3,0,17,40,3,0,43
31985,641,"CĂMIN CULTURAL VADU CRIŞULUI","VADU CRIŞULUI",BH,1484,18,0,0,18,41,1,0,42,58,1,0,59,86,6,0,92,102,6,0,108
31985,642,"ŞCOALA GENERALĂ VADU CRIŞULUI","VADU CRIŞULUI",BH,845,10,2,0,12,30,2,0,32,37,3,0,40,50,3,0,53,58,5,0,63
32009,643,"ŞCOALA GENERALĂ TOMNATIC",TOMNATIC,BH,222,0,0,0,0,0,5,0,5,3,5,0,8,4,5,0,9,4,5,0,9
32018,644,"ŞCOALA GENERALĂ TOPA DE CRIŞ","TOPA DE CRIŞ",BH,356,5,6,0,11,11,6,0,17,21,6,0,27,36,9,0,45,38,10,0,48
31994,645,"CĂMIN CULTURAL BIRTIN",BIRTIN,BH,293,7,1,0,8,8,1,0,9,14,1,0,15,19,1,0,20,21,2,0,23
32054,646,"CĂMIN CULTURAL",VIIŞOARA,BH,876,2,1,0,3,9,2,0,11,21,2,0,23,26,2,0,28,31,2,0,33
32063,647,"CĂMIN CULTURAL",IZVOARELE,BH,168,1,2,0,3,2,2,0,4,5,2,0,7,5,4,0,9,5,4,0,9
32107,648,"CĂMINUL CULTURAL",VÂRCIOROG,BH,870,7,0,0,7,17,6,0,23,21,10,0,31,43,11,0,54,57,11,0,68
32116,649,"ŞCOALA GIMNAZIALĂ NR.2",FÂŞCA,BH,356,3,3,0,6,8,4,0,12,10,4,0,14,25,15,0,40,31,17,0,48
32134,650,"GRĂDINIŢA DE COPII CU PROGRAM NORMAL",ŞERGHIŞ,BH,433,18,7,0,25,35,10,0,45,59,13,0,72,72,14,0,86,83,15,0,98
32401,1,"CLUBUL SPORTIV MUNICIPAL BISTRIŢA",BISTRIŢA,BN,1302,13,0,0,13,49,3,0,52,60,4,0,64,85,6,0,91,93,9,0,102
32401,2,"GRĂDINIŢA CU PROGRAM SĂPTĂMÂNAL ""DUMBRAVA MINUNATĂ""",BISTRIŢA,BN,1196,4,5,0,9,13,5,0,18,24,7,0,31,36,7,0,43,39,7,0,46
32401,3,"LICEUL DE MUZICĂ ""TUDOR JARDA""",BISTRIŢA,BN,1206,7,1,0,8,27,4,0,31,45,4,7,56,65,5,7,77,69,6,7,82
32401,4,"PRIMĂRIA MUNICIPIULUI BISTRIŢA, DIRECŢIA ECONOMICĂ-VENITURI",BISTRIŢA,BN,1725,20,0,0,20,62,0,0,62,94,3,0,97,134,3,0,137,134,3,1,138
32401,5,"GRĂDINIŢA CU PROGRAM PRELUNGIT NR. 6",BISTRIŢA,BN,1481,10,2,0,12,33,3,0,36,48,3,0,51,67,5,0,72,74,5,0,79
32401,6,"GRĂDINIŢA CU PROGRAM PRELUNGIT NR. 6",BISTRIŢA,BN,1411,7,5,0,12,29,5,0,34,50,5,0,55,63,5,0,68,71,5,0,76
32401,7,"LICEUL TEHNOLOGIC SPECIAL ""SFÂNTA MARIA"" BISTRIŢA",BISTRIŢA,BN,1328,14,1,0,15,36,2,0,38,51,4,0,55,74,5,38,117,76,6,38,120
32401,8,"ŞCOALA GIMNAZIALĂ NR. 1",BISTRIŢA,BN,1113,11,0,0,11,26,4,0,30,34,4,0,38,54,6,0,60,59,6,0,65
32401,9,"ŞCOALA GIMNAZIALĂ NR. 1",BISTRIŢA,BN,1194,8,4,0,12,21,10,0,31,33,12,0,45,45,14,0,59,53,15,0,68
32401,10,"ŞCOALA GIMNAZIALĂ NR. 1",BISTRIŢA,BN,1444,19,0,0,19,51,4,0,55,72,5,0,77,97,5,0,102,112,5,0,117
32401,11,"ŞCOALA GIMNAZIALĂ NR. 1",BISTRIŢA,BN,1238,13,4,0,17,53,4,0,57,75,4,0,79,101,4,0,105,110,4,0,114
32401,12,"GRĂDINIŢA CU PROGRAM NORMAL NR. 10",BISTRIŢA,BN,1380,16,4,0,20,34,5,0,39,49,7,0,56,68,9,0,77,76,9,0,85
32401,13,"ŞCOALA GIMNAZIALĂ ""LUCIAN BLAGA""",BISTRIŢA,BN,1726,8,5,0,13,25,5,0,30,50,5,0,55,75,7,0,82,81,8,0,89
32401,14,"ŞCOALA GIMNAZIALĂ ""LUCIAN BLAGA""",BISTRIŢA,BN,1635,12,0,0,12,41,2,0,43,49,2,0,51,70,2,0,72,77,2,0,79
32401,15,"ŞCOALA GIMNAZIALĂ ""LUCIAN BLAGA""",BISTRIŢA,BN,1681,6,0,0,6,25,4,0,29,33,4,0,37,52,4,0,56,58,4,0,62
32401,16,"COLEGIUL TEHNIC ""GRIGORE MOISIL""",BISTRIŢA,BN,1769,10,0,0,10,44,1,0,45,60,3,0,63,73,4,0,77,80,5,0,85
32401,17,"COLEGIUL TEHNIC ""GRIGORE MOISIL""",BISTRIŢA,BN,1353,15,2,0,17,38,3,0,41,61,3,0,64,86,4,0,90,91,7,0,98
32401,18,"GRĂDINIŢA CU PROGRAM NORMAL NR. 18",BISTRIŢA,BN,1211,8,1,0,9,23,3,0,26,30,4,0,34,48,6,0,54,58,6,0,64
32401,19,"GRĂDINIŢA CU PROGRAM NORMAL NR.18",BISTRIŢA,BN,1543,8,0,0,8,38,0,0,38,48,1,0,49,75,1,0,76,79,1,0,80
32401,20,"GRĂDINIŢA CU PROGRAM PRELUNGIT ""TRENULEŢUL VESELIEI""",BISTRIŢA,BN,1347,10,0,0,10,26,2,0,28,50,3,0,53,65,3,0,68,68,3,0,71
32401,21,"LICEUL TEHNOLOGIC FORESTIER",BISTRIŢA,BN,1741,17,2,0,19,33,4,147,184,61,6,148,215,108,7,148,263,119,7,148,274
32401,22,"GRĂDINIŢA CU PROGRAM NORMAL ""CĂSUŢA CU POVEŞTI""",BISTRIŢA,BN,1743,10,3,175,188,31,4,175,210,55,7,175,237,81,9,175,265,108,11,175,294
32401,23,"COLEGIUL NAŢIONAL ""ANDREI MUREŞANU""",BISTRIŢA,BN,1457,8,5,0,13,27,6,1,34,44,9,1,54,53,15,1,69,61,17,1,79
32401,24,"GRĂDINIŢA CU PROGRAM PRELUNGIT ""CĂSUŢA CU POVEŞTI""",BISTRIŢA,BN,1312,8,3,0,11,42,9,0,51,57,9,0,66,79,10,0,89,85,11,1,97
32401,25,"GRĂDINIŢA CU PROGRAM NORMAL NR. 15",BISTRIŢA,BN,1164,14,1,0,15,25,1,0,26,35,4,0,39,39,4,0,43,39,4,0,43
32401,26,"COLEGIUL NAŢIONAL ""LIVIU REBREANU"", ŞCOALA PRIMARĂ",BISTRIŢA,BN,1319,9,2,0,11,45,4,0,49,62,4,0,66,84,4,0,88,88,6,0,94
32401,27,"COLEGIUL NAŢIONAL ""LIVIU REBREANU""",BISTRIŢA,BN,1387,16,0,0,16,53,6,0,59,78,8,0,86,93,10,0,103,103,10,0,113
32401,28,"GRĂDINIŢA CU PROGRAM NORMAL NR. 9",BISTRIŢA,BN,1252,8,2,0,10,31,3,0,34,51,3,0,54,78,5,0,83,83,5,0,88
32401,29,"UNIVERSITATEA ""BABEŞ-BOLYAI"" CLUJ-NAPOCA, EXTENSIA UNIVERSITARĂ BISTRIŢA",BISTRIŢA,BN,1815,15,0,0,15,39,1,0,40,71,5,0,76,102,5,0,107,109,5,0,114
32401,30,"UNIVERSITATEA ""BABEŞ-BOLYAI"" CLUJ-NAPOCA, EXTENSIA UNIVERSITARĂ BISTRIŢA",BISTRIŢA,BN,1569,9,1,0,10,32,2,0,34,47,3,0,50,69,4,0,73,69,8,0,77
32401,31,"ŞCOALA GIMNAZIALĂ NR. 4",BISTRIŢA,BN,1885,34,0,0,34,81,0,0,81,125,4,0,129,163,8,0,171,182,10,0,192
32401,32,"ŞCOALA GIMNAZIALĂ NR. 4",BISTRIŢA,BN,1295,16,0,0,16,50,2,0,52,67,6,0,73,75,6,0,81,78,6,0,84
32401,33,"GRĂDINIŢA CU PROGRAM NORMAL NR. 5",BISTRIŢA,BN,1397,10,0,0,10,38,1,0,39,54,1,0,55,77,1,0,78,84,2,0,86
32401,34,"GRĂDINIŢA CU PROGRAM PRELUNGIT NR. 12",BISTRIŢA,BN,1375,9,3,0,12,46,3,0,49,65,3,0,68,96,3,0,99,106,3,0,109
32401,35,"GRĂDINIŢA CU PROGRAM NORMAL NR. 16",BISTRIŢA,BN,1306,13,1,0,14,48,2,0,50,74,5,0,79,89,6,0,95,94,7,0,101
32401,36,"ŞCOALA GIMNAZIALĂ ""AVRAM IANCU""",BISTRIŢA,BN,1313,15,4,0,19,47,7,0,54,58,10,0,68,80,11,0,91,84,13,0,97
32401,37,"ŞCOALA GIMNAZIALĂ ""AVRAM IANCU""",BISTRIŢA,BN,1300,7,3,0,10,21,6,0,27,41,6,0,47,73,6,0,79,74,6,0,80
32401,38,"GRĂDINIŢA CU PROGRAM PRELUNGIT NR. 13",BISTRIŢA,BN,1368,13,4,0,17,40,6,0,46,67,9,0,76,96,10,0,106,105,15,0,120
32401,39,"ŞCOALA GIMNAZIALĂ ""ŞTEFAN CEL MARE""",BISTRIŢA,BN,1320,16,1,0,17,36,3,0,39,63,3,0,66,82,4,0,86,90,7,0,97
32401,40,"ŞCOALA GIMNAZIALĂ ""ŞTEFAN CEL MARE""",BISTRIŢA,BN,1456,9,1,0,10,36,4,0,40,67,6,0,73,80,6,0,86,88,6,0,94
32401,41,"GRĂDINIŢA CU PROGRAM PRELUNGIT NR. 3",BISTRIŢA,BN,1462,13,3,0,16,41,4,0,45,56,6,0,62,75,6,0,81,84,7,0,91
32401,42,"CREŞA NR. 3",BISTRIŢA,BN,942,15,0,0,15,39,0,0,39,46,0,0,46,62,1,0,63,64,1,0,65
32401,43,"GRĂDINIŢA CU PROGRAM NORMAL NR. 7",BISTRIŢA,BN,1214,10,1,0,11,31,6,0,37,49,10,0,59,64,12,0,76,73,13,0,86
32401,44,"GRĂDINIŢA CU PROGRAM NORMAL NR. 7",BISTRIŢA,BN,940,5,0,0,5,15,0,0,15,27,0,0,27,39,1,0,40,46,1,0,47
32401,45,"ROTARY CLUBBISTRIŢA NOSA",BISTRIŢA,BN,1677,19,0,0,19,51,1,0,52,76,5,0,81,88,7,0,95,99,7,0,106
32401,46,"GRĂDINIŢA CU PROGRAM PRELUNGIT ""RAZĂ DE SOARE""",BISTRIŢA,BN,1383,8,1,0,9,45,3,0,48,61,3,0,64,85,6,0,91,85,6,0,91
32401,47,"COLEGIUL TEHNIC ""INFOEL""",BISTRIŢA,BN,1714,8,1,0,9,47,4,0,51,71,6,0,77,101,10,0,111,108,11,0,119
32401,48,"LICEUL CU PROGRAM SPORTIV",BISTRIŢA,BN,1279,2,4,0,6,11,9,0,20,29,12,0,41,44,16,0,60,45,18,0,63
32401,49,"LICEUL CU PROGRAM SPORTIV",BISTRIŢA,BN,1332,14,5,0,19,53,9,0,62,66,12,0,78,85,12,0,97,99,13,0,112
32456,50,"GRĂDINIŢA CU PROGRAM NORMAL UNIREA",UNIREA,BN,1462,14,1,0,15,28,2,0,30,50,5,0,55,76,7,0,83,89,11,0,100
32456,51,"GRĂDINIŢA CU PROGRAM NORMAL UNIREA",UNIREA,BN,1315,14,1,0,15,35,1,0,36,46,1,0,47,72,6,0,78,85,7,0,92
32447,52,"ŞCOALA PRIMARĂ ""DIMITRIE COJOCARU""SLĂTINIŢA",SLĂTINIŢA,BN,623,4,1,0,5,10,1,0,11,10,1,0,11,10,1,0,11,13,1,0,14
32410,53,"GRĂDINIŢA CU PROGRAM NORMAL GHINDA",GHINDA,BN,649,3,2,0,5,9,2,0,11,13,2,0,15,15,2,0,17,17,2,0,19
32438,54,"CASA DE CULTURĂ SIGMIR",SIGMIR,BN,850,5,2,0,7,12,2,0,14,16,2,0,18,20,3,0,23,23,4,0,27
32465,55,"ŞCOALA GIMNAZIALĂ NR. 7 VIIŞOARA",VIIŞOARA,BN,1285,4,0,0,4,9,1,0,10,16,2,0,18,30,2,0,32,36,3,0,39
32465,56,"ŞCOALA GIMNAZIALĂ NR.7 VIIŞOARA",VIIŞOARA,BN,1062,6,0,0,6,12,0,0,12,24,0,0,24,26,0,0,26,31,0,0,31
32429,57,"ŞCOALA PRIMARĂ SĂRATA",SĂRATA,BN,962,4,1,0,5,5,3,0,8,6,6,0,12,11,7,0,18,11,7,0,18
32492,58,"SALA DE CĂSĂTORII",BECLEAN,BN,1541,22,3,0,25,70,7,0,77,111,13,0,124,142,18,0,160,167,19,0,186
32492,59,"POLICLINICA ORĂŞENEASCĂ BECLEAN",BECLEAN,BN,1507,22,2,0,24,59,42,0,101,100,46,0,146,121,48,44,213,141,50,44,235
32492,60,"CLUBUL COPIILOR BECLEAN",BECLEAN,BN,820,6,3,0,9,22,3,0,25,40,5,0,45,53,7,0,60,60,8,0,68
32492,61,"CLUBUL COPIILOR BECLEAN",BECLEAN,BN,848,8,2,0,10,19,6,0,25,28,6,0,34,39,7,0,46,50,8,0,58
32492,62,"ŞCOALA GIMNAZIALĂ ""GRIGORE SILAŞI""",BECLEAN,BN,1573,19,2,0,21,36,4,0,40,50,5,0,55,79,7,0,86,98,8,0,106
32492,63,"CASA DE CULTURĂ ""RADU SĂPLĂCAN"" BECLEAN",BECLEAN,BN,1558,27,3,0,30,57,3,0,60,79,3,0,82,104,4,0,108,118,7,0,125
32492,64,"ŞCOALA GENERALĂ BECLENUŢ",BECLEAN,BN,344,5,3,0,8,12,3,0,15,16,3,0,19,19,3,0,22,28,3,0,31
32492,65,"GRĂDINIȚA CU PROGRAM NORMAL VALEA VIILOR",BECLEAN,BN,366,1,3,0,4,2,3,0,5,7,3,0,10,15,3,0,18,16,3,0,19
32508,66,"GRĂDINIȚA CU PROGRAM NORMAL COLDĂU",COLDĂU,BN,656,5,3,0,8,13,4,0,17,14,4,0,18,22,4,0,26,25,4,0,29
32517,67,"ȘCOALA PRIMARĂ FIGA",FIGA,BN,422,4,1,0,5,5,3,0,8,9,3,0,12,18,3,0,21,18,3,0,21
32526,68,"GRĂDINIȚA CU PROGRAM NORMAL RUSU DE JOS","RUSU DE JOS",BN,290,2,5,0,7,2,5,0,7,4,6,0,10,4,6,0,10,5,7,0,12
32553,69,"ŞCOALA DE APLICAŢIE",NĂSĂUD,BN,1397,20,2,0,22,48,2,0,50,59,4,0,63,72,5,0,77,78,5,0,83
32553,70,"ŞCOALA GIMNAZIALĂ ""MIHAI EMINESCU""",NĂSĂUD,BN,1488,9,2,0,11,37,3,0,40,61,4,0,65,84,4,0,88,92,7,0,99
32553,71,"COLEGIUL ECONOMIC",NĂSĂUD,BN,1165,9,1,0,10,21,2,0,23,39,2,0,41,48,2,0,50,51,3,0,54
32553,72,"COLEGIUL SILVIC ""TRANSILVANIA""",NĂSĂUD,BN,1480,10,3,0,13,47,3,0,50,75,4,25,104,93,4,26,123,103,4,26,133
32553,73,"AUTOGARA CĂLĂTORI",NĂSĂUD,BN,1732,16,3,0,19,44,4,0,48,71,6,0,77,89,8,0,97,94,8,0,102
32553,74,"ŞCOALA GENERALĂ VALEA SPINULUI",NĂSĂUD,BN,1010,5,0,0,5,19,0,0,19,36,0,0,36,42,0,0,42,46,3,0,49
32562,75,"CĂMINUL CULTURAL LIVIU REBREANU","LIVIU REBREANU",BN,609,3,0,0,3,10,1,0,11,13,1,0,14,21,1,0,22,25,1,0,26
32571,76,"CĂMINUL CULTURAL LUŞCA",LUŞCA,BN,532,3,0,0,3,5,3,0,8,9,3,0,12,16,4,0,20,17,4,0,21
32606,77,"ȘCOALA GIMNAZIALĂ ""ARTEMIU PUBLIU ALEXI"" SÎNGEORZ-BĂI",SÎNGEORZ-BĂI,BN,1366,9,2,0,11,36,9,0,45,47,11,0,58,56,14,0,70,64,14,0,78
32606,78,"ŞCOALA GIMNAZIALĂ ""ARTEMIU PUBLIU ALEXI"" SÎNGEORZ-BĂI",SÎNGEORZ-BĂI,BN,1414,12,1,0,13,20,3,0,23,38,4,0,42,50,8,0,58,60,8,0,68
32606,79,"ŞCOALA GIMNAZIALĂ ""ARTEMIU PUBLIU ALEXI"" SÎNGEORZ-BĂI",SÎNGEORZ-BĂI,BN,1297,1,0,0,1,17,0,0,17,27,1,0,28,40,1,0,41,49,2,0,51
32606,80,"CLUBUL TINERETULUI SÎNGEORZ-BĂI",SÎNGEORZ-BĂI,BN,1316,11,3,0,14,24,3,0,27,38,3,0,41,46,3,0,49,53,6,0,59
32606,81,"LICEUL TEORETIC ""SOLOMON HALIȚĂ""",SÎNGEORZ-BĂI,BN,1287,6,3,0,9,22,3,0,25,35,6,0,41,51,6,0,57,61,6,0,67
32606,82,"GRĂDINIȚA CU PROGRAM NORMAL SÎNGEORZ-BĂI",SÎNGEORZ-BĂI,BN,1382,5,22,0,27,12,34,0,46,29,44,0,73,50,46,0,96,63,47,0,110
32615,83,"ŞCOALA GIMNAZIALĂ CORMAIA",CORMAIA,BN,683,5,4,0,9,9,4,0,13,33,6,0,39,44,7,0,51,51,7,0,58
32642,84,"CĂMINUL CULTURALBISTRIŢA BÎRGĂULUI","BISTRIŢA BÎRGĂULUI",BN,1353,8,0,0,8,21,1,0,22,25,1,0,26,36,2,0,38,46,5,0,51
32642,85,"ŞCOALA GIMNAZIALĂ NR. 2 BISTRIŢA BÎRGĂULUI","BISTRIŢA BÎRGĂULUI",BN,988,0,0,0,0,8,0,0,8,9,0,0,9,11,0,0,11,12,0,0,12
32642,86,"SALA DE NUNŢI BISTRIŢA BÎRGĂULUI","BISTRIŢA BÎRGĂULUI",BN,1052,2,2,0,4,7,3,0,10,17,3,0,20,19,3,0,22,19,3,0,22
32651,87,"ŞCOALA GIMNAZIALĂ COLIBIŢA",COLIBIŢA,BN,248,0,0,0,0,0,0,0,0,1,1,0,2,3,1,0,4,3,1,0,4
32679,88,"PRIMĂRIA COMUNEI BRANIŞTEA",BRANIŞTEA,BN,951,6,1,0,7,8,1,0,9,9,1,0,10,12,1,0,13,12,1,0,13
32688,89,"CĂMINUL CULTURAL CIREŞOAIA",CIREŞOAIA,BN,1171,3,0,0,3,4,0,2,6,8,0,4,12,13,0,6,19,17,0,6,23
32697,90,"CĂMINUL CULTURAL MĂLUŢ",MĂLUŢ,BN,469,4,1,0,5,7,1,0,8,11,1,0,12,13,1,0,14,19,1,0,20
32713,91,"PRIMĂRIA COMUNEI BUDACU DE JOS","BUDACU DE JOS",BN,767,8,1,0,9,9,1,0,10,11,1,0,12,15,1,0,16,17,1,0,18
32722,92,"ŞCOALA GIMNAZIALĂ BUDUŞ",BUDUŞ,BN,450,3,0,0,3,6,0,0,6,9,0,0,9,15,0,0,15,16,1,0,17
32731,93,"CENTRUL LOCAL DE INFORMARE TURISTICĂ",JELNA,BN,775,6,1,0,7,14,1,0,15,16,2,0,18,25,4,0,29,29,4,0,33
32740,94,"ŞCOALA GIMNAZIALĂ MONARIU",MONARIU,BN,414,6,4,0,10,11,4,0,15,17,4,0,21,29,5,0,34,36,5,0,41
32759,95,"ŞCOALA GIMNAZIALĂ SIMIONEŞTI",SIMIONEŞTI,BN,175,5,2,0,7,7,5,0,12,9,7,0,16,9,7,0,16,11,7,0,18
32777,96,"ŞCOALA GIMNAZIALĂ BUDEŞTI",BUDEŞTI,BN,483,5,0,0,5,14,1,0,15,19,1,0,20,25,2,0,27,31,2,0,33
32786,97,"ŞCOALA PRIMARĂ BUDEŞTI-FÎNAŢE",BUDEŞTI-FÂNAŢE,BN,258,2,0,0,2,8,1,0,9,9,1,0,10,14,1,0,15,14,1,0,15
32795,98,"ŞCOALA PRIMARĂ ŢAGU",ŢAGU,BN,485,10,2,0,12,13,2,0,15,15,4,0,19,26,6,0,32,26,7,0,33
32802,99,"ŞCOALA PRIMARĂ ŢĂGŞORU",ŢĂGŞORU,BN,201,3,0,0,3,3,0,0,3,6,3,0,9,7,3,0,10,7,3,0,10
32820,100,"PRIMĂRIA COMUNEI CĂIANU MIC","CĂIANU MIC",BN,1230,13,2,0,15,20,3,0,23,29,8,0,37,56,12,0,68,83,17,28,128
32839,101,"ŞCOALA GIMNAZIALĂ CĂIANU MARE","CĂIANU MARE",BN,468,10,0,0,10,21,0,0,21,23,0,0,23,26,3,0,29,37,7,0,44
32857,102,"ŞCOALA GIMNAZIALĂ DOBRIC",DOBRIC,BN,1097,28,2,0,30,32,4,0,36,50,5,6,61,80,6,23,109,136,7,23,166
32848,103,"CĂMINUL CULTURAL CICEU-POIENI",CICEU-POIENI,BN,567,23,0,0,23,37,0,0,37,60,4,0,64,102,10,0,112,116,21,0,137
32893,104,"BIBLIOTECA COMUNALĂ SATU NOU","SATU NOU",BN,588,9,0,0,9,14,3,0,17,20,3,0,23,27,3,0,30,34,4,0,38
32937,105,"ŞCOALACLASELE I - IV PETRIŞ",PETRIŞ,BN,1004,5,0,0,5,8,6,0,14,14,10,0,24,22,10,0,32,31,12,0,43
32928,106,"CĂMINUL CULTURAL ORHEIU BISTRIŢEI","ORHEIU BISTRIŢEI",BN,644,9,2,0,11,15,2,0,17,18,2,0,20,21,4,0,25,26,4,0,30
33024,107,"PRIMĂRIA COMUNEI CHIOCHIŞ",CHIOCHIŞ,BN,317,4,0,0,4,6,0,0,6,10,3,0,13,10,4,0,14,10,4,0,14
33033,108,"ŞCOALA PRIMARĂ APATIU",APATIU,BN,257,1,0,0,1,1,0,0,1,1,0,0,1,2,0,0,2,3,0,0,3
33104,109,"ŞCOALA PRIMARĂ STRUGURENI",STRUGURENI,BN,160,1,0,0,1,1,2,0,3,1,2,0,3,2,2,0,4,2,2,0,4
33042,110,"GRĂDINIȚA BOZIEŞ",BOZIEŞ,BN,528,5,1,0,6,11,1,0,12,14,2,0,16,16,2,0,18,16,2,0,18
33060,111,"ŞCOALA PRIMARĂ CHEŢIU",CHEŢIU,BN,266,0,0,0,0,0,1,0,1,1,2,0,3,4,2,0,6,4,2,0,6
33097,112,"ŞCOALA PRIMARĂ SÎNNICOARĂ",SÎNNICOARĂ,BN,91,1,1,0,2,2,2,0,4,3,3,0,6,3,5,0,8,3,5,0,8
33113,113,"ŞCOALA PRIMARĂ ŢENTEA",ŢENTEA,BN,105,0,0,0,0,1,0,0,1,1,0,0,1,1,0,0,1,1,0,0,1
33088,114,"ŞCOALA PRIMARĂ MANIC",MANIC,BN,198,5,2,0,7,6,2,0,8,7,2,0,9,7,2,0,9,7,2,0,9
33079,115,"CĂMINUL CULTURAL JIMBOR",JIMBOR,BN,349,0,0,0,0,3,1,0,4,5,1,0,6,20,1,0,21,23,1,0,24
33051,116,"CĂMINUL CULTURAL BUZA-CĂTUN","BUZA CĂTUN",BN,95,0,0,0,0,1,0,0,1,1,0,0,1,1,0,0,1,1,0,0,1
33131,117,"ŞCOALA GIMNAZIALĂ""LIVIU REBREANU"" CHIUZA",CHIUZA,BN,739,8,0,0,8,18,0,0,18,19,0,0,19,27,4,0,31,31,5,0,36
33168,118,"CĂMINUL CULTURAL SĂSARM",SĂSARM,BN,552,6,3,0,9,12,4,0,16,15,7,0,22,22,7,0,29,27,7,0,34
33159,119,"ŞCOALA PRIMARĂ PIATRA",PIATRA,BN,404,1,0,0,1,2,1,0,3,10,1,0,11,13,1,0,14,21,3,0,24
33140,120,"CĂMINUL CULTURALMIREŞ",MIREŞ,BN,114,1,0,0,1,2,0,0,2,3,0,0,3,4,1,0,5,4,1,0,5
34217,121,"CĂMINUL CULTURAL CICEU-MIHĂIEŞTI",CICEU-MIHĂIEŞTI,BN,742,10,0,0,10,17,1,0,18,19,3,0,22,21,4,0,25,21,4,0,25
34226,122,"ŞCOALA GENERALĂ LELEŞTI",LELEŞTI,BN,119,0,0,0,0,0,1,0,1,1,1,0,2,4,3,0,7,4,3,0,7
34208,123,"ŞCOALA GENERALĂ CICEU-CORABIA",CICEU-CORABIA,BN,111,4,6,0,10,6,8,0,14,7,8,0,15,10,10,0,20,10,10,0,20
32964,124,"ŞCOALA GIMNAZIALĂ CICEU-GIURGEŞTI",CICEU-GIURGEŞTI,BN,752,9,1,0,10,25,2,0,27,41,6,0,47,63,11,0,74,64,11,0,75
32982,125,"CĂMINUL CULTURAL DUMBRĂVENI",DUMBRĂVENI,BN,522,8,2,0,10,13,2,0,15,19,2,0,21,27,3,0,30,28,7,0,35
33186,126,"ŞCOALA GIMNAZIALĂ „GEORGE COŞBUC”",COŞBUC,BN,1625,7,0,0,7,23,0,0,23,35,2,0,37,50,2,0,52,65,4,0,69
33211,127,"ŞCOALA GENERALĂ DUMITRA",DUMITRA,BN,1061,6,0,0,6,16,0,0,16,18,1,0,19,21,2,0,23,27,3,0,30
33211,128,"ŞCOALA GENERALĂ DUMITRA",DUMITRA,BN,1319,6,0,0,6,20,0,0,20,29,0,0,29,35,0,0,35,40,0,0,40
33220,129,"ŞCOALA GENERALĂ CEPARI",CEPARI,BN,910,9,0,0,9,18,0,0,18,22,2,0,24,31,4,0,35,35,5,0,40
33239,130,"ŞCOALA GENERALĂ TĂRPIU",TĂRPIU,BN,752,9,0,0,9,11,0,0,11,22,1,0,23,24,1,0,25,24,1,0,25
32919,131,"CENTRUL DE INFORMARE ŞI MARKETING TURISTIC",DUMITRIŢA,BN,1022,2,0,0,2,12,0,0,12,17,1,0,18,36,1,0,37,44,1,0,45
32900,132,"ŞCOALA DE ARTE ŞI MESERII BUDACU DE SUS","BUDACU DE SUS",BN,1496,6,0,0,6,10,0,0,10,13,0,0,13,17,0,0,17,22,0,0,22
33257,133,"PRIMĂRIA COMUNEI FELDRU",FELDRU,BN,1498,7,5,0,12,19,5,0,24,35,5,0,40,51,6,0,57,63,6,0,69
33257,134,"LICEUL TEHNOLOGIC FELDRU",FELDRU,BN,1420,16,2,0,18,25,4,0,29,40,4,0,44,54,5,0,59,60,5,0,65
33257,135,"AFTER-SCHOOL FELDRU",FELDRU,BN,1377,9,6,0,15,30,6,0,36,44,7,0,51,62,8,0,70,77,8,0,85
33257,136,"ŞCOALA PRIMARĂ PODEREI",FELDRU,BN,363,0,2,0,2,1,3,0,4,2,5,0,7,3,5,0,8,4,5,0,9
33266,137,"ȘCOALA GIMNAZIALĂ „GAVRIL ISTRATE” NEPOS",NEPOS,BN,1518,14,0,0,14,42,0,0,42,78,0,0,78,138,0,0,138,154,0,0,154
33284,138,"CĂMINUL CULTURAL GALAŢII BISTRIŢEI","GALAŢII BISTRIŢEI",BN,558,3,0,0,3,7,0,0,7,13,0,0,13,21,0,0,21,25,0,0,25
33300,139,"ŞCOALA GENERALĂ DIPŞA CLASELE I - IV",DIPŞA,BN,687,6,1,0,7,12,3,0,15,13,3,0,16,22,3,0,25,22,3,0,25
33319,140,"ŞCOALA GENERALĂ HERINA CLASELE I - IV",HERINA,BN,436,5,2,0,7,8,2,0,10,12,2,0,14,15,2,0,17,16,2,0,18
33293,141,"ŞCOALA GENERALĂ ALBEŞTII BISTRIŢEI","ALBEŞTII BISTRIŢEI",BN,127,0,0,0,0,1,1,0,2,2,2,0,4,4,4,0,8,5,10,0,15
33328,142,"ŞCOALA GENERALĂ TONCIU",TONCIU,BN,189,0,0,0,0,0,1,0,1,0,1,0,1,0,1,0,1,0,1,0,1
33346,143,"PRIMĂRIA COMUNEI ILVA MARE","ILVA MARE",BN,1065,14,0,0,14,28,1,0,29,41,1,26,68,50,1,26,77,60,1,26,87
33346,144,"PRIMĂRIA COMUNEI ILVA MARE","ILVA MARE",BN,904,12,2,0,14,20,3,0,23,26,3,0,29,36,3,0,39,49,3,25,77
33373,145,"ŞCOALA GIMNAZIALĂ NR. 2","ILVA MICA",BN,1295,11,2,0,13,41,3,0,44,61,3,0,64,74,3,0,77,77,3,0,80
33373,146,"ŞCOALA GIMNAZIALĂ ""DEMIAN NECHITI""","ILVA MICA",BN,1450,10,0,0,10,23,2,0,25,23,4,0,27,34,4,24,62,47,4,24,75
33391,147,"CĂMINUL CULTURAL JOSENII BÎRGĂULUI","JOSENII BÎRGĂULUI",BN,838,9,0,0,9,13,0,0,13,18,0,0,18,27,0,0,27,29,3,0,32
33391,148,"ȘCOALA GIMNAZIALĂ JOSENII BÎRGĂULUI","JOSENII BÎRGĂULUI",BN,860,8,1,0,9,12,1,0,13,17,1,0,18,22,1,0,23,23,1,0,24
33408,149,"GRĂDINIȚĂ MIJLOCENII BÎRGĂULUI","MIJLOCENII BÎRGĂULUI",BN,1393,10,1,0,11,18,2,0,20,21,4,0,25,27,4,0,31,33,4,0,37
33417,150,"CĂMINUL CULTURAL RUSU BÎRGĂULUI","RUSU BÎRGĂULUI",BN,769,8,0,0,8,14,0,0,14,21,0,0,21,30,4,0,34,34,4,0,38
33426,151,"ŞCOALA PRIMARĂ STRÎMBA",STRÎMBA,BN,354,2,2,0,4,14,7,0,21,18,8,0,26,24,8,0,32,30,9,0,39
33444,152,"PRIMĂRIA COMUNEI LECHINȚA",LECHINŢA,BN,1184,7,0,0,7,20,1,0,21,25,1,0,26,31,1,8,40,40,5,8,53
33444,153,"ȘCOALA PROFESIONALĂ LECHINȚA, NR.394",LECHINŢA,BN,1194,5,1,0,6,18,1,0,19,35,2,0,37,41,2,0,43,49,2,0,51
33471,154,"CĂMINULCULTURAL SÎNGEORZU- NOU","SÎNGEORZU NOU",BN,808,5,1,0,6,10,3,0,13,10,5,0,15,18,5,0,23,26,5,0,31
33462,155,"CĂMINULCULTURAL CHIRALEŞ",CHIRALEŞ,BN,413,4,0,0,4,8,3,0,11,12,3,0,15,20,3,0,23,27,3,0,30
33480,156,"ŞCOALA PRIMARĂ SÎNIACOB",SÎNIACOB,BN,182,1,1,0,2,6,1,0,7,10,2,0,12,12,2,0,14,12,3,0,15
33499,157,"ŞCOALA PRIMARĂ ŢIGĂU",ŢIGĂU,BN,363,1,0,0,1,4,2,0,6,7,2,0,9,13,2,0,15,17,3,0,20
33505,158,"CĂMINUL CULTURAL VERMEŞ",VERMEŞ,BN,738,0,0,0,0,5,0,0,5,6,0,0,6,17,0,0,17,25,0,0,25
33523,159,"ȘCOALA GIMNAZIALĂ NR. 1 - LEȘU",LEŞU,BN,1366,8,0,0,8,23,0,0,23,33,1,0,34,49,1,0,50,54,1,0,55
33532,160,"ŞCOALA GENERALĂ NR. 2 LUNCA LEŞULUI","LUNCA LEŞULUI",BN,916,1,0,0,1,4,3,0,7,5,3,0,8,11,3,0,14,11,3,0,14
33550,161,"CĂMINUL CULTURAL LIVEZILE",LIVEZILE,BN,1231,6,3,0,9,19,4,0,23,28,4,0,32,34,4,0,38,38,4,0,42
33550,162,"ŞCOALA GIMNAZIALĂ LIVEZILE",LIVEZILE,BN,1202,12,4,0,16,27,5,0,32,41,9,0,50,50,9,0,59,60,9,0,69
33578,163,"ŞCOALA GIMNAZIALĂ DOROLEA",DOROLEA,BN,560,3,0,0,3,11,1,0,12,17,1,0,18,24,3,0,27,35,3,0,38
33569,164,"ŞCOALA PRIMARĂ CUŞMA",CUŞMA,BN,520,10,1,0,11,15,5,0,20,16,12,0,28,17,10,7,34,17,10,7,34
33596,165,"ŞCOALA PRIMARĂ VALEA POENII","VALEA POENII",BN,126,3,1,0,4,5,1,0,6,10,3,0,13,19,6,0,25,20,6,0,26
33587,166,"ŞCOALA PRIMARĂ DUMBRAVA",DUMBRAVA,BN,330,3,1,0,4,5,1,0,6,13,1,0,14,18,1,0,19,26,5,0,31
33612,167,"CĂMINULCULTURAL LUNCA ILVEI","LUNCA ILVEI",BN,1499,2,0,0,2,22,0,0,22,38,0,0,38,54,0,0,54,57,1,0,58
33612,168,"CĂMINUL CULTURAL LUNCA ILVEI","LUNCA ILVEI",BN,1187,1,0,0,1,14,0,0,14,18,0,0,18,22,0,0,22,28,0,0,28
33630,169,"LICEUL TEHNOLOGICMAIERU",MAIERU,BN,1002,7,0,0,7,19,0,0,19,27,0,0,27,46,1,0,47,51,1,0,52
33630,170,"LICEUL TEHNOLOGIC MAIERU",MAIERU,BN,1307,8,0,0,8,27,0,0,27,42,0,0,42,90,0,0,90,110,0,0,110
33630,171,"LICEUL TEHNOLOGIC MAIERU",MAIERU,BN,946,9,0,0,9,27,0,0,27,37,0,0,37,59,0,0,59,71,0,0,71
33630,172,"CĂMINUL CULTURAL MAIERU",MAIERU,BN,1515,6,4,0,10,20,4,0,24,38,6,25,69,64,8,25,97,85,8,25,118
33649,173,"ŞCOALA GIMNAZIALĂ ANIEŞ",ANIEŞ,BN,1460,3,0,0,3,18,1,0,19,31,1,0,32,40,1,0,41,42,1,0,43
33667,174,"ŞCOALA GIMNAZIALĂMATEI",MATEI,BN,590,3,0,0,3,3,0,0,3,6,0,0,6,6,0,0,6,6,0,0,6
33676,175,"GRĂDINIŢA BIDIU",BIDIU,BN,166,6,1,0,7,6,1,0,7,9,1,0,10,11,1,0,12,11,1,0,12
33685,176,"ŞCOALA GIMNAZIALĂCORVINEŞTI",CORVINEŞTI,BN,540,4,0,0,4,9,0,0,9,12,2,0,14,15,2,0,17,19,2,0,21
33694,177,"GRĂDINIŢA ENCIU",ENCIU,BN,145,3,0,0,3,4,2,0,6,8,4,0,12,8,4,0,12,11,4,0,15
33701,178,"ŞCOALA PRIMARĂFÎNTÎNELE",FÎNTÎNELE,BN,473,1,0,0,1,8,2,0,10,9,2,0,11,11,2,0,13,13,3,0,16
33710,179,"ŞCOALA PRIMARĂMORUŢ",MORUŢ,BN,167,1,0,0,1,3,0,0,3,7,0,0,7,10,2,0,12,10,2,0,12
33738,180,"CĂMINUL CULTURAL MĂGURA ILVEI","MĂGURA ILVEI",BN,1389,12,0,0,12,27,0,0,27,38,0,0,38,42,0,0,42,50,0,0,50
33747,181,"CĂMINUL CULTURAL ARŞIŢA",ARŞIŢA,BN,346,0,0,0,0,0,0,0,0,0,0,0,0,2,0,0,2,5,6,0,11
33818,182,"ŞCOALA GIMNAZIALĂ MĂRIŞELU",MĂGURELE,BN,531,5,0,0,5,6,1,0,7,6,3,0,9,10,6,0,16,10,6,0,16
33792,183,"ŞCOALA PRIMARĂ DOMNEŞTI",DOMNEŞTI,BN,715,0,3,0,3,8,3,0,11,12,3,0,15,24,4,0,28,27,4,0,31
33783,184,"CĂMINUL CULTURAL BÎRLA",BÎRLA,BN,286,3,1,0,4,5,1,0,6,9,3,0,12,14,4,0,18,18,6,0,24
33836,185,"ŞCOALA PRIMARĂ SÎNTIOANA",SÎNTIOANA,BN,389,4,1,0,5,9,1,0,10,10,1,0,11,10,2,0,12,12,2,0,14
33809,186,"SOCIETATEA AGRICOLĂ",JEICA,BN,87,1,2,0,3,1,2,0,3,1,2,0,3,2,3,0,5,2,3,0,5
33854,187,"CĂMINUL CULTURAL MICEŞTII DE CÎMPIE","MICEŞTII DE CÎMPIE",BN,252,6,1,0,7,7,3,0,10,11,5,0,16,12,7,0,19,12,7,0,19
33863,188,"ȘCOALA GENERALĂFÎNTÎNIŢA",FÎNTÎNIŢA,BN,301,2,0,0,2,4,0,0,4,5,0,0,5,9,0,0,9,9,4,0,13
33872,189,"ȘCOALA GENERALĂ VISUIA",VISUIA,BN,322,3,0,0,3,4,0,0,4,7,3,0,10,10,4,0,14,11,5,0,16
33890,190,"GRADINITA CU PROGRAM NORMAL",MILAŞ,BN,591,8,1,0,9,12,2,0,14,16,2,0,18,21,2,0,23,21,3,0,24
33943,191,"CAMINUL CULTURAL OROSFAIA",OROSFAIA,BN,305,6,2,0,8,11,2,0,13,11,2,0,13,15,2,0,17,18,2,0,20
33907,192,"CĂMINUL CULTURAL COMLOD",COMLOD,BN,113,3,2,0,5,8,2,0,10,8,3,0,11,8,4,0,12,8,4,0,12
33961,193,"CĂMINUL CULTURAL MONOR",MONOR,BN,699,8,4,0,12,11,4,0,15,19,6,0,25,30,7,0,37,35,7,0,42
33970,194,"CĂMINUL CULTURAL GLEDIN",GLEDIN,BN,420,2,0,0,2,6,0,0,6,11,0,0,11,17,0,0,17,27,0,0,27
32991,195,"ŞCOALA GIMNAZIALĂ NEGRILEŞTI",NEGRILEŞTI,BN,1035,17,3,0,20,28,6,0,34,43,11,0,54,60,17,0,77,62,17,0,79
33006,196,"ŞCOALA GENERALĂ PURCĂRETE",PURCĂRETE,BN,175,1,2,0,3,2,3,0,5,7,3,0,10,8,5,0,13,9,10,0,19
32973,197,"ŞCOALA GIMNAZIALĂ ""VICTOR MOTOGNA"" BREAZA",BREAZA,BN,804,1,0,0,1,3,0,0,3,9,0,0,9,13,0,0,13,17,0,0,17
33998,198,"ŞCOALA GIMNAZIALĂ NIMIGEA DE JOS","NIMIGEA DE JOS",BN,1312,2,1,0,3,10,1,0,11,15,2,0,17,19,2,0,21,30,2,0,32
34039,199,"CĂMINUL CULTURAL MOCOD",MOCOD,BN,493,5,1,0,6,8,1,0,9,9,2,0,11,21,5,0,26,25,5,0,30
34020,200,"ŞCOALA GIMNAZIALĂ MITITEI",MITITEI,BN,593,1,0,0,1,6,1,0,7,7,1,0,8,16,2,0,18,18,2,0,20
34057,201,"ŞCOALA PRIMARĂ NIMIGEA DE SUS","NIMIGEA DE SUS",BN,479,8,1,0,9,13,3,0,16,16,3,0,19,22,6,0,28,28,7,0,35
34011,202,"ŞCOALA PRIMARĂ MINTIU",MINTIU,BN,349,2,0,0,2,9,0,0,9,14,0,0,14,19,0,0,19,21,0,0,21
34066,203,"ŞCOALA PRIMARĂ TĂURE",TĂURE,BN,352,3,3,0,6,10,3,0,13,12,6,0,18,14,7,0,21,19,7,0,26
34048,204,"ŞCOALA PRIMARĂ MOGOŞENI",MOGOŞENI,BN,290,2,2,0,4,2,2,0,4,4,3,0,7,5,4,0,9,7,4,0,11
34002,205,"ŞCOALA PRIMARĂ FLOREŞTI",FLOREŞTI,BN,392,2,0,0,2,4,0,0,4,6,0,0,6,8,0,0,8,10,0,0,10
34084,206,"PRIMĂRIA COMUNEI NUŞENI",NUŞENI,BN,733,15,44,0,59,23,51,28,102,28,53,28,109,38,53,28,119,44,53,28,125
34093,207,"ŞCOALA PRIMARĂ BEUDIU",BEUDIU,BN,470,2,0,0,2,4,1,0,5,10,1,0,11,14,1,0,15,16,1,0,17
34119,208,"CĂMINUL CULTURAL FELEAC",FELEAC,BN,267,4,1,0,5,5,1,0,6,5,2,0,7,10,4,0,14,11,4,0,15
34128,209,"ŞCOALAPRIMARĂ MALIN",MALIN,BN,356,6,1,0,7,6,1,0,7,13,1,0,14,16,1,0,17,18,1,0,19
34137,210,"ŞCOALA PRIMARĂ RUSU DE SUS","RUSU DE SUS",BN,243,1,0,0,1,4,1,0,5,6,2,0,8,8,2,0,10,8,7,0,15
34146,211,"ŞCOALA GIMNAZIALĂ VIŢA",VIŢA,BN,302,0,5,0,5,2,6,0,8,4,6,0,10,6,7,0,13,8,7,0,15
34164,212,"ŞCOALA GIMNAZIALĂ PARVA",PARVA,BN,971,7,0,0,7,17,0,0,17,37,0,0,37,63,0,0,63,74,0,0,74
34164,213,"CENTRUL DE INFORMARE TURISTICA",PARVA,BN,957,2,0,0,2,13,0,0,13,18,1,0,19,25,1,0,26,34,2,0,36
34182,214,"PRIMĂRIA COMUNEI PETRU RAREŞ",RETEAG,BN,1438,14,1,0,15,24,4,0,28,30,5,0,35,36,5,0,41,46,5,0,51
34182,215,"ŞCOALA GENERALĂ RETEAG POIENI, CLASELE I - IV",RETEAG,BN,754,1,0,0,1,31,0,0,31,41,0,0,41,53,0,0,53,55,0,0,55
34191,216,"CĂMINUL CULTURAL BAŢA",BAŢA,BN,706,4,1,0,5,8,1,0,9,11,1,0,12,14,1,0,15,15,1,0,16
33756,217,"ŞCOALA GIMNAZIALĂ ""SEVER POP"" POIANA ILVEI","POIANA ILVEI",BN,1259,15,0,0,15,22,1,0,23,28,1,0,29,36,1,12,49,40,1,12,53
34244,218,"ŞCOALA PRIMARĂPRUNDU BÎRGĂULUI","PRUNDU BÎRGĂULUI",BN,1169,7,2,0,9,20,5,0,25,26,5,0,31,33,6,0,39,38,6,0,44
34244,219,"ȘCOALA PRIMARĂPRUNDU BÎRGĂULUI","PRUNDU BÎRGĂULUI",BN,1364,6,0,0,6,25,1,0,26,27,3,0,30,38,3,0,41,44,3,0,47
34244,220,"CENTRU MULTIFUNCȚIONAL","PRUNDU BÎRGĂULUI",BN,1597,8,1,0,9,30,2,0,32,41,5,0,46,52,6,0,58,61,7,0,68
34253,221,"ŞCOALA PRIMARĂ SUSENII BÎRGĂULUI","SUSENII BÎRGĂULUI",BN,1147,4,0,0,4,6,0,0,6,8,0,0,8,16,5,22,43,17,6,22,45
34271,222,"ȘCOALA GIMNAZIALĂ REBRA CLASELE I-IV",REBRA,BN,989,7,3,0,10,11,3,0,14,27,5,0,32,38,9,0,47,47,9,0,56
34271,223,"ȘCOALA GIMNAZIALĂ REBRA CLASELE I-IV",REBRA,BN,1073,9,0,0,9,19,0,0,19,27,0,0,27,30,0,0,30,43,0,0,43
34299,224,"ŞCOALA GIMNAZIALĂ “ IACOB ŞI IOACHIM MUREŞANU “ REBRIŞOARA",REBRIŞOARA,BN,1460,33,0,0,33,61,0,0,61,72,0,0,72,100,1,0,101,114,1,0,115
34299,225,"ŞCOALA GIMNAZIALĂCLASELE I-IV REBRIŞOARA",REBRIŞOARA,BN,1651,16,0,0,16,46,1,1,48,63,1,1,65,78,3,1,82,92,6,1,99
34306,226,"ŞCOALA GIMNAZIALĂNR.1GERSA I","GERSA I",BN,577,0,0,0,0,0,0,0,0,7,0,0,7,17,0,0,17,19,0,0,19
34315,227,"ŞCOALA PRIMARĂ “VALEA BABII“","GERSA II",BN,147,0,0,0,0,0,2,0,2,2,7,0,9,3,7,0,10,6,7,0,13
34342,228,"ŞCOALA GIMNAZIALĂNR. 2""FLORIAN PORCIUS"" RODNA",RODNA,BN,975,3,1,0,4,19,2,0,21,26,2,0,28,34,4,0,38,39,6,0,45
34342,229,"ŞCOALA GIMNAZIALĂNR. 2 ""FLORIAN PORCIUS"" RODNA",RODNA,BN,961,13,1,0,14,29,1,0,30,30,1,0,31,32,5,0,37,36,6,0,42
34342,230,"PRIMĂRIA COMUNEI RODNA",RODNA,BN,1464,23,2,0,25,56,2,0,58,56,3,0,59,57,3,0,60,67,3,0,70
34342,231,"CĂMINUL CULTURAL ""GHERASIM DOMIDE"" RODNA",RODNA,BN,1447,20,0,0,20,38,1,0,39,44,5,0,49,54,7,0,61,64,7,0,71
34351,232,"ŞCOALAPRIMARĂVALEA VINULUI","VALEA VINULUI",BN,161,0,0,0,0,2,1,0,3,2,1,0,3,6,1,0,7,6,1,0,7
34379,233,"ŞCOALA GIMNAZIALĂ CLASELE I-VIII, ROMULI",ROMULI,BN,1030,7,0,0,7,12,1,0,13,17,1,0,18,29,1,0,30,32,1,0,33
34388,234,"GRĂDINIȚA CU PROGRAM NORMAL DEALU ŞTEFĂNIŢEI","DEALU ŞTEFĂNIŢEI",BN,344,6,0,0,6,11,0,0,11,14,1,0,15,15,1,0,16,15,1,0,16
34413,235,"PRIMĂRIA COMUNEI RUNCU SALVEI","RUNCU SALVEI",BN,1055,3,0,0,3,4,4,0,8,12,4,0,16,18,4,0,22,21,4,0,25
34404,236,"PRIMĂRIA COMUNEI SALVA",SALVA,BN,1111,27,1,0,28,36,1,0,37,40,1,0,41,50,1,0,51,61,4,0,65
34404,237,"ŞCOALA GIMANZIALĂ SALVA",SALVA,BN,1240,8,1,0,9,24,1,0,25,39,1,0,40,62,1,0,63,69,1,0,70
34431,238,"CĂMINUL CULTURAL","SILIVAŞU DE CÎMPIE",BN,798,4,0,0,4,7,0,0,7,13,0,0,13,15,1,0,16,15,2,0,17
34486,239,"CĂMINUL CULTURAL SÎNMIHAIU DE CÎMPIE","SÎNMIHAIU DE CÎMPIE",BN,543,4,1,0,5,8,1,0,9,9,6,0,15,25,7,0,32,29,12,0,41
34495,240,"CĂMINUL CULTURAL BRĂTENI",BRĂTENI,BN,64,2,2,0,4,3,2,0,5,4,2,0,6,6,3,0,9,7,5,0,12
34510,241,"CĂMINUL CULTURAL SĂLCUŢA",SĂLCUŢA,BN,96,2,2,0,4,2,2,0,4,3,3,0,6,9,5,0,14,9,5,0,14
34529,242,"ȘCOALA GIMNAZIALÂ STUPINI",STUPINI,BN,170,5,0,0,5,5,1,0,6,6,2,0,8,8,2,0,10,8,2,0,10
34538,243,"CĂMINUL CULTURAL ZORENI",ZORENI,BN,242,9,3,0,12,15,3,0,18,18,3,0,21,21,3,0,24,23,3,0,26
34556,244,"PRIMĂRIA COMUNEI SPERMEZEU",SPERMEZEU,BN,1429,20,7,0,27,33,7,0,40,50,7,0,57,79,12,0,91,86,13,0,99
34592,245,"ŞCOALA GIMNAZIALĂ SITA",SITA,BN,251,7,1,0,8,11,1,0,12,12,1,0,13,15,1,0,16,15,1,0,16
34565,246,"ŞCOALA PRIMARĂ HĂLMĂSĂU",HĂLMĂSĂU,BN,230,4,2,0,6,4,2,0,6,4,2,0,6,11,2,0,13,12,2,0,14
32875,247,"ŞCOALA GIMNAZIALĂ ""TEODOR COTUŢIU"" DUMBRĂVIŢA",DUMBRĂVIŢA,BN,648,7,1,0,8,12,3,0,15,13,4,0,17,22,6,0,28,26,6,0,32
32866,248,"ŞCOALA PRIMARĂ DOBRICEL",DOBRICEL,BN,446,5,2,0,7,19,3,0,22,25,5,0,30,28,6,0,34,28,6,0,34
34627,249,"PRIMĂRIA COMUNEI ŞANŢ",ŞANŢ,BN,1317,22,3,0,25,42,4,0,46,60,6,0,66,132,8,0,140,193,8,0,201
34627,250,"ȘCOALA GIMNAZIALĂ""ENEA GRAPINI""ŞANŢ",ŞANŢ,BN,1108,16,0,0,16,37,1,0,38,47,1,0,48,85,1,0,86,138,1,0,139
34636,251,"ŞCOALAPRIMARĂ""LUCIAN VALEA""","VALEA MARE",BN,258,4,3,0,7,7,3,0,10,15,3,0,18,22,3,0,25,33,7,0,40
34654,252,"PRIMĂRIA COMUNEI ŞIEU",ŞIEU,BN,1084,5,0,0,5,11,0,0,11,13,0,0,13,19,0,0,19,20,0,0,20
34663,253,"ŞCOALA GENERALĂ ARDAN",ARDAN,BN,591,1,0,0,1,4,0,0,4,4,0,0,4,5,0,0,5,7,0,0,7
34672,254,"ŞCOALA GENERALĂ POSMUŞ",POSMUŞ,BN,549,1,1,0,2,7,1,0,8,11,2,0,13,17,3,0,20,17,3,0,20
34681,255,"CĂMINUL CULTURAL ŞOIMUŞ",ŞOIMUŞ,BN,127,2,0,0,2,4,2,0,6,6,2,0,8,6,2,0,8,6,2,0,8
34707,256,"CĂMINUL CULTURAL ŞIEU-MĂGHERUŞ",ŞIEU-MĂGHERUŞ,BN,985,6,0,0,6,13,0,0,13,17,0,0,17,23,2,0,25,27,3,0,30
34725,257,"CAMIN CULTURAL ""GRIGORE PLETOSU""",CHINTELNIC,BN,546,2,1,0,3,8,1,0,9,14,2,0,16,16,2,0,18,16,2,0,18
34734,258,"CĂMINUL CULTURAL CRAINIMĂT",CRAINIMĂT,BN,816,4,1,0,5,9,1,0,10,17,2,0,19,26,3,0,29,28,4,0,32
34752,259,"CĂMINUL CULTURAL SĂRĂŢEL",SĂRĂŢEL,BN,481,2,0,0,2,2,0,0,2,5,0,0,5,6,0,0,6,7,0,0,7
34716,260,"ŞCOALA GENERALĂ ARCALIA, CLASELE V-VIII",ARCALIA,BN,738,5,0,0,5,7,2,0,9,16,4,0,20,22,7,0,29,25,9,0,34
34789,261,"PRIMĂRIA COMUNEI ŞIEU-ODORHEI",ŞIEU-ODORHEI,BN,601,4,0,0,4,8,0,0,8,10,0,0,10,14,0,0,14,15,0,0,15
34798,262,"ŞCOALA GENERALĂ AGRIŞU DE JOS","AGRIŞU DE JOS",BN,295,3,2,0,5,4,2,0,6,6,2,0,8,10,2,0,12,10,2,0,12
34805,263,"CĂMINULCULTURALAGRIŞU DE SUS","AGRIŞU DE SUS",BN,142,2,2,0,4,4,2,0,6,6,2,0,8,9,2,0,11,11,3,0,14
34814,264,"CĂMINUL CULTURAL BRETEA",BRETEA,BN,135,2,2,0,4,3,2,0,5,4,4,0,8,4,4,0,8,4,6,0,10
34823,265,"CĂMINUL CULTURAL COASTA",COASTA,BN,161,1,0,0,1,2,0,0,2,3,0,0,3,4,4,0,8,8,4,0,12
34832,266,"ŞCOALA GENERALĂ CRISTUR-ŞIEU",CRISTUR-ŞIEU,BN,401,2,0,0,2,6,0,0,6,11,2,0,13,17,3,0,20,20,3,0,23
34841,267,"ŞCOALA GENERALĂ ŞIRIOARA",ŞIRIOARA,BN,202,4,3,0,7,5,4,0,9,5,4,0,9,8,6,0,14,8,6,0,14
34869,268,"PRIMĂRIA COMUNEI ŞIEUŢ",ŞIEUŢ,BN,582,3,1,0,4,7,2,0,9,19,2,0,21,32,5,0,37,34,8,0,42
34887,269,"ŞCOALA PRIMARĂRUŞTIOR",RUŞTIOR,BN,494,4,0,0,4,5,1,0,6,6,1,0,7,9,5,0,14,14,6,0,20
34896,270,"ŞCOALA GIMNAZIALĂSEBIŞ",SEBIŞ,BN,686,3,2,0,5,8,2,0,10,13,2,0,15,14,2,0,16,18,4,0,22
34878,271,ŞCOALAPRIMARĂLUNCA,LUNCA,BN,310,11,0,0,11,11,0,0,11,12,0,0,12,20,0,0,20,20,0,0,20
34912,272,"PRIMĂRIA COMUNEI ŞINTEREAG",ŞINTEREAG,BN,845,6,2,0,8,12,4,0,16,21,4,0,25,32,13,0,45,37,16,0,53
34949,273,"CĂMINUL CULTURAL",CAILA,BN,258,1,2,0,3,4,2,0,6,6,3,0,9,12,4,0,16,15,4,0,19
34958,274,"ŞCOALA GIMNAZIALĂCOCIU",COCIU,BN,896,13,1,0,14,28,1,0,29,35,1,0,36,39,1,0,40,43,2,0,45
34921,275,"CĂMINUL CULTURALBLĂJENII DE JOS","BLĂJENII DE JOS",BN,301,2,0,0,2,2,0,0,2,2,0,0,2,3,1,0,4,5,1,0,6
34930,276,"ŞCOALA PRIMARĂ ,,NICOLAE BĂLAN"" BLĂJENII DE SUS","BLĂJENII DE SUS",BN,318,5,4,0,9,5,4,0,9,6,4,0,10,10,4,0,14,15,8,0,23
34967,277,"ŞCOALA PRIMARĂ CLASELE I-IV ŞIEU-SFÎNTU (FOSTUL SEDIU)",ŞIEU-SFÎNTU,BN,394,1,1,0,2,8,2,0,10,20,2,0,22,23,2,0,25,26,4,0,30
35009,278,"CĂMINUL CULTURALARCHIUD",ARCHIUD,BN,455,6,0,0,6,9,0,0,9,15,0,0,15,15,1,0,16,15,1,0,16
35018,279,"CĂMINUL CULTURAL BUDURLENI",BUDURLENI,BN,79,2,3,0,5,6,4,0,10,7,4,0,11,7,4,0,11,10,7,0,17
35027,280,"CĂMINUL CULTURAL OCNIŢA",OCNIŢA,BN,839,1,1,0,2,1,1,0,2,2,2,0,4,8,6,0,14,15,6,0,21
35036,281,"FOST SEDIU C.A.P. PINTICU",PINTICU,BN,628,1,0,0,1,7,1,0,8,12,1,0,13,17,1,0,18,22,1,0,23
34994,282,"CĂMINUL CULTURAL TEACA",TEACA,BN,901,2,0,0,2,4,2,0,6,10,2,0,12,14,6,0,20,14,6,0,20
34994,283,"PRIMĂRIA COMUNEI TEACA",TEACA,BN,773,9,2,0,11,18,4,0,22,20,5,0,25,23,6,0,29,23,6,0,29
35045,284,"ŞCOALA GIMNAZIALĂVIILE TECII","VIILE TECII",BN,835,2,0,0,2,7,0,0,7,11,1,0,12,19,2,0,21,21,3,0,24
35063,285,"LICEUL TEHNOLOGIC TELCIU",TELCIU,BN,1199,3,1,0,4,8,1,0,9,13,1,0,14,17,1,0,18,20,2,0,22
35063,286,"CĂMINUL CULTURAL TELCIU",TELCIU,BN,984,6,1,0,7,20,2,0,22,26,3,0,29,38,8,0,46,40,8,0,48
35063,287,"OCOLUL SILVIC TELCIU",TELCIU,BN,967,5,0,0,5,15,0,0,15,19,0,0,19,26,2,0,28,31,2,0,33
35081,288,"ŞCOALA GIMNAZIALĂ TELCIŞOR",TELCIŞOR,BN,866,0,0,0,0,0,0,0,0,0,0,0,0,19,0,0,19,35,0,0,35
35072,289,"ŞCOALA GIMNAZIALĂ FIAD",FIAD,BN,174,0,0,0,0,1,3,0,4,1,5,0,6,1,7,0,8,1,7,0,8
33195,290,"ŞCOALA GIMNAZIALĂ BICHIGIU",BICHIGIU,BN,670,1,0,0,1,6,0,0,6,12,0,0,12,23,0,0,23,25,0,0,25
35107,291,"CĂMINUL CULTURAL TIHA BÎRGĂULUI","TIHA BÎRGĂULUI",BN,1366,0,1,0,1,6,2,0,8,16,2,0,18,18,7,0,25,18,7,0,25
35143,292,"ȘCOALA GIMNAZIALĂ TUREAC",TUREAC,BN,538,2,8,0,10,4,11,0,15,5,11,0,16,8,12,0,20,8,12,0,20
35143,293,"ȘCOALA GIMNAZIALĂ TUREAC",TUREAC,BN,1564,4,3,0,7,8,3,0,11,16,3,0,19,18,3,0,21,22,6,0,28
35125,294,"ŞCOALA GIMNAZIALĂ MUREŞENII BÎRGĂULUI","MUREŞENII BÎRGĂULUI",BN,1349,7,0,0,7,10,4,0,14,19,6,0,25,24,7,0,31,30,7,0,37
35134,295,"ŞCOALA GIMNAZIALĂ PIATRA FÎNTÎNELE","PIATRA FÎNTÎNELE",BN,321,3,0,0,3,4,1,0,5,9,1,0,10,21,5,0,26,23,6,0,29
35161,296,"LICEUL TEHNOLOGIC TÎRLIȘUA",TÎRLIŞUA,BN,1031,5,0,0,5,21,3,0,24,29,7,0,36,30,7,0,37,37,7,0,44
35198,297,"ŞCOALA GENERALĂ BORLEASA",BORLEASA,BN,312,4,0,0,4,21,1,0,22,24,1,0,25,24,2,0,26,25,2,0,27
35214,298,"ŞCOALA GENERALĂ LUNCA SĂTEASCĂ","LUNCA SĂTEASCA",BN,464,2,1,0,3,8,5,0,13,10,5,0,15,11,6,0,17,16,6,0,22
35170,299,"ŞCOALA GENERALĂ AGRIEŞ",AGRIEŞ,BN,770,3,0,0,3,9,1,0,10,11,1,0,12,14,6,0,20,18,7,0,25
35223,300,"ŞCOALA GENERALĂ MOLIŞET (COSTEASA)",MOLIŞET,BN,177,3,1,0,4,5,1,0,6,5,1,0,6,7,3,0,10,7,4,0,11
35278,301,"ŞCOALA GENERALĂ URIU",URIU,BN,1225,19,0,0,19,24,3,0,27,30,3,0,33,36,3,0,39,44,3,0,47
35287,302,"ŞCOALA GENERALĂ CRISTEŞTII CICEULUI","CRISTEŞTII CICEULUI",BN,989,13,4,0,17,22,4,0,26,37,4,0,41,58,4,0,62,66,7,0,73
35303,303,"ŞCOALA GENERALĂ ILIŞUA",ILIŞUA,BN,594,10,0,0,10,23,1,0,24,29,1,0,30,32,1,0,33,36,1,0,37
35296,304,"ŞCOALA GENERALĂ HĂŞMAŞU CICEULUI","HĂŞMAŞU CICEULUI",BN,193,3,0,0,3,5,2,0,7,6,2,0,8,7,4,0,11,7,4,0,11
35321,305,"SALA DE SPORT URMENIŞ",URMENIŞ,BN,749,7,0,0,7,7,0,0,7,10,5,0,15,15,6,0,21,19,6,0,25
35394,306,"ŞCOALA GENERALĂ ŞOPTERIU",ŞOPTERIU,BN,302,3,4,0,7,3,4,0,7,3,4,0,7,3,4,0,7,3,4,0,7
35358,307,"ŞCOALA GENERALĂDELURENI",DELURENI,BN,257,1,0,0,1,1,0,0,1,5,1,0,6,8,8,0,16,8,8,0,16
35367,308,"CĂMINUL CULTURAL FÎNAŢE",FÎNAŢE,BN,157,1,0,0,1,1,1,0,2,7,3,0,10,7,4,0,11,8,4,0,12
35438,309,"ŞCOALA GENERALĂ ZAGRA",ZAGRA,BN,877,11,0,0,11,21,0,0,21,39,0,0,39,40,0,0,40,48,0,0,48
35465,310,"ŞCOALA GENERALĂ POIENILE ZAGREI","POIENILE ZAGREI",BN,703,5,0,0,5,8,0,0,8,17,0,0,17,29,0,0,29,40,0,3,43
35474,311,"ŞCOALA GENERALĂ SUPLAI",SUPLAI,BN,507,8,3,0,11,15,6,0,21,18,6,0,24,20,6,0,26,25,6,0,31
35456,312,"ŞCOALA GENERALĂ PERIŞOR",PERIŞOR,BN,436,1,0,0,1,5,0,0,5,8,0,0,8,10,0,0,10,11,0,0,11
35447,313,"ŞCOALA GENERALĂ ALUNIŞUL",ALUNIŞUL,BN,185,9,4,0,13,9,4,0,13,24,5,0,29,26,5,0,31,30,5,0,35
42691,1,"ŞCOALA GIMNAZIALĂ NR. 31 „MIHAI VITEAZUL”",BRĂILA,BR,1368,8,0,0,8,31,0,0,31,41,0,0,41,46,0,0,46,48,0,0,48
42691,2,"ŞCOALA GIMNAZIALĂ NR. 31 „MIHAI VITEAZUL”",BRĂILA,BR,1254,15,0,0,15,43,0,0,43,53,5,0,58,72,6,0,78,92,6,0,98
42691,3,"ŞCOALA GIMNAZIALĂ NR. 31 „MIHAI VITEAZUL”",BRĂILA,BR,1068,12,0,0,12,40,0,0,40,57,0,0,57,70,0,0,70,78,0,0,78
42691,4,"ŞCOALA GIMNAZIALĂ NR. 31 „MIHAI VITEAZUL”",BRĂILA,BR,1201,18,0,0,18,54,0,0,54,60,0,0,60,83,0,0,83,89,0,0,89
42691,5,"GRĂDINIŢA NR. 61 „BOBOCEL”",BRĂILA,BR,1177,12,0,0,12,39,0,0,39,55,1,0,56,87,1,0,88,88,2,0,90
42691,6,"GRĂDINIŢA NR. 61 „BOBOCEL”",BRĂILA,BR,1218,24,0,0,24,60,0,0,60,83,1,0,84,114,1,0,115,116,1,0,117
42691,7,"ȘCOALA GIMNAZIALĂ NR. 1 „VLAICU VODĂ”",BRĂILA,BR,1398,24,5,0,29,53,6,0,59,73,8,0,81,103,8,0,111,110,9,0,119
42691,8,"ȘCOALA GIMNAZIALĂ NR. 1 „VLAICU VODĂ”",BRĂILA,BR,1473,13,2,0,15,43,2,0,45,72,4,0,76,102,5,0,107,111,5,0,116
42691,9,"GRĂDINIŢA NR. 12 „SFÂNTUL NICOLAE”",BRĂILA,BR,1686,17,3,0,20,38,3,0,41,62,3,0,65,80,8,0,88,86,10,0,96
42691,10,"GRĂDINIŢA NR. 12 „SFÂNTUL NICOLAE”",BRĂILA,BR,1569,8,1,0,9,30,1,0,31,45,1,0,46,64,2,0,66,72,3,0,75
42691,11,"ȘCOALA GIMNAZIALĂ NR. 27 „AUREL VLAICU”",BRĂILA,BR,1353,11,0,0,11,36,0,0,36,44,3,0,47,60,4,0,64,69,4,0,73
42691,12,"ȘCOALA GIMNAZIALĂ NR. 27 „AUREL VLAICU”",BRĂILA,BR,1526,13,0,0,13,29,0,0,29,52,1,0,53,86,4,0,90,88,4,0,92
42691,13,"ŞCOALA GIMNAZIALĂ NR. 27 „AUREL VLAICU”",BRĂILA,BR,1313,11,3,0,14,36,3,0,39,60,4,0,64,85,4,0,89,88,4,0,92
42691,14,"ŞCOALA GIMNAZIALĂ NR. 27 „AUREL VLAICU”",BRĂILA,BR,1409,13,0,0,13,35,0,0,35,42,0,0,42,52,0,0,52,57,0,0,57
42691,15,"ȘCOALA GIMNAZIALĂ NR. 2 „FĂNUȘ NEAGU”",BRĂILA,BR,919,8,1,0,9,19,7,0,26,26,7,0,33,36,8,0,44,37,9,0,46
42691,16,"ȘCOALA GIMNAZIALĂ NR. 2 „FĂNUȘ NEAGU”",BRĂILA,BR,1103,14,0,0,14,32,0,0,32,42,1,0,43,63,1,0,64,66,1,0,67
42691,17,"ŞCOALA GIMNAZIALĂ NR. 2 „FĂNUŞ NEAGU”",BRĂILA,BR,1080,10,0,0,10,36,3,0,39,43,3,0,46,56,3,0,59,65,3,0,68
42691,18,"ŞCOALA GIMNAZIALĂ NR. 2 „FĂNUŞ NEAGU”",BRĂILA,BR,1363,14,0,0,14,42,1,0,43,50,1,0,51,65,1,0,66,70,1,0,71
42691,19,"ŞCOALA GIMNAZIALĂ NR. 2 „FĂNUŞ NEAGU”",BRĂILA,BR,1141,14,0,0,14,36,0,0,36,51,0,0,51,64,0,0,64,69,0,0,69
42691,20,"GRĂDINIŢA NR. 39 „CĂSUȚA FERMECATĂ”",BRĂILA,BR,1284,20,1,0,21,63,1,0,64,83,1,0,84,97,1,0,98,103,1,0,104
42691,21,"GRĂDINIŢA NR. 39 „CĂSUȚA FERMECATĂ”",BRĂILA,BR,1160,9,2,0,11,33,3,0,36,41,3,0,44,57,3,0,60,59,3,0,62
42691,22,"GRĂDINIŢA NR. 39 „CĂSUȚA FERMECATĂ”",BRĂILA,BR,1144,9,0,0,9,28,0,0,28,40,0,0,40,62,0,0,62,68,0,0,68
42691,23,"GRĂDINIŢA NR. 39 „CĂSUȚA FERMECATĂ”",BRĂILA,BR,1114,16,0,0,16,41,4,0,45,53,4,0,57,69,4,0,73,72,4,0,76
42691,24,"ȘCOALA GIMNAZIALĂ NR. 28 „VASILE ALECSANDRI”",BRĂILA,BR,1086,19,0,0,19,38,5,0,43,53,6,0,59,67,6,0,73,68,6,0,74
42691,25,"ȘCOALA GIMNAZIALĂ NR. 28 „VASILE ALECSANDRI”",BRĂILA,BR,988,16,1,0,17,30,1,0,31,38,1,0,39,57,1,0,58,59,1,0,60
42691,26,"ȘCOALA GIMNAZIALĂ NR. 28 „VASILE ALECSANDRI”",BRĂILA,BR,982,10,0,0,10,27,0,0,27,33,0,0,33,56,0,0,56,58,0,0,58
42691,27,"ŞCOALA GIMNAZIALĂ NR. 28 „VASILE ALECSANDRI”",BRĂILA,BR,1303,19,3,0,22,49,5,0,54,67,5,0,72,93,5,0,98,105,5,0,110
42691,28,"ŞCOALA GIMNAZIALĂ NR. 28 „VASILE ALECSANDRI”",BRĂILA,BR,901,11,0,0,11,40,0,0,40,44,0,0,44,57,0,0,57,61,0,0,61
42691,29,"GRĂDINIŢA NR. 38 „IZVORAȘUL”",BRĂILA,BR,1242,16,0,0,16,61,0,0,61,87,0,0,87,107,6,0,113,111,6,0,117
42691,30,"ŞCOALA GIMNAZIALĂ NR. 29 „MIHAIL SADOVEANU”",BRĂILA,BR,658,5,1,0,6,27,1,0,28,31,1,0,32,51,1,0,52,52,1,0,53
42691,31,"ȘCOALA GIMNAZIALĂ NR. 29 „MIHAIL SADOVEANU”",BRĂILA,BR,1209,18,0,0,18,49,1,0,50,65,1,0,66,77,1,0,78,81,1,0,82
42691,32,"ȘCOALA GIMNAZIALĂ NR. 29 „MIHAIL SADOVEANU”",BRĂILA,BR,1393,16,0,0,16,43,0,0,43,67,0,0,67,104,2,0,106,109,2,0,111
42691,33,"GRĂDINIŢA NR. 11 „BRÂNDUȘA”",BRĂILA,BR,1547,23,0,0,23,74,0,0,74,98,0,0,98,114,0,0,114,120,0,0,120
42691,34,"COLEGIUL NAȚIONAL „ANA ASLAN”",BRĂILA,BR,901,9,1,0,10,14,1,0,15,19,1,0,20,24,3,0,27,24,3,0,27
42691,35,"COLEGIUL NAȚIONAL „ANA ASLAN”",BRĂILA,BR,1349,12,0,0,12,54,1,0,55,64,2,0,66,76,3,0,79,79,3,0,82
42691,36,"COLEGIUL NAȚIONAL „ANA ASLAN”",BRĂILA,BR,1041,10,0,0,10,28,0,0,28,53,0,0,53,67,2,0,69,70,4,0,74
42691,37,"COLEGIUL NAȚIONAL „ANA ASLAN”",BRĂILA,BR,1473,15,0,0,15,39,1,0,40,55,1,0,56,83,3,0,86,85,3,0,88
42691,38,"COLEGIUL NAȚIONAL „ANA ASLAN”",BRĂILA,BR,1514,18,0,0,18,40,0,0,40,59,1,0,60,73,1,0,74,75,1,0,76
42691,39,"COLEGIUL TEHNIC „EDMOND NICOLAU”",BRĂILA,BR,1539,13,11,0,24,31,16,0,47,41,18,0,59,68,18,0,86,80,18,0,98
42691,40,"COLEGIUL TEHNIC „EDMOND NICOLAU”",BRĂILA,BR,1220,12,0,0,12,24,4,0,28,34,4,0,38,47,4,0,51,51,4,0,55
42691,41,"COMPANIA DE UTILITĂȚI PUBLICE „DUNĂREA” SA BRĂILA",BRĂILA,BR,1415,12,1,0,13,46,3,0,49,59,3,0,62,80,3,0,83,82,3,0,85
42691,42,"ŞCOALA GIMNAZIALĂ NR. 4 „ALEXANDRU IOAN CUZA”",BRĂILA,BR,1191,16,0,0,16,60,1,0,61,65,4,0,69,84,10,0,94,85,11,0,96
42691,43,"ŞCOALA GIMNAZIALĂ NR. 4 „ALEXANDRU IOAN CUZA”",BRĂILA,BR,1332,19,0,0,19,62,4,0,66,81,4,0,85,115,5,0,120,120,5,0,125
42691,44,"ȘCOALA GIMNAZIALĂ NR. 4 „ALEXANDRU IOAN CUZA”",BRĂILA,BR,1100,9,3,0,12,50,3,0,53,62,4,0,66,85,4,0,89,89,4,0,93
42691,45,"GRĂDINIȚA CU PROGRAM NORMAL WALDORF",BRĂILA,BR,1408,18,1,0,19,47,3,28,78,69,6,28,103,83,7,28,118,89,7,28,124
42691,46,"GRĂDINIȚA CU PROGRAM NORMAL WALDORF",BRĂILA,BR,899,23,4,0,27,71,6,0,77,85,6,0,91,97,8,0,105,102,8,0,110
42691,47,"ŞCOALA GIMNAZIALĂ NR. 8 „ION BĂNCILĂ”",BRĂILA,BR,1551,23,0,0,23,57,1,0,58,76,6,0,82,103,6,0,109,111,6,0,117
42691,48,"ŞCOALA GIMNAZIALĂ NR. 8 „ION BĂNCILĂ”",BRĂILA,BR,1157,25,1,0,26,69,1,0,70,84,1,0,85,99,1,0,100,105,1,0,106
42691,49,"ŞCOALA GIMNAZIALĂ NR. 8 „ION BĂNCILĂ”",BRĂILA,BR,728,12,4,0,16,29,4,0,33,37,4,0,41,50,4,0,54,54,4,0,58
42691,50,"ŞCOALA GIMNAZIALĂ NR. 8 „ION BĂNCILĂ”",BRĂILA,BR,986,11,1,0,12,47,2,0,49,55,2,0,57,78,2,0,80,82,2,0,84
42691,51,"ŞCOALA GIMNAZIALĂ NR. 8 „ION BĂNCILĂ”",BRĂILA,BR,1452,13,0,0,13,46,0,0,46,58,1,0,59,90,4,0,94,102,4,0,106
42691,52,"LICEUL TEORETIC „PANAIT CERNA”",BRĂILA,BR,890,11,0,0,11,42,4,0,46,49,5,0,54,67,6,0,73,68,6,0,74
42691,53,"LICEUL TEORETIC „PANAIT CERNA”",BRĂILA,BR,945,17,3,0,20,39,5,0,44,59,7,0,66,77,7,0,84,77,7,0,84
42691,54,"LICEUL TEORETIC „PANAIT CERNA”",BRĂILA,BR,1370,19,2,0,21,39,4,0,43,57,6,0,63,78,6,0,84,92,6,0,98
42691,55,"LICEUL TEORETIC „PANAIT CERNA”",BRĂILA,BR,1020,15,1,0,16,52,2,0,54,69,2,0,71,98,4,0,102,107,5,0,112
42691,56,"COLEGIUL NAȚIONAL „GHEORGHE MUNTEANU MURGOCI”",BRĂILA,BR,1243,28,1,0,29,74,1,0,75,102,4,0,106,124,14,0,138,136,19,0,155
42691,57,"COLEGIUL NAȚIONAL „GHEORGHE MUNTEANU MURGOCI”",BRĂILA,BR,1235,13,0,0,13,44,0,0,44,57,0,0,57,79,0,0,79,84,0,0,84
42691,58,"ŞCOALA GIMNAZIALĂ NR. 7 „ION CREANGĂ”",BRĂILA,BR,1211,8,0,0,8,35,3,0,38,57,4,0,61,97,5,0,102,102,5,0,107
42691,59,"ȘCOALA GIMNAZIALĂ NR. 7 „ION CREANGĂ”",BRĂILA,BR,1027,12,1,0,13,43,2,0,45,70,2,0,72,92,2,0,94,94,2,0,96
42691,60,"ȘCOALA GIMNAZIALĂ NR. 7 „ION CREANGĂ”",BRĂILA,BR,956,16,3,0,19,46,4,0,50,58,4,0,62,76,4,0,80,82,4,0,86
42691,61,"LICEUL TEORETIC „NICOLAE IORGA”",BRĂILA,BR,858,6,1,13,20,28,2,13,43,45,3,13,61,58,4,13,75,59,4,13,76
42691,62,"ŞCOALA GIMNAZIALĂ NR. 5 „NIKOS KAZANTZAKIS”",BRĂILA,BR,1030,8,1,0,9,34,3,0,37,46,4,0,50,54,4,0,58,61,5,0,66
42691,63,"COLEGIUL NAŢIONAL „NICOLAE BĂLCESCU”",BRĂILA,BR,1383,18,0,0,18,56,5,0,61,78,5,0,83,103,5,0,108,107,5,0,112
42691,64,"LICEUL DE ARTĂ „HARICLEA DARCLEE”",BRĂILA,BR,1458,10,3,0,13,48,6,0,54,55,7,0,62,68,8,0,76,76,8,0,84
42691,65,"LICEUL DE ARTĂ „HARICLEA DARCLEE”",BRĂILA,BR,1460,9,1,0,10,29,4,11,44,50,6,11,67,71,8,11,90,76,8,11,95
42691,66,"LICEUL TEHNOLOGIC „GRIGORE MOISIL”",BRĂILA,BR,1540,5,0,0,5,36,0,0,36,51,0,0,51,72,0,330,402,76,0,330,406
42691,67,"ȘCOALA GIMNAZIALĂ NR. 17 „ECATERINA TEODOROIU”",BRĂILA,BR,1295,12,1,0,13,52,2,0,54,75,2,0,77,99,2,0,101,102,2,0,104
42691,68,"ȘCOALA GIMNAZIALĂ NR. 17 „ECATERINA TEODOROIU”",BRĂILA,BR,1513,26,3,0,29,71,4,0,75,87,4,0,91,105,4,0,109,109,4,0,113
42691,69,"COLEGIUL TEHNIC „PANAIT ISTRATI”",BRĂILA,BR,1358,25,4,0,29,74,4,0,78,91,5,0,96,117,5,0,122,121,5,0,126
42691,70,"COLEGIUL TEHNIC „PANAIT ISTRATI”",BRĂILA,BR,910,19,5,0,24,39,5,0,44,51,5,0,56,64,5,0,69,72,6,0,78
42691,71,"COLEGIUL TEHNIC „PANAIT ISTRATI”",BRĂILA,BR,1298,24,0,0,24,39,0,0,39,42,0,0,42,57,0,0,57,64,0,0,64
42691,72,"ŞCOALA GIMNAZIALĂ NR. 18 „MIHU DRAGOMIR”",BRĂILA,BR,1041,15,3,0,18,37,4,0,41,40,5,0,45,59,7,0,66,66,7,0,73
42691,73,"ȘCOALA GIMNAZIALĂ NR. 18 „MIHU DRAGOMIR”",BRĂILA,BR,1289,18,0,0,18,48,1,0,49,64,1,0,65,93,1,0,94,97,1,0,98
42691,74,"GRĂDINIŢA NR. 21 „PESCĂRUȘUL”",BRĂILA,BR,1298,10,0,0,10,33,0,0,33,39,4,0,43,65,4,0,69,68,4,0,72
42691,75,"GRĂDINIŢA NR. 21 „PESCĂRUȘUL”",BRĂILA,BR,1020,9,4,0,13,40,4,0,44,52,4,0,56,64,4,0,68,67,4,0,71
42691,76,"GRĂDINIŢA NR. 21 „PESCĂRUȘUL”",BRĂILA,BR,1292,15,0,0,15,33,2,0,35,42,2,0,44,65,4,0,69,70,4,0,74
42691,77,"ŞCOALA GIMNAZIALĂ NR. 6 „CONSTANTIN SANDU ALDEA”",BRĂILA,BR,1287,12,0,0,12,61,1,0,62,84,1,0,85,109,1,0,110,123,1,0,124
42691,78,"ŞCOALA GIMNAZIALĂ NR. 6 „CONSTANTIN SANDU ALDEA”",BRĂILA,BR,1240,13,0,0,13,57,3,0,60,77,4,0,81,108,4,0,112,119,10,0,129
42691,79,"ŞCOALA GIMNAZIALĂ NR. 6 „CONSTANTIN SANDU ALDEA”",BRĂILA,BR,1189,12,0,0,12,41,2,0,43,46,2,0,48,55,3,0,58,60,3,0,63
42691,80,"ŞCOALA GIMNAZIALĂ NR. 6 „CONSTANTIN SANDU ALDEA”",BRĂILA,BR,1294,22,0,0,22,60,0,0,60,82,0,0,82,104,0,0,104,108,1,0,109
42691,81,"LICEUL TEHNOLOGIC „ANGHEL SALIGNY”",BRĂILA,BR,1253,18,1,0,19,61,2,0,63,86,3,0,89,111,4,0,115,122,6,0,128
42691,82,"LICEUL TEHNOLOGIC „ANGHEL SALIGNY”",BRĂILA,BR,1079,17,0,0,17,51,2,0,53,61,2,0,63,78,3,0,81,83,3,0,86
42691,83,"LICEUL TEHNOLOGIC „ANGHEL SALIGNY”",BRĂILA,BR,1231,17,0,0,17,52,3,0,55,66,4,0,70,84,6,0,90,92,6,0,98
42691,84,"COLEGIUL ECONOMIC „ION GHICA”",BRĂILA,BR,1116,8,0,0,8,37,0,0,37,57,0,0,57,84,0,0,84,87,1,0,88
42691,85,"COLEGIUL ECONOMIC „ION GHICA”",BRĂILA,BR,1412,11,0,0,11,30,0,0,30,41,1,0,42,50,1,0,51,55,2,0,57
42691,86,"CASA CORPULUI DIDACTIC",BRĂILA,BR,1203,17,0,0,17,37,1,0,38,46,1,0,47,60,1,0,61,67,1,0,68
42691,87,"ŞCOALA GIMNAZIALĂ NR. 32 „DIMITRIE CANTEMIR”",BRĂILA,BR,1212,10,0,0,10,37,1,0,38,55,1,0,56,77,1,0,78,89,1,0,90
42691,88,"ŞCOALA GIMNAZIALĂ NR. 32 „DIMITRIE CANTEMIR”",BRĂILA,BR,1439,18,0,0,18,51,1,0,52,65,1,0,66,90,1,0,91,98,1,0,99
42691,89,"ȘCOALA GIMNAZIALĂ NR. 32 „DIMITRIE CANTEMIR”",BRĂILA,BR,880,16,0,0,16,37,0,0,37,50,0,0,50,64,0,0,64,77,0,0,77
42691,90,"ȘCOALA GIMNAZIALĂ NR. 32 „DIMITRIE CANTEMIR”",BRĂILA,BR,1275,18,5,0,23,62,5,0,67,76,5,0,81,98,5,0,103,102,5,0,107
42691,91,"ȘCOALA GIMNAZIALĂ NR. 32 „DIMITRIE CANTEMIR”",BRĂILA,BR,1413,21,3,0,24,52,3,0,55,80,4,0,84,97,4,0,101,105,4,0,109
42691,92,"GRĂDINIŢA NR. 36 „FURNICUŢA”",BRĂILA,BR,1405,11,0,0,11,50,3,0,53,66,3,0,69,94,4,0,98,102,4,0,106
42691,93,"GRĂDINIŢA NR. 48 „LUCEAFĂRUL”",BRĂILA,BR,1243,15,1,0,16,43,4,0,47,62,5,0,67,84,8,0,92,92,9,0,101
42691,94,"GRĂDINIŢA NR. 48 „LUCEAFĂRUL”",BRĂILA,BR,1195,14,3,0,17,65,5,0,70,81,6,0,87,98,6,0,104,105,8,0,113
42691,95,"GRĂDINIŢA NR. 37 „DUMBRAVA MINUNATĂ”",BRĂILA,BR,1180,13,4,0,17,58,4,0,62,80,4,0,84,110,4,0,114,114,4,0,118
42691,96,"GRĂDINIŢA NR. 37 „DUMBRAVA MINUNATĂ”",BRĂILA,BR,1712,23,0,0,23,70,0,0,70,104,0,0,104,136,0,0,136,146,0,0,146
42691,97,"GRĂDINIŢA NR. 37 „DUMBRAVA MINUNATĂ”",BRĂILA,BR,1280,16,2,0,18,47,2,0,49,67,5,0,72,97,7,0,104,101,10,0,111
42691,98,"LICEUL PEDAGOGIC „D.P. PERPESSICIUS”",BRĂILA,BR,1083,9,0,0,9,37,1,0,38,51,1,0,52,71,1,0,72,76,1,0,77
42691,99,"LICEUL PEDAGOGIC „D.P. PERPESSICIUS”",BRĂILA,BR,1469,20,0,0,20,71,0,0,71,94,3,0,97,130,3,0,133,134,3,0,137
42691,100,"LICEUL PEDAGOGIC „D.P. PERPESSICIUS”",BRĂILA,BR,1492,28,0,0,28,115,2,0,117,147,3,0,150,183,3,0,186,188,3,0,191
42691,101,"ȘCOALA GIMNAZIALĂ NR. 23 „MIHAI EMINESCU”",BRĂILA,BR,1037,14,1,0,15,37,1,0,38,49,2,0,51,65,4,0,69,69,5,0,74
42691,102,"ȘCOALA GIMNAZIALĂ NR. 23 „MIHAI EMINESCU”",BRĂILA,BR,1282,14,5,0,19,48,6,0,54,61,7,0,68,85,7,0,92,91,7,0,98
42691,103,"ȘCOALA GIMNAZIALĂ NR. 23 „MIHAI EMINESCU”",BRĂILA,BR,1187,13,5,0,18,51,7,0,58,69,7,0,76,91,7,0,98,93,8,0,101
42691,104,"ŞCOALA GIMNAZIALĂ NR. 9 „ANTON PANN”",BRĂILA,BR,1156,12,0,0,12,36,1,0,37,45,1,0,46,56,1,0,57,56,1,0,57
42691,105,"ŞCOALA GIMNAZIALĂ NR. 9 „ANTON PANN”",BRĂILA,BR,1242,3,3,0,6,26,4,0,30,30,4,0,34,42,4,0,46,45,5,0,50
42691,106,"ŞCOALA GIMNAZIALĂ NR. 9 „ANTON PANN”",BRĂILA,BR,1361,12,0,0,12,23,0,0,23,35,0,0,35,41,0,0,41,44,0,0,44
42691,107,"ŞCOALA GIMNAZIALĂ NR. 9 „ANTON PANN”",BRĂILA,BR,1264,8,0,0,8,24,0,0,24,36,0,0,36,48,0,2,50,60,0,2,62
42691,108,"ŞCOALA GIMNAZIALĂ NR. 13 „NEDELCU CHERCEA”",BRĂILA,BR,1310,16,4,0,20,30,5,0,35,40,8,0,48,54,9,0,63,60,10,0,70
42691,109,"ŞCOALA GIMNAZIALĂ NR. 13 „NEDELCU CHERCEA”",BRĂILA,BR,1295,8,0,0,8,27,5,0,32,40,5,0,45,66,5,0,71,73,5,0,78
42691,110,"ȘCOALA GIMNAZIALĂ NR. 22 „RADU TUDORAN”",BRĂILA,BR,1375,10,0,0,10,26,2,0,28,41,2,0,43,47,3,0,50,49,3,0,52
42691,111,"ȘCOALA GIMNAZIALĂ NR. 22 „RADU TUDORAN”",BRĂILA,BR,1406,6,0,0,6,23,1,0,24,34,1,0,35,51,1,0,52,53,1,0,54
42691,112,"ȘCOALA GIMNAZIALĂ NR. 22 „RADU TUDORAN”",BRĂILA,BR,1250,11,0,0,11,31,0,0,31,50,0,0,50,63,0,0,63,65,0,0,65
42691,113,"ȘCOALA GIMNAZIALĂ NR. 22 „RADU TUDORAN”",BRĂILA,BR,1191,8,0,0,8,24,0,0,24,32,0,0,32,32,0,0,32,48,0,0,48
42691,114,"ȘCOALA GIMNAZIALĂ NR. 22 „RADU TUDORAN”",BRĂILA,BR,1185,13,0,0,13,31,4,0,35,33,4,0,37,48,4,0,52,55,4,0,59
42691,115,"CǍMINUL CULTURAL „NEDELCU CHERCEA”",BRĂILA,BR,1417,4,5,0,9,10,5,0,15,17,6,0,23,33,6,0,39,37,6,0,43
42691,116,"ȘCOALA GIMNAZIALĂ NR. 24 „GHEORGHE NAUM”",BRĂILA,BR,1386,7,0,0,7,26,0,0,26,36,0,0,36,52,0,0,52,59,0,0,59
42691,117,"ȘCOALA GIMNAZIALĂ NR. 24 „GHEORGHE NAUM”",BRĂILA,BR,1518,5,0,0,5,23,0,0,23,33,4,0,37,55,4,0,59,61,5,0,66
42691,118,"ȘCOALA GIMNAZIALĂ NR. 24 „GHEORGHE NAUM”",BRĂILA,BR,1330,14,0,0,14,32,0,0,32,48,0,0,48,71,0,0,71,84,0,0,84
42691,119,"ȘCOALA GIMNAZIALĂ NR. 24 „GHEORGHE NAUM”",BRĂILA,BR,1466,1,0,0,1,13,0,13,26,23,0,13,36,31,0,13,44,32,0,13,45
42691,120,"GRĂDINIŢA NR. 8 „SCUFIȚA ROȘIE”",BRĂILA,BR,1230,14,1,0,15,37,1,0,38,52,1,0,53,68,1,0,69,71,1,0,72
42691,121,"GRĂDINIŢA NR. 8 „SCUFIȚA ROȘIE”",BRĂILA,BR,1207,14,1,0,15,33,3,0,36,54,4,0,58,65,4,0,69,68,4,0,72
42691,122,"ȘCOALA GIMNAZIALĂ NR. 11 „ION LUCA CARAGIALE”",BRĂILA,BR,1207,8,0,0,8,36,3,0,39,53,3,0,56,70,3,0,73,73,4,0,77
42691,123,"ȘCOALA GIMNAZIALĂ NR. 11 „ION LUCA CARAGIALE”",BRĂILA,BR,1261,12,0,0,12,27,0,0,27,38,0,0,38,54,0,0,54,57,0,0,57
42691,124,"ȘCOALA GIMNAZIALĂ NR. 19 „MIHAIL KOGĂLNICEANU”",BRĂILA,BR,1414,15,2,0,17,53,2,0,55,70,2,0,72,93,2,0,95,96,2,0,98
42691,125,"ȘCOALA GIMNAZIALĂ NR. 19 „MIHAIL KOGĂLNICEANU”",BRĂILA,BR,1255,16,4,0,20,37,5,0,42,38,5,0,43,65,5,0,70,71,5,0,76
42691,126,"ȘCOALA GIMNAZIALĂ NR. 19 „MIHAIL KOGĂLNICEANU”",BRĂILA,BR,1418,6,2,0,8,16,2,0,18,20,3,0,23,32,3,0,35,37,3,0,40
42691,127,"ȘCOALA GIMNAZIALĂ NR. 19 „MIHAIL KOGĂLNICEANU”",BRĂILA,BR,1626,10,0,0,10,31,0,0,31,40,0,0,40,58,0,0,58,65,0,0,65
42691,128,"ȘCOALA GIMNAZIALĂ NR. 21 „ALEXANDR SERGHEEVICI PUȘKIN”",BRĂILA,BR,1249,11,0,0,11,30,1,0,31,39,3,0,42,47,3,0,50,55,4,0,59
42691,129,"ȘCOALA GIMNAZIALĂ NR. 21 „ALEXANDR SERGHEEVICI PUȘKIN”",BRĂILA,BR,1314,8,0,0,8,15,0,0,15,26,0,0,26,34,0,0,34,39,0,0,39
42691,130,"ŞCOALA GIMNAZIALĂ NR. 20 „GEORGE COŞBUC”",BRĂILA,BR,1397,17,2,0,19,41,4,0,45,57,4,0,61,75,4,0,79,77,4,0,81
42691,131,"ŞCOALA GIMNAZIALĂ NR. 20 „GEORGE COŞBUC”",BRĂILA,BR,1201,15,3,0,18,35,3,0,38,59,4,0,63,68,4,0,72,77,4,0,81
42691,132,"ŞCOALA GIMNAZIALĂ NR. 20 „GEORGE COŞBUC”",BRĂILA,BR,1354,9,0,0,9,34,0,0,34,48,0,0,48,76,0,0,76,78,0,0,78
42691,133,"LICEUL TEHNOLOGIC „CONSTANTIN BRÂNCOVEANU”",BRĂILA,BR,1045,10,2,0,12,38,2,0,40,57,3,0,60,74,6,0,80,76,6,0,82
42691,134,"LICEUL TEHNOLOGIC „CONSTANTIN BRÂNCOVEANU”",BRĂILA,BR,1619,24,1,0,25,49,1,0,50,69,2,0,71,91,4,0,95,92,4,0,96
42691,135,"LICEUL TEHNOLOGIC „CONSTANTIN BRÂNCOVEANU”",BRĂILA,BR,1363,20,0,0,20,34,1,0,35,54,1,0,55,81,1,0,82,88,1,0,89
42691,136,"LICEUL TEHNOLOGIC „CONSTANTIN BRÂNCOVEANU”",BRĂILA,BR,1208,15,1,0,16,39,2,0,41,57,2,0,59,88,2,0,90,82,8,0,90
42691,137,"LICEUL TEHNOLOGIC „CONSTANTIN BRÂNCOVEANU”",BRĂILA,BR,1186,8,3,0,11,34,4,0,38,45,4,0,49,63,6,0,69,67,6,0,73
42691,138,"ȘCOALA GIMNAZIALĂ NR. 33 „SFÂNTUL ANDREI”",BRĂILA,BR,1128,6,6,0,12,26,7,0,33,37,7,0,44,49,7,0,56,59,7,0,66
42691,139,"ȘCOALA GIMNAZIALĂ NR. 33 „SFÂNTUL ANDREI”",BRĂILA,BR,1424,12,5,0,17,29,5,0,34,47,5,0,52,76,5,0,81,78,5,0,83
42691,140,"ȘCOALA GIMNAZIALĂ NR. 33 „SFÂNTUL ANDREI”",BRĂILA,BR,1115,15,0,0,15,54,4,0,58,62,4,0,66,77,4,0,81,87,4,0,91
42762,141,"CASA DE CULTURĂ FĂUREI, SALA MICĂ",FĂUREI,BR,1433,29,1,0,30,56,6,0,62,74,7,0,81,102,8,0,110,106,8,0,114
42762,142,"ŞCOALA GIMNAZIALĂ CU CLASELE I-IV FĂUREI, SALA NR.2",FĂUREI,BR,1369,15,1,0,16,43,1,0,44,54,1,0,55,67,4,0,71,74,4,0,78
42762,143,"FOSTA ŞCOALA GENERALĂ NR.2 FĂUREI, SALA NR.1",FĂUREI,BR,539,8,0,0,8,13,0,0,13,16,1,0,17,19,1,0,20,19,1,0,20
43340,144,"ȘCOALA GIMNAZIALĂ IANCA",IANCA,BR,1053,7,0,0,7,18,0,0,18,27,0,0,27,34,0,0,34,36,0,0,36
43340,145,"ȘCOALA GIMNAZIALĂ IANCA",IANCA,BR,1185,22,0,0,22,39,2,0,41,49,3,0,52,60,3,0,63,64,3,0,67
43340,146,"CASA DE CULTURĂ ""ION THEODORESCU SION""",IANCA,BR,1198,11,0,0,11,22,0,0,22,31,4,0,35,47,7,0,54,51,7,0,58
43340,147,"LICEUL TEORETIC ”CONSTANTIN ANGELESCU”",IANCA,BR,1052,6,0,0,6,15,0,0,15,26,0,0,26,40,0,0,40,41,0,0,41
43340,148,"LICEUL TEORETIC ”CONSTANTIN ANGELESCU”",IANCA,BR,995,6,0,0,6,17,4,0,21,25,4,0,29,48,5,0,53,49,8,0,57
43395,149,"ȘCOALA GIMNAZIALĂ PLOPU",PLOPU,BR,1224,10,2,0,12,25,2,0,27,33,2,0,35,51,7,0,58,51,7,0,58
43377,150,"ȘCOALA PRIMARĂ OPRIȘENEȘTI",OPRIŞENEŞTI,BR,650,8,0,0,8,14,1,0,15,22,3,0,25,42,3,0,45,45,3,0,48
43386,151,"ȘCOALA GIMNAZIALĂ PERIȘORU",PERIŞORU,BR,877,25,4,0,29,44,4,0,48,60,4,0,64,97,5,0,102,101,5,0,106
43402,152,"ȘCOALA PRIMARĂ TÎRLELE FILIU","TÎRLELE FILIU",BR,447,4,3,0,7,10,3,0,13,20,3,0,23,22,3,0,25,26,4,0,30
43359,153,"ȘCOALA PRIMARĂ BERLEȘTI",BERLEŞTI,BR,268,8,1,0,9,14,4,0,18,21,4,0,25,25,4,0,29,34,4,0,38
43420,154,"ȘCOALA GIMNAZIALĂ ""SPIRU HARET"" ÎNSURĂȚEI - LOCAȚIA 1",ÎNSURĂŢEI,BR,1164,2,1,0,3,7,1,0,8,11,1,0,12,19,1,0,20,21,1,0,22
43420,155,"ȘCOALA GIMNAZIALĂ ""SPIRU HARET"" ÎNSURĂȚEI - LOCAȚIA 1",ÎNSURĂŢEI,BR,1083,5,1,0,6,10,2,0,12,16,3,0,19,26,3,0,29,30,3,0,33
43420,156,"LICEUL TEHNOLOGIC "" NICOLAE TITULESCU "" ÎNSURĂȚEI - ȘCOALA ANEXĂ",ÎNSURĂŢEI,BR,992,17,0,0,17,34,0,0,34,39,1,0,40,46,3,0,49,47,4,0,51
43420,157,"LICEUL TEHNOLOGIC "" NICOLAE TITULESCU "" ÎNSURĂȚEI - ȘCOALA ANEXĂ",ÎNSURĂŢEI,BR,876,7,1,0,8,12,1,0,13,17,2,0,19,21,2,0,23,24,5,0,29
43420,158,"ȘCOALA GIMNAZIALĂ "" SPIRU HARET ""ÎNSURĂȚEI - LOCAȚIA2",ÎNSURĂŢEI,BR,1284,9,4,0,13,32,5,0,37,32,5,0,37,43,11,0,54,45,11,0,56
43439,159,"ȘCOALA GIMNAZIALĂ "" SPIRU HARET "" ÎNSURĂȚEI- LOCAȚIA DIN SATUL LACU REZII","LACU REZII",BR,385,5,0,0,5,14,1,0,15,19,1,0,20,26,2,0,28,28,3,0,31
42833,160,"ŞCOALA CU CLASELE I - VIII BĂRĂGANUL",BĂRĂGANUL,BR,1243,11,1,0,12,17,4,0,21,27,4,0,31,31,4,0,35,33,7,0,40
42833,161,"SCOALA CU CLS. I - VIII BĂRĂGANUL - SALA DE CLASĂ NR. 1",BĂRĂGANUL,BR,1325,20,3,0,23,37,7,0,44,55,7,0,62,80,10,0,90,82,11,0,93
42851,162,"CĂMINUL CULTURAL BERTEȘTII DE JOS","BERTEŞTII DE JOS",BR,697,12,0,0,12,23,0,0,23,31,0,0,31,64,0,0,64,70,1,0,71
42904,163,"SEDIUL MULTIFUNCȚIONAL SPIRU HARET","SPIRU HARET",BR,1242,5,0,0,5,18,2,0,20,31,3,0,34,45,5,0,50,46,5,0,51
42860,164,"CĂMINUL CULTURAL BERTEȘTII DE SUS","BERTEŞTII DE SUS",BR,274,10,0,0,10,18,0,0,18,22,3,0,25,35,5,0,40,36,6,0,42
42879,165,"SEDIU MULTIFUNCȚIONAL GURA CĂLMĂȚUI","GURA CĂLMĂŢUI",BR,266,12,1,0,13,16,4,0,20,27,4,0,31,47,6,0,53,47,6,0,53
42922,166,"ȘCOALA CU CLASELE I-VIII BORDEI VERDE","BORDEI VERDE",BR,1112,11,1,0,12,17,1,0,18,31,3,0,34,59,4,0,63,65,5,0,70
42931,167,"ȘCOALA CU CLASELE I-IV CONSTANTIN GABRIELESCU","CONSTANTIN GABRIELESCU",BR,537,8,0,0,8,18,0,0,18,30,0,0,30,48,2,0,50,50,2,0,52
42959,168,"CĂMINUL CULTURAL LIȘCOTEANCA",LIŞCOTEANCA,BR,440,7,0,0,7,13,1,0,14,16,3,0,19,20,3,0,23,23,3,0,26
44275,169,"ȘCOALA CU CLASELE I-IV CAZASU (SATUC)",CAZASU,BR,1284,6,2,0,8,16,3,0,19,25,4,0,29,35,8,0,43,41,8,0,49
44275,170,"ȘCOALA GIMNAZIALĂ CAZASU",CAZASU,BR,1659,6,0,0,6,14,0,0,14,34,5,0,39,43,6,0,49,46,6,0,52
42717,171,"SCOALA GIMNAZIALACHISCANI - CENTRU",CHIŞCANI,BR,1485,10,3,0,13,22,3,0,25,30,4,0,34,43,5,0,48,44,6,0,50
42717,172,"SCOALA GIMNAZIALA- CHISCANI - CARTIER",CHIŞCANI,BR,1906,10,0,0,10,24,0,0,24,59,1,0,60,94,5,0,99,101,6,0,107
42726,173,"GRADINITA CU PROGRAM NORMAL-LACU SARAT","LACU SĂRAT",BR,1781,8,3,0,11,28,8,0,36,35,8,0,43,59,13,0,72,67,13,0,80
42977,174,"CAMINUL CULTURAL CIOCILE",CIOCILE,BR,783,4,0,0,4,7,1,0,8,8,1,0,9,11,1,0,12,18,1,0,19
42977,175,"CAMINUL CULTURAL CIOCILE",CIOCILE,BR,817,6,0,0,6,17,1,0,18,24,3,0,27,30,3,0,33,31,4,0,35
43000,176,ȘCOALAPRIMARAPRICHICHINEȚU,CHICHINEŢU,BR,448,4,5,0,9,12,6,0,18,20,7,0,27,33,9,0,42,37,9,0,46
43028,177,"ȘCOALA CU CLASELE I-VIII CIREȘU",CIREŞU,BR,744,7,4,0,11,16,5,0,21,28,5,0,33,31,6,0,37,31,6,0,37
43037,178,"ȘCOALA CU CLASELE I-VIII BATOGU",BATOGU,BR,532,4,1,0,5,7,2,0,9,16,2,0,18,34,4,0,38,40,4,0,44
43055,179,"ȘCOALA CU CLASELE I-VIII SCĂRLĂTEȘTI",SCĂRLĂTEŞTI,BR,684,7,0,0,7,13,0,0,13,17,0,0,17,28,0,0,28,30,0,0,30
43064,180,"ȘCOALA CU CLASELE I-VIII VULTURENI",VULTURENI,BR,468,2,2,0,4,13,2,0,15,25,2,0,27,40,4,0,44,40,4,0,44
43082,181,"ȘCOALA GIMNAZIALĂ DUDEȘTI",DUDEŞTI,BR,1342,6,1,0,7,18,4,0,22,26,4,0,30,35,4,0,39,36,5,0,41
43108,182,"ȘCOALA CU CLASELE V-VIII TĂTARU",TĂTARU,BR,1122,10,0,0,10,24,3,0,27,28,3,0,31,45,3,0,48,57,4,0,61
43108,183,"ŞCOALA CU CLASELE I-IV TATARU",TĂTARU,BR,424,3,0,0,3,8,0,0,8,8,5,0,13,10,5,0,15,13,7,0,20
43135,184,"ȘCOALA CU CLASELE I-IV AGAUA",AGAUA,BR,427,5,1,0,6,10,1,0,11,11,1,0,12,18,2,0,20,19,2,0,21
43126,185,"ȘCOALA CU CLASELE I-VIII FRECĂȚEI",FRECĂŢEI,BR,298,4,3,0,7,5,3,0,8,13,4,0,17,23,6,0,29,24,6,0,30
43171,186,"ȘCOALA CU CLASELE I-IV TITCOV",TITCOV,BR,382,6,1,0,7,11,1,0,12,17,1,0,18,23,2,0,25,26,2,0,28
43199,187,"ȘCOALA GIMNAZIALA ""TOMA TAMPEANU"" GALBENU",GALBENU,BR,759,8,4,0,12,22,7,0,29,25,9,0,34,32,10,0,42,33,10,0,43
43224,188,"ȘCOALA GIMNAZIALĂ SĂTUC",SĂTUC,BR,573,4,3,0,7,7,3,0,10,13,3,0,16,22,4,0,26,23,5,0,28
43233,189,"ȘCOALA GIMNAZIALĂ ZAMFIREȘTI",ZAMFIREŞTI,BR,300,5,0,0,5,6,0,0,6,9,0,0,9,15,0,0,15,18,5,0,23
43206,190,"ȘCOALA GIMNAZIALĂ DROGU",DROGU,BR,670,8,3,0,11,14,5,0,19,29,5,0,34,46,9,0,55,50,10,0,60
43215,191,"ȘCOALA GIMNAZIALĂ PÂNTECANI",PÎNTECANI,BR,143,6,2,0,8,10,2,0,12,11,2,0,13,12,3,0,15,13,3,0,16
43251,192,"ȘCOALA GIMNAZIALĂ CU CLASELE I-VIII",GEMENELE,BR,1454,24,2,0,26,41,4,0,45,64,4,0,68,72,4,0,76,92,4,0,96
43288,193,"CAMIN CULTURAL GRADISTEA",GRADIŞTEA,BR,1001,31,3,0,34,42,7,0,49,50,9,0,59,71,12,0,83,72,12,0,84
43297,194,"SCOALAIBRIANU - CORPUL NOU",IBRIANU,BR,515,7,0,0,7,17,0,0,17,21,5,0,26,26,8,0,34,26,8,0,34
43304,195,"SCOALA MARALOIU",MARALOIU,BR,232,9,1,0,10,18,5,0,23,21,5,0,26,27,8,0,35,32,8,0,40
43322,196,"CĂMIN CULTURAL",GROPENI,BR,1453,21,1,0,22,29,2,0,31,40,2,0,42,51,4,0,55,62,5,0,67
43322,197,"ȘCOALA GIMNAZIALĂ GROPENI",GROPENI,BR,1351,5,1,0,6,15,2,0,17,22,2,0,24,48,4,0,52,50,5,0,55
43475,198,"ŞCOALA GIMNAZIALĂ NR.2",JIRLĂU,BR,1397,4,1,0,5,20,4,0,24,25,4,0,29,27,5,0,32,31,5,0,36
43475,199,"SCOALA GIMNAZIALĂ NR.1",JIRLĂU,BR,1143,3,0,0,3,13,0,0,13,20,0,0,20,22,2,0,24,24,3,0,27
43509,200,"CĂMINUL CULTURAL MĂRAȘU",MĂRAŞU,BR,775,2,1,0,3,5,3,0,8,7,7,0,14,15,11,0,26,19,11,0,30
43518,201,"ȘCOALA PRIMARA BĂNDOIU",BĂNDOIU,BR,345,10,2,0,12,18,2,0,20,19,2,0,21,25,2,0,27,25,2,0,27
43554,202,"ȘCOALA GIMNAZIALĂ ȚĂCĂU",ŢĂCĂU,BR,570,5,3,0,8,6,3,0,9,8,3,0,11,14,3,0,17,14,3,0,17
43527,203,"CĂMINUL CULTURAL MĂGURENI",MĂGURENI,BR,436,5,3,0,8,6,4,0,10,7,4,0,11,9,6,0,15,9,6,0,15
43545,204,"ȘCOALA PRIMARA PLOPI",PLOPI,BR,149,3,3,0,6,6,3,0,9,9,3,0,12,11,3,0,14,11,3,0,14
43572,205,"ȘCOALA GENERALĂ CU CLASELE I-VIII MĂXINENI",MĂXINENI,BR,1223,9,2,0,11,14,7,0,21,23,10,0,33,35,11,0,46,36,13,0,49
43581,206,"CĂMINUL CULTURAL CORBU NOU","CORBU NOU",BR,693,10,2,0,12,22,2,0,24,33,2,0,35,51,3,0,54,52,3,0,55
43590,207,"CĂMINUL CULTURAL CORBU VECHI","CORBU VECHI",BR,233,3,0,0,3,10,0,0,10,15,0,0,15,31,0,0,31,31,0,0,31
43607,208,"CAMIN CULTURAL LATINU",LATINU,BR,607,1,0,0,1,6,0,0,6,9,0,0,9,15,0,0,15,20,0,0,20
43634,209,"SCOALA GIMNAZIALA MIRCEA VODA, JUDEȚUL BRAILA","MIRCEA VODĂ",BR,929,9,1,0,10,17,3,0,20,18,3,0,21,24,3,0,27,38,3,0,41
43634,210,"SCOALA GIMNAZIALA MIRCEA VODA, JUDETUL BRAILA","MIRCEA VODĂ",BR,1036,9,0,0,9,16,2,0,18,21,2,0,23,30,2,0,32,37,3,0,40
43643,211,"SCOALA GIMNAZIALA SAT DEDULESTI",DEDULEŞTI,BR,706,11,0,0,11,23,2,0,25,33,2,0,35,51,3,0,54,52,3,0,55
43661,212,"SCOALA VECHE","MOVILA MIRESII",BR,1151,35,5,0,40,58,13,0,71,84,13,0,97,125,14,0,139,132,16,0,148
43661,213,"CAMIN CULTURAL M.MIRESII","MOVILA MIRESII",BR,1176,43,2,0,45,94,9,0,103,132,12,0,144,152,17,0,169,166,17,0,183
43689,214,"SCOALA TEPES VODA","ŢEPEŞ VODĂ",BR,770,15,3,0,18,23,3,0,26,38,4,0,42,48,6,0,54,50,6,0,56
43670,215,"SCOALA ESNA",ESNA,BR,258,15,2,0,17,24,2,0,26,35,3,0,38,58,3,0,61,67,3,0,70
43705,216,"CĂMINUL CULTURAL RACOVIȚA",RACOVIŢĂ,BR,879,9,1,0,10,19,2,0,21,26,2,0,28,47,3,0,50,48,3,0,51
43741,217,"ȘCOALA GIMNAZIALĂ RÎMNICELU",RÎMNICELU,BR,1128,10,0,0,10,25,1,0,26,40,7,0,47,55,12,0,67,59,12,0,71
43769,218,"ȘCOALA PRIMARĂ CONSTANTINEȘTI",CONSTANTINEŞTI,BR,259,2,2,0,4,7,2,0,9,11,3,0,14,12,4,0,16,15,4,0,19
43778,219,"ȘCOALA PRIMARĂ MIHAIL KOGĂLNICEANU","MIHAIL KOGĂLNICEANU",BR,208,5,1,0,6,15,5,0,20,25,5,0,30,32,6,0,38,41,8,0,49
43796,220,"ȘCOALA GIMNAZIALA ROMANU",ROMANU,BR,1153,9,0,0,9,16,2,0,18,21,3,0,24,26,3,0,29,33,3,0,36
43803,221,"ȘCOALA GIMNAZIALA OANCEA",OANCEA,BR,321,12,5,0,17,16,5,0,21,17,8,0,25,22,12,0,34,24,12,0,36
43821,222,"CASA DE CULTURĂ ROȘIORI",ROŞIORI,BR,1277,14,2,0,16,34,3,0,37,43,6,0,49,54,8,0,62,63,8,0,71
43830,223,"ȘCOALA CU CLASELE I-VIII COLȚEA",COLŢEA,BR,851,11,1,0,12,23,1,0,24,27,1,0,28,36,1,0,37,36,1,0,37
43876,224,"CĂMINUL CULTURAL SALCIA TUDOR","SALCIA TUDOR",BR,607,7,2,0,9,13,4,0,17,16,5,0,21,21,9,0,30,21,9,0,30
43894,225,"ȘCOALA GIMNAZIALĂ CUZA VODĂ","CUZA VODĂ",BR,705,10,1,0,11,16,4,0,20,23,4,0,27,25,4,0,29,40,4,0,44
43901,226,"CĂMINUL CULTURAL GULIANCA",GULIANCA,BR,322,4,1,0,5,7,1,0,8,10,2,0,12,12,2,0,14,12,2,0,14
43910,227,"CĂMINUL CULTURAL OLĂNEASCA",OLĂNEASCA,BR,345,14,0,0,14,20,0,0,20,21,0,0,21,36,0,0,36,38,0,0,38
43885,228,"CĂMINUL CULTURAL ARICIU",ARICIU,BR,134,6,3,0,9,9,4,0,13,10,4,1,15,14,4,1,19,15,4,1,20
43938,229,"ȘCOALA GIMNAZIALĂ SCORȚARU NOU","SCORŢARU NOU",BR,694,8,1,0,9,10,1,0,11,18,2,0,20,19,4,0,23,21,4,0,25
43983,230,"GRĂDINIȚA CU PROGRAM NORMAL SIHLEANU",SIHLEANU,BR,381,5,1,0,6,7,1,0,8,15,1,0,16,25,2,0,27,27,2,0,29
44006,231,"CĂMINUL CULTURAL SILIȘTEA",SILIŞTEA,BR,870,8,0,0,8,18,0,0,18,26,0,0,26,36,0,0,36,40,0,0,40
44042,232,"ȘCOALA PRIMARĂ MUCHEA",MUCHEA,BR,337,8,1,0,9,11,3,0,14,11,7,0,18,30,10,0,40,43,11,0,54
44015,233,"GRĂDINIŢA CU PROGRAM NORMAL COTU-LUNG","COTU LUNG",BR,262,7,0,0,7,10,0,0,10,16,0,0,16,19,0,0,19,21,1,0,22
44079,234,"ȘCOALA GIMNAZIALA STĂNCUȚA",STĂNCUŢA,BR,1251,22,0,0,22,56,4,0,60,75,5,0,80,104,5,0,109,113,5,0,118
44088,235,"CĂMINUL CULTURAL CUZA VODĂ","CUZA VODĂ",BR,1208,14,1,0,15,20,2,0,22,25,2,0,27,32,5,0,37,39,5,0,44
44104,236,ȘCOALASTANCA,STANCA,BR,362,9,5,0,14,24,6,0,30,33,6,0,39,34,9,0,43,34,9,0,43
44122,237,"CĂMINUL CULTURAL SURDILA GĂISEANCA",SURDILA-GĂISEANCA,BR,1349,26,1,0,27,46,3,0,49,79,5,0,84,145,7,0,152,160,9,0,169
44131,238,"FOSTA ȘCOALA GIMNAZIALA FILIPESTI",FILIPEŞTI,BR,649,12,4,0,16,30,5,0,35,44,6,0,50,73,12,0,85,80,14,0,94
42780,239,"ȘCOALA CU CLASELE I-VIII SURDILA GRECI",SURDILA-GRECI,BR,602,13,0,0,13,35,2,0,37,56,2,0,58,77,3,0,80,81,4,0,85
42806,240,"ȘCOALA CU CLASELE I-IV FĂUREI - SAT","FĂUREI SAT",BR,284,5,4,0,9,9,6,0,15,18,7,0,25,22,9,0,31,25,9,0,34
42815,241,"ȘCOALA CU CLASELE I-IV HORIA",HORIA,BR,327,9,2,0,11,21,2,0,23,30,2,0,32,41,3,0,44,41,3,0,44
44159,242,"CĂMINUL CULTURAL ŞUŢEŞTI",ŞUŢEŞTI,BR,1147,11,0,0,11,18,4,0,22,30,4,0,34,40,7,0,47,42,7,0,49
44159,243,"ŞCOALA GIMNAZIALĂ ŞUŢEŞTI (ŞCOALA DE ARTE ŞI MESERII)",ŞUŢEŞTI,BR,1208,4,1,0,5,11,2,0,13,15,2,0,17,24,2,0,26,30,2,0,32
44159,244,"ŞCOALA GIMNAZIALĂ ŞUŢEŞTI (ŞCOALA DE ARTE ŞI MESERII)",ŞUŢEŞTI,BR,956,9,1,0,10,12,1,0,13,16,1,0,17,27,1,0,28,27,1,0,28
44168,245,"ŞCOALA CU CLASELE I-IV MIHAIL KOGĂLNICEANU","MIHAIL KOGĂLNICEANU",BR,297,0,0,0,0,10,1,0,11,10,1,0,11,14,1,0,15,14,1,0,15
44186,246,"SCOALA GIMNAZIALA TICHILESTI",TICHILEŞTI,BR,1427,13,0,0,13,25,4,107,136,45,10,107,162,46,10,107,163,63,10,107,180
44186,247,"SCOALA GIMNAZIALA TICHILESTI",TICHILEŞTI,BR,1376,11,0,0,11,21,0,0,21,30,0,0,30,44,0,0,44,47,3,0,50
44195,248,"SCOALA PRIMARA ALBINA",ALBINA,BR,255,0,2,0,2,5,3,0,8,8,3,0,11,10,5,0,15,11,5,0,16
44211,249,"ȘCOALA CU CLASELE I-VIII TRAIAN",TRAIAN,BR,935,3,2,0,5,15,3,0,18,22,3,0,25,33,3,0,36,36,3,0,39
44239,250,"GRĂDINIȚA SILISTRARU",SILISTRARU,BR,615,6,0,0,6,14,0,0,14,14,0,0,14,16,0,0,16,17,0,0,17
44248,251,"GRĂDINIȚA URLEASCA",URLEASCA,BR,1021,5,0,0,5,6,2,0,8,13,3,0,16,18,4,0,22,19,4,0,23
44220,252,"FOSTA ȘCOALĂ CĂLDĂRUȘA",CĂLDĂRUŞA,BR,162,3,0,0,3,9,0,0,9,11,0,0,11,20,0,0,20,20,0,0,20
44266,253,"ȘCOALA GIMNAZIALĂ TUDOR VLADIMIRESCU","TUDOR VLADIMIRESCU",BR,819,2,0,0,2,7,1,0,8,15,1,0,16,21,2,0,23,21,2,0,23
44293,254,"CĂMINUL CULTURAL SCORȚARU VECHI","SCORŢARU VECHI",BR,774,19,1,0,20,42,4,0,46,57,6,0,63,75,8,0,83,87,8,0,95
44284,255,"CĂMINUL CULTURAL COMĂNEASCA",COMĂNEASCA,BR,172,2,0,0,2,13,1,0,14,19,4,0,23,28,6,0,34,30,6,0,36
44319,256,"SCOALA PETRE CARP TUFESTI",TUFEŞTI,BR,870,3,4,0,7,8,5,0,13,13,8,0,21,19,8,0,27,25,8,0,33
44319,257,"CLADIREA FOSTEI GRADINITE TUFESTI",TUFEŞTI,BR,886,6,0,0,6,11,1,0,12,18,1,0,19,34,6,0,40,43,6,0,49
44319,258,"CAMIN CULTURAL DIN FOSTUL SAT TIBANESTI",TUFEŞTI,BR,1123,13,0,0,13,27,1,0,28,37,2,0,39,45,3,0,48,55,5,0,60
44319,259,"SCOALA PETRE CARP DIN FOSTUL SAT TIBANESTI",TUFEŞTI,BR,1370,6,4,0,10,33,6,0,39,36,6,0,42,53,10,0,63,67,10,0,77
44337,260,"CAMINUL CULTURAL ULMU",ULMU,BR,1282,5,1,0,6,17,1,0,18,32,2,0,34,41,4,0,45,43,5,0,48
44337,261,"CAMINUL CULTURAL MOHREANU",ULMU,BR,1004,12,1,0,13,18,2,0,20,38,4,0,42,53,4,0,57,58,4,0,62
44346,262,"CAMINUL CULTURAL JUGUREANU",JUGUREANU,BR,814,8,0,0,8,10,1,0,11,11,1,0,12,21,4,0,25,24,4,0,28
44364,263,"SCOALA GIMNAZIALA UNIREA",UNIREA,BR,885,13,6,0,19,19,6,1,26,29,8,1,38,43,8,1,52,53,11,1,65
44382,264,"STRUCTURA SCOALA GIMNAZIALA VALEA CINEPII,","VALEA CÎNEPII",BR,1048,4,3,0,7,12,7,0,19,24,7,0,31,40,10,0,50,46,10,0,56
44408,265,"SCOALA GIMNAZIALACU CLASELE I-VIII VADENI -SALA A",VĂDENI,BR,954,6,0,0,6,18,0,0,18,23,0,0,23,30,2,0,32,31,2,0,33
44408,266,"SCOALA GIMNAZIALACU CLASELE I-VIII-VADENI-SALA B",VĂDENI,BR,990,1,0,0,1,10,4,0,14,16,4,0,20,20,6,0,26,21,6,0,27
44417,267,"SCOALA GIMNAZIALA CU CLASELE I-VIII BALDOVINESTI",BALDOVINEŞTI,BR,973,7,0,0,7,19,0,0,19,25,0,0,25,27,0,0,27,30,0,0,30
44426,268,"SCOALA CU CLASELE I-IVPIETROIU",PIETROIU,BR,432,4,0,0,4,5,0,0,5,7,0,0,7,7,0,0,7,7,0,0,7
44444,269,"SCOALA GIMNAZIALA VICTORIA",VICTORIA,BR,894,12,0,0,12,15,1,0,16,16,1,0,17,34,1,0,35,35,2,0,37
44444,270,"SCOALA GIMNAZIALA VICTORIA",VICTORIA,BR,824,7,2,0,9,15,2,0,17,33,2,0,35,39,2,0,41,42,2,0,44
44453,271,"SCOALA GIMNAZIALAVICTORIA STRUCTURA SCOLARA GIMNAZIALA MIHAI BRAVU","MIHAI BRAVU",BR,1225,10,0,0,10,18,0,0,18,29,1,0,30,42,1,0,43,42,1,0,43
44471,272,"ȘCOALA GIMNAZIALĂ VIȘANI",VIŞANI,BR,1434,10,3,0,13,24,5,0,29,29,6,0,35,38,6,0,44,40,6,0,46
44480,273,"ȘCOALA PRIMARĂ CÂINENI-BĂI",CÎINENI-BĂI,BR,484,6,0,0,6,15,0,0,15,20,2,0,22,23,3,0,26,24,4,0,28
44514,274,"SCOALA CU CLASELE I-VIIIVIZIRU",VIZIRU,BR,1464,6,0,0,6,29,4,0,33,46,4,0,50,57,6,0,63,65,7,0,72
44514,275,"CENTRU EDUCATIONAL VIZIRU",VIZIRU,BR,1732,11,2,0,13,29,5,0,34,48,7,0,55,82,10,0,92,96,12,0,108
44523,276,"ȘCOALA LANURILE",LANURILE,BR,904,4,0,0,4,5,0,0,5,8,0,0,8,14,0,0,14,14,0,0,14
44523,277,"ȘCOALA LANURILE",LANURILE,BR,900,5,0,0,5,10,0,0,10,21,0,0,21,29,0,0,29,34,0,0,34
44541,278,"CAMIN CULTURAL ZAVOAIA",ZĂVOAIA,BR,983,10,0,0,10,22,4,0,26,41,7,0,48,56,9,0,65,61,9,0,70
44541,279,"CĂMINUL CULTURAL ZĂVOAIA",ZĂVOAIA,BR,916,6,0,0,6,19,1,0,20,21,1,0,22,37,1,0,38,48,3,0,51
44550,280,"CĂMINUL CULTURAL DUDESCU",DUDESCU,BR,621,3,3,0,6,9,8,0,17,15,8,0,23,26,9,0,35,27,9,0,36
35740,1,"LICEUL DE ARTĂ ,, ŞTEFAN LUCHIAN""",BOTOŞANI,BT,902,8,2,0,10,17,3,0,20,33,5,0,38,50,6,0,56,50,6,1,57
35740,2,"LICEUL DE ARTĂ ,, ŞTEFAN LUCHIAN""",BOTOŞANI,BT,1293,31,2,0,33,79,3,0,82,97,5,0,102,114,7,0,121,121,9,0,130
35740,3,"ŞCOALA GENERALĂ NR. 4",BOTOŞANI,BT,1537,24,2,0,26,70,2,0,72,88,2,0,90,114,3,0,117,127,3,0,130
35740,4,"ŞCOALA GENERALĂ NR. 4",BOTOŞANI,BT,1415,22,0,0,22,60,3,0,63,87,3,0,90,108,3,0,111,119,3,0,122
35740,5,"ŞCOALA GENERALĂ NR. 7",BOTOŞANI,BT,1120,29,5,0,34,74,5,0,79,86,6,0,92,104,7,0,111,108,7,0,115
35740,6,"ŞCOALA GENERALĂ NR. 7",BOTOŞANI,BT,1103,10,0,0,10,34,1,0,35,49,1,0,50,63,1,0,64,66,1,0,67
35740,7,"GRĂDINIŢA DE COPII NR. 19",BOTOŞANI,BT,1010,8,6,0,14,40,7,0,47,54,7,0,61,73,7,0,80,74,7,0,81
35740,8,"GRĂDINIŢA DE COPII NR. 19",BOTOŞANI,BT,1111,13,4,0,17,32,5,2,39,45,6,2,53,58,8,2,68,66,8,2,76
35740,9,"ŞCOALA GENERALĂ NR. 17",BOTOŞANI,BT,1498,16,6,0,22,38,6,0,44,64,10,0,74,99,12,1,112,112,12,1,125
35740,10,"LICEUL DE ŞTIINŢE ALE NATURII „GRIGOREANTIPA”",BOTOŞANI,BT,1656,22,2,0,24,63,10,0,73,95,14,0,109,125,18,0,143,135,18,0,153
35740,11,"LICEUL DE ŞTIINŢE ALE NATURII „GRIGOREANTIPA”",BOTOŞANI,BT,1422,17,6,0,23,47,8,0,55,70,11,0,81,104,14,0,118,119,15,0,134
35740,12,"ŞCOALA GENERALĂ NR. 16",BOTOŞANI,BT,1484,10,0,0,10,42,0,0,42,74,0,0,74,92,0,0,92,96,0,0,96
35740,13,"ŞCOALA GENERALĂ NR. 16",BOTOŞANI,BT,1413,19,0,0,19,44,0,0,44,68,0,0,68,96,1,0,97,112,1,0,113
35740,14,"ŞCOALA GENERALĂ NR. 16",BOTOŞANI,BT,1276,10,5,0,15,31,5,0,36,52,5,0,57,63,5,0,68,68,5,0,73
35740,15,"ŞCOALA GENERALĂ NR. 13",BOTOŞANI,BT,1350,8,1,0,9,38,1,0,39,63,1,0,64,95,1,0,96,97,1,0,98
35740,16,"ŞCOALA GENERALĂ NR. 13",BOTOŞANI,BT,1518,5,0,0,5,28,1,0,29,49,2,0,51,70,3,0,73,79,3,0,82
35740,17,"COLEGIUL NAŢIONAL “MIHAI EMINESCU”",BOTOŞANI,BT,1352,10,0,0,10,36,0,0,36,54,0,0,54,66,0,2,68,68,0,2,70
35740,18,"COLEGIUL NAŢIONAL “MIHAI EMINESCU”",BOTOŞANI,BT,1101,16,6,0,22,55,7,0,62,75,7,0,82,98,7,0,105,102,7,0,109
35740,19,"COLEGIUL NAŢIONAL “MIHAI EMINESCU”",BOTOŞANI,BT,1518,17,1,0,18,43,2,0,45,69,3,0,72,89,6,0,95,93,11,0,104
35740,20,"COLEGIUL NAŢIONAL “MIHAI EMINESCU”",BOTOŞANI,BT,1202,10,0,0,10,33,0,0,33,45,0,0,45,72,0,0,72,81,0,0,81
35740,21,"ŞCOALA GENERALĂ NR. 12",BOTOŞANI,BT,1022,11,3,0,14,28,3,0,31,49,4,0,53,63,4,0,67,67,4,0,71
35740,22,"ŞCOALA GENERALĂ NR. 12",BOTOŞANI,BT,861,2,1,0,3,16,2,0,18,26,2,0,28,36,2,0,38,42,2,0,44
35740,23,"ŞCOALA GENERALĂ NR. 12",BOTOŞANI,BT,1331,12,3,0,15,46,4,0,50,74,5,1,80,97,6,1,104,107,6,1,114
35740,24,"GRĂDINIŢA DE COPII NR. 23",BOTOŞANI,BT,1273,13,7,0,20,39,7,0,46,60,8,0,68,71,10,0,81,76,10,0,86
35740,25,"GRUPUL ŞCOLAR INDUSTRIAL “GHE.ASACHI”(LICEUL ELECTROCONTACT)",BOTOŞANI,BT,703,6,7,0,13,13,7,0,20,25,10,0,35,32,10,0,42,33,11,0,44
35740,26,"GRUPUL ŞCOLAR INDUSTRIAL “GHE.ASACHI”(LICEUL ELECTROCONTACT)",BOTOŞANI,BT,969,6,4,0,10,36,4,0,40,55,8,0,63,79,14,0,93,80,14,0,94
35740,27,"GRUPUL ŞCOLAR INDUSTRIAL “GHE.ASACHI”(ŞCOALA PROFESIONALĂ ELECTROCONTACT)",BOTOŞANI,BT,1243,7,0,0,7,16,4,0,20,22,4,0,26,37,4,0,41,39,4,0,43
35740,28,"GRUPUL ŞCOLAR INDUSTRIAL “GHE.ASACHI”(ŞCOALA PROFESIONALĂ ELECTROCONTACT)",BOTOŞANI,BT,1127,7,5,0,12,20,5,0,25,43,5,0,48,65,6,0,71,69,6,0,75
35740,29,"GRUPUL ŞCOLAR INDUSTRIAL “GHE.ASACHI”(ŞCOALA PROFESIONALĂ ELECTROCONTACT)",BOTOŞANI,BT,846,6,6,0,12,20,6,0,26,27,6,0,33,49,6,0,55,54,6,0,60
35740,30,"GRUPUL ŞCOLAR DE INDUSTRIE UŞOARĂ (LICEUL TEXTIL)",BOTOŞANI,BT,1431,23,4,0,27,49,6,0,55,56,7,0,63,81,9,0,90,82,9,0,91
35740,31,"GRUPUL ŞCOLAR DE INDUSTRIE UŞOARĂ (LICEUL TEXTIL)",BOTOŞANI,BT,805,2,3,0,5,25,3,0,28,43,3,2,48,56,3,2,61,56,3,2,61
35740,32,"GRUPUL ŞCOLAR DE INDUSTRIE UŞOARĂ (LICEUL TEXTIL)",BOTOŞANI,BT,837,5,5,0,10,18,6,0,24,40,11,0,51,47,11,5,63,52,11,5,68
35740,33,"ŞCOALA GENERALĂ NR. 14",BOTOŞANI,BT,854,12,4,0,16,31,4,0,35,40,4,0,44,48,5,0,53,52,5,0,57
35740,34,"ŞCOALA GENERALĂ NR. 14",BOTOŞANI,BT,1518,16,5,0,21,41,5,0,46,89,5,0,94,112,8,4,124,119,10,4,133
35740,35,"ŞCOALA GENERALĂ NR. 14",BOTOŞANI,BT,611,2,0,0,2,28,0,0,28,44,0,0,44,53,0,1,54,59,1,1,61
35740,36,"ŞCOALA GENERALĂ NR. 14",BOTOŞANI,BT,1094,10,1,0,11,27,1,0,28,34,2,0,36,66,3,0,69,79,3,0,82
35740,37,"ŞCOALA GENERALĂ NR. 14",BOTOŞANI,BT,1069,8,4,0,12,24,5,0,29,34,5,0,39,51,7,5,63,62,7,5,74
35740,38,"ŞCOALA GENERALĂ NR. 14",BOTOŞANI,BT,1182,5,1,0,6,27,2,0,29,31,2,0,33,46,2,0,48,48,3,0,51
35740,39,"GRĂDINIŢA DE COPII NR. 22",BOTOŞANI,BT,1177,10,6,0,16,33,6,0,39,49,6,0,55,61,6,0,67,67,6,0,73
35740,40,"GRĂDINIŢA DE COPII NR. 22",BOTOŞANI,BT,855,6,0,0,6,17,0,0,17,28,0,0,28,41,1,0,42,48,1,0,49
35740,41,"GRĂDINIŢA DE COPII NR. 22",BOTOŞANI,BT,972,6,3,0,9,13,3,0,16,28,3,0,31,52,3,1,56,60,3,1,64
35740,42,"GRĂDINIŢA DE COPII NR. 22",BOTOŞANI,BT,985,6,0,0,6,28,0,0,28,34,0,0,34,53,0,0,53,60,0,0,60
35740,43,"ŞCOALA GENERALĂ NR.8",BOTOŞANI,BT,1253,10,2,0,12,25,5,0,30,40,6,0,46,67,11,1,79,74,11,1,86
35740,44,"ŞCOALA GENERALĂ NR.8",BOTOŞANI,BT,1375,15,1,0,16,39,5,0,44,74,6,0,80,76,6,1,83,100,6,1,107
35740,45,"ŞCOALA GENERALĂ NR.8",BOTOŞANI,BT,1058,6,3,0,9,18,3,0,21,43,5,0,48,53,9,0,62,61,9,0,70
35740,46,"ŞCOALA GENERALĂ NR.8",BOTOŞANI,BT,1316,8,5,0,13,29,5,0,34,43,5,0,48,61,5,0,66,66,5,0,71
35740,47,"ŞCOALA GENERALĂ NR. 11",BOTOŞANI,BT,1121,18,1,0,19,43,1,0,44,74,1,0,75,96,1,0,97,100,1,0,101
35740,48,"ŞCOALA GENERALĂ NR. 11",BOTOŞANI,BT,867,10,0,0,10,33,0,0,33,44,0,0,44,59,0,0,59,72,2,0,74
35740,49,"ŞCOALA GENERALĂ NR. 11",BOTOŞANI,BT,1240,12,2,0,14,28,7,0,35,61,8,0,69,76,8,0,84,89,8,0,97
35740,50,"ŞCOALA GENERALĂ NR. 11",BOTOŞANI,BT,967,9,0,0,9,27,2,0,29,45,4,0,49,56,6,0,62,64,6,0,70
35740,51,"ŞCOALA GENERALĂ NR. 2",BOTOŞANI,BT,1123,10,1,0,11,21,1,0,22,37,2,0,39,62,2,0,64,62,6,0,68
35740,52,"ŞCOALA GENERALĂ NR. 2",BOTOŞANI,BT,647,6,0,0,6,18,0,0,18,27,0,0,27,35,0,0,35,35,0,0,35
35740,53,"ŞCOALA GENERALĂ NR. 2",BOTOŞANI,BT,1262,10,1,0,11,26,1,0,27,36,1,0,37,56,1,0,57,63,1,0,64
35740,54,"ŞCOALA GENERALĂ NR. 2",BOTOŞANI,BT,1295,10,0,0,10,26,0,0,26,42,0,0,42,55,0,0,55,62,0,0,62
35740,55,"GRUPUL ŞCOLAR ECONOMIC ŞI ADMINISTRATIV “OCTAV ONICESCU”",BOTOŞANI,BT,1009,9,0,0,9,16,0,0,16,30,7,0,37,42,8,0,50,43,8,0,51
35740,56,"GRUPUL ŞCOLAR ECONOMIC ŞI ADMINISTRATIV “OCTAV ONICESCU”",BOTOŞANI,BT,1094,8,6,0,14,22,8,0,30,45,8,0,53,67,8,0,75,80,9,0,89
35740,57,"GRĂDINIȚA NR. 20",BOTOŞANI,BT,1286,26,1,0,27,47,3,0,50,67,5,0,72,86,5,1,92,113,6,1,120
35740,58,"ŞCOALA GENERALĂ NR. 10",BOTOŞANI,BT,1314,15,3,0,18,38,7,0,45,51,8,0,59,74,11,0,85,76,13,0,89
35740,59,"ŞCOALA GENERALĂ NR. 10",BOTOŞANI,BT,1426,20,0,0,20,57,3,0,60,72,3,0,75,97,3,0,100,106,3,0,109
35740,60,"ŞCOALA GENERALĂ NR. 10",BOTOŞANI,BT,1301,12,6,0,18,50,6,0,56,63,6,0,69,96,7,0,103,107,7,0,114
35740,61,"COLEGIUL NAŢIONAL ”A.T. LAURIAN”",BOTOŞANI,BT,1319,13,3,0,16,58,4,0,62,80,7,0,87,116,10,0,126,122,10,0,132
35740,62,"COLEGIUL NAŢIONAL ”A.T. LAURIAN”",BOTOŞANI,BT,1356,7,0,0,7,26,0,0,26,55,0,0,55,77,6,0,83,81,6,0,87
35740,63,"LOCAL CLUBUL PENSIONARILOR",BOTOŞANI,BT,1090,21,0,0,21,49,4,0,53,66,6,0,72,94,10,0,104,99,11,0,110
35740,64,"ŞCOALA GENERALĂ NR. 1",BOTOŞANI,BT,1349,9,5,0,14,28,5,0,33,37,7,1,45,78,7,1,86,92,8,1,101
35740,65,"ŞCOALA GENERALĂ NR. 1",BOTOŞANI,BT,1011,1,0,0,1,19,0,0,19,25,3,0,28,40,3,0,43,43,3,0,46
35740,66,"ŞCOALA GENERALĂ NR. 1",BOTOŞANI,BT,1349,26,0,0,26,52,1,3,56,84,1,4,89,113,2,4,119,126,2,4,132
35740,67,"GRUP ŞCOLAR ECONOMIC ŞI ADMINISTRATIV ,, OCTAV ONICESCU""",BOTOŞANI,BT,1488,12,0,0,12,35,0,0,35,46,0,0,46,75,1,0,76,85,2,0,87
35740,68,"GRUPUL ŞCOLAR INDUSTRIAL “CONSTRUCŢII DE MAŞINI” (LICEUL INDUSTRIAL NR. 1)",BOTOŞANI,BT,1320,10,0,0,10,30,0,0,30,37,0,0,37,54,0,0,54,63,0,0,63
35740,69,"GRUPUL ŞCOLAR INDUSTRIAL “CONSTRUCŢII DE MAŞINI” (LICEUL INDUSTRIAL NR. 1)",BOTOŞANI,BT,1294,9,0,0,9,40,0,0,40,60,6,0,66,74,6,0,80,82,7,0,89
35740,70,"GRUPUL ŞCOLAR INDUSTRIAL “CONSTRUCŢII DE MAŞINI” (LICEUL INDUSTRIAL NR. 1)",BOTOŞANI,BT,1133,6,0,0,6,25,0,0,25,49,1,0,50,60,1,0,61,66,1,0,67
35740,71,"ŞCOALA GENERALĂ NR. 6",BOTOŞANI,BT,1030,8,1,0,9,28,4,0,32,43,4,0,47,57,6,0,63,66,6,0,72
35740,72,"ŞCOALA GENERALĂ NR. 6",BOTOŞANI,BT,845,8,0,0,8,25,0,0,25,41,0,0,41,59,0,0,59,64,0,0,64
35740,73,"ŞCOALA GENERALĂ NR. 6",BOTOŞANI,BT,1218,12,3,0,15,33,4,0,37,55,4,0,59,76,4,0,80,83,4,0,87
35740,74,"ŞCOALA GENERALĂ NR. 6",BOTOŞANI,BT,1127,17,1,0,18,33,2,0,35,44,3,0,47,61,3,0,64,66,4,0,70
35740,75,"ŞCOALA GENERALĂ NR. 6",BOTOŞANI,BT,805,7,0,0,7,26,0,0,26,42,0,0,42,51,0,0,51,59,0,0,59
35740,76,"ŞCOALA GENERALĂ NR.11",BOTOŞANI,BT,611,5,0,0,5,20,0,0,20,27,2,0,29,31,4,0,35,40,4,0,44
35740,77,"ŞCOALA GENERALĂ NR. 3",BOTOŞANI,BT,1483,11,0,0,11,28,5,0,33,51,5,0,56,69,5,0,74,75,5,0,80
35740,78,"GRĂDINIŢA DE COPII NR. 8",BOTOŞANI,BT,1568,10,0,0,10,28,1,3,32,56,2,3,61,87,2,3,92,106,4,3,113
35740,79,"ŞCOALA GENERALĂ NR. 9",BOTOŞANI,BT,926,9,0,0,9,19,1,0,20,31,1,0,32,45,1,0,46,57,1,0,58
35740,80,"GRUPUL ŞCOLAR AGRICOL (LICEUL AGROINDUSTRIAL)",BOTOŞANI,BT,1093,10,0,0,10,33,0,3,36,54,0,3,57,66,5,3,74,71,6,3,80
35740,81,"GRUPUL ŞCOLAR AGRICOL (LICEUL AGROINDUSTRIAL)",BOTOŞANI,BT,1421,7,0,0,7,32,0,0,32,55,1,0,56,74,1,0,75,85,6,0,91
35740,82,"LICEUL PEDAGOGIC “NICOLAE IORGA”",BOTOŞANI,BT,1276,9,1,0,10,30,3,0,33,51,4,0,55,71,9,186,266,77,11,186,274
35740,83,"LICEUL PEDAGOGIC “NICOLAE IORGA”",BOTOŞANI,BT,1583,5,3,0,8,35,4,0,39,54,4,0,58,71,4,188,263,86,4,188,278
35740,84,"LICEUL PEDAGOGIC “NICOLAE IORGA”",BOTOŞANI,BT,1128,13,1,0,14,33,1,0,34,47,1,191,239,68,6,191,265,72,6,191,269
35740,85,"LICEUL DE ARTĂ ŞTEFAN LUCHIAN",BOTOŞANI,BT,1312,10,4,0,14,73,9,11,93,108,9,11,128,137,11,11,159,146,11,11,168
36015,86,"COLEGIUL NAȚIONAL ""GRIGORE GHICA"" DOROHOI",DOROHOI,BT,1379,15,0,0,15,47,1,0,48,77,2,0,79,99,3,0,102,109,3,0,112
36015,87,"CLĂDIREA STĂRII CIVILE DOROHOI",DOROHOI,BT,1135,30,0,0,30,61,0,0,61,82,0,0,82,97,0,0,97,103,1,0,104
36015,88,"BIBLIOTECA MUNICIPALĂ DOROHOI",DOROHOI,BT,1664,26,1,0,27,60,3,0,63,92,4,0,96,120,4,0,124,122,4,0,126
36015,89,"ȘCOALA GIMNAZIALĂ ,,SPIRU HARET""DOROHOI",DOROHOI,BT,1415,32,2,0,34,74,3,0,77,106,5,0,111,127,6,0,133,140,7,0,147
36015,90,"GRĂDINIȚA CU PROGRAM NORMAL NR.4 DOROHOI",DOROHOI,BT,1001,6,5,0,11,23,7,0,30,35,8,0,43,54,10,0,64,67,10,0,77
36015,91,"ȘCOALA GIMNAZIALĂ NR.1 DOROHOI",DOROHOI,BT,1238,24,0,0,24,67,5,0,72,102,6,0,108,126,10,0,136,133,10,0,143
36015,92,"CASA MUNICIPALĂ DE CULTURĂ DOROHOI",DOROHOI,BT,1159,16,5,0,21,37,5,0,42,46,5,0,51,74,6,0,80,89,6,0,95
36015,93,"ȘCOALA GIMNAZIALĂ ,,ȘTEFAN CEL MARE"" DOROHOI",DOROHOI,BT,1090,11,2,0,13,31,3,0,34,39,3,0,42,54,4,0,58,60,4,0,64
36015,94,"ȘCOALA GIMNAZIALĂ ,, ȘTEFAN CEL MARE"" DOROHOI",DOROHOI,BT,1013,16,2,0,18,24,4,0,28,37,4,0,41,50,6,0,56,55,6,0,61
36015,95,"ȘCOALA GIMNAZIALĂ ,,ALEXANDRU IOAN CUZA"" DOROHOI",DOROHOI,BT,1122,3,6,0,9,13,6,0,19,32,6,0,38,48,8,0,56,54,8,0,62
36015,96,"ȘCOALA GIMNAZIALĂ ,,ALEXANDRU IOAN CUZA"" DOROHOI",DOROHOI,BT,1398,9,6,0,15,42,6,0,48,55,6,0,61,89,7,1,97,90,7,1,98
36015,97,"LICEUL,,REGINA MARIA"" DOROHOI",DOROHOI,BT,1302,11,1,0,12,27,1,0,28,47,1,0,48,68,2,0,70,78,2,0,80
36015,98,"LICEUL,,REGINA MARIA"" DOROHOI",DOROHOI,BT,1273,6,0,0,6,25,1,0,26,38,1,0,39,56,1,0,57,61,1,0,62
36015,99,"ȘCOALA GIMNAZIALĂ ,,MIHAIL KOGĂLNICEANU"" DOROHOI",DOROHOI,BT,1332,18,1,0,19,35,3,0,38,55,3,0,58,79,4,0,83,93,4,0,97
36015,100,"ȘCOALA GIMNAZIALĂ ,,MIHAIL KOGĂLNICEANU"" DOROHOI",DOROHOI,BT,1217,0,0,0,0,35,7,0,42,60,7,0,67,77,7,0,84,83,7,0,90
36015,101,"GRĂDINIȚA CU PROGRAM PRELUNGIT ,, ALBA CA ZĂPADA"" DOROHOI",DOROHOI,BT,1096,4,0,0,4,31,0,0,31,44,0,0,44,71,0,0,71,75,0,0,75
36015,102,"GRĂDINIȚA CU PROGRAM PRELUNGIT,,ALBA CA ZĂPADA"" DOROHOI",DOROHOI,BT,1430,11,1,0,12,28,3,0,31,44,3,0,47,59,3,0,62,63,3,0,66
36015,103,"SALA POLIVALENTĂDOROHOI",DOROHOI,BT,838,10,5,0,15,18,5,0,23,45,5,0,50,67,5,0,72,76,6,0,82
36015,104,"ȘCOALA GIMNAZIALĂ ,, DIMITRIE ROMANESCU"" DOROHOI",DOROHOI,BT,1002,12,3,0,15,20,3,0,23,30,3,0,33,48,3,0,51,49,3,0,52
36015,105,"ȘCOALA GIMNAZIALĂ ,,DIMITRIE ROMANESCU"" DOROHOI",DOROHOI,BT,1103,4,0,0,4,16,1,0,17,44,2,0,46,60,2,0,62,61,2,0,63
36015,106,"CLĂDIRE ȘCOALĂ(GRĂDINIȚĂ) SATU NOU",DOROHOI,BT,748,4,5,0,9,8,5,0,13,12,6,0,18,18,7,0,25,18,7,0,25
36033,107,"CLĂDIRE ȘCOALĂ LOTURI ENESCU","LOTURI ENESCU",BT,339,0,0,0,0,3,0,0,3,9,0,0,9,20,4,0,24,20,7,0,27
36462,108,"SCOALA NR.1 BUCECEA",BUCECEA,BT,718,11,8,0,19,35,8,0,43,43,8,0,51,58,8,0,66,68,13,0,81
36462,109,"CENTRUL CULTURAL BUCECEA",BUCECEA,BT,1635,12,3,0,15,55,8,0,63,93,11,0,104,138,12,0,150,157,14,0,171
36462,110,"SCOALA NR.2 BUCECEA",BUCECEA,BT,1539,8,1,0,9,35,4,0,39,43,5,0,48,57,7,0,64,63,8,0,71
36480,111,"SCOALA CALINESTI",CĂLINEŞTI,BT,546,7,0,0,7,15,0,0,15,19,1,0,20,26,4,0,30,32,4,0,36
35955,112,"LICEUL,,DIMITRIE CANTEMIR",DARABANI,BT,1420,13,0,0,13,18,0,0,18,19,0,8,27,23,1,8,32,32,1,8,41
35955,113,"ŞCOALA GIMNAZIALĂ,,LEON DĂNĂILĂ""",DARABANI,BT,1671,16,0,0,16,20,0,0,20,28,1,0,29,36,3,0,39,37,5,0,42
35955,114,"ŞCOALA GIMNAZIALĂ ,,LEON DĂNĂILĂ""",DARABANI,BT,1670,7,0,0,7,11,0,0,11,21,0,0,21,26,0,0,26,31,2,0,33
35955,115,"GRĂDINIŢA NR.2",DARABANI,BT,1671,8,5,0,13,12,5,0,17,26,5,0,31,39,5,0,44,51,5,0,56
35955,116,"ŞCOALAGIMNAZIALĂ CU CLASELE I-VIII LEON DĂNĂILĂ DARABANI, ȘCOALA CORNEŞTI, CORP A",DARABANI,BT,1024,3,0,0,3,8,0,0,8,10,1,0,11,19,1,0,20,26,5,0,31
35964,117,"ŞCOALAL BAJURA",BAJURA,BT,1523,8,3,0,11,21,3,0,24,28,3,0,31,33,4,0,37,34,4,0,38
35955,118,"ŞCOALA TEIOASA",DARABANI,BT,1163,3,5,0,8,14,6,0,20,16,6,0,22,20,6,0,26,21,6,0,27
35982,119,"ŞCOALA LIŞMĂNIŢA",LISMĂNIŢA,BT,553,2,4,0,6,4,4,0,8,15,4,0,19,17,4,0,21,17,4,0,21
35973,120,"ŞCOALA EŞANCA",EŞANCA,BT,265,3,0,0,3,8,2,0,10,12,3,0,15,12,4,0,16,12,4,0,16
37299,121,"ȘCOALAGIMNAZIALĂ ""MIHAIL STURZA""",FLAMÂNZI,BT,637,2,2,0,4,4,3,0,7,8,7,0,15,11,8,0,19,11,8,0,19
37299,122,"ȘCOALA .GIMNAZIALĂ ""MIHAIL STURZA""",FLAMÂNZI,BT,830,1,0,0,1,5,0,0,5,10,5,0,15,17,6,0,23,20,6,0,26
37299,123,"ȘCOALA.GIMNAZIALĂ ""ION BOJOI""",FLAMÂNZI,BT,1127,3,3,0,6,20,3,0,23,26,3,0,29,31,3,0,34,31,3,0,34
37299,124,"CASA DE CULTURA ""NICOLAE SEVEREANU""",FLAMÂNZI,BT,1119,7,4,0,11,14,5,5,24,15,5,5,25,16,6,5,27,19,6,5,30
37315,125,"ȘCOALAGIMNAZIALĂ ""CONSTANTIN COMICESCU""",POIANA,BT,1437,3,1,0,4,3,3,0,6,7,4,0,11,16,5,0,21,16,5,0,21
38410,126,"LICEUL TEHNOLOGIC ”NICOLAE BĂLCESCU”","NICOLAE BĂLCESCU",BT,1015,6,1,0,7,15,1,15,31,18,1,17,36,19,3,17,39,20,3,17,40
38410,127,"LICEUL TEHNOLOGIC ”NICOLAE BĂLCESCU”","NICOLAE BĂLCESCU",BT,1170,14,0,0,14,35,0,15,50,48,1,15,64,48,1,15,64,48,1,21,70
38410,128,"ŞCOALA TAMBA","NICOLAE BĂLCESCU",BT,1002,10,3,0,13,17,3,0,20,28,6,0,34,37,6,0,43,38,6,0,44
38438,129,"ȘCOALA PRIMARĂ ""GHEORGHE PRICOP""",CHIŢOVENI,BT,425,6,3,0,9,12,4,0,16,16,4,0,20,19,4,0,23,20,4,0,24
38447,130,"ȘCOALA GIMNAZIALĂ ""PETRU ZAMFIRESCU""",PRISĂCANI,BT,505,9,1,0,10,21,1,0,22,29,1,0,30,31,2,0,33,31,2,0,33
36079,131,"LICEUL TEORETIC DR. M. CIUCA SAVENI",SĂVENI,BT,1183,10,6,0,16,20,7,0,27,33,13,3,49,59,14,3,76,68,14,3,85
36079,132,"LICEUL TEORETIC DR. M.CIUCA SAVENI",SĂVENI,BT,894,9,3,0,12,18,3,0,21,21,5,0,26,33,8,0,41,40,8,0,48
36079,133,"SCOALA GENERALA NR. 1 SAVENI",SĂVENI,BT,1497,11,7,0,18,31,8,0,39,48,13,0,61,61,19,0,80,65,26,0,91
36079,134,"SCOALA GENERALA NR. 2 SAVENI",SĂVENI,BT,1362,14,2,0,16,27,2,0,29,40,3,0,43,57,7,0,64,57,12,0,69
36113,135,"SCOALA GENERALA PETRICANI",PETRICANI,BT,1008,17,5,0,22,27,7,0,34,34,8,0,42,38,8,0,46,43,8,0,51
36088,136,"SCOALA GENERALA BODEASA",BODEASA,BT,341,11,0,0,11,11,0,0,11,13,2,0,15,17,4,0,21,17,4,0,21
36097,137,"FOST MAGAZIN SĂTESC",BOZIENI,BT,219,1,4,0,5,5,6,0,11,8,7,0,15,10,7,0,17,12,7,0,19
39195,138,"SCOALA GIMNAZIALA BOBULESTI",BOBULEŞTI,BT,1183,10,3,0,13,17,4,0,21,22,4,0,26,30,10,0,40,31,10,0,41
39186,139,"SCOALA PRIMARA BADIUTI",BĂDIUŢI,BT,807,11,1,0,12,22,3,0,25,32,3,0,35,54,5,0,59,57,5,0,62
39177,140,"LICEUL TEORETIC “STEFAN D. LUCHIAN”",ŞTEFĂNEŞTI,BT,1208,9,2,0,11,19,3,0,22,27,6,0,33,45,8,42,95,50,8,42,100
39177,141,"LICEUL TEORETIC “STEFAN D. LUCHIAN”",ŞTEFĂNEŞTI,BT,842,6,0,0,6,12,2,0,14,21,4,0,25,25,6,0,31,25,7,0,32
39202,142,"SCOALA PRIMARA STANCA",STÂNCA,BT,760,16,3,0,19,28,3,0,31,43,3,0,46,52,4,0,56,63,4,0,67
36220,143,"SCOALA GIMNAZIALA NR.1 ADASENI",ADĂŞENI,BT,803,10,0,0,10,19,4,0,23,28,4,0,32,32,4,0,36,36,4,0,40
36293,144,"SCOALA ZOITANI",ZOIŢANI,BT,318,7,4,0,11,15,6,0,21,15,9,0,24,21,10,0,31,21,10,0,31
36140,145,"CAMIN CULTURAL ALBESTI",ALBEŞTI,BT,930,13,0,0,13,21,0,0,21,35,2,0,37,42,3,0,45,48,3,0,51
36140,146,"SCOALA PRIMARA NR.1 ALBESTI",ALBEŞTI,BT,637,0,3,0,3,1,4,0,5,1,4,0,5,10,5,0,15,12,6,0,18
36159,147,"SCOALA PRIMARA NR.2 BUIMACENI",BUIMĂCENI,BT,596,9,2,0,11,12,5,0,17,12,5,0,17,12,5,0,17,15,5,0,20
36168,148,"SCOALA PRIMARA NR.3 COSTIUGENI",COŞTIUGENI,BT,446,0,0,0,0,2,0,0,2,5,0,0,5,7,2,0,9,13,2,0,15
36177,149,"SCOALA PRIMARA NR.4 JIJIA",JIJIA,BT,503,3,0,0,3,6,0,0,6,11,1,0,12,13,1,0,14,13,1,0,14
36186,150,"SCOALA PRIMARA NR.5 MASCATENI",MĂŞCĂTENI,BT,304,4,2,0,6,8,2,0,10,14,4,0,18,18,4,0,22,21,4,0,25
36195,151,"SCOALAGIMNAZIALANR.2 TUDOR VLADIMIRESCU","TUDOR VLADIMIRESCU",BT,688,8,0,0,8,12,9,0,21,31,10,0,41,56,13,0,69,61,13,0,74
36195,152,"SCOALAGIMNAZIALA NR.2 TUDOR VLADIMIRESCU","TUDOR VLADIMIRESCU",BT,709,14,2,0,16,18,9,0,27,41,9,0,50,61,10,0,71,72,12,0,84
36211,153,"SCOALA CU CLASELE 1 -8 AVRAMENI",AVRĂMENI,BT,1148,5,0,0,5,10,0,0,10,17,0,0,17,18,2,0,20,18,2,0,20
36266,154,"SCOALA PRIMARĂ NR.1 TIMUȘ SAT TIMUȘ",PANAITOAIA,BT,561,9,0,0,9,22,1,0,23,30,1,0,31,33,2,0,35,33,2,0,35
36284,155,"SCOALA CU CLASELE 1-8 TUDOR VLADIMIRESCU","TUDOR VLADIMIRESCU",BT,578,8,2,0,10,23,3,0,26,40,4,0,44,51,6,0,57,53,6,0,59
36239,156,"SCOALA CU CLASELE 1-8 AUREL VLAICU","AUREL VLAICU",BT,468,4,2,0,6,7,2,0,9,8,2,0,10,15,2,0,17,15,3,0,18
36257,157,"SCOALA CU CLASELE 1-4 ICHIMENI",ICHIMENI,BT,106,3,4,0,7,12,5,0,17,15,5,0,20,17,5,0,22,17,5,0,22
36319,158,"SCOALA BALUSENI",BĂLUŞENI,BT,1128,7,2,0,9,25,5,0,30,41,5,0,46,53,10,0,63,55,11,0,66
36328,159,"SCOALA BALUSENII NOI","BĂLUŞENII NOI",BT,262,4,0,0,4,26,1,0,27,29,5,0,34,32,5,0,37,32,5,0,37
36337,160,"SCOALA BUZENI",BUZENI,BT,542,7,2,0,9,15,3,0,18,19,4,0,23,30,5,0,35,33,5,0,38
36355,161,"SCOALA DRAXINI",DRAXINI,BT,1526,17,9,0,26,37,13,0,50,46,15,0,61,57,18,0,75,61,19,0,80
36364,162,"SCOALA ZAICESTI",ZĂICEŞTI,BT,570,3,0,0,3,30,4,0,34,37,4,0,41,43,10,0,53,44,10,0,54
39079,163,"SCOALA GIMNAZIALA NR. 1",BLÂNDEŞTI,BT,622,9,3,0,12,22,3,0,25,25,3,0,28,29,3,0,32,30,3,0,33
39088,164,"SCOALA PRIMARA NR.2 CERCHEJENI",CERCHEJENI,BT,646,29,1,0,30,48,3,0,51,63,7,0,70,70,8,0,78,71,8,0,79
39113,165,"SCOLA PRIMARA NR. 3",ŞOLDĂNEŞTI,BT,333,10,0,0,10,14,0,0,14,17,2,0,19,17,3,0,20,20,3,0,23
36382,166,"CĂMIN CULTURAL BRĂEŞTI",BRĂEŞTI,BT,1139,8,4,0,12,25,8,0,33,38,12,0,50,53,13,0,66,56,13,0,69
36391,167,"SCOALA POIANA 2",POIANA,BT,354,6,0,0,6,9,1,0,10,11,2,0,13,14,3,0,17,16,3,0,19
36408,168,"ŞCOALA POPENI",POPENI,BT,208,3,1,0,4,13,1,0,14,20,3,0,23,21,3,0,24,23,3,0,26
36435,169,"SCOALA DIMITRIE POMPEIU BROSCAUTI",BROSCĂUŢI,BT,1484,14,2,0,16,38,2,0,40,53,4,0,57,69,5,0,74,71,5,0,76
36435,170,"CĂMINUL CULTURAL BROSCĂUȚI",BROSCĂUŢI,BT,1337,8,1,0,9,19,2,0,21,26,5,0,31,35,6,0,41,37,6,0,43
36505,171,"CAMIN CULTURAL CALARASI",CĂLĂRAŞI,BT,937,1,0,0,1,2,0,0,2,5,1,0,6,15,8,0,23,19,10,0,29
36505,172,"SCOALA CALARASI",CĂLĂRAŞI,BT,929,6,3,0,9,12,3,0,15,14,3,0,17,15,3,0,18,19,3,0,22
36523,173,"SCOALA PLESANI",PLEŞANI,BT,497,6,0,0,6,6,0,0,6,7,0,0,7,10,0,0,10,10,0,0,10
36514,174,"SCOALA LIBERTATEA",LIBERTATEA,BT,371,5,0,0,5,6,0,0,6,8,0,0,8,10,2,0,12,13,2,0,15
38198,175,"GRĂDINIȚA CU PROGRAM NORMAL, CÂNDEȘTI",CÂNDEŞTI,BT,853,6,2,0,8,17,9,0,26,39,11,0,50,52,11,5,68,52,11,5,68
38223,176,"ŞCOALA PRIMARĂ TALPA",TALPA,BT,549,26,3,0,29,42,6,0,48,50,6,0,56,59,9,0,68,59,9,0,68
38232,177,"ŞCOLA PRIMARĂ VIŢCANI",VIŢCANI,BT,271,2,1,0,3,4,2,0,6,16,3,0,19,21,8,0,29,23,8,0,31
36541,178,"CĂMINUL CULTURAL CONCEȘTI",CONCEŞTI,BT,1223,32,0,0,32,56,3,0,59,67,3,0,70,80,7,0,87,109,9,0,118
36550,179,"CAMINUL CULTURAL MOVILENI",MOVILENI,BT,262,13,2,0,15,17,2,0,19,24,6,0,30,24,8,0,32,24,8,0,32
36578,180,"ŞCOALA GIMNAZIALĂ NR.1 COPĂLĂU",COPĂLĂU,BT,1146,9,1,0,10,25,5,0,30,31,5,0,36,44,5,16,65,48,6,17,71
36578,181,"ŞCOALA GIMNAZIALĂ NR. 1 COPĂLĂU",COPĂLĂU,BT,1084,9,0,0,9,15,0,0,15,33,0,0,33,43,0,17,60,45,0,17,62
36612,182,"ŞCOALA PRIMARĂ NR. 2 COTU",COTU,BT,496,1,0,0,1,4,1,0,5,7,1,0,8,11,1,7,19,11,1,7,19
36596,183,"ŞCOALA PRIMARĂ NR.3 CERBU",CERBU,BT,645,10,2,0,12,22,3,0,25,26,3,0,29,37,5,0,42,37,5,0,42
36658,184,"CAMINUL CULTURAL CORDARENI",CORDĂRENI,BT,767,11,1,0,12,37,5,0,42,49,11,0,60,63,13,0,76,70,13,0,83
36667,185,"SCOALA GRIVITA",GRIVIŢA,BT,389,5,5,0,10,5,8,0,13,9,11,0,20,12,11,0,23,18,11,0,29
40001,186,"SCOALA SLOBOZIA",SLOBOZIA,BT,278,10,1,0,11,37,2,0,39,66,5,0,71,68,7,0,75,73,7,0,80
36685,187,"PRIMARIA CORLATENI",CORLĂTENI,BT,519,6,1,0,7,12,3,0,15,18,3,0,21,27,5,0,32,31,6,0,37
36694,188,"GRADINITA CARASA",CARASA,BT,443,7,1,0,8,30,3,0,33,47,4,0,51,51,4,0,55,51,4,0,55
36747,189,"SCOALA VLADENI",VLĂDENI,BT,364,4,2,0,6,12,5,0,17,17,5,0,22,18,5,0,23,18,6,0,24
36729,190,"SCOALA PODENI",PODENI,BT,331,3,2,0,5,9,3,0,12,11,3,0,14,17,3,0,20,19,3,0,22
36765,191,"SCOALA O. BANCILA",CORNI,BT,1328,23,2,0,25,30,2,0,32,38,4,0,42,43,4,0,47,44,4,0,48
36765,192,"SCOALA O. BANCILA",CORNI,BT,872,8,3,0,11,10,3,0,13,20,3,0,23,23,3,0,26,23,3,0,26
36765,193,"SCOALA O. BANCILA",CORNI,BT,1069,21,0,0,21,29,1,0,30,34,1,0,35,37,1,0,38,38,1,0,39
36792,194,"SCOALA CU CL I-VIII SARAFINESTI",SARAFINEŞTI,BT,1189,17,1,0,18,30,3,0,33,35,4,0,39,49,5,0,54,51,5,0,56
36783,195,"SCOALA CU CL I-IV MESTEACAN",MESTEACĂN,BT,350,9,1,0,10,10,1,0,11,17,2,0,19,26,7,0,33,30,7,0,37
36774,196,"SCOALA CU CL I-IV BALTA ARSA","BALTA ARSĂ",BT,335,2,3,0,5,15,5,0,20,18,5,0,23,25,10,0,35,32,12,0,44
36603,197,"GRĂDINIȚA *PRICHINDEL* COȘULA",COŞULA,BT,985,6,0,0,6,14,1,0,15,22,1,0,23,23,4,0,27,24,4,0,28
36587,198,"ȘCOALA CU CLASELE I-IV BUDA",BUDA,BT,247,0,3,0,3,0,3,0,3,7,4,0,11,9,4,0,13,11,4,0,15
36621,199,"ȘCOALA CU CLASELE I-IV PĂDURENI",PĂDURENI,BT,484,2,0,0,2,5,0,0,5,14,0,0,14,18,0,0,18,20,0,0,20
36630,200,"ȘCOALA CU CLASELE I-IV ȘUPITCA",ŞUPITCA,BT,660,5,2,0,7,17,2,0,19,27,2,0,29,41,2,0,43,47,2,0,49
36818,201,"LICEUL TEHNOLOGIC, CORP B",COŢUŞCA,BT,1498,13,0,0,13,24,1,0,25,28,2,0,30,34,3,0,37,35,3,0,38
36854,202,"ŞCOALA GIMNAZIALĂ NR.2",GHIRENI,BT,507,4,0,0,4,10,0,0,10,11,2,0,13,13,7,0,20,13,7,0,20
36836,203,"ŞCOALA PRIMARĂ NR.4","COTU MICULINŢI",BT,320,2,0,0,2,7,0,0,7,8,5,0,13,13,6,0,19,16,9,0,25
36845,204,"ŞCOALA GIMNAZIALĂ NR.1",CRASNALEUCA,BT,476,3,4,0,7,10,5,0,15,12,5,0,17,19,9,0,28,23,10,0,33
36890,205,"ŞCOALA PRIMARĂ NR.5",PUŢURENI,BT,449,2,1,0,3,7,1,0,8,16,3,0,19,19,4,0,23,19,4,0,23
36872,206,"ŞCOALA GIMNAZIALĂ NR.3",NICHITENI,BT,708,11,0,0,11,16,1,0,17,23,2,0,25,33,2,0,35,37,3,0,40
36916,207,"SCOALAGIMNAZIALANR. 1 CRISTESTICORPUL II",CRISTEŞTI,BT,1428,11,0,0,11,20,3,0,23,25,9,0,34,36,10,0,46,40,12,0,52
36916,208,"SCOALA PRIMARA NR. 1 SAT CRISTESTI, DENUMIRE UZUALA SCOALA DIN GHILANESTI",CRISTEŞTI,BT,472,4,3,0,7,12,6,0,18,12,6,0,18,14,6,0,20,14,6,0,20
36925,209,"SCOALA GIMNAZIALA NR. 2 SATONEAGA",ONEAGA,BT,1155,7,2,0,9,15,3,0,18,23,3,0,26,28,3,0,31,33,4,0,37
36934,210,"SCOALA PRIMARA NR. 3 SAT SCHIT - ORASENI",SCHIT-ORĂŞENI,BT,467,4,1,0,5,6,1,0,7,8,1,0,9,10,2,0,12,11,2,0,13
36935,211,"SCOALAPRIMARANR. 4 UNGUROAIA",UNGUROAIA,BT,151,9,4,0,13,36,7,0,43,62,7,0,69,77,8,0,85,77,8,0,85
36961,212,"CAMINUL CULTURAL CRISTINESTI",CRISTINEŞTI,BT,1221,9,3,0,12,18,4,0,22,29,8,0,37,39,8,0,47,43,8,0,51
36989,213,"SCOALA DRAGALINA",DRAGALINA,BT,524,2,0,0,2,3,0,0,3,7,1,0,8,13,1,0,14,15,1,0,16
36998,214,"SCOALA FUNDU HERTII","FUNDU HERŢII",BT,611,6,1,0,7,11,1,0,12,21,2,0,23,32,6,0,38,37,6,0,43
36970,215,"SCOALA BARANCA",BARANCA,BT,495,0,3,0,3,7,5,0,12,7,8,0,15,7,8,0,15,14,8,0,22
35768,216,"GRADINITA CURTESTI",CURTEŞTI,BT,1027,6,1,0,7,18,4,0,22,27,9,0,36,41,10,0,51,49,11,0,60
35777,217,"SPATIU SCOALA AGAFTON",AGAFTON,BT,219,5,5,0,10,24,7,0,31,28,7,0,35,34,27,0,61,34,30,0,64
35786,218,"SCOALA GENERALA.BAICENI",BĂICENI,BT,743,5,0,0,5,14,1,0,15,24,1,0,25,37,1,0,38,38,2,0,40
35802,219,"SCOALA GENERALAMANASTIREA DOAMNEI","MĂNĂSTIREA DOAMNEI",BT,976,9,3,0,12,19,4,0,23,27,4,0,31,43,6,0,49,49,10,0,59
35811,220,"SCOALA GENERAL ORASENI DEAL",ORĂŞENI-DEAL,BT,954,9,2,0,11,17,2,0,19,28,4,0,32,33,4,0,37,35,5,0,40
35820,221,"SCOALA GENERALA ORASENI VALE",ORĂŞENI-VALE,BT,552,5,1,0,6,14,3,0,17,20,6,0,26,23,6,0,29,30,6,0,36
37020,222,"CAMIN CULTURAL",DERSCA,BT,1371,13,0,0,13,22,1,0,23,27,1,0,28,43,2,0,45,49,3,0,52
37020,223,"SCOALA GENERALĂ DERSCA",DERSCA,BT,1147,4,0,0,4,20,1,0,21,33,4,0,37,40,8,0,48,43,8,0,51
36710,224,"CAMIN CULTURAL",MATEIENI,BT,194,0,0,0,0,4,0,0,4,9,4,0,13,12,5,0,17,12,5,0,17
36701,225,PRIMARIA,DIMĂCHENI,BT,827,14,4,0,18,26,10,0,36,30,12,0,42,37,12,0,49,41,13,0,54
37066,226,"CĂMINUL CULTURAL DÎNGENI",DÎNGENI,BT,602,6,2,0,8,11,2,0,13,20,2,0,22,23,2,3,28,24,3,3,30
37075,227,"CĂMINUL CULTURAL HULUB",HULUB,BT,438,4,1,0,5,8,3,0,11,16,3,0,19,23,3,0,26,25,5,0,30
37084,228,"SCOALA GIMNAZIALANR.2 IACOBENI",IACOBENI,BT,830,12,2,0,14,22,5,0,27,30,6,0,36,33,6,0,39,35,6,0,41
37093,229,"SCOALA PRIMARA NR.2 STRAHOTIN",STRAHOTIN,BT,420,5,3,0,8,8,5,0,13,9,5,0,14,14,7,0,21,16,7,0,23
37119,230,"ȘCOALA DOBIRCENI",DOBÂRCENI,BT,667,4,3,0,7,5,3,0,8,11,4,0,15,11,6,0,17,12,6,0,18
37128,231,"SCOALA BIVOLARI",BIVOLARI,BT,141,7,3,0,10,9,3,0,12,10,3,0,13,11,4,0,15,11,4,0,15
37164,232,ȘCOALABRATENI,BRĂTENI,BT,518,4,0,0,4,8,1,0,9,14,1,0,15,24,2,0,26,26,2,0,28
37137,233,"SCOALA CISMANESTI",CIŞMĂNEŞTI,BT,325,7,0,0,7,26,4,0,30,56,7,0,63,64,8,0,72,64,8,0,72
37146,234,"SCOALA MURGUTA",LIVADA,BT,383,8,0,0,8,9,1,0,10,16,3,0,19,16,3,0,19,17,3,0,20
37182,235,"SCOALA GIMNAZIALA ARISTOTEL CRISMARU DRAGUSENI",DRĂGUŞENI,BT,1270,8,3,0,11,12,3,0,15,23,3,0,26,31,3,0,34,31,3,0,34
37191,236,"SCOALA CU CLASELE I-IV PODRIGA",PODRIGA,BT,769,11,2,0,13,20,2,0,22,20,2,0,22,21,6,0,27,24,6,0,30
37208,237,"SCOALA CU CLASELE I-IV SARATA",SARATA-DRĂGUŞENI,BT,104,2,6,0,8,2,6,0,8,6,6,0,12,9,6,0,15,11,6,0,17
37226,238,"CĂMINUL CULTURAL DIN SATUL DURNEȘTI",DURNEŞTI,BT,938,3,2,0,5,21,3,0,24,24,3,0,27,35,3,0,38,35,3,0,38
37262,239,"ȘCOALA PRIMARĂ NR. 1 CUCUTENI",CUCUTENI,BT,673,5,0,0,5,32,2,0,34,53,7,0,60,60,7,0,67,61,7,0,68
37271,240,"ȘCOALA GIMNAZIALĂ NR. 2 GURANDA",GURANDA,BT,892,8,0,0,8,20,5,0,25,32,10,0,42,41,11,0,52,43,12,0,55
37235,241,"GRĂDINIȚA CU PROGRAM NORMAL NR. 3 BĂBICENI",BĂBICENI,BT,584,2,1,0,3,6,3,0,9,9,3,0,12,22,3,0,25,26,3,0,29
37333,242,"SCOALA GIMNAZIALA NR. 2 FRUMUSICA",FRUMUŞICA,BT,646,10,1,0,11,32,1,0,33,37,2,0,39,42,2,0,44,46,2,0,48
37360,243,"SCOALA GIMNAZIALA NR.4 STORESTI",STOREŞTI,BT,849,10,0,0,10,19,0,0,19,31,0,0,31,42,0,0,42,45,0,0,45
37379,244,"SCOALA GIMNAZIALA NR.5 SENDRENI",ŞENDRENI,BT,564,4,2,0,6,10,3,0,13,15,3,0,18,23,3,0,26,23,7,0,30
37388,245,"SCOALA GIMNAZIALA NR.1 VLADENI DEAL",VLĂDENI-DEAL,BT,1271,12,0,0,12,20,0,0,20,27,1,0,28,32,4,0,36,34,4,0,38
37342,246,"SCOALA GIMNAZIALA NR.6 BOSCOTENI",BOSCOTENI,BT,526,6,2,0,8,19,5,0,24,20,5,0,25,22,5,0,27,23,5,0,28
37351,247,"SCOALA GIMNAZIALA NR.3RADENI",RĂDENI,BT,782,27,0,0,27,53,3,0,56,76,3,0,79,80,3,0,83,85,3,0,88
37404,248,"SEDIUL PRIMARIEI COMUNEI GEORGE ENESCU",DUMENI,BT,560,6,1,0,7,11,1,0,12,12,1,0,13,15,3,0,18,17,3,0,20
37404,249,"SCOALA GENERALA NR.2 DUMENI",DUMENI,BT,876,3,0,0,3,27,0,0,27,28,0,0,28,34,0,0,34,34,0,0,34
37413,250,"SCOALA GENERALA ARBOREA",ARBOREA,BT,345,4,2,0,6,13,4,0,17,14,6,0,20,21,7,0,28,27,7,0,34
37431,251,"SCOALA GENERALA POPENI",POPENI,BT,410,2,0,0,2,9,0,0,9,14,1,0,15,21,5,0,26,23,7,0,30
37440,252,"SCOALA GENERALA STINCA",STÎNCA,BT,294,7,1,0,8,21,1,0,22,24,1,0,25,30,3,0,33,32,3,0,35
37468,253,SCOALAGORBANESTI,GORBĂNEŞTI,BT,818,12,0,0,12,22,1,0,23,27,1,1,29,33,3,1,37,36,3,1,40
37477,254,"ŞCOALAGENERALA BATRANESTI",BĂTRÎNEŞTI,BT,215,0,3,0,3,2,3,0,5,3,4,0,7,5,5,0,10,5,5,0,10
37486,255,"ŞCOALA GENERALĂGEORGECOSBUC","GEORGE COŞBUC",BT,192,7,3,0,10,11,3,0,14,14,4,0,18,15,4,0,19,15,4,0,19
37510,256,"SCOALA GENERALA SOCRUJENI",SOCRUJENI,BT,627,11,2,0,13,15,3,0,18,17,3,0,20,18,3,0,21,22,3,0,25
37538,257,"CAMIN CULTURAL VANATORI",VÎNĂTORI,BT,485,8,0,0,8,9,0,0,9,16,3,0,19,28,4,0,32,28,4,0,32
37501,258,"SCOALA GENERALASILISCANI",SILIŞCANI,BT,273,9,4,0,13,9,6,0,15,12,6,0,18,16,9,0,25,16,9,0,25
37556,259,"SCOALAGIMNAZIALA,, IOAN CERNAT,, HAVIRNA -CORPUL 3 DE LANGA GRADINITA",HAVÎRNA,BT,919,6,0,0,6,12,0,0,12,32,1,0,33,60,4,0,64,63,4,0,67
37556,260,"GRADINITACU PROGRAMNORMAL NR.2HAVIRNA(CATUN BASEU)",HAVÎRNA,BT,682,4,1,0,5,9,2,0,11,11,2,0,13,13,2,0,15,17,2,0,19
37556,261,"SCOALAGIMNAZIALA,, IOAN CERNAT,, HAVIRNA -CORPUL NR.2",HAVÎRNA,BT,1035,2,2,0,4,6,3,0,9,8,4,0,12,10,4,0,14,15,5,0,20
37565,262,"SCOALA PRIMARA ,,DUMITRUPOMPAS"" BALINTI",BALINŢI,BT,405,1,0,0,1,6,2,0,8,11,2,0,13,11,2,0,13,13,2,0,15
37609,263,"SCOALAGIMNAZIALA ,, IANCUMUNTEANU"" TATARASENI",TĂTĂRĂŞENI,BT,642,6,0,0,6,11,0,0,11,24,4,0,28,26,4,0,30,27,4,0,31
37627,264,"CAMIN CULTURAL HANESTI",HĂNEŞTI,BT,1018,14,0,0,14,28,2,0,30,39,2,0,41,44,3,0,47,51,3,0,54
37654,265,"ȘCOALA CU CLASELEI-IV SĂRATA BASARAB",SARATA-BASARAB,BT,330,7,0,0,7,9,0,0,9,12,0,0,12,12,0,0,12,13,1,0,14
37636,266,"SCOALA CUCL I-IV BOROLEA",BOROLEA,BT,302,1,0,0,1,11,2,0,13,15,2,0,17,23,3,0,26,33,3,0,36
37681,267,"SCOALA GIMNAZIALA NR. 1 HILISEU HORIA",HILIŞEU-HORIA,BT,595,4,4,0,8,6,5,0,11,13,7,0,20,18,8,0,26,18,9,0,27
37716,268,"SCOALA GIMNAZIALA NR. 2 HILISEU CRISAN",HILIŞEU-CRIŞAN,BT,1095,6,1,0,7,8,1,0,9,11,1,0,12,16,1,0,17,24,1,0,25
37707,269,"SCOALA PRIMARA NR. 4 HILISEU CLOSCA",HILIŞEU-CLOŞCA,BT,520,4,4,0,8,5,5,0,10,9,5,0,14,19,6,0,25,20,7,0,27
37717,270,"SCOALA GIMNAZIALA NR. 3 IEZER",IEZER,BT,473,4,3,0,7,12,4,0,16,17,4,0,21,20,8,0,28,22,8,0,30
37743,271,"SCOALA CU CL.I-VIII HLIPICENI",HLIPICENI,BT,1354,6,1,0,7,29,4,0,33,48,5,0,53,63,6,0,69,72,9,0,81
37752,272,"SCOALA CU CL .I-IV DRAGALINA",DRAGALINA,BT,301,4,6,0,10,10,8,0,18,13,10,0,23,16,10,0,26,19,11,0,30
37761,273,"SCOALA CU CL.I-VIII VICTORIA",VICTORIA,BT,1111,4,0,0,4,14,0,0,14,17,0,0,17,23,0,0,23,23,0,0,23
37789,274,"CĂMIN CULTURAL",HUDEŞTI,BT,926,4,1,0,5,11,3,0,14,20,3,0,23,27,3,0,30,29,3,0,32
40027,275,"CĂMIN CULTURAL",VATRA,BT,897,9,4,0,13,24,6,0,30,26,7,0,33,31,7,0,38,31,9,0,40
37798,276,GRĂDINIȚA,ALBA,BT,1155,3,0,0,3,30,2,0,32,37,5,0,42,46,5,0,51,46,5,0,51
37814,277,"ȘCOALA MLENĂUȚI",MLENĂUŢI,BT,602,9,1,0,10,10,1,0,11,33,5,0,38,49,6,0,55,54,8,0,62
40019,278,"ȘCOALĂ BAȘEU",BAŞEU,BT,401,3,5,0,8,11,8,0,19,18,9,0,27,23,9,0,32,24,11,0,35
37805,279,"ȘCOALA BARANCA",BARANCA,BT,846,2,0,0,2,6,0,0,6,9,3,0,12,20,5,0,25,22,5,0,27
37841,280,"SCOALA ""MIHAIL SADOVEANU"", CORP B",DUMBRĂVIŢA,BT,719,11,2,0,13,26,6,0,32,44,7,0,51,62,8,0,70,67,9,0,76
37841,281,"SCOALA ""MIHAIL SADOVEANU"", CORP B",DUMBRĂVIŢA,BT,716,10,0,0,10,30,2,0,32,47,3,0,50,51,4,0,55,56,6,0,62
37832,282,"GRADINITA CU 4 GRUPE IBANESTI",IBĂNEŞTI,BT,802,9,3,0,12,24,3,0,27,35,4,0,39,43,4,0,47,49,5,0,54
37832,283,"GRADINITA CU 4 GRUPE IBANESTI",IBĂNEŞTI,BT,893,15,3,0,18,40,6,0,46,60,8,0,68,83,8,0,91,85,10,0,95
37869,284,"SCOALA GENERALA NR. 1 LEORDA",LEORDA,BT,1144,7,4,0,11,14,14,0,28,23,17,0,40,27,17,0,44,33,18,0,51
37887,285,"SCOALA GENERALA CU CLASELE I-IV COSTINESTI",COSTINEŞTI,BT,171,4,5,0,9,11,6,0,17,13,6,0,19,15,6,0,21,15,6,0,21
37897,286,"SCOALA PRIMARA MITOC",MITOC,BT,793,10,0,0,10,14,6,0,20,24,8,0,32,28,13,0,41,29,13,0,42
37039,287,"CAMIN CULTURAL",LOZNA,BT,824,7,3,0,10,13,4,0,17,16,7,0,23,23,7,0,30,24,10,0,34
37048,288,"CAMIN CULTURAL",STRĂTENI,BT,712,4,3,0,7,12,3,0,15,19,5,0,24,32,5,0,37,37,5,0,42
37921,289,"CAMINUL CULTURAL LUNCA",LUNCA,BT,682,3,4,0,7,3,5,0,8,9,5,0,14,18,7,0,25,18,7,0,25
37921,290,"CAMINUL CULTURAL BIZNOASA",LUNCA,BT,594,11,1,0,12,18,4,0,22,32,5,0,37,44,12,0,56,49,12,0,61
37930,291,"CAMINUL CULTURAL STROIESTI",STROIEŞTI,BT,691,7,2,0,9,16,3,0,19,21,6,0,27,23,7,0,30,23,8,0,31
37949,292,"SCOALA GENERALA ZLATUNOAIA",ZLĂTUNOAIA,BT,1322,9,1,0,10,16,1,0,17,18,1,0,19,37,1,23,61,37,2,23,62
37949,293,"SCOALA GENERALA STANESTI",ZLĂTUNOAIA,BT,128,0,2,0,2,3,5,0,8,4,5,0,9,4,8,0,12,5,8,0,13
37967,294,"SCOALA MANOLEASA",MANOLEASA,BT,487,3,4,0,7,6,4,0,10,8,4,0,12,8,4,0,12,9,4,0,13
37985,295,"SCOALA FLONDORA",FLONDORA,BT,433,3,2,0,5,10,2,0,12,20,2,0,22,28,2,0,30,33,3,0,36
38036,296,"SCOALA SADOVENI",SADOVENI,BT,368,4,1,0,5,6,3,0,9,10,4,0,14,16,5,0,21,22,6,0,28
38054,297,"SCOALA ZAHORENI",ZAHORENI,BT,449,8,3,0,11,11,5,0,16,11,5,0,16,13,6,0,19,17,9,0,26
38009,298,"SCOALA LIVENI",LIVENI,BT,540,5,0,0,5,7,0,0,7,9,8,0,17,11,9,0,20,11,9,0,20
38018,299,"SCOALA LOTURI",LOTURI,BT,139,1,7,0,8,3,7,0,10,7,7,0,14,9,7,0,16,9,7,0,16
38027,300,"FOSTA SCOALA MANOLEASA PRUT",MANOLEASA-PRUT,BT,122,2,0,0,2,5,0,0,5,7,0,0,7,7,0,0,7,7,1,0,8
38072,301,"SCOALA IPOTEȘTI",IPOTEŞTI,BT,503,8,1,0,9,8,3,0,11,9,4,0,13,9,4,0,13,9,4,0,13
38134,302,"SCOALA CUCORĂNI",CUCORĂNI,BT,674,3,2,0,5,10,2,0,12,17,3,0,20,22,5,0,27,22,5,0,27
38116,303,"SCOALA CERVICEȘTI",CERVICEŞTI,BT,714,17,4,0,21,34,5,0,39,49,10,11,70,64,12,11,87,67,12,11,90
38107,304,"SCOALA CĂTĂMĂREȘTI DEAL",CĂTĂMĂREŞTI-DEAL,BT,1409,17,0,0,17,37,2,0,39,50,8,0,58,79,10,6,95,85,13,6,104
38107,305,"SCOALA CĂTĂMĂREȘTI DEAL",CĂTĂMĂREŞTI-DEAL,BT,1394,11,1,0,12,37,2,0,39,67,3,0,70,112,6,5,123,114,6,5,125
38152,306,"ȘCOALA STÎNCEȘTI",STÎNCEŞTI,BT,1351,8,1,0,9,26,1,0,27,41,2,0,43,58,2,0,60,74,3,0,77
38090,307,"ȘCOALA CĂTĂMĂREȘTI",CĂTĂMĂREŞTI,BT,514,6,1,0,7,16,4,0,20,18,5,0,23,22,5,0,27,26,5,0,31
38170,308,"SCOALA CL I-IV MIHAILENI",MIHĂILENI,BT,1215,3,2,0,5,19,3,0,22,26,5,0,31,29,6,0,35,32,6,0,38
38214,309,"ŞCOALA GENERALĂ ROGOJESTI",ROGOJEŞTI,BT,448,5,3,0,8,10,7,0,17,15,7,0,22,20,7,0,27,23,7,0,30
38205,310,"ŞCOALAGENERALĂ PARAU NEGRU","PÂRÂU NEGRU",BT,411,2,4,0,6,20,9,0,29,26,10,0,36,35,10,0,45,40,12,0,52
38250,311,"SCOALA MIHALASENI",MIHĂLĂŞENI,BT,624,4,2,0,6,11,3,0,14,13,3,0,16,16,3,0,19,18,3,0,21
38303,312,"SCOALA SARATA",SARATA,BT,403,12,1,0,13,18,1,0,19,18,1,0,19,20,1,0,21,20,1,0,21
38287,313,"SCOALA NEGRESTI",NEGREŞTI,BT,381,0,1,0,1,6,4,0,10,8,6,0,14,9,6,0,15,10,6,0,16
38278,314,"SCOALA NASTASE",NĂSTASE,BT,339,7,0,0,7,8,0,0,8,8,7,0,15,8,9,0,17,11,11,0,22
38330,315,"SCOALA GIMNAZIALA NR.1 MILEANCA, CORP B, PARTER",MILEANCA,BT,1293,5,0,0,5,21,1,0,22,33,1,0,34,39,4,0,43,45,4,0,49
38349,316,"SCOALA GIMNAZIALA NR.2 CODRENI",CODRENI,BT,271,0,0,0,0,1,0,0,1,2,0,0,2,3,4,0,7,4,4,0,8
38358,317,"SCOALA CU CLASELE I-IV SCUTARI",SCUTARI,BT,230,0,2,0,2,1,2,0,3,2,2,0,4,4,6,0,10,4,8,0,12
38367,318,"SCOALA CU CLASELE I-IVSELIŞTEA",SELIŞTEA,BT,319,0,0,0,0,4,0,0,4,4,2,0,6,4,6,0,10,7,6,0,13
38385,319,"ŞCOALA GIMNAZIALĂ ""FLORICĂ MURARIU"" MITOC",MITOC,BT,964,3,1,0,4,12,1,0,13,14,7,0,21,18,8,0,26,20,8,0,28
38394,320,"ŞCOALA PRIMARĂ NR. 1 HORIA",HORIA,BT,400,2,0,0,2,4,1,0,5,4,2,0,6,5,2,0,7,6,2,0,8
38465,321,"CAMIN CULTURAL NICŞENI",NICŞENI,BT,760,3,2,0,5,8,2,0,10,11,2,0,13,20,5,0,25,20,7,0,27
38483,322,"CAMIN CULTURAL DOROBANŢI",DOROBANŢI,BT,1251,7,1,0,8,11,1,0,12,17,1,0,18,26,2,0,28,32,2,0,34
38474,323,"ŞCOALA DACIA",DACIA,BT,125,0,0,0,0,3,7,0,10,3,7,0,10,13,8,0,21,13,8,0,21
38508,324,"CAMIN CULTURAL PALTINIS",PĂLTINIŞ,BT,1044,7,1,0,8,19,2,0,21,24,6,0,30,32,10,0,42,35,10,0,45
38508,325,"ȘCOALA GRIVIȚA",PĂLTINIŞ,BT,366,3,1,0,4,5,1,0,6,9,3,0,12,11,4,0,15,11,4,0,15
38508,326,"CĂMIN CULTURAL IVANCĂUȚI",PĂLTINIŞ,BT,532,1,1,0,2,5,4,0,9,6,6,0,12,8,7,0,15,12,8,0,20
38517,327,"ȘCOALA CUZLĂU",CUZLĂU,BT,357,1,2,0,3,1,4,0,5,7,4,0,11,15,4,0,19,17,4,0,21
38526,328,"ȘCOALA CU CL I-VIII HORODIȘTEA",HORODIŞTEA,BT,593,8,0,0,8,12,0,0,12,13,5,0,18,22,9,0,31,27,17,0,44
38553,329,"LICEUL TEORETIC ANASTASIE BAŞOTĂ",POMÎRLA,BT,973,4,0,0,4,15,0,0,15,18,0,0,18,20,1,0,21,21,1,0,22
38553,330,"SCOALA PRIMARA NR. 1POMÎRLA",POMÎRLA,BT,872,4,1,0,5,13,1,0,14,23,1,0,24,30,5,0,35,31,5,0,36
38571,331,"SOALA PRIMARA NR. 2 RACOVĂŢ",RACOVĂŢ,BT,278,1,1,0,2,14,5,0,19,15,5,0,20,21,5,0,26,22,6,0,28
38599,332,"ŞCOALA CU CLASELE I-IV SALA I",PRĂJENI,BT,998,22,2,0,24,25,4,0,29,30,4,0,34,41,5,0,46,41,5,0,46
38606,333,"ŞCOALA CU CLASELE I-IV",CÎMPENI,BT,507,4,0,0,4,10,0,0,10,19,2,0,21,20,3,0,23,22,3,0,25
38615,334,"CENTRUL DE ASISTENŢĂ COPII DUPĂ PROGRAMUL ŞCOLAR, SATUL LUPĂRIA, COMUNA PRĂJENI",LUPĂRIA,BT,589,6,0,0,6,14,1,0,15,22,2,0,24,28,2,0,30,30,2,0,32
38624,335,"ŞCOALA GIMNAZIALA NR.2MILETIN",MILETIN,BT,468,8,2,0,10,9,4,0,13,12,4,0,16,20,4,0,24,20,4,0,24
35848,336,"CĂMIN CULTURAL RĂCHIŢI",RĂCHIŢI,BT,1002,16,1,0,17,25,5,16,46,38,6,16,60,56,7,16,79,67,7,16,90
35866,337,"ŞCOALA GIMNAZIALĂ ""PETRE ŞUŞTER""",COSTEŞTI,BT,1258,2,0,0,2,5,1,0,6,9,1,0,10,17,2,0,19,26,6,0,32
35875,338,"CĂMIN CULTURAL ROŞIORI",ROŞIORI,BT,1190,11,0,0,11,35,0,0,35,49,1,0,50,59,1,0,60,63,2,0,65
35876,339,"GRĂDINITA CU PROGRARM NORMAL NR.1 CISMEA",CIŞMEA,BT,478,8,0,0,8,22,0,0,22,37,0,0,37,45,1,0,46,45,1,0,46
38642,340,"CAMIN CULTURAL RADAUTI-PRUT",RĂDĂUŢI-PRUT,BT,767,11,4,0,15,16,5,0,21,18,6,0,24,18,6,0,24,26,7,0,33
38660,341,"CAMINUL CULTURAL SATREDIU",REDIU,BT,732,6,1,0,7,19,1,0,20,23,1,0,24,38,1,0,39,38,4,0,42
38651,342,"SALA DE SPORT A ȘCOLII NR. 1 MIORCANI",MIORCANI,BT,755,5,0,0,5,7,0,0,7,9,0,0,9,15,0,0,15,20,3,0,23
38651,343,"SALA DE SPORT A ȘCOLII NR. 1 MIORCANI",MIORCANI,BT,687,2,1,0,3,3,1,0,4,6,3,0,9,7,3,0,10,15,4,0,19
38688,344,"CAMIN CULTURAL RAUSENI",RĂUSENI,BT,1070,5,0,0,5,15,0,0,15,18,0,0,18,19,0,0,19,19,0,0,19
38697,345,"CENTRUL SOCIAL BISERICA DOINA",DOINA,BT,428,16,5,0,21,8,0,0,8,9,0,0,9,12,0,0,12,15,0,0,15
38713,346,"SCOALA GENERALA REDIU",REDIU,BT,430,5,1,0,6,16,2,0,18,26,3,0,29,26,4,0,30,32,6,0,38
38722,347,"SCOALA GENERALA STOLNICENI",STOLNICENI,BT,157,7,5,0,12,12,5,0,17,13,5,0,18,18,5,0,23,18,5,0,23
38740,348,CĂMINULCULTURAL,RIPICENI,BT,2282,4,0,0,4,9,1,0,10,10,2,0,12,11,2,0,13,11,3,0,14
38740,349,GRĂDINIŢADECOPII,RIPICENI,BT,1311,6,0,0,6,12,4,0,16,20,6,0,26,22,8,0,30,22,8,0,30
38820,350,"SCOALA NR. 1 ROMA",ROMA,BT,1424,21,2,0,23,37,3,0,40,45,4,0,49,59,6,0,65,64,6,0,70
38820,351,"SCOALA NR.2 ROMA",ROMA,BT,937,10,2,0,12,27,3,0,30,34,3,0,37,42,3,0,45,43,4,0,47
38839,352,"SCOALA NR. 4 COTIRGACI",COTÎRGACI,BT,614,5,0,0,5,7,0,0,7,11,1,0,12,15,2,0,17,15,4,0,19
38857,353,"CĂMINUL CULTURAL",ROMÂNEŞTI,BT,1129,8,3,0,11,26,5,0,31,27,5,0,32,29,5,0,34,31,5,0,36
38866,354,"SCOALA PRIMARĂ NR 1",DĂMIDENI,BT,482,5,9,0,14,5,9,0,14,8,9,0,17,12,9,0,21,13,9,0,22
38900,355,"CAMINUL CULTURAL SANTA MARE","SANTA MARE",BT,1000,7,0,0,7,11,1,0,12,16,1,0,17,20,1,0,21,20,1,0,21
38928,356,"SCOALA GENERALA BERZA",BERZA,BT,179,6,0,0,6,7,0,0,7,7,0,0,7,7,0,0,7,8,0,0,8
38937,357,"SCOALA GENERALA BOGDANESTI",BOGDĂNEŞTI,BT,309,4,2,0,6,6,2,0,8,7,2,0,9,7,2,0,9,7,3,0,10
38964,358,"SCOALA GENERALA RINGHILESTI",RÎNGHILEŞTI,BT,297,3,2,0,5,6,3,0,9,7,3,0,10,8,3,0,11,10,3,0,13
38955,359,"SCOALA GENERALA ILISENI",ILIŞENI,BT,324,10,0,0,10,12,1,0,13,13,1,0,14,17,1,0,18,19,1,0,20
35893,360,"CAMIN CULTURAL",STĂUCENI,BT,1104,7,1,0,8,11,2,0,13,15,2,0,17,16,2,0,18,19,3,0,22
35900,361,"SCOALA GENERALA CU CLASELE I-IV",SILIŞTEA,BT,414,3,1,0,4,5,1,0,6,12,1,0,13,27,2,0,29,32,4,0,36
35928,362,"SCOALA GENERALA CU CLASELE I-IV",VICTORIA,BT,521,9,3,0,12,17,3,0,20,22,3,0,25,27,4,0,31,30,4,0,34
35919,363,"SCOALA GENERALA CU CLASELE I-VIII PATRIARH TEOCTIST ARAPASU",TOCILENI,BT,896,5,1,0,6,13,2,0,15,22,3,0,25,28,4,0,32,30,6,0,36
38991,364,"SCOALA PRIMARA NR. 3 SUHARAU",SUHARĂU,BT,984,1,0,0,1,8,1,0,9,14,1,12,27,19,3,12,34,26,4,12,42
38991,365,"SCOALA GIMNAZIALA NR. 2 SUHARAU",SUHARĂU,BT,573,1,4,0,5,5,4,0,9,10,4,0,14,20,4,0,24,22,4,0,26
39015,366,"GRADINITA LISNA",LIŞNA,BT,725,5,0,0,5,7,0,0,7,17,1,0,18,21,2,0,23,25,3,0,28
39024,367,"SCOALA GENERALA NR. 4 OROFTIANA",OROFTIANA,BT,743,1,0,0,1,3,1,0,4,4,1,0,5,5,2,0,7,12,4,0,16
39042,368,"GRADINITA SMARDAN",SMÎRDAN,BT,633,1,1,0,2,9,1,0,10,13,1,0,14,21,2,0,23,23,2,0,25
39060,369,"SCOALA CU CL I-VIII SULITA",SULIŢA,BT,1326,5,1,0,6,10,1,0,11,23,4,0,27,37,7,0,44,40,8,0,48
39104,370,"SCOALA CU CL. I - VIII DRACSANI",DRACŞANI,BT,1170,15,1,0,16,20,1,0,21,24,1,0,25,29,3,0,32,29,5,0,34
39131,371,"ŞCOALA NR.1",ŞENDRICENI,BT,1134,2,0,0,2,8,0,0,8,14,0,4,18,23,1,4,28,24,1,4,29
39131,372,"ŞCOALA GENERALĂ COBÎLA",ŞENDRICENI,BT,757,2,1,0,3,8,3,0,11,11,6,0,17,14,6,0,20,18,7,0,25
39140,373,"ŞCOALA GENERALĂ",HORLĂCENI,BT,473,2,2,0,4,7,3,0,10,8,6,0,14,14,9,0,23,16,9,0,25
39159,374,ŞCOALAGENERALĂ,PĂDURENI,BT,881,5,2,0,7,8,2,0,10,12,2,1,15,21,2,1,24,21,3,1,25
39239,375,"CAMINUL CULTURALȘTIUBIENI",ŞTIUBIENI,BT,1424,20,6,0,26,42,8,0,50,62,9,0,71,70,11,0,81,71,12,0,83
39257,376,"CAMINUL CULTURAL NEGRENI",NEGRENI,BT,650,5,0,0,5,14,1,0,15,20,5,0,25,29,6,0,35,29,6,0,35
39275,377,"CĂMIN CULTURAL TODIRENI",TODIRENI,BT,1186,33,1,0,34,44,1,0,45,49,4,0,53,63,5,0,68,64,5,0,69
39275,378,"ŞCOALA CU CLASELE I-IV NR.2 TODIRENI",TODIRENI,BT,500,3,1,0,4,12,4,0,16,13,4,0,17,24,4,0,28,27,4,0,31
39284,379,"ŞCOALA CU CLASELE I-VIII CERNEŞTI",CERNEŞTI,BT,671,6,1,0,7,12,1,0,13,19,8,0,27,50,14,0,64,55,14,0,69
39319,380,"ŞCOALA CU CLASELE I-IVIUREŞTI",IUREŞTI,BT,442,8,0,0,8,12,1,0,13,17,1,0,18,22,2,0,24,24,4,0,28
39337,381,"GRĂDINIŢA DE COPII TRUSESTI",TRUŞEŞTI,BT,1035,12,0,0,12,22,4,0,26,35,4,0,39,47,4,0,51,52,4,0,56
39337,382,"GRĂDINIŢA DE COPIITRUSESTI",TRUŞEŞTI,BT,1046,11,0,0,11,31,2,0,33,45,2,0,47,50,3,0,53,51,4,0,55
39346,383,"ŞCOALA GENERALĂ NR. 4 BUHĂCENI",BUHĂCENI,BT,640,8,2,0,10,21,2,0,23,26,3,0,29,31,3,0,34,31,3,0,34
39364,384,"ŞCOALA GENERALĂ NR. 3 DRISLEA",DRISLEA,BT,839,3,1,0,4,7,3,0,10,18,5,0,23,28,7,0,35,28,7,0,35
39373,385,"ŞCOALA GENERALĂ NR. 2 IONĂŞENI",IONĂŞENI,BT,788,5,0,0,5,8,1,0,9,11,2,0,13,16,3,0,19,16,3,0,19
39408,386,"SCOALA TIBERIU CRUDU CORP B SALA 1",TUDORA,BT,1415,2,3,0,5,8,3,0,11,10,4,15,29,13,4,15,32,15,7,15,37
39408,387,"SCOALA TIBERIU CRUDU CORP B SALA 2",TUDORA,BT,1279,4,3,0,7,19,3,0,22,21,4,0,25,27,6,12,45,29,6,12,47
39408,388,"SCOALA CU CLASELE I-VIII ARINI",TUDORA,BT,1271,1,6,0,7,13,6,20,39,14,6,20,40,23,8,20,51,24,8,20,52
39426,389,"ŞCOALA GIMNAZIALĂ NR. 1 UNGURENI",UNGURENI,BT,1162,2,0,0,2,11,2,0,13,23,2,0,25,29,5,0,34,33,5,0,38
39426,390,"CĂMIN CULTURAL",UNGURENI,BT,1070,6,1,0,7,16,1,0,17,23,1,0,24,24,3,0,27,25,3,0,28
39471,391,"ŞCOALA PRIMARĂ NR. 5 MIHAI VITEAZU","MIHAI VITEAZU",BT,388,9,0,0,9,12,2,0,14,14,3,0,17,19,3,0,22,21,3,0,24
39435,392,"ŞCOALA GIMNAZIALĂ NR. 3 BORZEŞTI",BORZEŞTI,BT,1106,9,0,0,9,14,4,0,18,25,7,0,32,31,7,0,38,31,7,0,38
39499,393,"LICEUL TEHNOLOGIC PLOPENII MARI","PLOPENII MARI",BT,805,15,2,0,17,25,2,0,27,28,2,0,30,36,4,0,40,36,4,0,40
39444,394,"ŞCOALA GIMNAZIALĂ NR. 8 CĂLUGĂRENII VECHI",CĂLUGĂRENI,BT,589,5,3,0,8,8,3,0,11,12,3,0,15,17,3,0,20,17,3,0,20
39541,395,"ŞCOALA GIMNAZIALĂ NR.1 UNŢENI",UNŢENI,BT,989,9,0,0,9,30,1,0,31,42,4,0,46,54,5,0,59,58,5,0,63
39578,396,"ŞCOALA GIMNAZIALĂ NR.2 MÎNĂSTIRENI",MÎNĂSTIRENI,BT,654,3,0,0,3,10,2,0,12,12,4,0,16,17,5,0,22,23,8,0,31
39569,397,"ŞCOALA PRIMARĂ NR.3 BURLEŞTI",BURLEŞTI,BT,553,2,3,0,5,4,4,0,8,10,4,0,14,13,4,0,17,13,5,0,18
39621,398,"SCOALA VACULESTI",VĂCULEŞTI,BT,877,7,1,0,8,21,5,0,26,25,7,0,32,32,12,0,44,33,13,0,46
39649,399,"SCOALA SAUCENITA",SAUCENIŢA,BT,770,14,4,0,18,23,4,0,27,34,4,0,38,37,4,0,41,38,4,0,42
39630,400,"SCOALA GOROVEI",GOROVEI,BT,29,2,5,0,7,5,8,0,13,6,10,0,16,6,10,0,16,7,10,0,17
40050,401,"ŞC.CU CLASELE I-VIII NR.1",MAGHERA,BT,642,11,1,0,12,17,6,0,23,18,6,0,24,24,6,0,30,31,6,0,37
39701,402,"ŞC.CU CLASELE I-VIII GEORGE HAZGAN","VÂRFU CÂMPULUI",BT,1519,9,2,0,11,15,4,0,19,25,7,0,32,32,9,0,41,35,9,0,44
39710,403,"ŞC.CU CLASELE I-VIII IONĂŞENI",IONĂŞENI,BT,703,9,0,0,9,14,2,0,16,16,2,0,18,23,2,0,25,23,4,0,27
39729,404,"ŞC.CU CLASELE I-IV LUNCA",LUNCA,BT,545,6,5,0,11,16,7,0,23,37,15,0,52,66,19,0,85,92,23,0,115
39667,405,"CĂMINUL CULTURAL VIIŞOARA",VIIŞOARA,BT,715,8,0,0,8,15,0,0,15,21,1,0,22,25,1,0,26,28,2,0,30
39676,406,"ŞCOLA CU CLASELE I-IV CUZA VODĂ","CUZA VODĂ",BT,444,4,0,0,4,7,0,0,7,11,1,0,12,15,1,0,16,19,2,0,21
39685,407,"ŞCOLA CU CLASELE I-IV VIIŞOARA MICĂ","VIIŞOARA MICĂ",BT,399,1,0,0,1,3,0,0,3,6,1,0,7,11,1,0,12,11,1,0,12
39747,408,"SCOALA CU CLASELE I-VIII VLADENI(CORP NOU)",VLĂDENI,BT,1479,11,1,0,12,35,10,0,45,39,11,0,50,58,17,0,75,62,19,0,81
39756,409,"SCOALA CU CLASELE I-VIII BREHUIESTI(CORPUL B)",BREHUIEŞTI,BT,1365,5,3,0,8,11,3,0,14,15,3,0,18,19,3,0,22,20,3,0,23
39783,410,"SCOALA CU CLASELE I-VIII MANDRESTI",MÎNDREŞTI,BT,1115,12,1,0,13,23,6,0,29,40,9,0,49,59,11,0,70,64,11,0,75
39809,411,"ŞCOALA CU CLASELE I-VIII GHEORGHE BURAC",VLĂSINEŞTI,BT,1242,14,0,0,14,43,9,0,52,60,10,0,70,68,10,34,112,73,11,34,118
39827,412,"ŞCOALA CU CLASELE I-IV",SÎRBI,BT,839,10,0,0,10,12,0,0,12,24,0,0,24,32,0,0,32,32,0,0,32
39818,413,"ŞCOALA CU CLASELE I-IV","MIRON COSTIN",BT,326,8,0,0,8,9,1,0,10,10,1,0,11,12,2,0,14,12,2,0,14
39845,414,"SCOALA NR.1 VORNICENI",VORNICENI,BT,1217,6,0,0,6,12,0,0,12,19,0,0,19,26,2,0,28,28,2,0,30
39845,415,"SCOALA NR.2 VORNICENI",VORNICENI,BT,891,1,0,0,1,11,2,0,13,15,2,0,17,18,3,0,21,22,7,0,29
39845,416,"SCOALA NR.3 VORNICENI",VORNICENI,BT,854,1,2,0,3,6,3,0,9,6,3,0,9,8,3,0,11,9,3,0,12
39863,417,"SCOALA DEALU CRUCII","DEALU CRUCII",BT,307,1,0,0,1,3,0,0,3,7,0,0,7,7,0,0,7,7,0,0,7
39881,418,",,SOCIETATEA COOPERATIVA DE CONSUM VORONA - MAGAZIN MIXT VORONA NOUA""",VORONA,BT,753,5,2,0,7,10,2,0,12,12,2,0,14,19,3,0,22,29,4,0,33
39881,419,"LICEUL TEHNOLOGICSTEFAN CEL MARE VORONA",VORONA,BT,826,9,5,0,14,36,8,0,44,50,11,0,61,63,12,0,75,63,12,0,75
39881,420,"SCOALA CU CLASELE I-VIII IONITA PANCUL VORONA",VORONA,BT,508,9,4,0,13,17,5,0,22,22,7,0,29,26,7,0,33,31,11,0,42
39925,421,"SCOALA CU CLASELE I-VIII LUCA ARBORE VORONA MARE","VORONA MARE",BT,1019,20,2,0,22,28,3,5,36,30,6,5,41,36,7,5,48,38,7,5,50
39907,422,"SCOALA CU CLASELE I-VIII RALUCA IURASCU JOLDESTI",JOLDEŞTI,BT,1030,8,3,0,11,11,3,1,15,18,3,1,22,28,3,1,32,36,4,1,41
39890,423,"GRADINITA NUMARUL 2 ICUSENI",ICUŞENI,BT,232,1,0,0,1,1,0,0,1,3,0,0,3,3,0,0,3,4,1,0,5
39890,424,"SCOALA CU CLASELE I-VIII ALEXANDRU CEL BUN ICUSENI",ICUŞENI,BT,815,4,1,0,5,5,1,0,6,5,4,0,9,10,4,0,14,10,5,0,15
39916,425,"SCOALA CU CLASELE I-VIII NICOLAE IORGA POIANA",POIANA,BT,996,3,0,0,3,7,0,2,9,12,1,2,15,16,3,2,21,18,3,2,23
40205,1,"SEMINARUL TEOLOGIC LICEAL ORTODOX “DUMITRU STĂNILOAIE”",BRAŞOV,BV,1489,17,0,0,17,41,1,0,42,64,1,0,65,77,6,0,83,85,8,0,93
40205,2,"SEMINARUL TEOLOGIC LICEAL ORTODOX “DUMITRU STĂNILOAIE”",BRAŞOV,BV,1219,5,0,0,5,39,0,0,39,66,1,0,67,76,1,0,77,86,4,0,90
40205,3,"GRĂDINIŢA CU PROGRAM PRELUNGIT NR. 2",BRAŞOV,BV,1022,10,2,0,12,37,2,0,39,52,5,0,57,69,7,0,76,74,7,0,81
40205,4,"GRĂDINIŢA CU PROGRAM PRELUNGIT NR. 2",BRAŞOV,BV,1126,6,2,0,8,21,2,0,23,42,2,35,79,56,7,35,98,63,7,35,105
40205,5,"LICEUL ""ANDREI MUREŞANU""",BRAŞOV,BV,1430,15,2,0,17,62,5,0,67,83,22,0,105,97,26,0,123,99,30,0,129
40205,6,"LICEUL ""ANDREI MUREŞANU""",BRAŞOV,BV,1400,12,0,0,12,45,1,0,46,70,8,0,78,89,8,0,97,97,9,0,106
40205,7,"COLEGIUL TEHNIC ""MARIA BAIULESCU""",BRAŞOV,BV,1345,16,2,0,18,39,3,0,42,58,3,0,61,68,3,0,71,77,6,0,83
40205,8,"COLEGIUL TEHNIC ""MARIA BAIULESCU""",BRAŞOV,BV,1506,7,0,0,7,31,14,0,45,64,17,0,81,101,20,0,121,112,20,0,132
40205,9,"COLEGIUL NAŢIONAL ""APRILY LAJOS""",BRAŞOV,BV,982,13,4,0,17,27,10,0,37,44,28,0,72,58,31,0,89,65,34,0,99
40205,10,"COLEGIUL NAŢIONAL ""APRILY LAJOS""",BRAŞOV,BV,982,6,4,0,10,39,5,0,44,52,7,0,59,67,7,0,74,67,7,0,74
40205,11,"COLEGIUL NAŢIONAL ""APRILY LAJOS""",BRAŞOV,BV,735,3,3,0,6,26,3,0,29,41,4,0,45,57,5,0,62,64,8,0,72
40205,12,"COLEGIUL NAŢIONAL ""UNIREA""",BRAŞOV,BV,1281,6,3,0,9,37,22,0,59,49,44,0,93,59,46,0,105,62,48,0,110
40205,13,"COLEGIUL NAŢIONAL ""UNIREA""",BRAŞOV,BV,1271,12,3,0,15,30,4,0,34,53,27,0,80,78,34,0,112,87,39,0,126
40205,14,"ŞCOALA GIMNAZIALĂ NR. 8",BRAŞOV,BV,991,5,4,0,9,22,5,0,27,38,5,0,43,59,8,0,67,60,9,0,69
40205,15,"ŞCOALA GIMNAZIALĂ NR. 8",BRAŞOV,BV,1071,11,3,0,14,48,3,0,51,65,6,16,87,81,6,16,103,85,6,16,107
40205,16,"ŞCOALA GIMNAZIALĂ NR. 8",BRAŞOV,BV,1189,10,0,0,10,56,1,0,57,85,1,0,86,116,2,0,118,122,2,0,124
40205,17,"ŞCOALA GIMNAZIALĂ NR. 8",BRAŞOV,BV,1701,25,4,0,29,67,5,0,72,97,5,0,102,134,6,0,140,149,6,0,155
40205,18,"ŞCOALA GIMNAZIALĂ NR.5",BRAŞOV,BV,1453,15,1,0,16,45,1,0,46,56,1,4,61,84,12,4,100,89,18,4,111
40205,19,"ŞCOALA GIMNAZIALĂ NR.5",BRAŞOV,BV,1620,1,21,0,22,70,4,0,74,97,5,0,102,127,6,1,134,133,6,1,140
40205,20,"ŞCOALA GIMNAZIALĂ NR. 15",BRAŞOV,BV,1622,13,0,0,13,52,8,0,60,74,8,0,82,113,11,0,124,125,15,0,140
40205,21,"ŞCOALA GIMNAZIALĂ NR. 15",BRAŞOV,BV,1571,16,2,0,18,53,2,0,55,89,3,0,92,120,5,0,125,125,8,0,133
40205,22,"ŞCOALA GIMNAZIALĂ NR. 15",BRAŞOV,BV,1500,19,5,0,24,61,9,0,70,85,11,0,96,102,13,0,115,106,13,0,119
40205,23,"ŞCOALA GIMNAZIALĂ NR. 15",BRAŞOV,BV,1447,10,1,0,11,18,1,0,19,37,1,0,38,54,2,0,56,54,2,0,56
40205,24,"ŞCOALA GIMNAZIALĂ NR. 15",BRAŞOV,BV,1317,11,0,0,11,33,2,0,35,49,2,0,51,60,2,0,62,68,2,0,70
40205,25,"ŞCOALA GIMNAZIALĂ NR. 15",BRAŞOV,BV,1213,4,5,0,9,13,5,0,18,21,6,0,27,41,6,0,47,43,6,0,49
40205,26,"LICEUL DE MUZICĂ ""TUDOR CIORTEA""",BRAŞOV,BV,1363,11,5,0,16,51,17,0,68,56,22,0,78,80,35,0,115,100,40,0,140
40205,27,"ŞCOALA GIMNAZIALĂ NR. 12",BRAŞOV,BV,1624,5,0,0,5,18,3,0,21,39,13,0,52,58,13,0,71,67,15,0,82
40205,28,"ŞCOALA GIMNAZIALĂ NR. 12",BRAŞOV,BV,1455,2,3,0,5,37,6,0,43,65,11,0,76,83,19,0,102,92,21,0,113
40205,29,"GRĂDINIŢA CU PROGRAM PRELUNGIT ""CASUTA BUCURIEI"" NR. 11",BRAŞOV,BV,881,9,3,0,12,28,5,0,33,41,7,0,48,53,9,0,62,61,10,0,71
40205,30,"GRĂDINIŢA CU PROGRAM PRELUNGIT ""CASUTA BUCURIEI"" NR. 11",BRAŞOV,BV,889,6,1,0,7,42,2,0,44,63,2,0,65,77,4,0,81,81,4,0,85
40205,31,"COLEGIUL ""EMIL RACOVIŢĂ""",BRAŞOV,BV,1603,19,1,0,20,62,7,0,69,105,11,0,116,136,18,0,154,144,18,0,162
40205,32,"COLEGIUL ""EMIL RACOVIŢĂ""",BRAŞOV,BV,1402,8,2,0,10,50,4,0,54,78,7,0,85,98,7,0,105,106,7,0,113
40205,33,"COLEGIUL ""EMIL RACOVIŢĂ""",BRAŞOV,BV,1326,8,4,0,12,35,5,0,40,63,5,0,68,83,6,0,89,85,6,0,91
40205,34,"COLEGIUL ""EMIL RACOVIŢĂ""",BRAŞOV,BV,877,3,0,0,3,13,0,0,13,28,0,0,28,37,0,0,37,42,0,0,42
40205,35,"COLEGIUL NAŢIONAL “DR. I. MEŞOTĂ”",BRAŞOV,BV,1681,7,0,0,7,55,2,0,57,102,6,0,108,123,7,0,130,133,7,0,140
40205,36,"COLEGIUL NAŢIONAL “DR. I. MEŞOTĂ”",BRAŞOV,BV,976,9,3,0,12,36,11,0,47,57,11,0,68,68,18,0,86,73,19,0,92
40205,37,"COLEGIUL NAŢIONAL “DR. I. MEŞOTĂ”",BRAŞOV,BV,1534,11,0,0,11,58,2,0,60,82,6,0,88,110,7,0,117,118,7,0,125
40205,38,"ŞCOALA GIMNAZIALĂ NR. 19",BRAŞOV,BV,1128,13,2,0,15,64,6,0,70,108,12,0,120,126,17,0,143,135,19,1,155
40205,39,"ŞCOALA GIMNAZIALĂ NR. 19",BRAŞOV,BV,1374,23,2,0,25,66,3,0,69,91,3,0,94,121,4,0,125,126,4,0,130
40205,40,"ŞCOALA GIMNAZIALĂ NR. 19",BRAŞOV,BV,993,15,1,0,16,61,3,0,64,84,6,0,90,100,7,0,107,102,7,0,109
40205,41,"ŞCOALA GIMNAZIALĂ NR. 19",BRAŞOV,BV,1574,18,0,0,18,59,0,0,59,79,0,0,79,116,2,0,118,130,3,0,133
40205,42,"ŞCOALA GIMNAZIALĂ NR. 19",BRAŞOV,BV,1468,10,0,0,10,51,0,0,51,78,1,0,79,99,1,0,100,108,1,0,109
40205,43,"VILA ORIZONT",BRAŞOV,BV,332,0,0,0,0,4,22,0,26,10,28,0,38,12,34,0,46,13,35,0,48
40205,44,"ŞCOALA GIMNAZIALĂ NR. 27 ""ANATOL GHERMANSCHI""",BRAŞOV,BV,1505,16,3,0,19,43,5,0,48,63,6,0,69,73,8,0,81,81,8,0,89
40205,45,"ŞCOALA GIMNAZIALĂ NR. 27 ""ANATOL GHERMANSCHI""",BRAŞOV,BV,1496,12,1,0,13,42,7,0,49,64,15,0,79,85,21,0,106,110,24,0,134
40205,46,"ŞCOALA GIMNAZIALĂ NR. 27 ""ANATOL GHERMANSCHI""",BRAŞOV,BV,652,2,5,0,7,23,5,0,28,35,5,0,40,44,5,0,49,46,7,0,53
40205,47,"ŞCOALA GIMNAZIALĂ NR. 27 ""ANATOL GHERMANSCHI""",BRAŞOV,BV,1616,19,1,0,20,65,2,0,67,90,4,0,94,118,4,0,122,123,4,0,127
40205,48,"ŞCOALA GIMNAZIALĂ NR. 27 ""ANATOL GHERMANSCHI""",BRAŞOV,BV,1444,16,2,0,18,62,3,0,65,80,3,0,83,96,3,0,99,103,3,0,106
40205,49,"ŞCOALA GIMNAZIALĂ NR. 27 ""ANATOL GHERMANSCHI""",BRAŞOV,BV,1532,24,3,0,27,65,4,0,69,105,4,0,109,130,4,0,134,140,4,0,144
40205,50,"ŞCOALA GIMNAZIALĂ NR. 27 ""ANATOL GHERMANSCHI""",BRAŞOV,BV,1588,22,3,0,25,67,3,0,70,99,3,0,102,131,3,0,134,142,3,0,145
40205,51,"ŞCOALA GIMNAZIALĂ NR. 11 „ST.O.IOSIF”",BRAŞOV,BV,1192,8,0,0,8,34,3,0,37,53,4,0,57,76,6,0,82,83,7,0,90
40205,52,"ŞCOALA GIMNAZIALĂ NR. 11 „ST.O.IOSIF”",BRAŞOV,BV,1525,7,0,0,7,28,0,0,28,57,1,0,58,83,2,0,85,85,2,0,87
40205,53,"ŞCOALA GIMNAZIALĂ NR. 11 „ST.O.IOSIF”",BRAŞOV,BV,1081,8,0,0,8,21,0,0,21,36,0,0,36,54,0,0,54,58,0,0,58
40205,54,"ŞCOALA GIMNAZIALĂ NR. 11 „ST.O.IOSIF”",BRAŞOV,BV,926,7,0,0,7,29,0,0,29,36,2,0,38,41,2,0,43,45,2,0,47
40205,55,"ŞCOALA GIMNAZIALĂ NR. 11 „ST.O.IOSIF”",BRAŞOV,BV,1474,9,4,0,13,39,4,0,43,66,4,0,70,75,4,0,79,80,4,0,84
40205,56,"ŞCOALA GIMNAZIALĂ NR. 11 „ST.O.IOSIF”",BRAŞOV,BV,1396,11,0,0,11,36,0,0,36,63,1,0,64,83,1,0,84,84,1,0,85
40205,57,"ȘCOALĂ GENERALĂ NR. 11 ȘTEFAN OCTAVIAN IOSIF",BRAŞOV,BV,1417,16,0,0,16,57,1,0,58,81,4,0,85,94,4,0,98,98,4,0,102
40205,58,"ȘCOALĂ GENERALĂ NR. 11 ȘTEFAN OCTAVIAN IOSIF",BRAŞOV,BV,999,3,0,0,3,29,1,0,30,48,1,0,49,61,2,0,63,77,2,0,79
40205,59,"ŞCOALA GIMNAZIALĂ NR. 11",BRAŞOV,BV,1246,8,0,0,8,34,2,0,36,45,3,0,48,57,4,0,61,66,5,0,71
40205,60,"ŞCOALA GIMNAZIALĂ NR. 11",BRAŞOV,BV,1361,15,1,0,16,42,6,0,48,61,6,0,67,81,6,0,87,86,6,0,92
40205,61,"ŞCOALA GIMNAZIALĂ NR. 11",BRAŞOV,BV,1245,6,0,0,6,43,2,0,45,68,4,0,72,87,6,0,93,96,6,0,102
40205,62,"ŞCOALA GIMNAZIALĂ NR. 11",BRAŞOV,BV,1290,4,0,0,4,21,0,0,21,39,0,0,39,60,1,0,61,60,2,0,62
40205,63,"ŞCOALA GIMNAZIALĂ NR. 11",BRAŞOV,BV,1588,8,0,0,8,47,1,0,48,74,2,0,76,93,2,0,95,110,2,0,112
40205,64,"ŞCOALA GIMNAZIALĂ NR. 11",BRAŞOV,BV,1535,22,3,0,25,54,3,0,57,77,3,0,80,90,3,0,93,102,3,0,105
40205,65,"ŞCOALA GIMNAZIALĂ NR. 25",BRAŞOV,BV,1535,26,0,0,26,66,1,0,67,89,1,0,90,109,1,0,110,129,1,0,130
40205,66,"ŞCOALA GIMNAZIALĂ NR. 25",BRAŞOV,BV,1655,6,0,0,6,35,0,0,35,67,0,0,67,87,0,0,87,97,0,0,97
40205,67,"ŞCOALA GIMNAZIALĂ NR. 25",BRAŞOV,BV,869,6,0,0,6,14,0,0,14,26,1,0,27,38,3,0,41,48,3,0,51
40205,68,"ŞCOALA GIMNAZIALĂ NR. 25",BRAŞOV,BV,1582,13,0,0,13,53,5,0,58,73,8,0,81,92,10,0,102,97,10,0,107
40205,69,"LICEUL DE ARTE PLASTICE „HANS MATTIS-TEUTSCH""",BRAŞOV,BV,1324,8,2,0,10,21,4,0,25,41,6,0,47,59,13,0,72,62,13,0,75
40205,70,"LICEUL DE ARTE PLASTICE „HANS MATTIS-TEUTSCH""",BRAŞOV,BV,1240,7,8,0,15,26,12,0,38,38,13,0,51,55,15,0,70,59,16,0,75
40205,71,"LICEUL DE ARTE PLASTICE „HANS MATTIS-TEUTSCH""",BRAŞOV,BV,1561,15,5,0,20,42,5,0,47,72,6,0,78,91,6,0,97,100,6,0,106
40205,72,"LICEUL DE ARTE PLASTICE „HANS MATTIS-TEUTSCH""",BRAŞOV,BV,1466,9,0,0,9,34,2,0,36,60,2,0,62,71,2,0,73,78,2,0,80
40205,73,"LICEUL DE ARTE PLASTICE „HANS MATTIS-TEUTSCH""",BRAŞOV,BV,1145,4,0,0,4,28,0,0,28,40,0,1,41,54,4,1,59,61,4,1,66
40205,74,"ŞCOALA GIMNAZIALĂ NR. 25",BRAŞOV,BV,1278,5,3,0,8,37,4,0,41,57,7,0,64,83,8,0,91,93,8,0,101
40205,75,"ŞCOALA GIMNAZIALĂ NR. 25",BRAŞOV,BV,1326,12,1,0,13,37,3,0,40,75,5,0,80,98,5,0,103,106,5,0,111
40205,76,"ŞCOALA GIMNAZIALĂ NR. 25",BRAŞOV,BV,1602,8,1,0,9,36,2,0,38,58,2,0,60,80,2,0,82,85,2,0,87
40205,77,"ŞCOALA GIMNAZIALĂ NR. 25",BRAŞOV,BV,1125,5,1,0,6,20,1,0,21,31,3,0,34,53,3,0,56,59,3,0,62
40205,78,"ŞCOALA GIMNAZIALĂ NR. 9 ""NICOLAE ORGHIDAN""",BRAŞOV,BV,1585,10,0,0,10,35,1,0,36,51,6,0,57,78,9,0,87,81,9,0,90
40205,79,"ŞCOALA GIMNAZIALĂ NR. 9 ""NICOLAE ORGHIDAN""",BRAŞOV,BV,1675,14,0,0,14,30,0,0,30,61,1,0,62,83,5,0,88,91,7,0,98
40205,80,"ŞCOALA GIMNAZIALĂ NR. 9 ""NICOLAE ORGHIDAN""",BRAŞOV,BV,1437,8,0,0,8,32,1,0,33,49,2,0,51,75,2,0,77,84,3,0,87
40205,81,"ŞCOALA GIMNAZIALĂ NR. 9",BRAŞOV,BV,1514,15,1,0,16,54,6,0,60,80,9,0,89,101,9,0,110,110,10,0,120
40205,82,"ŞCOALA GIMNAZIALĂ NR. 9",BRAŞOV,BV,1051,22,4,0,26,39,7,0,46,53,17,0,70,66,22,0,88,70,22,0,92
40205,83,"ŞCOALA GIMNAZIALĂ NR. 9",BRAŞOV,BV,1182,6,0,0,6,15,0,0,15,27,0,0,27,42,2,0,44,45,2,0,47
40205,84,"ŞCOALA GIMNAZIALĂ NR. 9",BRAŞOV,BV,1435,4,0,0,4,25,1,0,26,40,1,0,41,70,3,0,73,75,5,0,80
40205,85,"ŞCOALA GIMNAZIALĂ NR. 9",BRAŞOV,BV,1584,10,0,0,10,36,0,0,36,65,3,0,68,87,3,0,90,93,3,0,96
40205,86,"ŞCOALA GIMNAZIALĂ NR. 9",BRAŞOV,BV,1583,21,0,0,21,49,0,0,49,91,0,0,91,114,0,0,114,129,0,0,129
40205,87,"ŞCOALA GIMNAZIALĂ NR. 9",BRAŞOV,BV,1524,10,0,0,10,34,0,0,34,51,1,0,52,73,3,0,76,79,3,0,82
40205,88,"ȘCOALĂ GENERALĂ NR. 9",BRAŞOV,BV,1429,14,0,0,14,38,0,0,38,54,0,0,54,69,1,0,70,71,1,0,72
40205,89,"ŞCOALA GIMNAZIALĂ NR. 3 ""GHEORGHE LAZĂR""",BRAŞOV,BV,1634,10,10,0,20,80,15,0,95,104,17,0,121,126,20,0,146,130,21,0,151
40205,90,"ŞCOALA GIMNAZIALĂ NR. 3 ""GHEORGHE LAZĂR""",BRAŞOV,BV,1612,12,2,0,14,42,4,0,46,66,5,0,71,86,5,0,91,88,5,0,93
40205,91,"ŞCOALA GIMNAZIALĂ NR. 3 ""GHEORGHE LAZĂR""",BRAŞOV,BV,1687,31,8,0,39,80,10,0,90,119,10,0,129,155,12,0,167,159,12,0,171
40205,92,"ŞCOALA GIMNAZIALĂ NR. 3 ""GHEORGHE LAZĂR""",BRAŞOV,BV,1268,8,0,0,8,40,2,0,42,71,2,0,73,101,6,0,107,101,6,0,107
40205,93,"ŞCOALA GIMNAZIALĂ NR. 3 ""GHEORGHE LAZĂR""",BRAŞOV,BV,1558,17,0,0,17,60,0,0,60,87,0,0,87,112,1,0,113,119,1,0,120
40205,94,"ŞCOALA GIMNAZIALĂ NR. 3 ""GHEORGHE LAZĂR""",BRAŞOV,BV,1515,14,0,0,14,37,0,0,37,77,0,0,77,88,0,0,88,91,0,0,91
40205,95,"ŞCOALA GIMNAZIALĂ NR. 3 ""GHEORGHE LAZĂR""",BRAŞOV,BV,1691,12,0,0,12,74,1,0,75,97,2,0,99,126,2,0,128,144,2,0,146
40205,96,"LICEUL TEHNOLOGIC SILVIC ""DOCTOR NICOLAE RUCĂREANU""",BRAŞOV,BV,1124,11,3,0,14,37,4,0,41,70,4,0,74,98,7,0,105,103,7,0,110
40205,97,"LICEUL TEHNOLOGIC SILVIC ""DOCTOR NICOLAE RUCĂREANU""",BRAŞOV,BV,1392,12,3,0,15,55,4,0,59,89,5,0,94,112,5,0,117,115,5,0,120
40205,98,"LICEUL TEHNOLOGIC SILVIC ""DOCTOR NICOLAE RUCĂREANU""",BRAŞOV,BV,874,4,0,0,4,19,3,0,22,31,4,0,35,48,5,0,53,53,5,0,58
40205,99,"LICEUL TEHNOLOGIC SILVIC ""DOCTOR NICOLAE RUCĂREANU""",BRAŞOV,BV,1491,9,0,0,9,42,0,0,42,67,0,0,67,86,0,0,86,89,0,0,89
40205,100,"ŞCOALA GIMNAZIALĂ NR. 2",BRAŞOV,BV,1544,9,0,0,9,52,4,0,56,79,8,0,87,102,12,0,114,109,14,0,123
40205,101,"ŞCOALA GIMNAZIALĂ NR. 2",BRAŞOV,BV,1476,16,0,0,16,62,6,0,68,93,8,0,101,121,9,0,130,136,9,0,145
40205,102,"ŞCOALA GIMNAZIALĂ NR. 2",BRAŞOV,BV,1506,21,0,0,21,72,0,0,72,93,0,0,93,124,1,0,125,133,1,0,134
40205,103,"ŞCOALA GIMNAZIALĂ NR. 2",BRAŞOV,BV,1633,9,3,0,12,55,4,0,59,78,4,0,82,106,4,0,110,118,5,0,123
40205,104,"ŞCOALA GIMNAZIALĂ NR. 2",BRAŞOV,BV,1507,20,3,0,23,60,4,0,64,76,5,0,81,100,5,0,105,103,5,0,108
40205,105,"ȘCOALA GIMNAZIALĂ NR. 2",BRAŞOV,BV,1801,20,3,0,23,80,6,0,86,117,10,0,127,147,14,0,161,161,16,0,177
40205,106,"COLEGIUL DE ŞTIINŢE ""GRIGORE ANTIPA""",BRAŞOV,BV,1491,8,2,0,10,59,7,0,66,78,11,0,89,111,12,0,123,121,13,0,134
40205,107,"COLEGIUL DE ŞTIINŢE ""GRIGORE ANTIPA""",BRAŞOV,BV,1499,15,4,0,19,43,4,0,47,66,4,0,70,82,4,0,86,84,4,0,88
40205,108,"COLEGIUL DE ŞTIINŢE ""GRIGORE ANTIPA""",BRAŞOV,BV,1427,14,0,0,14,37,2,0,39,61,4,0,65,74,4,0,78,78,4,0,82
40205,109,"COLEGIUL DE ŞTIINŢE ""GRIGORE ANTIPA""",BRAŞOV,BV,1218,20,0,0,20,56,5,0,61,92,6,0,98,111,6,0,117,115,7,0,122
40205,110,"COLEGIUL NAŢIONAL DE INFORMATICĂ ""GRIGORE MOISIL""",BRAŞOV,BV,1225,10,3,0,13,52,8,0,60,75,12,0,87,96,21,0,117,99,25,0,124
40205,111,"COLEGIUL NAŢIONAL DE INFORMATICĂ ""GRIGORE MOISIL""",BRAŞOV,BV,1425,7,0,0,7,26,1,0,27,44,3,0,47,57,3,0,60,77,3,0,80
40205,112,"COLEGIUL NAŢIONAL DE INFORMATICĂ ""GRIGORE MOISIL""",BRAŞOV,BV,1602,13,5,0,18,38,5,0,43,60,5,0,65,75,5,0,80,80,5,0,85
40205,113,"COLEGIUL NAŢIONAL DE INFORMATICĂ ""GRIGORE MOISIL""",BRAŞOV,BV,1383,3,0,0,3,23,0,0,23,44,0,0,44,73,0,0,73,78,0,0,78
40205,114,"COLEGIUL NAŢIONAL DE INFORMATICĂ ""GRIGORE MOISIL""",BRAŞOV,BV,1615,23,0,0,23,71,0,0,71,91,0,0,91,113,4,0,117,127,4,0,131
40205,115,"COLEGIUL NAŢIONAL DE INFORMATICĂ ""GRIGORE MOISIL""",BRAŞOV,BV,988,5,0,0,5,21,12,0,33,29,15,0,44,43,21,0,64,51,22,0,73
40205,116,"COLEGIUL NAŢIONAL DE INFORMATICĂ ""GRIGORE MOISIL""",BRAŞOV,BV,1305,6,0,0,6,27,0,0,27,39,7,0,46,57,7,0,64,65,7,0,72
40205,117,"COLEGIUL NAŢIONAL DE INFORMATICĂ ""GRIGORE MOISIL""",BRAŞOV,BV,1641,11,0,0,11,36,4,0,40,57,4,0,61,70,5,1,76,81,5,1,87
40205,118,"LICEUL CU PROGRAM SPORTIV",BRAŞOV,BV,1587,27,0,0,27,79,0,0,79,110,0,0,110,146,0,0,146,157,0,0,157
40205,119,"LICEUL CU PROGRAM SPORTIV",BRAŞOV,BV,1120,12,0,0,12,41,0,0,41,73,0,0,73,86,2,0,88,90,3,0,93
40205,120,"LICEUL CU PROGRAM SPORTIV",BRAŞOV,BV,1271,14,0,0,14,46,1,0,47,64,2,0,66,81,2,0,83,83,2,0,85
40205,121,"LICEUL CU PROGRAM SPORTIV",BRAŞOV,BV,1489,11,0,0,11,37,0,0,37,64,0,0,64,87,0,0,87,105,0,0,105
40205,122,"LICEUL CU PROGRAM SPORTIV",BRAŞOV,BV,1430,11,3,0,14,40,5,0,45,67,5,0,72,89,9,0,98,97,10,0,107
40205,123,"ŞCOALA GIMNAZIALĂ NR. 1",BRAŞOV,BV,1481,17,2,0,19,56,8,0,64,93,10,0,103,105,11,0,116,109,12,0,121
40205,124,"ŞCOALA GIMNAZIALĂ NR. 1",BRAŞOV,BV,1421,10,1,0,11,61,1,0,62,85,1,0,86,120,1,0,121,126,1,0,127
40205,125,"ŞCOALA GIMNAZIALĂ NR. 1",BRAŞOV,BV,1359,10,2,0,12,34,4,0,38,53,5,0,58,73,5,0,78,80,5,0,85
40205,126,"ŞCOALA GIMNAZIALĂ NR. 1",BRAŞOV,BV,1672,15,0,0,15,49,0,0,49,83,0,0,83,109,0,0,109,114,1,0,115
40205,127,"ŞCOALA GIMNAZIALĂ NR. 1",BRAŞOV,BV,1521,14,0,0,14,38,0,0,38,67,2,0,69,88,2,0,90,93,2,0,95
40205,128,"ŞCOALA GIMNAZIALĂ NR. 1",BRAŞOV,BV,941,9,1,0,10,27,1,0,28,33,1,0,34,42,1,0,43,46,1,0,47
40205,129,"ŞCOALA GIMNAZIALĂ NR. 1",BRAŞOV,BV,1058,11,1,0,12,32,1,0,33,44,1,0,45,50,1,0,51,58,1,0,59
40205,130,"ŞCOALA GIMNAZIALĂ NR. 1",BRAŞOV,BV,1610,19,0,0,19,62,2,0,64,86,2,0,88,97,2,0,99,110,2,0,112
40205,131,"CENTRUL REGIONAL DE FORMARE PROFESIONALĂ BRAŞOV",BRAŞOV,BV,1021,4,4,0,8,19,5,0,24,29,6,0,35,38,6,0,44,41,6,0,47
40205,132,"CENTRUL REGIONAL DE FORMARE PROFESIONALĂ BRAŞOV",BRAŞOV,BV,1300,16,4,0,20,42,5,0,47,63,8,0,71,86,10,0,96,92,10,0,102
40205,133,"ŞCOALA GIMNAZIALĂ NR.15",BRAŞOV,BV,1214,10,4,0,14,35,37,0,72,63,78,2,143,78,78,2,158,80,81,2,163
40205,134,"CANTINA STUDENŢEASCĂ",BRAŞOV,BV,1629,11,0,0,11,35,18,0,53,59,39,0,98,81,53,0,134,90,58,0,148
40205,135,"COLEGIUL NAŢIONAL ECONOMIC ""ANDREI BÂRSEANU""",BRAŞOV,BV,932,8,4,0,12,28,7,0,35,39,8,0,47,46,10,0,56,50,11,0,61
40205,136,"COLEGIUL NAŢIONAL ECONOMIC ""ANDREI BÂRSEANU""",BRAŞOV,BV,1198,1,2,0,3,19,2,0,21,37,5,0,42,53,7,0,60,55,7,0,62
40205,137,"COLEGIUL NAŢIONAL ECONOMIC ""ANDREI BÂRSEANU""",BRAŞOV,BV,1221,2,3,0,5,19,4,0,23,36,7,0,43,46,7,0,53,54,9,0,63
40205,138,"ŞCOALA GIMNAZIALĂ NR. 14",BRAŞOV,BV,1340,6,2,0,8,18,3,0,21,23,5,0,28,28,6,0,34,29,6,0,35
40205,139,"ŞCOALA GIMNAZIALĂ NR. 14",BRAŞOV,BV,1445,4,6,0,10,20,8,0,28,30,12,0,42,36,12,0,48,43,12,0,55
40205,140,"ŞCOALA GIMNAZIALĂ NR. 14",BRAŞOV,BV,1646,6,0,0,6,34,0,0,34,37,0,0,37,62,1,0,63,73,3,0,76
40205,141,"ŞCOALA GIMNAZIALĂ NR. 14",BRAŞOV,BV,1525,8,1,0,9,22,8,0,30,42,8,0,50,50,8,0,58,50,9,0,59
40205,142,"ŞCOALA GIMNAZIALĂ NR. 14",BRAŞOV,BV,1430,4,1,0,5,28,7,0,35,39,12,0,51,46,14,0,60,52,19,0,71
40205,143,"ŞCOALA GIMNAZIALĂ NR. 14",BRAŞOV,BV,1677,9,0,0,9,33,7,0,40,52,7,0,59,71,8,0,79,81,10,0,91
40205,144,"ŞCOALA GIMNAZIALĂ NR. 14",BRAŞOV,BV,2336,16,1,0,17,43,1,0,44,66,1,0,67,88,3,0,91,92,5,0,97
40205,145,"ŞCOALA GIMNAZIALĂ NR. 14",BRAŞOV,BV,1874,9,1,0,10,24,2,0,26,40,3,0,43,64,3,0,67,79,3,0,82
40205,146,"ŞCOALA GIMNAZIALĂ NR. 14",BRAŞOV,BV,1857,16,3,0,19,35,3,0,38,56,3,0,59,77,3,0,80,84,3,0,87
40205,147,"ŞCOALA GIMNAZIALĂ NR. 14",BRAŞOV,BV,1813,14,0,0,14,43,0,0,43,59,0,0,59,74,0,0,74,80,0,0,80
40205,148,"ŞCOALA GIMNAZIALĂ NR. 14",BRAŞOV,BV,1351,8,3,0,11,33,3,0,36,51,3,0,54,72,4,0,76,81,5,0,86
40205,149,"ŞCOALA GIMNAZIALĂ NR. 14",BRAŞOV,BV,2007,15,0,0,15,35,1,0,36,51,3,0,54,69,5,0,74,86,6,0,92
40205,150,"ŞCOALA GIMNAZIALĂ NR. 14",BRAŞOV,BV,1469,7,1,0,8,19,1,0,20,26,1,0,27,41,1,0,42,50,1,0,51
40205,151,"ŞCOALA GIMNAZIALĂ NR. 30",BRAŞOV,BV,1895,12,4,0,16,63,4,0,67,104,5,0,109,127,6,0,133,133,6,0,139
40205,152,"ŞCOALA GIMNAZIALĂ NR. 30",BRAŞOV,BV,2026,11,0,0,11,41,0,0,41,67,0,0,67,104,2,0,106,116,2,0,118
40205,153,"ŞCOALA GIMNAZIALĂ NR. 30",BRAŞOV,BV,2350,16,0,0,16,69,2,0,71,114,3,0,117,152,4,0,156,163,4,0,167
40205,154,"ŞCOALA GIMNAZIALĂ NR. 30",BRAŞOV,BV,2200,24,0,0,24,67,3,0,70,97,5,0,102,120,5,0,125,127,11,0,138
40205,155,"ŞCOALA GIMNAZIALĂ NR. 13",BRAŞOV,BV,1482,12,4,0,16,59,7,0,66,77,8,0,85,92,8,0,100,98,8,0,106
40205,156,"ŞCOALA GIMNAZIALĂ NR. 13",BRAŞOV,BV,1274,30,0,0,30,80,0,0,80,90,0,0,90,120,0,0,120,120,0,0,120
40205,157,"ŞCOALA GIMNAZIALĂ NR. 13",BRAŞOV,BV,1554,17,0,0,17,61,0,0,61,85,2,0,87,107,2,0,109,120,5,0,125
40205,158,"ŞCOALA GIMNAZIALĂ NR. 13",BRAŞOV,BV,1536,13,0,0,13,76,0,0,76,85,0,0,85,117,0,0,117,126,0,0,126
40205,159,"ŞCOALA GIMNAZIALĂ NR. 13",BRAŞOV,BV,1663,18,0,0,18,66,4,0,70,93,7,0,100,120,8,0,128,129,9,0,138
40205,160,"COLEGIUL ""NICOLAE TITULESCU""",BRAŞOV,BV,1572,1,5,0,6,14,19,0,33,27,24,0,51,38,26,0,64,42,29,0,71
40205,161,"COLEGIUL ""NICOLAE TITULESCU""",BRAŞOV,BV,1468,6,2,0,8,31,4,0,35,46,6,0,52,56,14,0,70,73,14,0,87
40205,162,"COLEGIUL ""NICOLAE TITULESCU""",BRAŞOV,BV,1445,11,1,0,12,36,1,0,37,59,3,0,62,79,3,0,82,83,3,0,86
40205,163,"COLEGIUL ""NICOLAE TITULESCU""",BRAŞOV,BV,1465,9,0,0,9,35,0,0,35,56,0,0,56,70,0,0,70,78,0,0,78
40205,164,"COLEGIUL ""NICOLAE TITULESCU""",BRAŞOV,BV,1631,10,0,0,10,40,1,0,41,53,5,0,58,73,5,0,78,81,6,0,87
40205,165,"COLEGIUL ""NICOLAE TITULESCU""",BRAŞOV,BV,1511,2,0,0,2,15,0,0,15,24,0,0,24,33,1,0,34,40,3,0,43
40205,166,"ŞCOALA PROFESIONALĂ GERMANĂ „KRONSTADT”",BRAŞOV,BV,2320,3,1,0,4,33,2,0,35,55,4,0,59,75,5,0,80,80,9,0,89
40205,167,"COLEGIUL TEHNIC DE TRANSPORTURI",BRAŞOV,BV,764,6,0,0,6,13,1,0,14,23,1,0,24,27,3,0,30,30,4,0,34
40205,168,"COLEGIUL TEHNIC DE TRANSPORTURI",BRAŞOV,BV,1191,11,4,0,15,26,5,0,31,40,5,0,45,63,7,0,70,66,8,0,74
40205,169,"COLEGIUL TEHNIC DE TRANSPORTURI",BRAŞOV,BV,1660,4,3,0,7,31,4,0,35,50,4,0,54,80,4,0,84,81,5,0,86
40205,170,"ŞCOALA GIMNAZIALĂ NR. 31",BRAŞOV,BV,1387,13,0,0,13,38,1,0,39,72,3,0,75,92,4,0,96,100,4,0,104
40205,171,"ŞCOALA GIMNAZIALĂ NR. 31",BRAŞOV,BV,1420,16,0,0,16,42,1,0,43,66,1,0,67,95,3,0,98,96,8,0,104
40205,172,"ŞCOALA GIMNAZIALĂ NR. 31",BRAŞOV,BV,1187,11,3,0,14,34,3,0,37,53,3,0,56,94,3,0,97,97,3,0,100
40205,173,"COLEGIUL TEHNIC ""REMUS RĂDULEŢ""",BRAŞOV,BV,553,2,0,0,2,11,0,0,11,16,0,0,16,26,0,0,26,30,0,0,30
40205,174,"COLEGIUL TEHNIC ""REMUS RĂDULEŢ""",BRAŞOV,BV,1009,7,0,0,7,26,0,0,26,32,0,0,32,41,2,0,43,45,2,0,47
40205,175,"COLEGIUL TEHNIC ""REMUS RĂDULEŢ""",BRAŞOV,BV,1119,7,0,0,7,13,1,0,14,26,2,0,28,42,2,0,44,45,2,0,47
40205,176,"COLEGIUL TEHNIC ""REMUS RĂDULEŢ""",BRAŞOV,BV,1117,7,0,0,7,19,0,0,19,30,0,0,30,46,0,0,46,47,0,0,47
40205,177,"COLEGIUL TEHNIC ""REMUS RĂDULEŢ""",BRAŞOV,BV,1059,5,0,0,5,14,0,0,14,28,0,0,28,35,0,0,35,35,3,0,38
40250,178,"COLEGIUL TEHNIC SIMION MEHEDINŢI",CODLEA,BV,982,6,0,0,6,19,0,0,19,31,0,0,31,37,0,0,37,39,0,0,39
40250,179,"COLEGIUL TEHNIC SIMION MEHEDINŢI",CODLEA,BV,1165,5,0,0,5,27,0,0,27,44,1,0,45,59,1,0,60,64,1,0,65
40250,180,"COLEGIUL TEHNIC SIMION MEHEDINŢI",CODLEA,BV,1121,8,0,0,8,32,2,0,34,49,3,0,52,63,3,0,66,63,3,0,66
40250,181,"COLEGIUL TEHNIC SIMION MEHEDINTI",CODLEA,BV,1082,9,0,0,9,15,0,0,15,26,2,0,28,43,3,0,46,43,4,0,47
40250,182,"ŞCOALA GENERALA NR.2",CODLEA,BV,1060,6,5,0,11,30,5,0,35,53,5,0,58,57,6,0,63,73,6,0,79
40250,183,"GRADINITA NR.1",CODLEA,BV,1203,9,0,0,9,34,1,0,35,40,1,0,41,52,1,0,53,57,1,0,58
40250,184,"GRADINITA NR.1",CODLEA,BV,1267,17,1,0,18,30,2,0,32,43,4,0,47,62,4,0,66,70,5,0,75
40250,185,"GRUP SCOLAR FORESTIER",CODLEA,BV,1554,25,2,0,27,54,6,0,60,72,10,0,82,82,12,0,94,94,14,0,108
40250,186,"ŞCOALA GENERALA NR.1",CODLEA,BV,1366,4,0,0,4,32,4,0,36,66,5,0,71,83,8,0,91,85,8,0,93
40250,187,"GRADINITA NR.4",CODLEA,BV,1286,9,0,0,9,33,0,0,33,48,0,0,48,57,0,0,57,61,0,0,61
40250,188,"GRADINITA NR.4",CODLEA,BV,1756,16,0,0,16,55,0,0,55,93,1,0,94,120,1,0,121,127,2,0,129
40250,189,"ŞCOALA GENERALA NR. 3",CODLEA,BV,954,11,3,0,14,33,3,0,36,57,3,0,60,77,4,0,81,80,5,0,85
40250,190,"ŞCOALA GENERALA NR. 3",CODLEA,BV,1424,14,1,0,15,54,1,0,55,69,1,0,70,94,2,0,96,105,2,0,107
40250,191,"ŞCOALA GENERALA NR. 3",CODLEA,BV,1043,12,0,0,12,37,1,0,38,53,2,0,55,73,4,0,77,82,4,0,86
40250,192,"LICEUL TEORETIC",CODLEA,BV,1276,5,0,0,5,28,1,0,29,43,1,0,44,61,4,0,65,61,4,0,65
40250,193,"ŞCOALA DE ARTE SI MESERII",CODLEA,BV,1046,15,0,0,15,32,3,0,35,46,4,0,50,55,5,0,60,58,5,0,63
40250,194,"ŞCOALA DE ARTE SI MESERII",CODLEA,BV,1417,6,0,0,6,9,0,0,9,36,4,0,40,56,4,0,60,56,4,0,60
40287,195,"SERVICIUL PUBLIC DE ASISTENTA SOCIALA, STR. T. VLADIMIRESCU NR.8",FĂGĂRAŞ,BV,1625,12,0,0,12,44,0,0,44,56,1,0,57,76,2,0,78,80,2,0,82
40287,196,"GRADINITA CU PROGRAM NORMAL „VOINICELUL""",FĂGĂRAŞ,BV,1737,17,0,0,17,55,0,0,55,82,1,0,83,101,1,0,102,112,1,0,113
40287,197,"CASAMUNICIPALĂ DE CULTURĂ",FĂGĂRAŞ,BV,1505,9,0,0,9,42,0,0,42,49,0,0,49,66,0,0,66,68,0,0,68
40287,198,"CASAMUNICIPALĂ DE CULTURĂ",FĂGĂRAŞ,BV,1338,12,0,0,12,36,0,0,36,46,0,0,46,58,0,0,58,61,0,0,61
40287,199,"ŞCOALA GIMNAZIALĂ "" OVID DENSUŞIANU"" - ŞCOALA GENERALĂ NR.4",FĂGĂRAŞ,BV,1149,6,0,0,6,20,0,0,20,37,0,0,37,52,0,0,52,60,1,0,61
40287,200,"FUNDAŢIA CULTURALĂ ""NEGRU VODA""",FĂGĂRAŞ,BV,1000,12,6,0,18,25,8,0,33,45,10,0,55,56,12,0,68,67,13,0,80
40287,201,"COLEGIUL NAŢIONAL ""D-NA STANCA""",FĂGĂRAŞ,BV,1511,8,0,0,8,30,3,0,33,50,4,0,54,75,5,0,80,89,5,0,94
40287,202,"COLEGIUL NAŢIONAL ""D-NA STANCA""",FĂGĂRAŞ,BV,1383,8,0,0,8,39,4,0,43,54,4,0,58,63,5,0,68,70,5,0,75
40287,203,"COLEGIUL NAŢIONAL ""RADU NEGRU"" - ŞCOALA GENERALĂ NR.1",FĂGĂRAŞ,BV,1163,12,0,0,12,39,2,0,41,52,4,0,56,64,6,0,70,77,8,0,85
40287,204,"COLEGIUL NAŢIONAL ""RADU NEGRU"" - ŞCOALA GENERALĂ NR.1",FĂGĂRAŞ,BV,1355,6,1,0,7,47,3,0,50,66,6,0,72,80,7,0,87,84,7,0,91
40287,205,"COLEGIUL NAŢIONAL „RADU NEGRU”",FĂGĂRAŞ,BV,1184,5,0,0,5,26,4,0,30,35,7,0,42,48,11,0,59,52,11,0,63
40287,206,"COLEGIUL NAŢIONAL „RADU NEGRU”",FĂGĂRAŞ,BV,1432,8,0,0,8,35,0,0,35,44,0,0,44,60,0,0,60,71,0,0,71
40287,207,"COLEGIUL NAŢIONAL ""D-NA STANCA""-ŞCOALA GIMNAZIALĂ NR.7",FĂGĂRAŞ,BV,1558,8,3,0,11,41,3,0,44,55,8,0,63,70,8,0,78,74,8,0,82
40287,208,"COLEGIUL NAŢIONAL ""D-NA STANCA""-ŞCOALA GIMNAZIALĂ NR.7",FĂGĂRAŞ,BV,1647,15,2,0,17,47,6,0,53,59,6,0,65,74,10,0,84,81,10,0,91
40287,209,"COLEGIUL NAŢIONAL ""D-NA STANCA""-ŞCOALA GIMNAZIALĂ NR. 7",FĂGĂRAŞ,BV,1652,18,0,0,18,56,0,0,56,73,0,0,73,89,0,0,89,91,0,0,91
40287,210,"COLEGIUL „AUREL VIJOLI”",FĂGĂRAŞ,BV,1434,4,2,0,6,18,3,0,21,31,4,0,35,39,4,0,43,39,4,0,43
40287,211,"COLEGIUL „AUREL VIJOLI”",FĂGĂRAŞ,BV,1165,9,0,0,9,16,0,0,16,21,0,0,21,21,0,0,21,21,0,0,21
40287,212,"LICEUL TEOLOGIC ORTODOX ""CONSTANTIN BRÂNCOVEANU""",FĂGĂRAŞ,BV,1186,4,2,0,6,21,2,0,23,31,3,0,34,51,6,0,57,57,6,0,63
40287,213,"LICEUL TEOLOGIC ORTODOX “SF. CONSTANTIN BRÂNCOVEANU”",FĂGĂRAŞ,BV,1335,6,0,0,6,25,1,0,26,35,3,0,38,52,3,0,55,59,4,0,63
40287,214,"LICEUL TEOLOGIC ORTODOX “ SF.. CONSTANTIN BRÂNCOVEANU”",FĂGĂRAŞ,BV,1520,12,0,0,12,32,0,0,32,49,0,0,49,56,0,0,56,59,0,0,59
40287,215,"LICEUL TEOLOGIC ORTODOX “ SF.. CONSTANTIN BRÂNCOVEANU”",FĂGĂRAŞ,BV,1670,13,3,0,16,37,4,0,41,51,5,0,56,65,8,0,73,78,8,0,86
40287,216,"LICEUL TEOLOGIC ORTODOX “ SF.. CONSTANTIN BRÂNCOVEANU” -GRĂDINIŢA CU PROGRAM NORMAL „MATEIAŞ BRÂNCOVEANU”,",FĂGĂRAŞ,BV,1277,6,0,0,6,23,1,0,24,33,2,0,35,50,2,0,52,55,2,0,57
40287,217,"ŞCOALA GIMNAZIALĂ "" OVID DENSUŞIANU""",FĂGĂRAŞ,BV,1120,4,0,0,4,39,0,0,39,54,0,0,54,77,1,0,78,81,1,0,82
40447,218,"ŞCOALA GIMNAZIALĂNR. 1, CORPUL A(LÂNGĂ GRĂDINIŢĂ)",SĂCELE,BV,1986,15,0,0,15,42,2,0,44,62,4,0,66,77,5,0,82,85,5,0,90
40447,219,"ŞCOALA GIMNAZIALĂNR. 1 CORPUL B",SĂCELE,BV,1782,19,1,0,20,47,4,0,51,74,10,0,84,91,11,0,102,105,13,0,118
40447,220,"ŞCOALA GIMNAZIALĂNR. 1 CORPUL F",SĂCELE,BV,1743,14,0,0,14,41,3,0,44,62,3,0,65,76,4,0,80,84,5,0,89
40447,221,"LICEU ZAJZONI RAB ISTVAN",SĂCELE,BV,1605,7,0,0,7,30,0,0,30,43,1,0,44,60,1,0,61,63,2,0,65
40447,222,"LICEUL GEORGE MOROIANU CORPUL C",SĂCELE,BV,1668,12,0,0,12,32,0,0,32,49,0,0,49,65,0,0,65,66,0,0,66
40447,223,"LICEUL GEORGE MOROIANU CORPUL C",SĂCELE,BV,1507,6,6,0,12,40,6,0,46,60,6,0,66,77,6,0,83,82,7,0,89
40447,224,"SALA DE SPORT",SĂCELE,BV,1499,8,2,0,10,41,4,0,45,65,4,0,69,96,4,0,100,106,4,0,110
40447,225,"SALA DE SPORT",SĂCELE,BV,1391,9,1,0,10,35,1,0,36,62,1,0,63,69,1,0,70,85,1,0,86
40447,226,"LICEUL GEORGE MOROIANU",SĂCELE,BV,1704,13,3,0,16,39,4,0,43,54,4,0,58,68,4,0,72,72,4,0,76
40447,227,"ŞCOALA GIMNAZIALĂ NR.4 FRAŢII POPEEA",SĂCELE,BV,1643,22,6,0,28,47,10,0,57,61,13,0,74,74,14,0,88,77,14,0,91
40447,228,"ŞCOALA GIMNAZIALĂ NR.4 FRAŢII POPEEA",SĂCELE,BV,1376,15,0,0,15,52,2,0,54,73,3,0,76,102,3,0,105,105,3,0,108
40447,229,"ŞCOALA GIMNAZIALĂ NR.4 FRAŢII POPEEA",SĂCELE,BV,1154,12,1,0,13,42,1,0,43,64,2,0,66,78,2,0,80,82,2,0,84
40447,230,"GRUP ŞCOLAR INDUSTRIAL VICTOR JINGA",SĂCELE,BV,1034,7,2,0,9,20,2,0,22,38,5,0,43,54,7,0,61,57,8,0,65
40447,231,"GRUP ŞCOLAR INDUSTRIAL VICTOR JINGA",SĂCELE,BV,1146,10,2,0,12,51,5,0,56,67,7,0,74,74,8,0,82,76,8,0,84
40447,232,"ŞCOALA GIMNAZIALĂNR.4 FRAŢII POPEEA",SĂCELE,BV,1457,9,0,0,9,45,0,0,45,71,0,0,71,88,0,0,88,92,0,0,92
40447,233,"ŞCOALA GIMNAZIALĂNR.5 CORPUL B",SĂCELE,BV,1094,3,6,0,9,10,6,0,16,19,6,0,25,22,6,0,28,22,6,0,28
40447,234,"ŞCOALA GIMNAZIALĂ NR.5 CORPUL B",SĂCELE,BV,1182,4,0,0,4,8,5,0,13,15,6,0,21,25,6,0,31,25,6,0,31
40447,235,"ŞCOALA GIMNAZIALĂ NR.5 CORPUL A",SĂCELE,BV,1098,1,0,0,1,10,0,0,10,17,0,0,17,26,0,0,26,26,0,0,26
40447,236,"ŞCOALA GIMNAZIALĂNR.5 CORPUL A",SĂCELE,BV,1301,4,0,0,4,6,0,0,6,8,0,0,8,24,0,0,24,28,0,0,28
40223,237,"PRIMĂRIA GHIMBAV",GHIMBAV,BV,1908,7,0,0,7,21,11,0,32,35,13,0,48,56,15,0,71,61,17,0,78
40223,238,"ŞCOALA GENERALĂGHIMBAV CLASELE V-VIII",GHIMBAV,BV,1745,5,3,0,8,24,4,0,28,44,5,0,49,63,6,0,69,72,10,0,82
40223,239,"ŞCOALA GENERALĂGHIMBAV CLASELE I-IV",GHIMBAV,BV,1749,15,0,0,15,31,1,0,32,45,1,0,46,74,2,0,76,80,3,0,83
40312,240,"CENTRUL DE CULTURĂ MIHAIL SAULESCU",PREDEAL,BV,1277,16,4,0,20,54,55,0,109,78,94,0,172,106,130,0,236,108,138,0,246
40312,241,"LICEUL TEORETICMIHAIL SAULESCU",PREDEAL,BV,1007,4,0,0,4,35,5,0,40,46,8,0,54,61,16,0,77,64,16,0,80
40312,242,"LICEUL TEORETIC MIHAIL SĂULESCU",PREDEAL,BV,1142,6,4,0,10,27,11,0,38,43,14,0,57,58,20,0,78,58,24,0,82
40349,243,"AGENȚIA POȘTALĂ","TIMIŞU DE SUS",BV,302,4,1,0,5,6,2,0,8,12,2,0,14,17,3,0,20,18,3,0,21
40330,244,"GRADINITA CUPROGRAMNORMAL TIMISUL DE JOS","TIMIŞU DE JOS",BV,351,0,0,0,0,1,0,0,1,2,4,0,6,3,5,0,8,3,5,0,8
40312,245,"CLUBUL DÂMBUL MORII",PREDEAL,BV,187,2,0,0,2,2,1,0,3,5,1,0,6,6,1,0,7,10,3,0,13
40376,246,"ȘCOALA GENERALĂ NR. 1 RÂȘNOV",RÂŞNOV,BV,1547,9,1,0,10,14,3,0,17,38,3,0,41,51,3,0,54,53,3,0,56
40376,247,"ȘCOALA GENERALĂ NR. 1 RÂȘNOV",RÂŞNOV,BV,1256,0,0,0,0,4,0,0,4,6,0,0,6,13,0,0,13,15,0,0,15
40376,248,"ȘCOALA GENERALĂ NR. 3 RÂȘNOV",RÂŞNOV,BV,1262,12,1,0,13,33,5,0,38,46,10,0,56,57,14,0,71,63,16,0,79
40376,249,"ȘCOALA GENERALĂ NR. 3 RÂȘNOV",RÂŞNOV,BV,1580,8,0,0,8,32,5,0,37,43,5,0,48,54,7,0,61,54,8,0,62
40376,250,"GRĂDINIŢA NR.1",RÂŞNOV,BV,914,3,0,0,3,15,0,0,15,25,0,0,25,41,0,0,41,42,0,0,42
40376,251,"ȘCOALA GENERALĂ NR. 2 RÂȘNOV",RÂŞNOV,BV,1625,11,0,0,11,33,5,0,38,51,5,0,56,77,6,0,83,80,6,0,86
40376,252,"ȘCOALA GENERALĂ NR. 2 RÂȘNOV",RÂŞNOV,BV,1447,1,0,0,1,12,4,0,16,31,7,0,38,48,10,0,58,57,12,0,69
40376,253,"ȘCOALA GENERALĂ NR. 2 RÂȘNOV",RÂŞNOV,BV,1255,9,3,0,12,26,11,0,37,41,11,0,52,49,15,0,64,57,15,0,72
40376,254,"GRUP ȘCOLAR INDUSTRIAL RÂȘNOV",RÂŞNOV,BV,1356,7,4,0,11,27,11,0,38,46,29,0,75,61,46,0,107,66,51,0,117
40376,255,"GRUP ȘCOLAR INDUSTRIAL RÂȘNOV",RÂŞNOV,BV,1489,13,2,0,15,40,2,0,42,58,17,0,75,79,28,0,107,86,28,0,114
40401,256,"ŞCOALA GENERALA I",RUPEA,BV,1123,6,0,0,6,28,2,0,30,32,2,0,34,37,2,0,39,40,2,0,42
40401,257,"CASA ORASENEASCA DE CULTURA",RUPEA,BV,1243,6,1,0,7,30,6,0,36,36,6,0,42,42,8,0,50,43,8,0,51
40401,258,"SCOALA GENERALA II",RUPEA,BV,1557,8,0,0,8,34,1,0,35,39,2,0,41,41,2,0,43,43,2,0,45
40401,259,"CLUB MUNCITORESC BRAFOR GARA RUPEA",RUPEA,BV,558,3,0,0,3,5,0,0,5,13,0,0,13,18,0,0,18,18,0,0,18
40410,260,"SCOALA PRIMARA FISER",FIŞER,BV,386,1,2,0,3,7,2,0,9,8,2,0,10,13,2,0,15,13,2,0,15
40474,261,"PRIMARIA VICTORIA",VICTORIA,BV,1284,11,1,0,12,25,5,0,30,33,5,0,38,54,8,0,62,59,8,0,67
40474,262,"LICEUL TEORETIC I.C. DRĂGUȘANU",VICTORIA,BV,1657,8,1,0,9,32,8,0,40,56,9,0,65,74,10,0,84,75,10,0,85
40474,263,"ŞCOALA GIMNAZIALA VICTORIA",VICTORIA,BV,1670,9,0,0,9,36,0,0,36,58,2,0,60,70,2,1,73,84,2,1,87
40474,264,"COLEGIUL TEHNIC DR. ALEXANDRU BĂRBAT",VICTORIA,BV,1087,2,3,0,5,28,4,0,32,33,5,0,38,49,5,0,54,54,5,0,59
40474,265,"GRĂDINIŢA NR. 1",VICTORIA,BV,1506,6,4,0,10,10,4,0,14,20,6,0,26,28,6,0,34,34,6,0,40
40508,266,"GRĂDINIŢA BOBOCEL",ZĂRNEŞTI,BV,1429,16,0,0,16,30,0,0,30,41,0,0,41,56,1,0,57,57,1,0,58
40508,267,"LICEUL TEORETIC M.I.MEŢIANU - CORP A",ZĂRNEŞTI,BV,1341,5,2,0,7,14,2,0,16,25,17,0,42,34,17,0,51,36,17,0,53
40508,268,"LICEUL TEORETIC M.I.MEŢIANU - CORP B",ZĂRNEŞTI,BV,1350,8,2,0,10,24,8,0,32,39,9,0,48,44,10,0,54,46,10,0,56
40508,269,"LICEUL TEORETIC M.I.MEŢIANU - CORP B",ZĂRNEŞTI,BV,1626,15,0,0,15,39,1,0,40,51,1,0,52,60,1,0,61,61,1,0,62
40508,270,"CASA DE CULTURĂ",ZĂRNEŞTI,BV,1298,5,3,0,8,11,5,0,16,25,7,0,32,28,7,0,35,30,8,0,38
40508,271,"GRĂDINIŢA VOINICELUL NR. 2",ZĂRNEŞTI,BV,1230,6,1,0,7,18,6,0,24,32,10,0,42,45,11,0,56,46,11,0,57
40508,272,"CLUBUL PENSIONARILOR - CARAIMAN",ZĂRNEŞTI,BV,1448,9,2,0,11,34,2,0,36,43,2,0,45,62,2,0,64,69,2,0,71
40508,273,"CLUBUL PENSIONARILOR",ZĂRNEŞTI,BV,1276,23,1,0,24,59,1,0,60,81,1,0,82,110,1,0,111,116,1,0,117
40508,274,"ŞCOALA GIMNAZIALĂ NR. 3 POMPILIU DAN-CORP A",ZĂRNEŞTI,BV,948,6,2,0,8,40,4,0,44,44,4,0,48,50,6,0,56,52,6,0,58
40508,275,"SPITALUL ORĂŞENESC DR. CAIUS TIBERIU SPÂRCHEZ",ZĂRNEŞTI,BV,1327,8,0,0,8,54,7,0,61,85,15,0,100,102,17,0,119,107,17,0,124
40508,276,"ŞCOALA GIMNAZIALĂNR. 1 GHEORGHECRĂCIUN CORP B",ZĂRNEŞTI,BV,1353,9,0,0,9,43,0,0,43,54,0,0,54,75,0,0,75,84,0,0,84
40508,277,"ŞCOALA GIMNAZIALĂNR. 1 GHEORGHECRĂCIUN",ZĂRNEŞTI,BV,1369,12,1,0,13,35,1,0,36,53,1,0,54,81,2,0,83,84,2,0,86
40508,278,"LICEUL TEHNOLOGICMALAXA",ZĂRNEŞTI,BV,1037,3,0,0,3,14,3,0,17,21,3,0,24,27,3,0,30,28,3,0,31
40508,279,"SCOALA GIMNAZIALA NR. 2",ZĂRNEŞTI,BV,1604,5,0,0,5,7,0,0,7,10,0,0,10,14,0,0,14,18,0,0,18
40517,280,"CĂMINUL CULTURAL TOHANUL NOU","TOHANU NOU",BV,1194,3,0,0,3,22,1,0,23,28,1,0,29,42,4,0,46,50,5,0,55
40508,281,"CAMINUL CULTURAL TOHANUL VECHI",ZĂRNEŞTI,BV,1724,6,1,0,7,27,6,0,33,41,7,0,48,54,8,0,62,64,8,0,72
40535,282,"CĂMINUL CULTURAL",APAŢA,BV,1230,6,0,0,6,8,0,0,8,11,1,0,12,15,2,0,17,15,2,0,17
40535,283,"CĂMINUL CULTURAL",APAŢA,BV,1159,3,0,0,3,10,0,0,10,10,0,0,10,15,0,0,15,18,0,0,18
41569,284,"GRĂDINIȚA DE COPII",AUGUSTIN,BV,1282,4,5,0,9,11,9,0,20,25,11,0,36,30,11,0,41,34,11,0,45
40553,285,"CAMIN CULTURAL BECLEAN",BECLEAN,BV,634,3,0,0,3,8,1,0,9,16,3,0,19,17,3,0,20,18,3,0,21
40580,286,"CAMIN CULTURAL HUREZ",HUREZ,BV,365,1,0,0,1,9,0,0,9,11,1,0,12,12,3,0,15,14,3,0,17
40562,287,"CAMIN CULTURAL BOHOLT",BOHOLŢ,BV,158,3,0,0,3,8,0,0,8,13,2,0,15,19,4,0,23,22,5,0,27
40571,288,"CAMIN CULTURAL CALBOR",CALBOR,BV,195,3,1,0,4,4,1,0,5,6,1,0,7,10,1,0,11,11,1,0,12
40599,289,"CAMIN CULTURAL LUTA",LUŢA,BV,59,2,0,0,2,5,0,0,5,5,1,0,6,6,1,0,7,6,1,0,7
40615,290,"ȘCOALA GIMNAZIALĂ BOD SAT",BOD,BV,1271,16,2,0,18,33,3,0,36,46,3,0,49,61,6,0,67,66,14,0,80
40615,291,"SEDIUL PRIMARIEI BOD",BOD,BV,1024,8,2,0,10,19,4,0,23,22,6,0,28,27,9,0,36,32,10,0,42
40624,292,"GRĂDINIŢA BOD COLONIE","COLONIA BOD",BV,906,7,1,0,8,22,3,0,25,29,7,0,36,35,8,0,43,41,10,0,51
40624,293,"ȘCOALA GENERALĂ COLONIA BOD","COLONIA BOD",BV,930,5,0,0,5,12,1,0,13,15,2,0,17,18,3,0,21,20,6,0,26
40642,294,"PRIMĂRIA COMUNEI BRAN",BRAN,BV,810,2,5,0,7,13,17,0,30,16,36,0,52,28,56,0,84,34,66,0,100
40642,295,"CĂMINUL CULTURAL POARTA",BRAN,BV,897,7,2,0,9,14,5,0,19,19,8,0,27,27,10,0,37,36,11,0,47
40651,296,"ŞCOALA GENERALĂ PREDELUŢ",PREDELUŢ,BV,872,5,0,0,5,9,4,0,13,14,13,0,27,18,18,0,36,23,22,0,45
40660,297,"CĂMINUL CULTURAL SOHODOL",SOHODOL,BV,907,6,0,0,6,8,2,0,10,11,3,0,14,22,3,0,25,28,4,0,32
40679,298,"CĂMINUL CULTURAL ŞIMON",ŞIMON,BV,1042,5,5,0,10,10,11,0,21,13,12,0,25,20,14,0,34,26,15,0,41
40697,299,"ȘCOALA GIMNAZIALĂ BUDILA",BUDILA,BV,987,1,1,0,2,2,4,0,6,5,4,0,9,10,4,0,14,12,4,0,16
40697,300,"ȘCOALA GIMNAZIALĂ BUDILA",BUDILA,BV,1133,5,0,0,5,9,1,0,10,17,1,0,18,28,1,0,29,29,5,0,34
40697,301,"PRIMĂRIA COMUNEI BUDILA",BUDILA,BV,940,1,0,0,1,1,0,0,1,5,1,0,6,8,1,0,9,17,1,0,18
40713,302,"PRIMĂRIA BUNEŞTI",BUNEŞTI,BV,617,1,2,0,3,4,2,0,6,6,2,0,8,8,4,0,12,16,8,0,24
40722,303,"ŞCOALA PRIMARĂ CRIȚ",CRIŢ,BV,545,3,0,0,3,3,0,0,3,3,0,0,3,6,0,0,6,7,0,0,7
40731,304,"CĂMINUL CULTURAL MEŞENDORF",MEŞENDORF,BV,286,2,0,0,2,2,0,0,2,2,1,0,3,2,1,0,3,4,1,0,5
40740,305,"ŞCOALA PRIMARĂ ROADEŞ",ROADEŞ,BV,251,4,0,0,4,8,0,0,8,10,0,0,10,12,0,0,12,12,0,0,12
40759,306,"ŞCOALA PRIMARĂ VISCRI",VISCRI,BV,365,0,0,0,0,3,0,0,3,3,8,0,11,4,8,0,12,5,8,0,13
40777,307,"CĂMINUL CULTURAL CAŢA",CAŢA,BV,1034,2,0,0,2,8,0,0,8,23,0,0,23,27,2,0,29,27,2,0,29
40786,308,"ŞCOALA GENERALĂ BEIA",BEIA,BV,328,0,0,0,0,4,1,0,5,6,1,0,7,9,1,0,10,9,1,0,10
40795,309,"GRĂDINIŢA DRĂUŞENI",DRĂUŞENI,BV,406,1,0,0,1,3,0,0,3,6,0,0,6,12,0,0,12,12,0,0,12
40802,310,"CĂMINUL CULTURAL IONEŞTI",IONEŞTI,BV,104,0,0,0,0,2,1,0,3,3,1,0,4,5,2,0,7,5,3,0,8
40811,311,"ŞCOALA GENERALĂ PALOŞ",PALOŞ,BV,193,0,0,0,0,2,0,0,2,3,2,0,5,4,4,0,8,4,4,0,8
40839,312,"CAMINUL CULTURAL CINCU",CINCU,BV,1292,9,53,0,62,21,106,0,127,26,159,0,185,36,207,0,243,45,214,0,259
40848,313,"ȘCOALA GENERALĂ TOARCLA",TOARCLA,BV,281,3,1,0,4,3,2,0,5,3,2,0,5,4,2,0,6,4,2,0,6
40866,314,"CĂMINUL CULTURAL COMĂNA DE JOS","COMANA DE JOS",BV,848,5,0,0,5,7,0,0,7,10,6,0,16,13,6,0,19,14,6,0,20
40875,315,"CĂMINUL CULTURAL COMĂNA DE SUS","COMANA DE SUS",BV,288,0,2,0,2,2,6,0,8,6,8,0,14,8,11,0,19,9,11,0,20
40884,316,"CĂMINUL CULTURAL CRIHALMA",CRIHALMA,BV,563,5,0,0,5,11,0,0,11,15,1,0,16,17,1,0,18,18,4,0,22
40893,317,"CĂMINUL CULTURAL TICUŞU NOU","TICUŞU NOU",BV,460,3,0,0,3,8,0,0,8,12,0,0,12,13,1,0,14,13,1,0,14
40919,318,"GRADINITA DE COPII CRISTIAN",CRISTIAN,BV,1527,11,4,0,15,25,14,0,39,36,27,0,63,58,36,0,94,67,38,0,105
40919,319,"CAMINUL CULTURAL NR. 1",CRISTIAN,BV,1262,7,1,0,8,21,1,0,22,28,5,0,33,42,6,0,48,47,6,0,53
40919,320,"SCOALA GENERALA, CORP B",CRISTIAN,BV,1589,8,4,0,12,41,15,0,56,59,15,0,74,72,16,0,88,79,17,0,96
41051,321,"CĂMINUL CULTURAL",CRIZBAV,BV,1326,4,4,0,8,19,4,0,23,33,7,0,40,41,8,0,49,45,9,0,54
41060,322,"ŞCOALA PRIMARĂ CUTUŞ",CUTUŞ,BV,559,6,0,0,6,13,0,0,13,24,0,0,24,26,0,0,26,26,0,0,26
42254,323,"PRIMĂRIA DRĂGUŞ",DRĂGUŞ,BV,936,6,0,0,6,11,0,0,11,16,0,0,16,18,5,0,23,21,5,0,26
40937,324,"PRIMĂRIA COMUNEI DUMBRĂVIŢA",DUMBRĂVIŢA,BV,1603,8,0,0,8,19,7,0,26,25,7,0,32,38,7,0,45,50,8,0,58
40937,325,"GRĂDINIŢA CU PROGRAM NORMAL DUMBRĂVIŢA",DUMBRĂVIŢA,BV,1758,6,0,0,6,17,0,0,17,31,3,0,34,56,5,0,61,65,5,0,70
40946,326,"ŞCOALA GENERALĂ SAT VLĂDENI",VLĂDENI,BV,720,11,4,0,15,24,7,0,31,27,7,0,34,43,11,0,54,51,12,0,63
40964,327,"CĂMINUL CULTURAL FELDIOARA",FELDIOARA,BV,1822,12,0,0,12,33,1,0,34,56,2,0,58,80,8,0,88,85,10,0,95
40964,328,"LICEUL TEORETIC PETRU RAREȘ FELDIOARA",FELDIOARA,BV,1318,9,0,0,9,20,1,0,21,39,2,0,41,45,2,0,47,48,2,0,50
40964,329,"LICEUL TEORETIC PETRU RAREȘ FELDIOARA",FELDIOARA,BV,1198,9,2,0,11,27,2,0,29,39,3,0,42,49,3,0,52,50,3,0,53
40982,330,"CĂMINUL CULTURAL ROTBAV",ROTBAV,BV,1051,4,0,0,4,10,1,0,11,27,2,0,29,30,5,0,35,31,5,0,36
40973,331,"CĂMINUL CULTURAL RECONSTRUCŢIA","COLONIA RECONSTRUCŢIA",BV,590,11,4,0,15,14,4,0,18,19,4,0,23,22,4,0,26,24,4,0,28
41006,332,"ŞCOALA GENERALĂ FUNDATA",FUNDATA,BV,456,4,2,0,6,8,5,0,13,12,11,0,23,19,14,0,33,19,16,0,35
41024,333,"ŞCOALA GENERALĂ ŞIRNEA",ŞIRNEA,BV,216,1,3,0,4,1,7,0,8,3,13,0,16,6,21,0,27,7,24,0,31
41042,334,"CĂMINUL CULTURAL",HĂLCHIU,BV,1508,4,0,0,4,10,1,0,11,23,3,0,26,41,7,0,48,42,7,0,49
41042,335,"LOCAȚIA KREDENT",HĂLCHIU,BV,1464,3,1,0,4,9,2,0,11,18,8,0,26,27,10,0,37,30,10,0,40
41079,336,"CAMIN CULTURAL","SATU NOU",BV,989,12,1,0,13,21,5,0,26,26,5,0,31,33,6,0,39,35,6,0,41
41104,337,"CĂMINUL CULTURAL","PODU OLTULUI",BV,644,11,1,0,12,17,5,0,22,21,6,0,27,25,8,0,33,25,9,0,34
41097,338,"SCOALA GIMNAZIALA HARMAN",HĂRMAN,BV,1669,11,1,0,12,28,1,0,29,35,2,0,37,57,4,0,61,59,5,0,64
41097,339,"SCOALA GIMNAZIALA HARMAN",HĂRMAN,BV,1579,10,0,0,10,27,1,0,28,35,1,0,36,47,2,0,49,56,2,0,58
41097,340,"SCOALA GIMNAZIALA HARMAN",HĂRMAN,BV,1490,16,5,0,21,42,8,0,50,51,10,0,61,58,11,0,69,65,15,0,80
41122,341,"ŞCOALA GIMNAZIALĂ PROF.DR. IOAN CERGHIT HÂRSENI",HÂRSENI,BV,480,7,1,0,8,20,4,0,24,27,4,0,31,36,6,0,42,40,6,0,46
41168,342,"GRĂDINIȚA SEBEȘ",SEBEŞ,BV,653,3,0,0,3,7,0,0,7,11,2,0,13,14,2,0,16,19,3,0,22
41159,343,"GRĂDINIȚA MĂRGINENI",MĂRGINENI,BV,246,5,5,0,10,12,5,0,17,19,7,0,26,23,8,0,31,26,11,0,37
41131,344,"GRĂDINIȚA COPĂCEL",COPĂCEL,BV,511,1,1,0,2,1,1,0,2,2,1,0,3,4,2,0,6,4,3,0,7
41186,345,"CĂMINUL CULTURAL HOGHIZ",HOGHIZ,BV,1016,7,2,0,9,10,2,0,12,17,4,0,21,22,5,0,27,23,7,0,30
41186,346,"CĂMINUL CULTURAL HOGHIZ",HOGHIZ,BV,795,2,2,0,4,7,2,0,9,12,4,0,16,17,4,0,21,18,4,0,22
41195,347,"CĂMINUL CULTURAL BOGATA","BOGATA OLTEANĂ",BV,329,3,1,0,4,5,1,0,6,6,1,0,7,12,1,0,13,13,3,0,16
41202,348,"ȘCOALA GIMNAZIALĂ ""ARON PUMNU"" CUCIULATA",CUCIULATA,BV,1142,2,0,0,2,12,3,0,15,15,6,0,21,20,8,0,28,22,8,0,30
41211,349,"CĂMINUL CULTURAL DOPCA",DOPCA,BV,407,5,3,0,8,10,3,0,13,13,3,0,16,13,3,0,16,13,3,0,16
41220,350,"CĂMUNUL CULTURAL FÂNTÂNA",FÂNTÂNA,BV,214,0,0,0,0,3,2,0,5,3,2,0,5,5,2,0,7,5,3,0,8
41239,351,"CĂMINUL CULTURAL LUPŞA",LUPŞA,BV,79,0,0,0,0,2,0,0,2,2,0,0,2,3,0,0,3,3,0,0,3
42423,352,"PRIMARIA COMUNEI HOLBAV",HOLBAV,BV,1028,8,2,0,10,28,3,0,31,43,3,0,46,63,4,0,67,66,4,0,70
41257,353,"CAMIN CULTURAL HOMOROD",HOMOROD,BV,1179,5,0,0,5,12,0,0,12,17,1,0,18,28,3,0,31,34,4,0,38
41275,354,"CAMIN CULTURAL MERCHEASA",MERCHEAŞA,BV,413,2,0,0,2,20,1,0,21,24,2,0,26,29,3,0,32,29,3,0,32
41266,355,"CAMIN CULTURAL JIMBOR",JIMBOR,BV,381,3,0,0,3,3,0,0,3,3,1,0,4,3,1,0,4,3,1,0,4
41293,356,"ŞCOALA GENERALĂ JIBERT",JIBERT,BV,627,1,0,0,1,4,0,0,4,4,0,0,4,7,0,0,7,7,0,0,7
41300,357,"ŞCOALA GENERALĂ DACIA",DACIA,BV,607,0,0,0,0,10,0,0,10,13,0,0,13,17,0,0,17,19,0,0,19
41328,358,"ŞCOALA GENERALĂ LOVNIC",LOVNIC,BV,437,3,3,0,6,5,3,0,8,5,3,0,8,7,3,0,10,7,3,0,10
41319,359,"ŞCOALA GENERALĂ GRÎNARI",GRÎNARI,BV,292,2,0,0,2,6,2,0,8,7,2,0,9,7,2,0,9,9,2,0,11
41337,360,"ŞCOALA GENERALĂ VĂLENI",VĂLENI,BV,136,3,1,0,4,8,5,0,13,11,5,0,16,11,5,0,16,11,6,0,17
41355,361,"CĂMINUL CULTURAL LISA",LISA,BV,875,4,0,0,4,12,3,0,15,14,5,0,19,19,7,0,26,20,7,0,27
41364,362,"CĂMINUL CULTURAL BREAZA",BREAZA,BV,559,3,2,0,5,4,6,0,10,6,8,0,14,7,8,0,15,10,12,0,22
41391,363,"CAMINUL CULTURAL MAIERUS",MĂIERUŞ,BV,1451,8,0,0,8,21,1,0,22,37,1,0,38,43,1,0,44,50,1,0,51
41408,364,"CAMINUL CULTURAL ARINI",ARINI,BV,761,7,1,0,8,11,2,0,13,13,3,0,16,16,3,0,19,16,3,0,19
41426,365,"SCOALA GENERALA MÂNDRA",MÂNDRA,BV,950,1,0,0,1,6,2,0,8,13,5,0,18,27,8,0,35,33,8,0,41
41435,366,"AŞEZAMÂNT CULTURAL",ILENI,BV,642,8,2,0,10,17,3,0,20,22,6,0,28,24,7,0,31,24,10,0,34
41444,367,"AŞEZAMÂNT CULTURAL",RÂUŞOR,BV,426,0,0,0,0,4,3,0,7,4,4,0,8,12,11,0,23,12,11,0,23
41462,368,"AŞEZAMÂNT CULTURAL",TODERIŢA,BV,231,3,2,0,5,7,3,0,10,9,5,0,14,10,9,0,19,13,10,0,23
41453,369,"AŞEZAMÂNT CULTURAL",ŞONA,BV,195,0,1,0,1,1,2,0,3,3,5,0,8,10,12,0,22,10,13,0,23
41480,370,"PRIMĂRIA COMUNEI MOIECIU","MOIECIU DE JOS",BV,1064,7,5,0,12,14,19,0,33,21,25,0,46,31,28,0,59,35,28,0,63
41480,371,"PRIMĂRIA COMUNEI MOIECIU","MOIECIU DE JOS",BV,1252,5,0,0,5,22,11,0,33,31,16,0,47,39,17,0,56,45,18,0,63
41523,372,"ŞCOALA GIMNAZIALĂ MOIECIU DE SUS","MOIECIU DE SUS",BV,768,1,0,0,1,4,10,0,14,4,13,0,17,9,25,0,34,11,28,0,39
41532,373,"ŞCOALA GIMNAZIALĂ PEȘTERA",PEŞTERA,BV,364,0,0,0,0,9,4,0,13,28,6,0,34,29,6,0,35,29,7,0,36
41514,374,"ŞCOALA GIMNAZIALĂ MĂGURA",MĂGURA,BV,428,2,1,0,3,3,1,0,4,4,2,0,6,8,4,0,12,15,4,0,19
41550,375,"DISPENSAR MEDICAL ORMENIŞ",ORMENIŞ,BV,1555,3,0,0,3,9,3,0,12,22,4,0,26,31,4,0,35,32,4,0,36
41587,376,"CĂMINUL CULTURAL PĂRĂU",PĂRĂU,BV,506,4,0,0,4,8,0,0,8,13,2,0,15,14,2,0,16,14,2,0,16
41596,377,"ŞCOALA PRIMARĂ GRID",GRID,BV,250,4,0,0,4,5,5,0,10,5,7,0,12,7,7,0,14,7,7,0,14
41603,378,"CLĂDIREA FOSTEI PRIMĂRII","VENEŢIA DE JOS",BV,577,8,0,0,8,12,0,0,12,17,2,0,19,19,3,0,22,19,3,0,22
41612,379,"CLĂDIREA FOSTEI PRIMĂRII","VENEŢIA DE SUS",BV,368,2,5,0,7,5,6,0,11,9,6,0,15,20,8,0,28,26,8,0,34
41630,380,"ȘCOALA GIMNAZIALĂ NR.1 CORP A2","POIANA MĂRULUI",BV,1266,12,0,0,12,31,5,0,36,41,6,0,47,61,8,0,69,68,8,0,76
41630,381,"ȘCOALĂ GIMNAZIALĂNR.1 CORP B","POIANA MĂRULUI",BV,1117,2,2,0,4,10,2,0,12,22,2,0,24,40,3,0,43,47,4,0,51
41630,382,"ȘCOALĂ GIMNAZIALĂ NR. 2ÎNTRE-VAI","POIANA MĂRULUI",BV,278,4,4,0,8,5,4,0,9,5,4,0,9,6,5,0,11,7,5,0,12
41676,383,"ȘCOALA GIMNAZIALĂ PREJMER, STR.ȘCOLII, NR.1, CORP A, PARTER",PREJMER,BV,1603,3,1,0,4,19,4,0,23,27,6,0,33,35,8,0,43,36,8,0,44
41676,384,"ȘCOALA GIMNAZIALĂ PREJMER, STR.ȘCOLII, NR.1, CORP A, PARTER",PREJMER,BV,1815,8,0,0,8,25,2,0,27,41,2,0,43,59,5,0,64,63,5,0,68
41676,385,"ȘCOALA GIMNAZIALĂ PREJMER, STR.ȘCOLII, NR.1, CORP A, PARTER",PREJMER,BV,1721,7,3,0,10,32,7,0,39,38,7,0,45,44,7,0,51,50,7,0,57
41685,386,"SCOALA GIMNAZIALA LUNCA CALNICULUI SAT","LUNCA CALNICULUI",BV,1271,6,2,0,8,13,6,0,19,24,7,0,31,46,8,0,54,47,8,0,55
41685,387,"SCOALA GIMNAZIALA LUNCA CALNICULUI COLONIE","LUNCA CALNICULUI",BV,1330,6,5,0,11,28,6,0,34,54,7,0,61,72,8,0,80,75,8,0,83
41729,388,"CAMIN CULTURAL",MATEIAŞ,BV,393,5,0,0,5,8,3,0,11,10,3,0,13,10,4,0,14,10,4,0,14
41710,389,"SCOALA GENERALA „BETHLEN SAMUEL”",RACOŞ,BV,1092,0,1,0,1,6,1,0,7,6,1,0,7,6,1,0,7,6,1,0,7
41710,390,"PRIMĂRIA COMUNEI RACOS",RACOŞ,BV,1028,1,0,0,1,8,1,0,9,12,1,0,13,14,1,0,15,15,1,0,16
41747,391,"CĂMINUL CULTURAL RECEA",RECEA,BV,1584,2,2,0,4,14,4,0,18,24,9,0,33,36,12,0,48,51,15,0,66
41756,392,"GRĂDINIŢA BERIVOI",BERIVOI,BV,471,4,1,0,5,9,5,0,14,12,7,0,19,14,9,0,23,18,10,0,28
41809,393,"CĂMINUL CULTURAL SĂVĂSTRENI",SĂVĂSTRENI,BV,568,2,1,0,3,5,1,0,6,11,1,0,12,20,5,0,25,20,7,0,27
42361,394,"SCOALA GENERALA","SÂMBĂTA DE SUS",BV,1304,28,6,0,34,43,10,0,53,52,14,0,66,67,16,0,83,76,16,0,92
41934,395,"ŞCOALA GIMNAZIALĂ SÂNPETRU",SÎNPETRU,BV,1516,7,1,0,8,23,4,0,27,36,6,0,42,57,8,0,65,65,10,0,75
41934,396,"GRADINITA CU PROGRAM NORMAL 4ORE SANPETRU",SÎNPETRU,BV,1493,7,0,0,7,32,4,0,36,40,9,0,49,55,14,0,69,62,19,0,81
41934,397,"CĂMINUL CULTURAL AL BISERICII ORTODOXE",SÎNPETRU,BV,1452,8,3,0,11,31,6,0,37,52,6,0,58,81,7,0,88,73,7,0,80
41827,398,"CĂMIN CULTURAL ŞERCAIA",ŞERCAIA,BV,1405,2,1,0,3,8,1,0,9,11,2,0,13,20,3,0,23,25,3,0,28
41845,399,"CĂMIN CULTURAL VAD",VAD,BV,447,4,0,0,4,12,1,0,13,16,1,0,17,26,2,0,28,34,3,0,37
41836,400,"FOSTUL SEDIU CAP",HĂLMEAG,BV,401,0,2,0,2,2,2,0,4,7,2,0,9,11,2,0,13,11,2,0,13
41916,401,"ȘCOALĂ GENERALĂ",VÂLCEA,BV,180,1,0,0,1,2,0,0,2,8,1,0,9,8,1,0,9,10,1,0,11
41872,402,"CĂMINUL CULTURAL",BUCIUM,BV,213,2,1,0,3,3,1,0,4,7,4,0,11,8,5,0,13,9,7,0,16
41881,403,"CĂMINUL CULTURAL",OHABA,BV,274,1,3,0,4,7,6,0,13,9,6,0,15,12,11,0,23,15,11,0,26
41890,404,"CĂMINUL CULTURAL",PERŞANI,BV,884,5,2,0,7,15,4,0,19,17,4,0,21,33,5,0,38,34,6,0,40
41907,405,"CĂMINUL CULTURAL",ŞERCĂIŢA,BV,575,7,2,0,9,15,5,0,20,18,6,0,24,24,7,0,31,25,8,0,33
41863,406,PRIMĂRIE,"ŞINCA VECHE",BV,708,1,2,0,3,2,2,0,4,8,6,0,14,13,8,0,21,15,8,0,23
41658,407,"CĂMINUL CULTURAL","ŞINCA NOUĂ",BV,964,14,1,0,15,40,4,0,44,59,6,0,65,77,9,0,86,83,9,0,92
41658,408,"ȘCOALĂ GENERALĂ","ŞINCA NOUĂ",BV,182,1,0,0,1,1,0,0,1,2,1,0,3,7,5,0,12,7,5,0,12
41649,409,"ȘCOALA PRIMARĂ PALTIN",PALTIN,BV,136,2,0,0,2,6,1,0,7,8,3,0,11,9,5,0,14,10,7,0,17
41952,410,"PRIMĂRIA COMUNEI ȘOARȘ",ŞOARŞ,BV,499,4,1,0,5,13,1,0,14,16,2,0,18,16,2,0,18,16,2,0,18
41970,411,"ȘCOALA GENERALĂ FELMER",FELMER,BV,376,12,5,0,17,20,6,0,26,21,8,0,29,28,10,0,38,28,10,0,38
41961,412,"ȘCOALA GENERALĂ BĂRCUT",BĂRCUT,BV,346,7,1,0,8,8,1,0,9,12,1,0,13,12,1,0,13,14,3,0,17
41989,413,"ȘCOALA GENERALĂ RODBAV",RODBAV,BV,259,0,0,0,0,2,0,0,2,4,1,0,5,5,2,0,7,7,3,0,10
41998,414,"CĂMINUL CULTURAL ORTODOX SELIȘTAT",SELIŞTAT,BV,173,2,2,0,4,2,4,0,6,4,4,0,8,5,4,0,9,5,4,0,9
42012,415,"CAMIN CULTURAL",TĂRLUNGENI,BV,1712,9,3,0,12,17,5,0,22,17,9,0,26,43,9,0,52,53,10,0,63
42012,416,"GRADINITA PROGRAM PRELUNGIT",TĂRLUNGENI,BV,1837,7,0,0,7,16,1,0,17,20,2,0,22,35,2,0,37,37,2,0,39
42030,417,"SCOALA GENERALA PURCARENI",PURCĂRENI,BV,1241,6,1,0,7,17,1,0,18,31,1,0,32,37,3,0,40,40,6,0,46
42049,418,"SCOALA GENERALA ZIZIN",ZIZIN,BV,1000,7,4,0,11,14,4,0,18,18,4,0,22,25,4,0,29,26,4,0,30
42049,419,"SCOALA GENERALA ZIZIN",ZIZIN,BV,1091,7,0,0,7,12,0,0,12,21,4,0,25,27,4,0,31,30,4,0,34
42021,420,"SCOALA GENERALA CARPINIS",CĂRPINIŞ,BV,402,6,2,0,8,17,3,0,20,22,4,0,26,27,7,0,34,31,11,0,42
42067,421,"ȘCOALĂ GENERALĂ TELIU",TELIU,BV,1321,0,3,0,3,1,4,0,5,15,5,0,20,16,8,0,24,16,8,0,24
42067,422,"CĂMINUL CULTURAL TELIU",TELIU,BV,1073,2,0,0,2,7,0,0,7,13,0,0,13,16,1,0,17,18,3,0,21
42067,423,"ȘCOALĂ GENERALĂ TELIU VALE",TELIU,BV,800,0,1,0,1,2,3,0,5,4,3,0,7,4,6,0,10,7,6,0,13
42085,424,"CĂMINUL CULTURAL TICUŞU VECHI","TICUŞU VECHI",BV,584,0,1,0,1,1,1,0,2,2,1,0,3,5,1,0,6,6,2,0,8
42094,425,"ŞCOALA PRIMARĂ COBOR",COBOR,BV,186,0,1,0,1,0,1,0,1,1,3,0,4,1,3,0,4,1,3,0,4
42110,426,"SEDIUL PRIMARIEI COMUNEI UCEA","UCEA DE JOS",BV,698,6,4,0,10,14,6,0,20,15,6,0,21,23,9,0,32,27,9,0,36
42147,427,"CAMINUL CULTURAL UCEA DE SUS","UCEA DE SUS",BV,822,11,0,0,11,22,4,0,26,26,7,0,33,43,12,0,55,43,13,0,56
42138,428,"CAMINUL CULTURALFELDIOARA",FELDIOARA,BV,173,0,0,0,0,1,2,0,3,4,6,0,10,4,6,0,10,4,6,0,10
42129,429,"CAMINUL CULTURAL CORBI",CORBI,BV,166,0,0,0,0,0,0,0,0,2,1,0,3,5,3,0,8,7,3,0,10
42165,430,"ŞCOALA GENERALĂ UNGRA",UNGRA,BV,1097,11,0,0,11,13,0,0,13,15,0,0,15,19,1,0,20,19,1,0,20
42174,431,"GRĂDINIŢA DĂIŞOARA",DĂIŞOARA,BV,577,7,2,0,9,10,2,0,12,15,3,0,18,26,4,0,30,27,4,0,31
42192,432,"ANEXĂ PRIMARIE","VAMA BUZĂULUI",BV,1354,6,3,0,9,12,4,0,16,22,5,0,27,25,6,0,31,30,6,0,36
42209,433,"CENTRUL LOCAL DE INFORMARE ȘI PROMOVARE TURISTICĂ VAMA BUZĂULUI",ACRIŞ,BV,959,2,0,0,2,3,6,0,9,6,11,0,17,8,11,0,19,9,11,0,20
42218,434,"ŞCOALA PRIMARĂ BUZĂIEL",BUZĂIEL,BV,458,2,4,0,6,8,4,0,12,9,4,0,13,9,4,0,13,9,4,0,13
42245,435,"PRIMĂRIA COMUNEI VIŞTEA","VIŞTEA DE JOS",BV,631,4,3,0,7,9,3,0,12,14,4,0,18,21,5,0,26,23,5,0,28
42281,436,"GRĂDINIŢA VIŞTEA DE SUS","VIŞTEA DE SUS",BV,490,1,4,0,5,16,6,0,22,23,8,0,31,27,8,0,35,28,11,0,39
42263,437,"ŞCOALA GENERALĂ OLTEŢ",OLTEŢ,BV,291,1,0,0,1,2,4,0,6,2,4,0,6,6,4,0,10,7,5,0,12
42272,438,"GRADINIŢA RUCĂR",RUCĂR,BV,323,7,3,0,10,9,3,0,12,11,3,0,14,12,3,0,15,12,5,0,17
42316,439,"PRIMARIA VOILA",VOILA,BV,622,3,1,0,4,8,2,0,10,17,3,0,20,23,3,0,26,27,4,0,31
42325,440,"CAMINUL CULTURAL CINCSOR",CINCŞOR,BV,654,0,0,0,0,2,3,0,5,5,6,0,11,7,7,0,14,14,9,0,23
42334,441,"CAMINUL CULTURAL DRIDIF",DRIDIF,BV,340,6,0,0,6,15,2,0,17,15,6,0,21,19,11,0,30,23,13,0,36
42343,442,"CAMINUL CULTURAL LUDISOR",LUDIŞOR,BV,152,0,0,0,0,2,1,0,3,2,5,0,7,7,7,0,14,7,7,0,14
42352,443,"CAMINUL CULTURAL SAMBATA DE JOS","SÂMBĂTA DE JOS",BV,427,1,0,0,1,3,0,0,3,7,1,0,8,10,4,0,14,11,4,0,15
42389,444,"CAMINUL CULTURAL VOIVODENII MARI",VOIVODENI,BV,347,4,0,0,4,6,0,0,6,10,1,0,11,15,4,0,19,18,4,0,22
42405,445,"CAMINUL CULTURAL VULCAN",VULCAN,BV,1682,9,1,0,10,38,4,0,42,50,5,0,55,76,6,0,82,97,7,0,104
42405,446,"CAMINUL CULTURAL VULCAN",VULCAN,BV,1579,2,0,0,2,7,0,0,7,14,0,0,14,24,0,0,24,26,0,0,26
42414,447,"CAMINUL CULTURAL 1 MAI","COLONIA 1 MAI",BV,678,6,1,0,7,19,1,0,20,20,2,0,22,38,2,0,40,44,4,0,48
41934,448,"GRADINITA CU PROGRAM NORMAL 8 ORESÎNPETRU",SÎNPETRU,BV,1469,7,1,0,8,26,1,0,27,43,4,0,47,61,4,0,65,70,6,0,76
40376,449,"GRUP ȘCOLAR INDUSTRIAL RÂȘNOV",RÂŞNOV,BV,1035,13,0,0,13,23,0,0,23,38,4,0,42,51,4,0,55,53,4,0,57
44827,1,"ŞCOALA GIMNAZIALĂ ""EP.DIONISIE ROMANO""",BUZĂU,BZ,1556,34,1,0,35,74,3,0,77,102,11,0,113,123,13,0,136,134,13,0,147
44827,2,"ŞCOALA GIMNAZIALĂ NR.11",BUZĂU,BZ,1391,19,1,0,20,53,3,0,56,71,3,0,74,96,5,0,101,105,5,0,110
44827,3,"ŞCOALA GIMNAZIALĂ NR.11",BUZĂU,BZ,1599,17,0,0,17,70,2,0,72,94,2,0,96,118,2,0,120,133,3,0,136
44827,4,"ŞCOALA GIMNAZIALĂ NR.11",BUZĂU,BZ,1681,23,1,0,24,82,1,0,83,121,1,0,122,147,3,0,150,159,3,0,162
44827,5,"ŞCOALA GIMNAZIALĂ NR.11",BUZĂU,BZ,1477,23,1,0,24,59,1,14,74,86,1,14,101,107,3,14,124,117,3,14,134
44827,6,"DIRECŢIA DE ASISTENŢĂ SOCIALĂ",BUZĂU,BZ,1063,23,2,0,25,41,5,0,46,54,6,0,60,75,7,0,82,86,7,0,93
44827,7,"DIRECŢIA DE ASISTENŢĂ SOCIALĂ",BUZĂU,BZ,1137,16,0,0,16,43,1,0,44,49,1,0,50,60,2,0,62,67,2,0,69
44827,8,"LICEUL TEHNOLOGIC ""GRIGORE MOISIL""",BUZĂU,BZ,1651,22,4,0,26,45,4,0,49,67,5,0,72,88,5,0,93,96,5,0,101
44827,9,"LICEUL TEHNOLOGIC ""GRIGORE MOISIL""",BUZĂU,BZ,1455,15,4,0,19,30,5,0,35,40,7,0,47,55,8,0,63,63,8,0,71
44827,10,"LICEUL TEHNOLOGIC ""GRIGORE MOISIL""",BUZĂU,BZ,1321,12,0,0,12,32,1,0,33,51,1,0,52,60,1,0,61,72,1,0,73
44827,11,"LICEUL TEHNOLOGIC ""GRIGORE MOISIL""",BUZĂU,BZ,1488,12,5,0,17,36,6,0,42,54,7,0,61,71,7,0,78,87,7,0,94
44827,12,"COLEGIULUNIVERSITAR ECONOMIC",BUZĂU,BZ,1639,13,0,0,13,33,0,0,33,50,0,0,50,78,4,0,82,87,4,0,91
44827,13,"ŞCOALA GIMNAZIALĂ NR. 7",BUZĂU,BZ,1823,15,2,0,17,37,2,0,39,57,2,0,59,68,3,0,71,80,4,0,84
44827,14,"ŞCOALA GIMNAZIALĂ NR. 7",BUZĂU,BZ,1781,17,3,0,20,58,3,0,61,87,5,0,92,108,6,0,114,113,6,0,119
44827,15,"ŞCOALA GIMNAZIALĂ ""GENERAL GRIGORE BAŞTAN""",BUZĂU,BZ,974,5,0,0,5,18,6,0,24,31,6,0,37,41,7,0,48,52,8,0,60
44827,16,"ŞCOALA GIMNAZIALĂ ""GENERAL GRIGORE BAŞTAN""",BUZĂU,BZ,948,11,6,0,17,19,8,0,27,31,8,0,39,49,10,0,59,54,10,0,64
44827,17,"ŞCOALA GIMNAZIALĂ ""GENERAL GRIGORE BAŞTAN""",BUZĂU,BZ,1779,19,0,0,19,43,0,0,43,59,0,0,59,90,1,0,91,101,2,0,103
44827,18,"ŞCOALA GIMNAZIALĂ ""GENERAL GRIGORE BAŞTAN""",BUZĂU,BZ,1309,8,0,0,8,20,1,0,21,37,1,0,38,46,1,0,47,50,5,0,55
44827,19,"LICEUL TEORETIC ""ALEXANDRU MARGHILOMAN""",BUZĂU,BZ,1398,7,2,0,9,20,3,0,23,37,3,0,40,68,7,0,75,68,8,0,76
44827,20,"LICEUL TEORETIC ""ALEXANDRU MARGHILOMAN""",BUZĂU,BZ,1299,9,1,0,10,29,3,0,32,42,3,0,45,65,5,0,70,77,5,0,82
44827,21,"LICEUL TEORETIC ""ALEXANDRU MARGHILOMAN""",BUZĂU,BZ,1427,17,0,0,17,41,0,0,41,58,5,0,63,72,7,0,79,75,7,0,82
44827,22,"LICEUL TEHNOLOGIC ""HENRI COANDĂ""",BUZĂU,BZ,1375,7,0,0,7,21,0,0,21,30,4,0,34,33,4,0,37,36,5,0,41
44827,23,"LICEUL TEHNOLOGIC ""HENRI COANDĂ""",BUZĂU,BZ,1312,3,3,0,6,4,3,0,7,16,3,0,19,26,3,0,29,28,3,0,31
44827,24,"LICEUL TEHNOLOGIC ""HENRI COANDĂ""",BUZĂU,BZ,1172,12,3,0,15,32,4,17,53,39,5,17,61,57,5,17,79,62,5,17,84
44827,25,"LICEUL TEHNOLOGIC ""HENRI COANDĂ""",BUZĂU,BZ,1368,8,0,0,8,23,0,0,23,32,0,0,32,48,0,0,48,49,3,0,52
44827,26,"ŞCOALA GIMNAZIALĂ ""ION CREANGĂ""",BUZĂU,BZ,1624,16,3,0,19,44,4,0,48,54,4,0,58,71,5,0,76,75,5,0,80
44827,27,"ŞCOALA GIMNAZIALĂ ""ION CREANGĂ""",BUZĂU,BZ,1401,16,5,0,21,32,5,0,37,52,5,0,57,67,5,0,72,71,5,0,76
44827,28,"ŞCOALA GIMNAZIALĂ ""ION CREANGĂ""",BUZĂU,BZ,1655,22,0,0,22,58,1,0,59,88,2,0,90,105,3,0,108,113,3,0,116
44827,29,"ŞCOALA GIMNAZIALĂ ""ION CREANGĂ""",BUZĂU,BZ,1394,24,1,0,25,44,1,0,45,53,1,0,54,68,1,0,69,76,1,0,77
44827,30,"COLEGIUL TEHNIC",BUZĂU,BZ,857,9,1,0,10,34,2,0,36,44,2,0,46,62,2,0,64,66,2,0,68
44827,31,"COLEGIUL TEHNIC",BUZĂU,BZ,941,5,0,0,5,30,3,0,33,41,4,0,45,47,4,0,51,48,4,0,52
44827,32,"LICEUL DE ARTE ""MARGARETA STERIAN""",BUZĂU,BZ,1527,13,5,0,18,46,6,0,52,58,7,0,65,75,7,0,82,85,8,0,93
44827,33,"COLEGIUL NAŢIONAL ""B.P. HAŞDEU""",BUZĂU,BZ,1413,15,5,0,20,36,8,0,44,54,10,0,64,68,11,1,80,74,11,1,86
44827,34,"ŞCOALA GIMNAZIALĂ ""P.H. ZANGOPOL""",BUZĂU,BZ,1016,9,0,0,9,16,1,0,17,27,1,0,28,36,3,0,39,40,4,0,44
44827,35,"ŞCOALA GIMNAZIALĂ ""P.H. ZANGOPOL""",BUZĂU,BZ,1258,14,0,0,14,41,0,0,41,53,0,0,53,65,0,0,65,71,0,0,71
44827,36,"ŞCOALA GIMNAZIALĂ ""P.H. ZANGOPOL""",BUZĂU,BZ,1595,12,0,0,12,42,0,0,42,58,4,0,62,74,10,1,85,84,10,1,95
44827,37,"LICEUL TEHNOLOGIC ""DIMITRIE FILIPESCU""",BUZĂU,BZ,1451,12,0,0,12,33,0,0,33,48,0,0,48,63,0,0,63,68,0,0,68
44827,38,"LICEUL TEHNOLOGIC ""DIMITRIE FILIPESCU""",BUZĂU,BZ,1533,10,0,0,10,16,3,0,19,25,4,0,29,36,4,0,40,46,4,0,50
44827,39,"COLEGIUL AGRICOL ""DR. C. ANGELESCU""",BUZĂU,BZ,1385,16,3,0,19,40,7,0,47,61,8,0,69,84,9,0,93,90,11,0,101
44827,40,"ŞCOALA GIMNAZIALĂ ""N.CONSTANTINESCU""",BUZĂU,BZ,1063,10,3,0,13,36,4,0,40,49,6,0,55,66,6,0,72,72,6,0,78
44827,41,"ŞCOALA GIMNAZIALĂ ""N.CONSTANTINESCU""",BUZĂU,BZ,985,9,3,0,12,25,3,0,28,41,4,0,45,59,8,0,67,59,8,0,67
44827,42,"ŞCOALA GIMNAZIALĂ ""N.CONSTANTINESCU""",BUZĂU,BZ,1685,15,0,0,15,46,1,0,47,62,1,0,63,80,1,0,81,93,1,0,94
44827,43,"GRĂDINIŢA CU PROGRAM PRELUNGIT NR. 8",BUZĂU,BZ,1017,10,0,0,10,30,0,0,30,52,0,0,52,69,0,0,69,73,0,0,73
44827,44,"GRĂDINIŢA CU PROGRAM PRELUNGIT NR. 8",BUZĂU,BZ,850,9,0,0,9,28,0,0,28,44,0,0,44,60,1,0,61,62,2,0,64
44827,45,"GRĂDINIŢA CU PROGRAM PRELUNGIT NR. 8",BUZĂU,BZ,1662,22,3,0,25,58,5,0,63,86,5,0,91,117,8,0,125,127,8,0,135
44827,46,"COLEGIUL NAŢIONAL ""M. EMINESCU""",BUZĂU,BZ,1677,12,4,0,16,37,11,0,48,56,12,0,68,78,12,0,90,87,13,0,100
44827,47,"COLEGIUL NAŢIONAL ""M. EMINESCU""",BUZĂU,BZ,1527,16,4,0,20,56,4,0,60,80,4,1,85,95,4,1,100,99,4,1,104
44827,48,"LICEUL PEDAGOGIC “SPIRU HARET”",BUZĂU,BZ,1729,24,0,0,24,61,4,0,65,89,4,0,93,112,4,0,116,140,4,0,144
44827,49,"GRĂDINIŢA CU PROGRAM PRELUNGIT NR. 1",BUZĂU,BZ,947,2,0,0,2,33,4,0,37,40,6,0,46,55,6,0,61,55,9,0,64
44827,50,"LICEUL PEDAGOGIC ""SPIRU HARET""",BUZĂU,BZ,1416,11,0,0,11,46,3,0,49,71,3,0,74,108,5,0,113,117,5,0,122
44827,51,"LICEUL PEDAGOGIC ""SPIRU HARET""",BUZĂU,BZ,1204,18,4,0,22,70,6,0,76,93,8,0,101,113,8,0,121,119,8,0,127
44827,52,"ŞCOALA GIMNAZIALĂ ""DR. GEORGE EMIL PALADE""",BUZĂU,BZ,1547,13,1,0,14,49,1,0,50,65,1,0,66,94,6,0,100,102,6,0,108
44827,53,"ŞCOALA GIMNAZIALĂ ""DR. GEORGE EMIL PALADE""",BUZĂU,BZ,1309,12,0,0,12,45,0,0,45,61,4,0,65,87,4,0,91,94,6,0,100
44827,54,"ŞCOALA GIMNAZIALĂ ""DR. GEORGE EMIL PALADE""",BUZĂU,BZ,1584,28,2,0,30,67,5,0,72,79,8,0,87,106,11,0,117,110,11,0,121
44827,55,"ŞCOALA GIMNAZIALĂ ""DR. GEORGE EMIL PALADE""",BUZĂU,BZ,1143,18,0,0,18,49,0,0,49,73,1,0,74,90,3,0,93,102,8,0,110
44827,56,"ŞCOALA GIMNAZIALĂ ""DR. GEORGE EMIL PALADE""",BUZĂU,BZ,1230,13,0,0,13,35,2,0,37,50,2,0,52,70,6,0,76,71,6,0,77
44827,57,"COLEGIUL ECONOMIC",BUZĂU,BZ,1170,19,0,0,19,68,0,0,68,94,0,0,94,113,3,0,116,122,4,0,126
44827,58,"ŞCOALA GIMNAZIALĂ ""CPT. AV. MIRCEA T. BĂDULESCU""",BUZĂU,BZ,1304,14,0,0,14,57,6,0,63,88,12,0,100,112,15,0,127,124,18,0,142
44827,59,"ŞCOALA GIMNAZIALĂ ""CPT. AV. MIRCEA T. BĂDULESCU""",BUZĂU,BZ,1494,15,2,0,17,51,3,0,54,65,3,0,68,81,8,0,89,100,8,0,108
44827,60,"ŞCOALA GIMNAZIALĂ ""CPT. AV. MIRCEA T. BĂDULESCU""",BUZĂU,BZ,1011,5,1,0,6,20,1,0,21,37,1,0,38,56,1,0,57,61,1,0,62
44827,61,"ŞCOALA GIMNAZIALĂ ""CPT. AV. MIRCEA T. BĂDULESCU""",BUZĂU,BZ,1317,11,5,0,16,54,5,0,59,69,5,0,74,88,5,0,93,94,5,0,99
44827,62,"GRĂDINIŢA CU PROGRAM PRELUNGIT NR.4",BUZĂU,BZ,1351,16,4,0,20,58,5,0,63,70,6,0,76,99,8,0,107,109,8,0,117
44827,63,"ŞCOALA GIMNAZIALĂ “N.TITULESCU”",BUZĂU,BZ,1324,13,0,0,13,45,0,0,45,59,0,0,59,88,2,0,90,96,2,0,98
44827,64,"ŞCOALA GIMNAZIALĂ “N.TITULESCU”",BUZĂU,BZ,1474,14,5,0,19,35,7,0,42,46,8,0,54,75,8,0,83,82,8,0,90
44827,65,"ŞCOALA GIMNAZIALĂ ""SF.APOSTOL ANDREI""",BUZĂU,BZ,1351,14,7,0,21,43,8,0,51,52,10,0,62,69,12,30,111,74,13,30,117
44827,66,"ŞCOALA GIMNAZIALĂ ""SF.APOSTOL ANDREI""",BUZĂU,BZ,1448,40,0,0,40,70,4,0,74,84,4,0,88,97,4,0,101,98,5,0,103
44827,67,"ŞCOALA GIMNAZIALĂ ""SF.APOSTOL ANDREI""",BUZĂU,BZ,1588,17,3,0,20,56,4,0,60,76,6,0,82,101,7,0,108,110,8,0,118
44827,68,"ŞCOALA GIMNAZIALĂ ""SF.APOSTOL ANDREI""",BUZĂU,BZ,1748,32,7,0,39,79,8,0,87,104,8,0,112,131,8,0,139,140,8,0,148
44827,69,"LICEUL CU PROGRAM SPORTIV ""I.BALAŞ-SÖTER""",BUZĂU,BZ,965,16,2,0,18,37,3,0,40,45,3,0,48,51,4,0,55,57,5,0,62
44827,70,"LICEUL CU PROGRAM SPORTIV “I.BALAŞ- SÖTER ”",BUZĂU,BZ,1319,19,0,0,19,45,0,0,45,53,0,0,53,68,0,0,68,81,0,0,81
44827,71,"LICEUL CU PROGRAM SPORTIV “I.BALAŞ- SÖTER ”",BUZĂU,BZ,1111,4,1,0,5,31,1,0,32,44,2,0,46,49,2,0,51,65,2,0,67
44827,72,"GRĂDINIŢA CU PROGRAM PRELUNGIT ""BOBOCEII DIN MICRO III""",BUZĂU,BZ,1443,24,4,0,28,51,5,0,56,72,6,0,78,105,6,0,111,115,7,0,122
44827,73,"SEMINARUL TEOLOGIC ORTODOX ""CHESARIE EPISCOPUL""",BUZĂU,BZ,1501,12,1,0,13,36,4,0,40,54,6,0,60,65,10,0,75,81,10,0,91
44827,74,"SEMINARUL TEOLOGIC ORTODOX ""CHESARIE EPISCOPUL""",BUZĂU,BZ,1690,16,2,0,18,43,3,0,46,58,3,0,61,84,3,0,87,92,11,0,103
44827,75,"LICEUL TEHNOLOGIC ""COSTIN NENIŢESCU""",BUZĂU,BZ,1956,6,0,0,6,11,3,0,14,24,3,0,27,37,4,0,41,44,5,0,49
44827,76,"LICEUL TEHNOLOGIC MESERII ŞI SERVICII",BUZĂU,BZ,1466,2,4,0,6,20,5,0,25,32,5,0,37,43,5,0,48,46,5,0,51
44827,77,"LICEUL TEHNOLOGIC MESERII ŞI SERVICII",BUZĂU,BZ,1211,6,0,0,6,15,0,0,15,26,0,0,26,38,0,0,38,42,1,0,43
44827,78,"ŞCOALA GIMNAZIALĂ “ M. KOGĂLNICEANU”",BUZĂU,BZ,1629,7,0,0,7,27,1,0,28,40,4,0,44,53,5,0,58,62,7,0,69
44827,79,"ŞCOALA GIMNAZIALĂ “ M. KOGĂLNICEANU”",BUZĂU,BZ,1736,7,0,0,7,21,1,0,22,28,1,0,29,37,1,0,38,37,1,0,38
44827,80,"ŞCOALA GIMNAZIALĂ “ M. KOGĂLNICEANU”",BUZĂU,BZ,1658,5,0,0,5,10,1,0,11,18,1,0,19,24,2,0,26,35,2,0,37
44854,81,"CENTRUL DE RECUPERARE PENTRU COPII CU DIZABILITĂŢI","RÂMNICU SĂRAT",BZ,1937,9,0,0,9,46,2,0,48,76,2,0,78,101,3,0,104,109,3,0,112
44854,82,"ŞCOALA GIMNAZIALĂ ""DR. ILIE PAVEL""","RÂMNICU SĂRAT",BZ,1740,2,0,0,2,10,0,0,10,20,0,0,20,77,0,0,77,87,0,0,87
44854,83,"ŞCOALA GIMNAZIALĂ ""VASILE CRISTOFOREANU""","RÂMNICU SĂRAT",BZ,1609,23,4,0,27,68,7,0,75,79,9,0,88,110,9,0,119,112,9,0,121
44854,84,"ŞCOALA GIMNAZIALĂ ""VASILE CRISTOFOREANU""","RÂMNICU SĂRAT",BZ,1620,26,48,0,74,60,51,0,111,73,53,0,126,97,55,0,152,106,55,0,161
44854,85,"ŞCOALA GIMNAZIALĂ ""VASILE CRISTOFOREANU""","RÂMNICU SĂRAT",BZ,1488,27,3,0,30,62,8,0,70,80,9,0,89,102,9,0,111,114,9,0,123
44854,86,"GRĂDINIŢA CU PROGRAM NORMAL ""ORIZONT""","RÂMNICU SĂRAT",BZ,1534,25,0,0,25,58,3,0,61,73,5,0,78,98,8,0,106,111,8,0,119
44854,87,"LICEUL TEHNOLOGIC ""VICTOR FRUNZĂ""","RÂMNICU SĂRAT",BZ,1657,18,0,0,18,41,1,0,42,52,2,0,54,67,3,0,70,81,3,0,84
44854,88,"LICEUL TEHNOLOGIC ""VICTOR FRUNZĂ""","RÂMNICU SĂRAT",BZ,1371,11,4,0,15,52,5,0,57,83,6,0,89,100,6,44,150,111,8,44,163
44854,89,"COLEGIUL NAŢIONAL ""ALEXANDRU VLAHUŢĂ""","RÂMNICU SĂRAT",BZ,1192,18,5,0,23,63,7,0,70,82,7,0,89,98,9,0,107,104,10,0,114
44854,90,"COLEGIUL NAŢIONAL ""ALEXANDRU VLAHUŢĂ""","RÂMNICU SĂRAT",BZ,1348,16,5,0,21,42,9,0,51,63,11,1,75,73,14,1,88,78,14,1,93
44854,91,"GRĂDINIŢA CU PROGRAM PRELUNGIT ""MUGURAŞII""","RÂMNICU SĂRAT",BZ,1497,12,4,0,16,45,9,0,54,58,10,0,68,87,10,0,97,97,10,0,107
44854,92,"GRĂDINIŢA CU PROGRAM PRELUNGIT ""LUMEA COPILĂRIEI""","RÂMNICU SĂRAT",BZ,1688,19,0,0,19,64,0,0,64,83,0,0,83,112,0,0,112,128,0,0,128
44854,93,"GRĂDINIŢA CU PROGRAM PRELUNGIT ""LUMEA COPILĂRIEI""","RÂMNICU SĂRAT",BZ,1811,17,1,0,18,44,2,0,46,65,2,0,67,81,4,0,85,89,5,0,94
44854,94,"ŞCOALA GIMNAZIALĂ NR. 6","RÂMNICU SĂRAT",BZ,1910,17,1,0,18,62,7,0,69,90,8,0,98,117,9,0,126,117,9,0,126
44854,95,"LICEUL TEORETIC ""ŞTEFAN CEL MARE""","RÂMNICU SĂRAT",BZ,1227,5,2,0,7,26,2,0,28,39,2,0,41,58,2,0,60,72,2,0,74
44854,96,"CANTINA DE AJUTOR SOCIAL","RÂMNICU SĂRAT",BZ,1340,21,4,0,25,52,4,0,56,70,4,0,74,103,4,0,107,116,4,0,120
44854,97,"ŞCOALA GIMNAZIALĂ NR. 1","RÂMNICU SĂRAT",BZ,1188,14,1,0,15,41,1,1,43,60,4,1,65,74,5,8,87,82,7,8,97
44854,98,"ŞCOALA GIMNAZIALĂ NR. 2","RÂMNICU SĂRAT",BZ,1795,14,0,0,14,46,2,16,64,63,8,16,87,86,9,16,111,94,10,16,120
44854,99,"S.C. RAFINĂRIA VENUS OILREG S.A.","RÂMNICU SĂRAT",BZ,1890,12,4,0,16,39,8,0,47,55,11,0,66,69,11,0,80,78,12,0,90
44854,100,"GRĂDINIŢA CU PROGRAM PRELUNGIT NR.2","RÂMNICU SĂRAT",BZ,1508,18,0,0,18,51,0,0,51,78,1,0,79,79,2,0,81,84,2,0,86
44854,101,"LICEUL ECONOMIC ""ELINA MATEI BASARAB""","RÂMNICU SĂRAT",BZ,1549,17,0,0,17,44,0,0,44,63,0,0,63,83,5,0,88,89,5,0,94
47925,102,"CASA DE CULTURĂ GEORGE BĂICULESCU NEHOIU",NEHOIU,BZ,1161,7,1,0,8,27,2,0,29,34,3,0,37,46,5,0,51,52,5,0,57
47925,103,"GRUP SCOLAR TEHNIC NEHOIU STR. SCOLII",NEHOIU,BZ,1059,6,0,0,6,25,0,0,25,36,1,4,41,52,3,4,59,53,3,4,60
47925,104,"SALA DE SPORT A ORASULUI",NEHOIU,BZ,682,7,3,0,10,16,3,0,19,23,3,0,26,32,3,3,38,33,3,3,39
47925,105,"CĂMIN CULTURAL BĂDÂRLEGI",NEHOIU,BZ,105,2,3,0,5,3,3,0,6,3,3,0,6,6,3,0,9,6,3,0,9
47925,106,"CLĂDIREA FOSTA SECŢIE CONFECŢIONAT ÎNCĂLŢĂMINTE DÂMBOVIŢA (LÂNGĂ BISERICA ORTODOXĂ) STR. VALEA NEHOIULUI",NEHOIU,BZ,562,4,2,0,6,16,3,0,19,21,8,0,29,23,8,0,31,23,8,0,31
47925,107,"CĂMIN CULTURAL VALEA NEHOIULUI",NEHOIU,BZ,834,15,0,0,15,34,2,0,36,45,2,0,47,51,2,0,53,58,3,0,61
47925,108,"ŞCOALA PRIMARĂ NEHOIAŞU",NEHOIU,BZ,348,3,0,0,3,12,0,0,12,18,0,0,18,22,1,0,23,26,1,0,27
47925,109,"ŞCOALA GIMNAZIALĂ LUNCA PRIPORULUI",NEHOIU,BZ,649,2,0,0,2,13,2,0,15,21,2,0,23,33,3,0,36,37,3,0,40
47961,110,"SCOALA CU CLASELE I-IV PRUND","LUNCA PRIPORULUI",BZ,351,8,0,0,8,8,0,0,8,11,0,0,11,15,3,0,18,18,4,9,31
47934,111,"CĂMIN CULTURAL BÎSCA ROZILEI","BÎSCA ROZILEI",BZ,599,4,1,0,5,11,1,0,12,17,1,0,18,20,1,0,21,21,4,0,25
47934,112,"GRĂDINITA POD VINETIS - VECHE","BÎSCA ROZILEI",BZ,490,1,0,0,1,6,0,0,6,9,0,0,9,14,3,0,17,18,3,0,21
48012,113,"CĂMIN CULTURAL VINETIS",VINEŢIŞU,BZ,122,2,3,0,5,4,3,0,7,8,3,0,11,10,4,0,14,10,5,0,15
47998,114,"CĂMIN CULTURAL PĂLTINENI",PĂLTINENI,BZ,701,10,1,0,11,28,2,0,30,43,2,0,45,48,2,19,69,48,2,19,69
47970,115,"CĂMIN CULTURAL MLĂJET",MLĂJET,BZ,712,16,0,0,16,20,2,0,22,39,2,0,41,48,2,0,50,50,2,0,52
47943,116,"SCOALA CU CLASELE I-IV CHIRLESTI",CHIRLEŞTI,BZ,658,4,0,0,4,5,0,0,5,20,0,0,20,25,0,0,25,30,2,0,32
47952,117,"CĂMIN CULTURAL CURMĂTURA",CURMĂTURA,BZ,136,6,4,0,10,9,4,0,13,13,4,0,17,18,4,12,34,19,5,12,36
48334,118,"LICEUL TEHNOLOGIC PĂTÂRLAGELE",PĂTÂRLAGELE,BZ,968,26,5,0,31,48,16,0,64,56,16,0,72,66,18,0,84,71,18,0,89
48334,119,"LICEUL TEHNOLOGIC PĂTÂRLAGELE",PĂTÂRLAGELE,BZ,1139,32,4,0,36,51,6,0,57,62,10,0,72,77,13,0,90,80,13,0,93
48423,120,"ŞCOALĂ PRIMARĂ",POIENILE,BZ,248,0,0,0,0,5,0,0,5,13,0,0,13,19,1,0,20,22,2,0,24
48398,121,"ŞCOALA GENERALĂ",MĂRUNŢIŞU,BZ,1237,12,2,0,14,24,4,0,28,36,5,0,41,54,6,0,60,55,6,0,61
48414,122,"ŞCOALA GENERALĂ",MUŞCEL,BZ,597,4,0,0,4,13,2,0,15,20,3,0,23,30,3,0,33,30,3,0,33
48450,123,"ŞCOALA PRIMARĂ","VALEA LUPULUI",BZ,376,2,4,0,6,8,6,0,14,15,8,0,23,25,11,0,36,25,11,0,36
48478,124,"ŞCOALA PRIMARĂ","VALEA VIEI",BZ,405,4,1,0,5,9,2,0,11,16,3,0,19,24,3,0,27,25,3,0,28
48352,125,"ŞCOALA PRIMARĂ",CRÂNG,BZ,533,8,3,0,11,27,7,0,34,36,9,0,45,49,9,0,58,52,9,0,61
48432,126,"ŞCOALA PRIMARĂ","SIBICIU DE SUS",BZ,719,12,2,0,14,22,4,0,26,26,5,0,31,30,5,0,35,34,5,0,39
48469,127,"ŞCOALA PRIMARĂ","VALEA SIBICIULUI",BZ,185,1,2,0,3,8,3,0,11,10,3,0,13,11,4,0,15,13,5,0,18
48753,128,"LICEUL TEORETIC POGOANELE",POGOANELE,BZ,1506,6,1,0,7,11,2,0,13,19,2,0,21,21,3,0,24,29,3,0,32
48753,129,"CLUBUL COPIILOR POGOANELE",POGOANELE,BZ,1419,6,1,0,7,16,3,0,19,17,5,0,22,23,5,0,28,24,5,0,29
48753,130,"ŞCOALA GENERALĂ NR.2 POGOANELE",POGOANELE,BZ,1500,4,1,0,5,12,2,0,14,21,4,0,25,27,7,0,34,33,7,0,40
48762,131,"ŞCOALA GENERALĂ CĂLDĂRĂŞTI",CĂLDĂRĂŞTI,BZ,1548,15,3,0,18,42,4,0,46,85,4,0,89,125,6,28,159,133,6,28,167
44872,132,"ŞCOALA GENERALA AMARU",AMARU,BZ,957,5,1,0,6,20,4,0,24,29,8,0,37,41,10,0,51,46,13,0,59
44890,133,"CĂMINUL CULTURAL",DULBANU,BZ,405,12,3,0,15,20,8,0,28,26,11,0,37,39,12,0,51,41,12,0,53
44907,134,"CĂMINUL CULTURAL","LACU SINAIA",BZ,196,4,0,0,4,6,0,0,6,12,0,0,12,17,0,0,17,20,2,0,22
44916,135,"CAMINUL CULTURALLUNCA",LUNCA,BZ,309,11,0,0,11,27,16,0,43,31,16,1,48,38,16,1,55,39,16,1,56
44943,136,"GRĂDINIŢA CU PROGRAM NORMAL SAT BALTA ALBĂ","BALTA ALBĂ",BZ,443,14,1,0,15,22,4,0,26,26,4,0,30,38,17,0,55,41,17,0,58
44961,137,"CAMINUL CULTURAL BAILE",BĂILE,BZ,364,5,5,0,10,17,7,0,24,23,10,0,33,24,10,0,34,24,10,0,34
44952,138,"ŞCOALA GIMNAZIALĂ SAT AMARA",AMARA,BZ,1226,5,0,0,5,6,1,0,7,16,2,0,18,34,6,0,40,37,8,0,45
44998,139,"PRIMARIA COMUNEI BĂLĂCEANU",BĂLĂCEANU,BZ,1284,10,3,0,13,18,3,0,21,28,3,13,44,43,3,13,59,46,4,13,63
45012,140,"ŞCOALA PRIMARĂ BECENI",BECENI,BZ,810,5,2,0,7,10,4,0,14,11,4,0,15,17,5,0,22,19,5,0,24
45067,141,"ŞCOALA GIMNAZIALĂ GURA DIMIENII","GURA DIMIENII",BZ,778,4,0,0,4,13,0,0,13,31,0,0,31,38,0,0,38,43,4,0,47
45094,142,"ŞCOALA GIMNAZIALĂ VALEA PĂRULUI","VALEA PĂRULUI",BZ,1165,5,2,0,7,22,4,0,26,37,4,0,41,43,4,0,47,51,5,0,56
45076,143,"ŞCOALA PRIMARĂ IZVORU DULCE","IZVORU DULCE",BZ,694,4,3,0,7,13,5,0,18,27,5,0,32,35,8,0,43,36,9,0,45
45058,144,"ŞCOALA PRIMARĂFLOREŞTI",FLOREŞTI,BZ,205,0,6,0,6,0,6,0,6,4,7,0,11,7,8,0,15,9,8,0,17
45110,145,"CASA DE CULTURĂ BERCA-PARTER",BERCA,BZ,1223,9,3,0,12,20,10,0,30,40,13,22,75,52,14,22,88,57,14,22,93
45110,146,"CASA DE CULTURĂ BERCA-ETAJ 1",BERCA,BZ,1131,8,4,0,12,15,4,0,19,27,5,0,32,37,5,0,42,42,5,0,47
45110,147,"LICEUL TEHNOLOGIC SF.MUCENIC SAVA, BERCA",BERCA,BZ,629,3,0,0,3,8,1,0,9,13,2,0,15,15,2,0,17,18,2,0,20
45209,148,"GRĂDINIŢA SĂTUC",SĂTUC,BZ,545,2,0,0,2,13,2,0,15,13,2,0,15,14,6,0,20,16,6,0,22
45192,149,"GRĂDINIȚA CU PROGRAM NORMAL RĂTEŞTI",RĂTEŞTI,BZ,821,11,7,0,18,23,8,0,31,47,10,0,57,63,10,0,73,67,12,0,79
45165,150,"CĂMIN CULTURAL PÎCLE",PÎCLELE,BZ,134,2,0,0,2,3,5,0,8,3,5,0,8,4,5,0,9,6,5,0,11
45147,151,"CĂMIN CULTURAL JOSENI",JOSENI,BZ,776,3,0,0,3,11,4,0,15,17,4,0,21,24,4,0,28,26,4,0,30
45183,152,"ŞCOALA GIMNAZIALĂ PLEȘCOI",PLEŞEŞTI,BZ,803,6,1,0,7,11,2,0,13,14,7,0,21,19,7,0,26,24,7,0,31
45183,153,"CĂMIN CULTURAL PLEŞCOI",PLEŞEŞTI,BZ,749,3,5,0,8,8,7,0,15,17,9,0,26,26,9,0,35,26,9,0,35
45227,154,"ŞCOALA PRIMARĂ VALEA NUCULUI","VALEA NUCULUI",BZ,577,2,1,0,3,5,1,0,6,5,1,0,6,13,2,0,15,14,2,0,16
45254,155,"SALA DE FESTIVITATI A PRIMARIEI BISOCA",BISOCA,BZ,487,487,0,0,487,5,6,0,11,13,7,0,20,18,7,0,25,21,8,0,29
45307,156,"CAMPUS PENTRU COPII SF.SAVA - RECEA",RECEA,BZ,800,4,0,0,4,16,3,0,19,21,3,0,24,26,4,0,30,26,4,0,30
45290,157,"ŞCOALA GENERALĂ PLEŞI",PLEŞI,BZ,353,3,0,0,3,7,1,0,8,10,1,0,11,12,1,0,13,14,1,0,15
45316,158,"ŞCOALA GENERALĂ SĂRILE",SĂRILE,BZ,401,0,0,0,0,6,0,0,6,10,0,0,10,12,0,0,12,12,0,0,12
45343,159,"CĂMINUL CULTURAL BLĂJANI",BLĂJANI,BZ,600,5,0,0,5,10,0,0,10,20,5,0,25,27,7,0,34,31,9,0,40
45352,160,"CĂMINUL CULTURAL SOREŞTI",SOREŞTI,BZ,239,0,0,0,0,2,0,0,2,9,3,0,12,12,3,0,15,12,3,0,15
45370,161,CLUBULPRIMĂRIEIBOLDU,BOLDU,BZ,967,17,3,0,20,41,5,0,46,57,10,0,67,75,11,25,111,78,11,25,114
45370,162,"GRĂDINIŢA DE COPII BOLDU",BOLDU,BZ,843,18,3,0,21,26,4,0,30,36,4,26,66,60,7,26,93,74,7,26,107
45398,163,"ŞCOALA GIMNAZIALĂ BOZIORU",BOZIORU,BZ,511,1,1,0,2,4,1,0,5,6,2,0,8,12,4,0,16,14,4,0,18
45414,164,"ŞCOALA PRIMARĂ FIŞICI",FIŞICI,BZ,316,2,0,0,2,3,2,0,5,7,2,0,9,13,13,0,26,13,13,0,26
45502,165,"ŞCOALA GIMNAZIALĂ BRĂDEANU",BRĂDEANU,BZ,909,11,1,0,12,23,5,0,28,33,10,0,43,45,11,0,56,48,12,0,60
45520,166,"ŞCOALA GIMNAZIALĂ SMÎRDAN",SMÎRDAN,BZ,734,5,3,0,8,9,3,0,12,14,6,0,20,22,9,0,31,23,9,0,32
45511,167,"ŞCOALA PRIMARĂ MITROPOLIA",MITROPOLIA,BZ,354,14,0,0,14,17,1,0,18,19,2,0,21,23,4,0,27,25,4,0,29
45548,168,"SALA MARE A CLADIRII FOSTULUI SEDIU C.A.P. – SAT BRAESTI",BRĂEŞTI,BZ,376,3,1,0,4,9,2,0,11,14,3,0,17,16,5,0,21,16,5,0,21
45557,169,"CAMINUL CULTURALBRĂTILEŞTI",BRĂTILEŞTI,BZ,1094,11,1,0,12,12,1,0,13,17,1,0,18,22,2,0,24,23,2,0,25
45584,170,"CAMINUL CULTURAL PINU",PINU,BZ,297,3,0,0,3,7,0,0,7,10,0,0,10,13,0,0,13,15,2,0,17
45628,171,"GRADINITA CU PROGRAM NORMAL BREAZA",BREAZA,BZ,792,9,1,0,10,23,4,0,27,34,5,0,39,44,8,0,52,48,8,0,56
45646,172,"ŞCOALA GENERALĂ GRECEANCA",GRECEANCA,BZ,768,3,2,0,5,7,3,0,10,13,5,0,18,15,5,0,20,18,5,0,23
45664,173,"ŞCOALA PRIMARĂ VISPEŞTI",VISPEŞTI,BZ,581,8,5,0,13,25,11,0,36,40,15,0,55,46,15,0,61,46,17,0,63
45682,174,"ŞCOALA BUDA",BUDA,BZ,892,4,1,0,5,12,1,0,13,19,1,0,20,32,2,0,34,34,2,0,36
45717,175,"ŞCOALAPRIMARĂ MUCEŞTI DĂNULEŞTI",MUCEŞTI-DĂNULEŞTI,BZ,947,8,3,0,11,8,3,0,11,12,3,0,15,23,4,0,27,30,5,0,35
45735,176,"GRADINITA PN PIETROIU",TOROPĂLEŞTI,BZ,527,1,0,0,1,3,0,0,3,14,0,0,14,27,0,0,27,35,0,0,35
45824,177,"ȘCOALA GIMNAZIALĂ C.A.ROSETTI","C.A. ROSETTI",BZ,721,5,0,0,5,9,0,0,9,13,2,0,15,19,2,0,21,19,2,0,21
45833,178,"ŞCOALA PRIMARĂ BĂLTENI",BĂLTENI,BZ,375,4,3,0,7,7,3,0,10,9,5,0,14,12,5,0,17,17,5,0,22
45842,179,"CĂMINUL CULTURAL BÎLHACU",BÎLHACU,BZ,183,1,0,0,1,5,0,0,5,8,3,0,11,13,3,0,16,18,3,0,21
45851,180,"ŞCOALA PRIMARĂ COTU CIORII","COTU CIORII",BZ,491,12,1,0,13,23,10,0,33,28,12,0,40,38,14,0,52,44,14,0,58
45860,181,"ȘCOALA GIMNAZIALĂ LUNCA",LUNCA,BZ,847,10,1,0,11,52,4,0,56,71,5,0,76,98,6,0,104,100,6,0,106
45879,182,"ŞCOALA PRIMARĂ VIZIRENI",VIZIRENI,BZ,372,5,0,0,5,9,0,0,9,11,0,0,11,16,0,0,16,16,0,0,16
45762,183,"CAMIN CULTURAL CALVINI",CALVINI,BZ,788,1,1,0,2,13,2,0,15,16,2,0,18,23,3,0,26,23,3,0,26
45771,184,"SCOALA GIMNAZIALA ""DUMITRU I. IONESCU"" CALVINI","BÎSCENII DE JOS",BZ,1503,4,0,0,4,8,3,0,11,18,6,0,24,29,7,0,36,29,8,0,37
45771,185,"SCOALA PRIMARA BÎSCENII DE JOS","BÎSCENII DE JOS",BZ,488,0,0,0,0,8,0,0,8,20,1,0,21,25,1,0,26,25,1,0,26
45780,186,"SCOALA GIMNAZIALA BÎSCENII DE SUS","BÎSCENII DE SUS",BZ,726,9,0,0,9,11,2,0,13,13,3,0,16,13,3,0,16,13,3,0,16
45897,187,"SCOALA GIMNAZIALA CANESTI",CĂNEŞTI,BZ,469,5,9,0,14,5,18,0,23,20,19,0,39,21,23,0,44,24,24,0,48
45913,188,"SCOALA PRIMARA NEGOSINA",NEGOŞINA,BZ,159,6,0,0,6,9,0,0,9,13,0,0,13,17,0,0,17,18,0,0,18
45968,189,"ŞCOALA GIMNAZIALĂ NR.1 CĂTINA",CĂTINA,BZ,621,7,1,0,8,17,5,0,22,20,5,0,25,21,6,0,27,21,6,0,27
45977,190,"ŞCOALA GIMNAZIALĂ NR.2 CORBU",CORBU,BZ,665,7,0,0,7,13,0,0,13,14,0,0,14,26,3,0,29,26,4,0,30
45995,191,"ŞCOALA PRIMARĂ NR.1 VALEA CĂTINEI","VALEA CĂTINEI",BZ,392,6,2,0,8,16,4,0,20,19,5,0,24,24,6,0,30,25,6,0,31
45986,192,"ŞCOALA CU CLS.I-IV SLOBOZIA",SLOBOZIA,BZ,163,2,5,0,7,4,5,0,9,5,5,0,10,7,5,0,12,8,5,0,13
46000,193,"ŞCOALA PRIMARĂ NR.2ZELETIN",ZELETIN,BZ,160,0,0,0,0,3,2,0,5,7,2,0,9,8,2,0,10,8,2,0,10
46028,194,"GRADINITA CU PROGRAM NORMAL CERNATESTI",CERNĂTEŞTI,BZ,935,3,3,0,6,8,3,0,11,17,4,0,21,22,5,0,27,24,6,0,30
46091,195,"CĂMINUL CULTURAL DIN SATUL ZĂRNEŞTI SLĂNIC","ZĂRNEŞTII DE SLĂNIC",BZ,1108,5,0,0,5,22,0,0,22,31,1,0,32,39,4,0,43,42,7,0,49
46037,196,"CĂMINUL CULTURAL DIN SATUL ALDENI",ALDENI,BZ,686,5,5,0,10,21,9,0,30,29,11,0,40,40,11,0,51,41,11,0,52
46064,197,"ŞCOALA PRIMARA DIN SATUL FULGA",FULGA,BZ,396,3,0,0,3,7,5,0,12,12,7,0,19,18,7,0,25,19,7,0,26
46117,198,"CAMINUL CULTURAL CHILIILE",CHILIILE,BZ,271,3,0,0,3,7,3,0,10,15,4,0,19,18,6,0,24,18,6,0,24
46171,199,"ŞCOALA TRESTIOARA",TRESTIOARA,BZ,180,1,0,0,1,7,1,0,8,10,2,0,12,15,2,0,17,16,2,0,18
46199,200,"GRADINITA CU PROGRAM NORMAL CHIOJDU",CHIOJDU,BZ,801,10,3,0,13,20,20,0,40,26,21,0,47,30,24,0,54,37,24,0,61
46206,201,"ŞCOALA GIMNAZIALA BISCA-CHIOJDULUI","BÎSCA CHIOJDULUI",BZ,960,4,4,0,8,6,6,0,12,7,7,0,14,9,7,0,16,11,7,0,18
46233,202,"ŞCOALA PRIMARA PLESCIOARA",PLESCIOARA,BZ,134,0,3,0,3,6,3,0,9,7,5,0,12,8,5,0,13,8,6,0,14
46215,203,"ŞCOALA PRIMARA CATIASU",CĂTIAŞU,BZ,296,3,3,0,6,6,3,0,9,10,7,0,17,16,7,0,23,16,7,0,23
46224,204,"ŞCOALA PRIMARA LERA",LERA,BZ,359,9,2,0,11,15,2,0,17,25,2,0,27,29,2,0,31,31,2,0,33
46242,205,"ŞCOALA PRIMARA POENITELE",POENIŢELE,BZ,187,6,0,0,6,13,3,0,16,25,4,0,29,44,4,0,48,44,4,0,48
46260,206,"PRIMĂRIA COMUNACILIBIA – LA PARTER",CILIBIA,BZ,1212,9,7,0,16,33,10,0,43,54,10,0,64,91,11,0,102,101,11,0,112
46297,207,"ŞCOALAPRIMARĂ DIN SATULMOVILA OII","MOVILA OII",BZ,304,6,2,0,8,10,5,0,15,18,7,0,25,26,9,0,35,26,11,0,37
46322,208,"GRĂDINIŢA CU PROGRAM NORMAL NR. 1 COMUNA CISLĂU",CISLĂU,BZ,1845,11,0,0,11,38,4,0,42,48,4,0,52,58,5,0,63,61,5,0,66
46368,209,"ŞCOALA GIMNAZIALĂ SAT SCĂRIŞOARA, COMUNA CISLĂU",SCĂRIŞOARA,BZ,1033,6,0,0,6,6,1,0,7,13,4,0,17,23,4,0,27,25,4,0,29
46340,210,"CENTRUL DE ZI « DOAMNA NEAGA » PENTRU COPII CU VÂRSTE CUPRINSE ÎNTRE 3-6 ANI","BUDA CRĂCIUNEŞTI",BZ,643,7,1,0,8,10,2,0,12,11,4,0,15,16,4,0,20,17,4,0,21
46359,211,"ŞCOALA PRIMARĂ SAT GURA BÂSCEI, COMUNA CISLĂU","GURA BÎSCEI",BZ,302,4,5,0,9,5,6,0,11,10,6,0,16,15,8,0,23,15,8,0,23
46386,212,"SCOALA GIMNAZIALA COCHIRLEANCA NR.1",COCHIRLEANCA,BZ,1318,13,2,0,15,30,5,0,35,40,5,0,45,73,6,0,79,75,6,0,81
46386,213,"SCOALA GIMNAZIALA COCHIRLEANCA NR.2",COCHIRLEANCA,BZ,825,9,0,0,9,22,0,0,22,29,4,0,33,42,4,0,46,54,5,0,59
46395,214,"CLĂDIRE PUNCT SANITAR UMAN SATBOBOC",BOBOC,BZ,1370,6,1,0,7,26,2,0,28,34,2,0,36,51,3,0,54,53,3,0,56
46411,215,"SCOALA PRIMARAROSIORU",ROŞIORU,BZ,573,4,4,0,8,11,4,0,15,16,4,0,20,26,5,0,31,27,5,0,32
46402,216,"SCOALA PRIMARA GARA BOBOCU","GARA BOBOCU",BZ,295,5,23,0,28,9,23,0,32,15,26,0,41,20,28,0,48,20,28,0,48
46420,217,"SCOALA PRIMARA TARLELE",TÎRLELE,BZ,41,1,1,0,2,1,2,0,3,2,4,0,6,6,6,0,12,8,6,0,14
46448,218,"ȘCOALA GIMNAZIALĂ COLȚI",COLŢI,BZ,407,1,0,0,1,8,6,0,14,11,7,0,18,13,7,0,20,13,7,0,20
46457,219,"ȘCOALA GIMNAZIALĂ ALUNIȘ",ALUNIŞ,BZ,127,0,0,0,0,2,4,0,6,2,6,0,8,2,7,0,9,2,7,0,9
46475,220,"CĂMINUL CULTURAL MUSCELUL CĂRĂMĂNEŞTI","MUSCELU CĂRĂMĂNEŞTI",BZ,84,0,1,0,1,1,2,0,3,4,3,0,7,7,3,0,10,7,3,0,10
46466,221,"ŞCOALA GIMNAZIALĂ COLȚII DE JOS","COLŢII DE JOS",BZ,254,1,0,0,1,2,0,0,2,2,0,0,2,11,0,0,11,12,0,0,12
46493,222,"ȘCOALA GIMNAZIALĂ COSTEȘTI",COSTEŞTI,BZ,1281,6,1,0,7,16,4,0,20,19,5,0,24,25,5,0,30,33,5,0,38
46536,223,"GRĂDINIŢA CU PROGRAM NORMAL PIETROSU",PIETROSU,BZ,1115,3,0,0,3,7,0,0,7,16,0,0,16,27,0,0,27,27,0,0,27
46509,224,"GRĂDINIȚA CU PROGRAM NORMAL BUDIȘTENI",BUDIŞTENI,BZ,406,3,3,0,6,8,6,0,14,13,6,0,19,16,7,0,23,16,7,0,23
46545,225,"ŞCOALA GIMNAZIALĂ ""GENERAL ȘTEFAN GUȘĂ"" SPĂTARU",SPĂTARU,BZ,1054,8,0,0,8,22,0,0,22,30,3,0,33,36,4,0,40,36,4,0,40
46518,226,"ŞCOALA PRIMARĂ GOMOEȘTI",GOMOEŞTI,BZ,184,2,0,0,2,5,2,0,7,7,3,0,10,10,4,0,14,10,4,0,14
46563,227,"ŞCOALA COZIENI",COZIENI,BZ,522,3,1,0,4,11,7,0,18,16,8,0,24,17,13,0,30,17,20,0,37
46581,228,"ŞCOALA BĂLĂNEŞTI",BĂLĂNEŞTI,BZ,611,7,2,0,9,14,5,0,19,17,8,0,25,29,9,0,38,29,9,0,38
46714,229,"CĂMINUL CULTURAL TRESTIA",TRESTIA,BZ,323,5,5,0,10,5,5,0,10,6,5,0,11,10,5,0,15,10,7,0,17
46689,230,"ŞCOALA PIETRARU",PIETRARU,BZ,184,0,0,0,0,5,2,0,7,10,4,0,14,10,10,0,20,10,10,0,20
47603,231,"ŞCOALA GIMNAZIALA FLORICA",FLORICA,BZ,1068,8,2,0,10,26,3,0,29,38,5,0,43,72,9,0,81,77,10,0,87
46778,232,"ŞCOALA GIMNAZIALĂ GĂLBINAŞI",GĂLBINAŞI,BZ,1077,5,4,0,9,15,4,0,19,16,4,0,20,17,5,0,22,18,6,0,24
46787,233,"CĂMINUL CULTURAL BENTU",BENTU,BZ,766,16,2,0,18,32,3,0,35,58,5,0,63,75,15,0,90,79,15,0,94
46796,234,"ȘCOALA PRIMARĂNR.1 TĂBĂRĂȘTI",TĂBĂRĂŞTI,BZ,722,2,1,0,3,4,2,0,6,5,2,0,7,6,2,0,8,8,3,0,11
46796,235,"GRĂDINIȚA CU PROGRAM NORMAL NR. 2 TĂBĂRĂȘTI",TĂBĂRĂŞTI,BZ,943,2,0,0,2,8,1,0,9,19,2,0,21,24,2,0,26,28,3,0,31
46812,236,"GRADINITA CU PROGRAM NORMAL GHERASENI",GHERĂSENI,BZ,1466,18,0,0,18,38,5,0,43,57,7,0,64,82,9,0,91,89,11,0,100
46812,237,"ŞCOALA CU CLASELE I-IV GHERASENI",GHERĂSENI,BZ,870,8,0,0,8,20,0,0,20,47,1,0,48,52,2,0,54,62,3,0,65
46821,238,"ŞCOALA CU CLS.I-IV SUDITI",SUDIŢI,BZ,446,6,1,0,7,14,1,0,15,19,2,0,21,23,2,0,25,25,2,0,27
46849,239,"ŞCOALA GIMNAZIALA GHERGHEASA",GHERGHEASA,BZ,991,8,2,0,10,16,5,0,21,20,8,0,28,23,10,0,33,23,10,0,33
46858,240,"ŞCOALA PRIMARA SĂLCIOARA",SĂLCIOARA,BZ,846,0,0,0,0,0,0,0,0,3,0,0,3,9,0,0,9,10,0,0,10
46876,241,"SCOALA GIMNAZIALA GLODEANU SARAT","GLODEANU SĂRAT",BZ,1744,10,0,0,10,20,1,0,21,31,1,0,32,47,8,0,55,54,9,0,63
46894,242,"GRADINITA CU PROGRAM NORMALILEANA",ILEANA,BZ,346,3,4,0,7,9,4,0,13,14,4,0,18,20,4,0,24,20,7,0,27
46901,243,"ŞCOALA GIMNAZIALA PITULICEA",PITULICEA,BZ,760,4,0,0,4,14,4,0,18,24,6,0,30,32,6,0,38,49,6,4,59
46885,244,"GRĂDINIȚA CU PROGRAM NORMAL",CĂLDĂRUŞEANCA,BZ,470,5,3,0,8,12,6,0,18,24,10,0,34,26,10,0,36,29,11,0,40
46929,245,"ȘCOALA GIMNAZIALĂ GLODEANU-SILIȘTEA",GLODEANU-SILIŞTEA,BZ,1102,10,2,0,12,21,5,0,26,36,9,0,45,46,10,0,56,51,11,0,62
46974,246,"ȘCOALA PRIMARĂ COTORCA",COTORCA,BZ,789,4,1,0,5,15,3,0,18,21,4,0,25,29,5,0,34,32,5,0,37
46947,247,"ŞCOALA CÎRLIGU MARE","CÎRLIGU MARE",BZ,364,3,2,0,5,8,3,0,11,12,3,0,15,25,4,0,29,25,5,0,30
46992,248,"ŞCOALA GIMNAZIALĂ VĂCĂREASCA",VĂCĂREASCA,BZ,401,3,4,0,7,5,4,0,9,7,6,0,13,8,8,0,16,13,8,0,21
46938,249,"GRĂDINIŢA CAŞOTA",CASOTA,BZ,277,3,0,0,3,10,3,0,13,15,4,0,19,24,4,0,28,24,4,0,28
47015,250,"ŞCOALA GIMNAZIALĂ GREBĂNU",GREBĂNU,BZ,1810,7,2,0,9,13,3,0,16,30,5,0,35,32,5,0,37,32,5,0,37
47024,251,"ŞCOALA PRIMARĂ HOMEŞTI",HOMEŞTI,BZ,808,6,5,0,11,9,5,0,14,16,7,0,23,18,7,0,25,19,8,0,27
47033,252,"ŞCOALA PRIMARĂ LIVADA",LIVADA,BZ,597,9,6,0,15,28,12,0,40,40,15,0,55,44,18,0,62,52,19,0,71
47051,253,"ŞCOALA GIMNAZIALĂ PLEVNA",PLEVNA,BZ,1146,3,1,0,4,34,3,0,37,45,4,0,49,51,8,0,59,52,8,0,60
47113,254,"ŞCOALA GIMNAZIALĂ PĂLTINIŞ",PĂLTINIŞ,BZ,523,3,0,0,3,5,2,0,7,8,4,0,12,12,7,0,19,13,7,0,20
47097,255,"CĂMINUL CULTURAL SAT FURTUNEŞTI",FURTUNEŞTI,BZ,749,4,0,0,4,11,2,0,13,21,2,0,23,22,3,0,25,23,3,0,26
47088,256,"CAMINUL CULTURAL SATUL GURA TEGHII","GURA TEGHII",BZ,1109,9,2,0,11,10,7,0,17,13,7,0,20,16,7,0,23,16,8,0,24
47140,257,"ŞCOALA PRIMARĂ VARLAAM",VARLAAM,BZ,457,2,0,0,2,7,0,0,7,11,0,0,11,19,0,0,19,19,0,0,19
47168,258,"PRIMARIA LARGU",LARGU,BZ,1252,3,3,0,6,17,4,0,21,28,5,0,33,42,9,0,51,48,10,0,58
47195,259,"PRIMARIA LOPĂTARI",LOPĂTARI,BZ,1001,14,1,0,15,26,4,0,30,33,5,0,38,45,11,0,56,45,11,0,56
47220,260,"ŞCOALA PRIMARĂ SAT LUNCILE",LUNCILE,BZ,666,4,0,0,4,10,0,0,10,15,0,0,15,29,4,0,33,29,4,0,33
47284,261,"CĂMINUL CULTURAL TERCA",TERCA,BZ,349,0,0,0,0,5,0,0,5,11,4,0,15,16,6,0,22,17,6,0,23
47257,262,"ŞCOALA PRIMARĂ SATPLOŞTINA",PLOŞTINA,BZ,408,4,0,0,4,7,2,0,9,17,2,0,19,17,3,0,20,17,4,0,21
47248,263,"CĂMINUL CULTURAL DIN SATUL PLAIU NUCULUI","PLAIU NUCULUI",BZ,594,5,2,0,7,11,11,0,22,23,12,0,35,38,14,0,52,42,15,0,57
47319,264,"FOSTA ŞCOALĂ GIMNAZIALĂ ""PROF. DR. ION ANGHEL""",LUCIU,BZ,1534,20,2,0,22,39,6,0,45,67,8,0,75,95,13,0,108,102,14,0,116
47328,265,"ŞCOALA CARAGELE",CARAGELE,BZ,695,12,1,0,13,22,2,0,24,39,3,0,42,56,5,0,61,73,5,0,78
47346,266,"ȘCOALA GIMNAZIALĂ MĂGURA",MĂGURA,BZ,1087,18,3,0,21,30,3,0,33,42,7,0,49,48,12,0,60,58,12,0,70
47355,267,"ŞCOALA GIMNAZIALĂ CIUTA",CIUTA,BZ,637,5,0,0,5,10,0,0,10,14,2,0,16,18,4,0,22,22,9,0,31
47382,268,"SCOALA GENERALA MARACINENI",MĂRĂCINENI,BZ,1384,7,1,0,8,17,2,0,19,36,2,0,38,53,2,0,55,56,4,0,60
47382,269,"ŞCOALA GENERALĂ MĂRĂCINENI",MĂRĂCINENI,BZ,1202,5,2,0,7,10,2,0,12,16,2,0,18,27,6,0,33,29,6,0,35
47391,270,"ŞCOALA GENERALĂ CĂPĂŢÎNEŞTI",CĂPĂŢÎNEŞTI,BZ,1467,7,1,0,8,15,1,0,16,24,2,0,26,37,2,0,39,39,2,0,41
47391,271,"GRĂDINIŢA CU PROGRAM NORMAL CĂPĂŢÎNEŞTI",CĂPĂŢÎNEŞTI,BZ,1493,9,3,0,12,20,5,0,25,38,7,0,45,50,7,0,57,55,7,0,62
47408,272,"ŞCOALA GENERALĂ POTOCENI",POTOCENI,BZ,1712,13,0,0,13,20,0,0,20,36,3,0,39,45,3,0,48,48,3,0,51
47426,273,"PRIMARIA MĂRGĂRITEŞTI",MĂRGĂRITEŞTI,BZ,539,0,0,0,0,2,0,0,2,3,0,0,3,8,0,0,8,8,0,0,8
47462,274,"ŞCOALA GIMNAZIALĂ MEREI",MEREI,BZ,927,8,2,0,10,14,3,0,17,19,4,0,23,21,6,0,27,21,10,0,31
47523,275,"GRĂDINIȚA CU PROGRAM NORMAL LIPIA",LIPIA,BZ,1610,9,2,0,11,24,6,0,30,41,6,0,47,60,11,0,71,60,11,0,71
47550,276,"CLĂDIRE PRESTĂRI SERVICII",SĂRATA-MONTEORU,BZ,668,6,7,0,13,9,24,0,33,13,62,0,75,22,73,0,95,22,73,0,95
47505,277,"ŞCOALAGURA SĂRĂŢII","GURA SĂRĂŢII",BZ,143,2,0,0,2,6,3,0,9,13,3,0,16,16,4,0,20,16,6,0,22
47480,278,"ŞCOALA PRIMARĂDEALUL VIEI","DEALUL VIEI",BZ,645,4,3,0,7,7,5,0,12,10,6,0,16,19,7,0,26,23,8,0,31
47514,279,"ŞCOALA GIMNAZIALĂ IZVORU DULCE","IZVORU DULCE",BZ,736,3,0,0,3,9,2,0,11,12,3,0,15,22,5,0,27,23,5,0,28
47532,280,ŞCOALANENCIULEŞTI,NENCIULEŞTI,BZ,267,2,1,0,3,4,5,0,9,4,5,0,9,11,8,0,19,12,8,0,20
47541,281,"ŞCOALA PRIMARĂ OGRĂZILE",OGRĂZILE,BZ,596,0,0,0,0,9,3,0,12,9,3,0,12,14,4,0,18,14,4,0,18
47587,282,"ŞCOALA GIMNAZIALA MIHAILESTI",MIHĂILEŞTI,BZ,986,10,4,0,14,21,7,0,28,25,9,0,34,39,11,0,50,46,11,0,57
47612,283,"ŞCOALA PRIMARA MĂRGINEANU",MĂRGINEANU,BZ,636,7,0,0,7,11,2,0,13,22,2,0,24,43,7,0,50,45,7,0,52
47649,284,"ŞCOALA GIMNAZIALĂMÎNZĂLEŞTI",MÎNZĂLEŞTI,BZ,624,1,0,0,1,6,2,0,8,9,3,0,12,18,3,0,21,19,3,0,22
47658,285,"ŞCOALAGIMNAZIALĂ“DUMITRU N. CRISTEA” BEŞLII",BEŞLII,BZ,471,1,2,0,3,6,2,0,8,19,2,0,21,26,7,0,33,30,7,0,37
47756,286,"ŞCOALA PRIMARĂ VALEA COTOAREI","VALEA COTOAREI",BZ,167,0,2,0,2,0,2,0,2,4,3,0,7,6,3,0,9,6,3,0,9
47694,287,"ŞCOALA GIMNAZIALĂGURA BĂDICULUI","GURA BĂDICULUI",BZ,371,2,0,0,2,3,0,0,3,5,4,0,9,5,6,0,11,5,6,0,11
47747,288,"ŞCOALA PRIMARĂ TRESTIOARA",TRESTIOARA,BZ,295,0,0,0,0,3,0,0,3,6,1,0,7,7,1,0,8,7,1,0,8
47783,289,"CAMINUL CULTURAL MOVILA BANULUI","MOVILA BANULUI",BZ,1031,9,2,0,11,18,4,0,22,23,5,0,28,30,10,0,40,44,12,0,56
47809,290,"GRĂDINIŢA CU PROGRAM NORMAL LIMPEZIŞ",LIMPEZIŞ,BZ,817,3,1,0,4,19,2,0,21,24,5,0,29,30,5,0,35,30,6,0,36
47792,291,"ŞCOALA GENERALA CIORANCA",CIORANCA,BZ,210,7,2,0,9,10,2,0,12,13,2,0,15,13,3,0,16,13,3,0,16
47827,292,"PRIMĂRIA MURGEŞTI",MURGEŞTI,BZ,751,3,3,0,6,15,4,0,19,22,6,0,28,28,9,0,37,31,9,0,40
47863,293,"ŞCOALA GIMNAZIALĂ NĂENI",NĂENI,BZ,473,10,2,0,12,18,3,0,21,23,11,0,34,26,11,4,41,27,12,4,43
47872,294,"ŞCOALA PRIMARĂ FINŢESTI",FINŢEŞTI,BZ,484,11,2,0,13,23,6,0,29,28,8,0,36,33,13,0,46,37,13,0,50
47907,295,"ŞCOALA VÎRF",VÎRF,BZ,206,5,3,0,8,5,3,0,8,14,3,0,17,17,4,0,21,17,4,0,21
47890,296,"GRĂDINIŢA PROSCA",PROŞCA,BZ,188,3,0,0,3,7,1,0,8,11,1,0,12,16,5,0,21,16,6,0,22
48030,297,"ŞCOALA GIMNAZIALĂ ODĂILE",ODĂILE,BZ,656,0,0,0,0,5,0,0,5,5,0,0,5,9,1,0,10,10,1,0,11
48147,298,"GRADINITACU PROGRAM NORMAL NR. 2 COMUNA PADINA",PADINA,BZ,1279,10,3,0,13,15,8,0,23,26,8,0,34,33,9,0,42,35,9,0,44
48147,299,"GRADINITA CU PROGRAM NORMAL NR. 1 PADINA",PADINA,BZ,918,4,2,0,6,8,3,0,11,12,6,0,18,13,6,0,19,14,6,0,20
48147,300,"SCOALA GIMNAZIALA NR.1 COMUNA PADINA",PADINA,BZ,1015,4,1,0,5,15,4,0,19,28,4,0,32,36,7,0,43,40,10,0,50
48174,301,"ŞCOALA PARDOŞI",PARDOŞI,BZ,332,5,1,0,6,30,8,0,38,36,8,0,44,40,9,0,49,40,9,0,49
48236,302,"ŞCOALA GIMNAZIALĂ PĂNĂTĂU",PĂNĂTĂU,BZ,1265,13,1,0,14,39,4,0,43,51,6,0,57,68,8,0,76,68,8,0,76
48307,303,"ŞCOALA TEGA",TEGA,BZ,537,4,2,0,6,7,4,0,11,13,5,0,18,19,9,0,28,23,9,0,32
48245,304,"CAMIN CULTURAL BEGU",BEGU,BZ,186,3,1,0,4,8,2,0,10,8,3,0,11,10,3,0,13,15,6,0,21
48496,305,"ŞCOALA GIMNAZIALĂ PIETROASELE",PIETROASELE,BZ,1558,6,0,0,6,12,8,0,20,21,9,0,30,36,11,0,47,40,14,0,54
48548,306,"GRĂDINIŢA CU PROGRAM NORMAL DIN SATUL ŞARÎNGA",ŞARÎNGA,BZ,1192,12,3,0,15,25,8,0,33,39,11,0,50,52,13,0,65,56,13,0,69
48566,307,"CĂMINUL CULTURALPÎRSCOV",PÎRSCOV,BZ,1253,2,3,0,5,10,9,0,19,25,13,0,38,33,13,0,46,33,13,0,46
48566,308,"CĂMINUL CULTURALPÎRSCOV",PÎRSCOV,BZ,1214,10,2,0,12,30,2,0,32,41,5,0,46,51,6,0,57,56,6,0,62
48575,309,"ŞCOALA GENERALĂ BĂDILA",BADILA,BZ,663,2,3,0,5,2,3,0,5,6,3,0,9,10,3,0,13,15,3,0,18
48593,310,"ŞCOALA LUNCA FRUMOASA","LUNCA FRUMOASĂ",BZ,910,3,3,0,6,8,6,0,14,9,8,0,17,12,8,0,20,14,9,0,23
48628,311,"ŞCOALA GENERALĂ ROBEŞTI",ROBEŞTI,BZ,491,8,1,0,9,15,2,0,17,15,4,0,19,20,8,0,28,23,12,0,35
48664,312,"FOSTUL MAGAZIN TRESTIENI",TRESTIENI,BZ,47,0,0,0,0,2,0,0,2,4,0,0,4,4,0,0,4,4,0,0,4
48726,313,"ŞCOALA PRIMARĂ PLEȘEȘTI",PLEŞEŞTI,BZ,312,3,1,0,4,9,2,0,11,12,2,0,14,16,3,0,19,20,3,0,23
48691,314,"ŞCOALA GIMNAZIALĂ PODGORIA",PODGORIA,BZ,1304,8,4,0,12,28,6,0,34,49,8,1,58,60,8,1,69,64,10,1,75
48708,315,"ŞCOALA GIMNAZIALĂ COȚATCU",COŢATCU,BZ,972,5,2,0,7,18,6,0,24,28,8,0,36,40,8,0,48,40,8,0,48
48780,316,"GRĂDINIŢA DE COPII POŞTA CÎLNĂU","POŞTA CÎLNĂU",BZ,1060,8,0,0,8,15,3,0,18,20,5,0,25,37,6,0,43,37,7,0,44
48780,317,"GRĂDINIŢA DE COPII POŞTA CÎLNĂU","POŞTA CÎLNĂU",BZ,995,7,0,0,7,18,0,0,18,20,0,0,20,27,0,0,27,29,0,0,29
48815,318,"SCOALA GENERALA DIN POTIRNICHESTI",POTÎRNICHEŞTI,BZ,391,0,0,0,0,2,0,0,2,4,0,0,4,7,0,0,7,12,0,0,12
48833,319,"ŞCOALA GENERALĂ ZILIŞTEANCA",ZILIŞTEANCA,BZ,1117,2,0,0,2,12,0,0,12,14,3,0,17,24,3,0,27,31,3,0,34
48824,320,"ŞCOALA GENERALĂ, SATUL SUDIŢI",SUDIŢI,BZ,1470,12,0,0,12,25,3,0,28,40,5,0,45,78,8,0,86,78,9,0,87
48913,321,"ŞCOALA PUIEŞTII DE SUS","PUIEŞTII DE SUS",BZ,320,10,1,0,11,23,3,0,26,27,3,0,30,37,5,0,42,37,5,0,42
48851,322,"ŞCOALA GIMNAZIALĂ PUIEŞTII DE JOS","PUIEŞTII DE JOS",BZ,1112,6,0,0,6,15,1,0,16,23,2,0,25,27,3,0,30,35,3,0,38
48897,323,"ŞCOALA GIMNAZIALĂNICOLEŞTI",NICOLEŞTI,BZ,597,6,5,0,11,26,8,0,34,29,10,0,39,41,11,0,52,41,12,0,53
48860,324,GRĂDINIŢADĂSCĂLEŞTI,DĂSCĂLEŞTI,BZ,594,4,0,0,4,9,0,0,9,17,0,0,17,31,0,0,31,31,0,0,31
48888,325,"ŞCOALA MĂCRINA",MĂCRINA,BZ,455,5,1,0,6,12,7,0,19,15,7,0,22,16,7,0,23,17,7,0,24
48931,326,"PRIMĂRIA RACOVIŢENI",RACOVIŢENI,BZ,1054,8,1,0,9,16,1,0,17,22,3,0,25,29,6,0,35,31,6,0,37
48977,327,"SCOALA GIMNAZIALA NR.1",RÎMNICELU,BZ,1028,4,2,0,6,11,6,0,17,24,7,0,31,31,7,0,38,33,7,0,40
48977,328,"SCOALA NR.2 SAT RAMNICELU",RÎMNICELU,BZ,1417,6,3,0,9,20,3,0,23,32,3,0,35,55,3,0,58,60,3,0,63
49000,329,"SCOALA SAT ŞTIUBEI",ŞTIUBEI,BZ,484,3,2,0,5,6,4,0,10,10,5,0,15,17,7,0,24,17,7,0,24
48986,330,"ŞCOALA SAT COLIBAŞI",COLIBAŞI,BZ,332,4,3,0,7,9,3,0,12,15,3,0,18,25,6,0,31,26,7,0,33
48995,331,"ŞCOALA SAT FOTIN",FOTIN,BZ,175,5,3,0,8,13,4,0,17,17,4,0,21,21,9,0,30,23,9,0,32
49028,332,"ŞCOALA GIMNAZIALĂ ROBEASCA",ROBEASCA,BZ,570,11,1,0,12,19,2,0,21,24,2,0,26,28,5,15,48,31,5,15,51
49037,333,"CAMINUL CULTURAL MOŞEŞTI",MOŞEŞTI,BZ,265,3,4,0,7,12,12,0,24,18,18,24,60,21,20,24,65,23,20,24,67
49055,334,"LICEUL TEHNOLOGIC RUȘEȚU",RUŞEŢU,BZ,1008,5,1,0,6,7,3,0,10,10,4,0,14,21,6,0,27,23,8,0,31
49055,335,"CLĂDIREA GRĂDINIŢEI CU PROGRAM NORMAL",RUŞEŢU,BZ,968,3,0,0,3,8,1,0,9,15,1,0,16,25,1,0,26,29,1,0,30
49055,336,"CĂMINUL CULTURAL ""DIMITRIE GUSTI""",RUŞEŢU,BZ,961,14,0,0,14,26,0,0,26,50,1,0,51,68,4,0,72,80,5,0,85
49064,337,"ŞCOALA PRIMARĂ","SERGENT IONEL ŞTEFAN",BZ,166,1,0,0,1,3,1,0,4,4,5,0,9,6,7,0,13,7,7,0,14
49082,338,ŞCOALASĂGEATA,SĂGEATA,BZ,1135,15,0,0,15,34,4,0,38,40,8,0,48,68,10,0,78,71,12,0,83
49126,339,"ŞCOALA DÎMBROCA",DÎMBROCA,BZ,1022,8,2,0,10,18,3,0,21,35,4,0,39,47,5,0,52,49,5,0,54
49117,340,ŞCOALABORDUŞANI,BORDUŞANI,BZ,320,7,9,0,16,15,9,0,24,20,11,0,31,30,12,0,42,33,13,0,46
49108,341,ŞCOALABEILIC,BEILIC,BZ,301,8,0,0,8,19,6,0,25,24,6,7,37,32,6,7,45,35,6,7,48
49135,342,"ŞCOALA GĂVĂNEŞTI",GĂVĂNEŞTI,BZ,853,13,2,0,15,28,4,0,32,39,5,0,44,63,6,0,69,71,6,0,77
49091,343,SCOALABANIŢA,BANIŢA,BZ,254,7,5,0,12,8,5,0,13,15,5,0,20,17,10,0,27,17,11,0,28
49162,344,"CAMINUL CULTURAL SĂHĂTENI",SĂHĂTENI,BZ,1297,8,1,0,9,24,3,0,27,42,3,0,45,52,5,0,57,52,5,0,57
49180,345,"ŞCOALA CU CLS.I-IV ISTRIŢA DE JOS","ISTRIŢA DE JOS",BZ,274,6,1,0,7,7,1,0,8,10,1,0,11,15,5,0,20,15,5,0,20
49171,346,"ŞCOALA CU CLS.I-IV GĂGENI",GĂGENI,BZ,363,6,2,0,8,13,2,0,15,19,5,0,24,21,5,0,26,22,5,0,27
49199,347,"ŞCOALA CLS.I-VIII VINTILEANCA",VINTILEANCA,BZ,721,8,0,0,8,16,2,0,18,26,2,0,28,47,2,0,49,53,2,0,55
49215,348,"ȘCOALA GIMNAZIALĂ SĂPOCA",SĂPOCA,BZ,1428,12,1,0,13,28,5,0,33,34,6,0,40,40,6,0,46,42,7,67,116
49224,349,"ȘCOALA GIMNAZIALĂ MĂTESTI",MĂTEŞTI,BZ,1416,4,0,0,4,13,1,0,14,26,1,0,27,33,2,0,35,39,2,0,41
49242,350,"CĂMINUL CULTURAL SĂRULEŞTI",SĂRULEŞTI,BZ,1070,14,1,0,15,31,2,0,33,34,4,0,38,43,7,0,50,53,7,0,60
49322,351,"SALA DE FESTIVITĂŢI SCORTOASA",SCORŢOASA,BZ,1017,4,1,0,5,9,2,0,11,18,2,0,20,23,5,0,28,23,5,0,28
49402,352,"ŞCOALA PRIMARĂSAT GURA VĂII","GURA VĂII",BZ,181,1,2,0,3,3,2,0,5,8,2,0,10,15,2,0,17,16,2,0,18
49411,353,"ŞCOALA PRIMARĂ SATPLOPEASA DE SUS",PLOPEASA,BZ,164,2,1,0,3,10,1,0,11,12,2,0,14,14,2,0,16,14,2,0,16
49386,354,"ŞCOALAPRIMARĂ SAT GRABICINA DE JOS","GRABICINA DE JOS",BZ,174,1,4,0,5,7,7,0,14,11,7,0,18,12,8,0,20,12,8,0,20
49377,355,"ŞCOALA PRIMARĂ SAT GOLU GRABICINA","GOLU GRABICINA",BZ,233,3,2,0,5,6,2,0,8,8,2,0,10,15,3,0,18,15,3,0,18
49331,356,"SCOALA GIMNAZIALĂ SATBALTA TOCILA","BALTA TOCILA",BZ,265,9,4,0,13,13,7,0,20,15,9,0,24,19,10,0,29,20,11,0,31
49340,357,"ŞCOALA PRIMARĂ SATBECIU",BECIU,BZ,115,2,0,0,2,2,1,0,3,5,2,0,7,12,4,0,16,12,5,0,17
49448,358,"CĂMINUL CULTURAL DIN SATUL SCUTELNICI",SCUTELNICI,BZ,902,8,2,0,10,18,7,0,25,24,11,0,35,35,13,0,48,37,14,0,51
49466,359,"GRĂDINIŢA CU PROGRAM NORMAL SAT BRAGAREASA",BRĂGĂREASA,BZ,529,7,2,0,9,7,2,0,9,10,5,0,15,12,5,0,17,14,6,0,20
49457,360,"ŞCOALA PRIMARA SAT ARCANU",ARCANU,BZ,330,1,1,0,2,13,3,0,16,17,3,0,20,21,3,0,24,22,3,0,25
49493,361,"ŞCOALA GIMNAZIALA COMUNA SIRIU, JUDETUL BUZAU,DIN SATUL LUNCA JARISTEI","LUNCA JARIŞTEI",BZ,1425,9,1,0,10,28,1,0,29,43,3,0,46,44,4,0,48,49,4,0,53
49509,362,"ŞCOALA PRIMARĂ SAT COLŢU PIETRII,COMUNA SIRIU,JUDETUL BUZĂU","COLŢU PIETRII",BZ,1135,8,1,0,9,20,1,0,21,27,1,0,28,32,1,0,33,38,1,0,39
49554,363,"CĂMINUL DE NUNTI SMEENI",SMEENI,BZ,1209,4,1,0,5,10,1,0,11,11,2,0,13,14,4,0,18,18,5,0,23
49554,364,"GRĂDINIȚA CU PROGRAM NORMAL SMEENI",SMEENI,BZ,1109,10,3,0,13,19,5,0,24,21,5,0,26,30,11,0,41,40,11,0,51
49554,365,"ȘCOALA PRIMARĂ SĂLCIOARA",SMEENI,BZ,544,3,1,0,4,7,1,0,8,7,2,0,9,13,2,0,15,14,2,0,16
49590,366,"GRĂDINIȚA CU PROGRAM NORMAL MOISICA",MOISICA,BZ,289,10,4,0,14,13,5,0,18,17,5,0,22,28,7,0,35,30,7,0,37
49563,367,"ŞCOALA GIMNAZIALĂ ALBEŞTI",ALBEŞTI,BZ,719,2,0,0,2,5,3,0,8,9,3,0,12,13,3,0,16,15,3,0,18
49616,368,"GRĂDINIȚA CU PROGRAM NORMAL UDAŢI- MÂNZU",UDAŢI-MÂNZU,BZ,721,5,0,0,5,10,2,0,12,15,2,0,17,18,2,0,20,18,2,0,20
49581,369,"ŞCOALA PRMARĂ CĂLŢUNA",CĂLŢUNA,BZ,433,7,0,0,7,7,2,0,9,7,2,0,9,7,3,0,10,7,4,0,11
49607,370,"ŞCOALA PRMARĂ LUCIENI",UDAŢI-LUCIENI,BZ,349,0,0,0,0,0,0,0,0,0,0,0,0,1,4,0,5,1,4,0,5
49634,371,"SCOALA GIMNAZIALA STILPU",STÎLPU,BZ,1382,14,0,0,14,33,4,0,37,58,5,0,63,70,11,0,81,76,11,0,87
49634,372,"PRIMARIA STILPU",STÎLPU,BZ,1203,6,6,0,12,27,6,0,33,44,11,0,55,64,13,0,77,68,14,0,82
49670,373,"CAMINUL CULTURAL SAT GRAJDANA",GRĂJDANA,BZ,920,4,1,0,5,7,2,0,9,14,5,0,19,20,6,0,26,22,6,0,28
49698,374,"SCOALA PRIMARA, SAT IZVORANU, COMUNA TISAU",IZVORANU,BZ,97,3,1,0,4,3,2,0,5,5,2,0,7,8,2,0,10,8,4,0,12
49750,375,"GRADINIŢA CU PROGRAM NORMAL SAT VALEA SĂLCIILOR, COMUNA TISAU","VALEA SĂLCIILOR",BZ,500,1,1,0,2,4,1,0,5,6,1,0,7,11,1,0,12,11,1,0,12
49689,376,"ŞCOALAGIMNAZIALA SAT HALEŞ, COMUNA TISAU",HALEŞ,BZ,774,11,2,0,13,15,2,0,17,23,2,0,25,27,10,0,37,27,10,0,37
49714,377,"GRADINITA CU PROGRAM NORMAL SATPADURENI, COMUNA TISAU",PĂDURENII,BZ,468,4,1,0,5,12,1,0,13,17,1,0,18,24,1,0,25,24,1,0,25
49741,378,"GRADINIŢĂ CU PROGRAM NORMAL COMUNA TISAU",TISĂU,BZ,619,5,1,0,6,10,1,0,11,14,2,0,16,17,2,0,19,18,2,0,20
49732,379,"SCOALAPRIMARĂ SAT STREZENI, COMUNA TISAU",STREZENI,BZ,444,5,2,0,7,9,2,0,11,14,2,0,16,25,3,0,28,25,4,0,29
49821,380,"ŞCOALA PRIMARA POŞTA",POŞTA,BZ,437,5,1,0,6,6,2,0,8,12,5,0,17,13,5,0,18,13,5,0,18
49778,381,"ŞCOALA GIMNAZIALA TOPLICENI",TOPLICENI,BZ,1046,0,0,0,0,5,0,0,5,14,1,0,15,18,4,0,22,21,8,0,29
49830,382,"GRADINITA CU PROGRAM NORMAL RĂDUCEŞTI",RĂDUCEŞTI,BZ,380,0,1,0,1,4,2,0,6,7,3,0,10,15,5,0,20,15,5,0,20
49787,383,"ŞCOALAGIMNAZIALA BĂBENI ""ION ARISTOTEL""",BĂBENI,BZ,847,4,3,0,7,6,6,0,12,12,6,0,18,23,10,0,33,23,11,0,34
49803,384,"GRADINITA CU PROGRAM NORMAL DEDULEŞTI",DEDULEŞTI,BZ,776,1,1,0,2,3,2,0,5,8,2,0,10,18,2,0,20,19,2,0,21
49812,385,"SCOALA GURA-FAGETULUI","GURA FĂGETULUI",BZ,133,2,0,0,2,3,1,0,4,6,1,0,7,8,5,0,13,8,6,0,14
49858,386,"ŞCOALA PRIMARA SAT ŢINTEŞTI",ŢINTEŞTI,BZ,1847,20,1,0,21,52,4,0,56,83,7,0,90,144,11,0,155,158,14,0,172
49867,387,"SPAŢIUL DE UTILITATE PUBLICĂ DIN SATUL MAXENU",MAXENU,BZ,1810,6,4,0,10,20,4,0,24,26,5,0,31,48,8,0,56,60,8,0,68
49901,388,"SCOALA GIMNAZIALA PROFESOR CONSTANTIN DINCA ULMENI",ULMENI,BZ,1237,8,1,0,9,18,18,0,36,23,24,0,47,37,30,0,67,40,30,0,70
49929,389,"LOCALUL FOSTULUI SFAT POPULAR CLONDIRU",CLONDIRU,BZ,1348,9,0,0,9,30,6,0,36,47,7,0,54,78,14,0,92,87,14,0,101
47364,390,"SCOALA GIMNAZIALA ING. OPRISAN IARCA UNGURIU",UNGURIU,BZ,938,4,0,0,4,19,2,85,106,29,9,85,123,34,12,85,131,34,12,85,131
47364,391,"SCOALA GIMNAZIALA ING. OPRISAN IARCA UNGURIU",UNGURIU,BZ,956,7,0,0,7,13,0,0,13,19,0,0,19,22,2,0,24,22,5,0,27
49965,392,"SCOALA GIMNAZIALA VADU PAŞII","VADU PAŞII",BZ,1950,2,0,0,2,24,1,0,25,41,1,0,42,48,2,0,50,50,2,0,52
49965,393,"GRĂDINIŢA CU PROGRAM NORMAL VADU PAŞII","VADU PAŞII",BZ,1451,10,0,0,10,14,3,0,17,18,3,0,21,51,6,0,57,51,7,0,58
49983,394,"SCOALA FOCŞĂNEI",FOCŞĂNEI,BZ,1189,4,0,0,4,23,0,0,23,42,0,0,42,63,2,0,65,68,2,0,70
50004,395,"SCOALA CIOCÂRLIA",SCURTEŞTI,BZ,557,4,1,0,5,8,2,0,10,41,5,0,46,55,8,0,63,55,9,0,64
50004,396,"SCOALA GIMNAZIALA SCURTEŞTI",SCURTEŞTI,BZ,1638,3,0,0,3,16,2,0,18,27,2,0,29,32,3,0,35,40,5,0,45
50013,397,"ŞCOALA GIMNAZIALA STĂNCEŞTI",STĂNCEŞTI,BZ,1209,13,0,0,13,33,1,0,34,52,4,0,56,62,4,0,66,68,4,0,72
50040,398,"GRADINITA CU PROGRAM NORMAL OREAVU",OREAVUL,BZ,1905,11,0,0,11,32,1,0,33,40,1,0,41,73,4,0,77,82,4,0,86
50031,399,"SCOALA GIMNAZIALA VALEA RAMNICULUI","VALEA RÎMNICULUI",BZ,1826,27,0,0,27,60,2,0,62,85,4,0,89,115,4,30,149,120,4,30,154
50059,400,"GRADINITA CU PROGRAM NORMAL RUBLA",RUBLA,BZ,968,13,0,0,13,26,1,0,27,35,1,0,36,53,4,0,57,55,5,0,60
50077,401,"CĂMINUL CULTURAL VALEA SALCIEI","VALEA SALCIEI",BZ,590,13,0,0,13,15,0,0,15,16,0,0,16,18,0,11,29,23,0,11,34
50111,402,"ŞCOALA GIMNAZIALĂ ,,NICOLAE IOAN JILINSCHI,, VERNEȘTI",VERNEŞTI,BZ,1915,7,3,0,10,16,6,0,22,31,8,0,39,44,10,0,54,47,13,0,60
50139,403,"ŞCOALA GIMNAZIALĂSAT CÎNDEȘTI",CÎNDEŞTI,BZ,1390,7,1,0,8,10,2,0,12,14,4,0,18,20,4,0,24,20,4,0,24
50139,404,"ŞCOALA GIMNAZIALĂ SAT CINDEŞTI",CÎNDEŞTI,BZ,1355,2,0,0,2,5,0,0,5,10,0,0,10,16,0,0,16,17,0,0,17
50219,405,"ŞCOALA GIMNAZIALĂ ,,VASILE ALDEA,, ZOREȘTI",ZOREŞTI,BZ,1105,5,2,0,7,14,6,0,20,22,10,0,32,24,10,0,34,26,11,0,37
50175,406,"GRĂDINIȚA CU PROGRAM NORMAL NIȘCOV",NIŞCOV,BZ,1064,11,1,0,12,27,5,0,32,38,10,0,48,46,14,0,60,46,15,0,61
50184,407,"ŞCOALA PRIMARĂ SĂSENII NOI","SĂSENII NOI",BZ,296,4,0,0,4,7,0,0,7,11,0,0,11,15,4,0,19,16,4,0,20
50157,408,"GRADINITA CU PROGRAM NORMAL MIEREA",MIEREA,BZ,374,10,2,0,12,10,3,0,13,16,5,0,21,23,9,0,32,25,9,0,34
50237,409,"ŞCOALA GIMNAZIALĂ TACHE ŞI ECATERINA TOCILESCU","VINTILĂ VODĂ",BZ,1292,13,1,0,14,31,4,0,35,54,8,0,62,75,11,23,109,78,15,23,116
50273,410,"ŞCOALA PRIMARĂ SAT NICULEŞTI",NICULEŞTI,BZ,966,6,5,0,11,9,5,0,14,11,7,0,18,19,7,0,26,24,7,0,31
50255,411,"ŞCOALA PRIMARĂ SAT COCA ANTIMIREŞTI",COCA-ANTIMIREŞTI,BZ,206,0,3,0,3,3,3,0,6,3,3,0,6,3,4,0,7,3,4,0,7
50335,412,"ŞCOALA GIMNAZIALA VIPEREŞTI",VIPEREŞTI,BZ,906,8,0,0,8,12,1,0,13,15,1,0,16,26,3,0,29,28,3,0,31
50371,413,"ŞCOALA PRIMARA TRONARI",TRONARI,BZ,753,5,0,0,5,10,0,0,10,12,0,0,12,31,1,0,32,32,3,0,35
50380,414,"ŞCOALA GIMNAZIALA URSOAIA",URSOAIA,BZ,874,0,0,0,0,2,1,0,3,2,1,0,3,4,4,0,8,4,4,0,8
50344,415,"ŞCOALA PRIMARA MUŞCEL",MUSCEL,BZ,106,2,0,0,2,6,5,0,11,6,5,0,11,6,6,0,12,6,6,0,12
50406,416,"SCOALA GIMNAZIALA NR 1 VILCELELE",VÎLCELELE,BZ,1217,18,2,0,20,34,9,0,43,51,16,0,67,51,16,0,67,51,16,0,67
50424,417,"ŞCOALA GIMNAZIALĂ ""CONSTANTIN POPESCU"" FUNDENI",FUNDENI,BZ,1856,18,2,0,20,43,2,0,45,63,2,0,65,97,2,0,99,99,8,0,107
50442,418,"SCOALA GENERALA PRUNENI",PRUNENI,BZ,307,3,6,0,9,8,6,0,14,13,6,0,19,19,9,0,28,20,9,0,29
50451,419,"GRĂDINIŢA DE COPII VADU SOREŞTI","VADU SOREŞTI",BZ,1075,7,2,0,9,17,3,0,20,37,3,0,40,73,5,2,80,77,5,2,84
50460,420,"GRĂDINIŢA DE COPII ZĂRNEŞTI",ZĂRNEŞTI,BZ,869,11,2,0,13,20,3,0,23,33,8,0,41,39,10,0,49,47,11,0,58
50488,421,"SALA DE ŞEDINŢE PRIMĂRIA ZIDURI",ZIDURI,BZ,817,6,4,0,10,8,4,0,12,14,7,0,21,24,9,0,33,27,9,0,36
50521,422,"CĂMINUL CULTURAL LANURILE",LANURILE,BZ,599,5,2,0,7,19,4,0,23,28,8,0,36,35,11,0,46,35,15,0,50
50512,423,"ŞCOALA PRIMARĂ HELIADE RĂDULESCU","HELIADE RĂDULESCU",BZ,668,11,4,0,15,26,6,0,32,38,8,0,46,63,12,0,75,63,14,0,77
50497,424,"ŞCOALA PRIMARĂCOSTIENI",COSTIENI,BZ,617,3,3,0,6,8,4,0,12,14,4,0,18,22,4,0,26,24,4,0,28
50530,425,"CĂMINUL CULTURAL ZOIŢA",ZOIŢA,BZ,454,6,1,0,7,23,3,0,26,37,3,0,40,37,4,0,41,42,4,0,46
50503,426,"ŞCOALA PRIMARĂ CUCULEASA",CUCULEASA,BZ,372,2,0,0,2,5,0,0,5,12,0,0,12,22,4,0,26,25,4,0,29
54984,1,"COLEGIUL ECONOMIC “IULIAN POP”",CLUJ-NAPOCA,CJ,931,0,2,0,2,0,18,0,18,2,50,0,52,2,73,0,75,2,80,0,82
54984,2,"COLEGIUL ECONOMIC “IULIAN POP”",CLUJ-NAPOCA,CJ,1197,4,1,0,5,17,5,0,22,29,5,0,34,42,17,0,59,51,21,0,72
54984,3,"COLEGIUL TEHNIC DE TELECOMUNICATII“AUGUSTIN MAIOR”,",CLUJ-NAPOCA,CJ,1539,10,8,0,18,22,18,0,40,33,33,40,106,52,52,90,194,60,59,90,209
54984,4,"COLEGIUL TEHNIC DE TELECOMUNICATII“AUGUSTIN MAIOR”,",CLUJ-NAPOCA,CJ,1421,8,2,0,10,45,18,0,63,55,28,0,83,74,42,3,119,81,46,3,130
54984,5,"ŞCOALA""ION CREANGĂ"" ,",CLUJ-NAPOCA,CJ,1067,8,1,0,9,32,7,0,39,61,13,0,74,73,16,0,89,78,16,0,94
54984,6,"ŞCOALA""ION CREANGĂ"" ,",CLUJ-NAPOCA,CJ,1568,12,1,0,13,39,2,0,41,63,11,0,74,83,17,0,100,92,32,0,124
54984,7,"ŞCOALA""ION CREANGĂ"" ,",CLUJ-NAPOCA,CJ,1270,14,0,0,14,40,1,0,41,51,2,0,53,71,4,0,75,80,4,0,84
54984,8,"GRADINITA DUMBRAVA MINUNATA",CLUJ-NAPOCA,CJ,1267,15,3,0,18,50,4,1,55,72,4,1,77,86,4,1,91,95,4,1,100
54984,9,"GRADINITA ""DUMBRAVA MINUNATĂ""",CLUJ-NAPOCA,CJ,1597,13,4,0,17,58,11,0,69,71,13,0,84,100,15,0,115,109,15,0,124
54984,10,"GRĂDINIŢA ""DUMBRAVA MINUNATĂ"" (FOSTA 66),",CLUJ-NAPOCA,CJ,1524,9,3,0,12,46,5,0,51,67,5,0,72,92,5,0,97,104,5,0,109
54984,11,"ŞCOALA “IULIU HAŢIEGANU” (FOSTĂ NR.21)",CLUJ-NAPOCA,CJ,918,2,0,0,2,19,5,0,24,29,5,0,34,43,6,0,49,46,6,0,52
54984,12,"ŞCOALA “IULIU HAŢIEGANU” (FOSTĂ NR.21)",CLUJ-NAPOCA,CJ,917,9,1,0,10,21,3,0,24,33,13,0,46,56,18,0,74,58,23,0,81
54984,13,"GRĂDINIŢA ""ALBINUŢA"" (FOSTĂ CĂSUŢA POVEŞTILOR), STR. GRIGORE ALEXANDRESCU, NR.21/A",CLUJ-NAPOCA,CJ,1652,18,3,0,21,61,3,0,64,83,3,0,86,112,7,0,119,119,10,0,129
54984,14,"ŞCOALA “IULIU HAŢIEGANU” (FOSTĂ NR.21),",CLUJ-NAPOCA,CJ,1600,11,0,0,11,45,2,0,47,77,2,0,79,93,10,0,103,101,11,0,112
54984,15,"ŞCOALA “IULIU HAŢIEGANU” (FOSTĂ NR.21),",CLUJ-NAPOCA,CJ,1882,19,1,0,20,55,2,0,57,88,2,0,90,115,4,0,119,130,8,0,138
54984,16,"ŞCOALA “IULIU HAŢIEGANU” (FOSTĂ NR.21),",CLUJ-NAPOCA,CJ,1390,16,2,0,18,35,8,0,43,50,13,0,63,65,17,0,82,81,18,0,99
54984,17,"COLEGIUL TEHNIC NAPOCA",CLUJ-NAPOCA,CJ,1540,8,2,0,10,26,7,0,33,48,18,0,66,68,24,0,92,82,29,0,111
54984,18,"LICEUL CU PROGRAM SPORTIV (FOSTA SCOALA NR.20).",CLUJ-NAPOCA,CJ,1614,13,0,0,13,54,0,0,54,74,5,0,79,104,7,0,111,119,9,0,128
54984,19,"LICEUL CU PROGRAM SPORTIV (FOSTA SCOALA NR.20).",CLUJ-NAPOCA,CJ,1593,10,0,0,10,24,0,0,24,54,0,0,54,70,0,0,70,84,5,0,89
54984,20,"LICEUL CU PROGRAM SPORTIV (FOSTA SCOALA NR.20).",CLUJ-NAPOCA,CJ,1564,11,0,0,11,52,1,0,53,64,3,0,67,91,3,0,94,105,5,0,110
54984,21,"LICEUL TEORETIC ""EUGEN PORA""",CLUJ-NAPOCA,CJ,1657,12,3,0,15,37,6,0,43,57,8,0,65,80,8,0,88,97,9,0,106
54984,22,"LICEUL TEORETIC ""EUGEN PORA""",CLUJ-NAPOCA,CJ,1621,11,1,0,12,36,6,0,42,58,16,0,74,88,22,0,110,100,30,0,130
54984,23,"LICEUL TEORETIC ""EUGEN PORA""",CLUJ-NAPOCA,CJ,889,9,1,0,10,23,9,0,32,35,12,0,47,48,12,0,60,52,13,0,65
54984,24,"LICEUL TEORETIC ""EUGEN PORA""",CLUJ-NAPOCA,CJ,1709,20,2,0,22,53,2,0,55,82,2,0,84,99,5,0,104,116,6,0,122
54984,25,"SCOALA INTERNATIONALA ""SPECTRUM""",CLUJ-NAPOCA,CJ,1713,14,2,0,16,49,6,0,55,82,16,0,98,101,22,0,123,110,31,0,141
54984,26,"SCOALA INTERNATIONALA ""SPECTRUM""",CLUJ-NAPOCA,CJ,1447,16,2,0,18,34,2,0,36,58,10,0,68,69,15,0,84,74,18,0,92
54984,27,"SCOALA INTERNATIONALA ""SPECTRUM""",CLUJ-NAPOCA,CJ,1304,3,1,0,4,25,4,0,29,48,9,0,57,68,13,0,81,71,13,0,84
54984,28,"SCOALA INTERNATIONALA ""SPECTRUM""",CLUJ-NAPOCA,CJ,1216,12,0,0,12,36,2,0,38,46,2,0,48,72,2,0,74,76,2,0,78
54984,29,"LICEUL TEORETIC ""EUGEN PORA"", STR.MOGOŞOAIA NR.6",CLUJ-NAPOCA,CJ,1624,17,0,0,17,53,0,0,53,72,0,0,72,98,5,0,103,109,5,0,114
54984,30,"SALA SPORTURILOR ""HOREA DEMIAN""",CLUJ-NAPOCA,CJ,921,13,4,0,17,45,9,0,54,66,11,0,77,90,17,0,107,93,17,0,110
54984,31,"SALA SPORTURILOR ""HOREA DEMIAN""",CLUJ-NAPOCA,CJ,1427,3,1,0,4,37,8,0,45,53,15,0,68,65,20,0,85,77,22,0,99
54984,32,"SALA SPORTURILOR ""HOREA DEMIAN""",CLUJ-NAPOCA,CJ,1382,12,3,0,15,49,4,0,53,65,11,0,76,86,13,0,99,92,13,0,105
54984,33,"CENTRUL REGIONAL DE EXCELENŢĂ,",CLUJ-NAPOCA,CJ,1635,10,3,0,13,47,4,0,51,74,5,0,79,89,7,0,96,91,9,0,100
54984,34,"LICEUL TEORETIC ""ONISIFOR GHIBU"",",CLUJ-NAPOCA,CJ,1726,21,8,0,29,68,14,0,82,93,22,0,115,114,23,2,139,121,28,2,151
54984,35,"LICEUL TEORETIC ""ONISIFOR GHIBU"",",CLUJ-NAPOCA,CJ,1542,3,6,0,9,34,7,0,41,51,7,0,58,66,8,0,74,76,8,0,84
54984,36,"LICEUL TEORETIC ""ONISIFOR GHIBU"",",CLUJ-NAPOCA,CJ,1272,10,0,0,10,33,0,0,33,51,1,0,52,63,2,0,65,64,2,0,66
54984,37,"LICEUL TEORETIC ""ONISIFOR GHIBU"",",CLUJ-NAPOCA,CJ,1685,17,1,0,18,53,3,0,56,92,8,0,100,128,18,0,146,135,20,0,155
54984,38,"LICEUL TEORETIC ""ONISIFOR GHIBU"",",CLUJ-NAPOCA,CJ,1285,14,2,0,16,38,7,0,45,55,7,0,62,70,9,0,79,76,9,0,85
54984,39,"GRADINIŢA"" MICA SIRENA"" (FOSTĂ 64),",CLUJ-NAPOCA,CJ,1477,11,5,0,16,46,9,0,55,65,9,0,74,91,13,0,104,106,17,0,123
54984,40,"GRADINIŢA ""LICURICI"" (FOSTA STELUŢA FERMECATĂ), STR.FÂNTÂNELE NR.46",CLUJ-NAPOCA,CJ,1380,16,3,0,19,60,6,0,66,79,11,0,90,122,15,0,137,129,15,0,144
54984,41,"GRADINIŢA ""LICURICI"" (FOSTA STELUŢA FERMECATĂ), STR.FÂNTÂNELE NR.46",CLUJ-NAPOCA,CJ,1665,22,3,0,25,46,6,0,52,60,6,0,66,88,7,0,95,100,7,0,107
54984,42,"INSTITUTUL DE CERCETARI ÎN CHIMIE ”RALUCA RIPAN”",CLUJ-NAPOCA,CJ,1680,18,1,0,19,63,8,0,71,87,13,0,100,99,13,0,112,106,13,0,119
54984,43,"GRADINITA MICA SIRENA (FOSTA 12)",CLUJ-NAPOCA,CJ,1469,19,0,0,19,43,2,0,45,59,2,0,61,91,5,0,96,97,6,0,103
54984,44,"INSTITUTUL DE CERCETARI ÎN CHIMIE"" RALUCA RIPAN"",",CLUJ-NAPOCA,CJ,1525,7,0,0,7,33,0,0,33,51,1,0,52,73,2,0,75,83,5,0,88
54984,45,"INSTITUTUL DE CERCETARI ÎN CHIMIE"" RALUCA RIPAN"",",CLUJ-NAPOCA,CJ,1856,16,0,0,16,59,11,0,70,84,14,0,98,123,14,0,137,133,15,0,148
54984,46,"COLEGIUL TEHNIC ”EDMOND NICOLAU”",CLUJ-NAPOCA,CJ,1105,7,0,0,7,20,3,0,23,30,15,0,45,48,19,0,67,58,23,0,81
54984,47,"LICEUL DE INFORMATICĂ „TIBERIU POPOVICIU”",CLUJ-NAPOCA,CJ,1587,12,6,0,18,34,15,0,49,59,19,0,78,81,30,0,111,95,37,0,132
54984,48,"LICEUL DE INFORMATICĂ „TIBERIU POPOVICIU”",CLUJ-NAPOCA,CJ,1529,9,2,0,11,37,18,0,55,51,24,0,75,70,30,0,100,74,33,0,107
54984,49,"LICEUL DE INFORMATICĂ „TIBERIU POPOVICIU”",CLUJ-NAPOCA,CJ,1649,23,1,0,24,57,2,0,59,91,4,0,95,112,7,0,119,124,11,0,135
54984,50,"LICEUL DE INFORMATICĂ „TIBERIU POPOVICIU”",CLUJ-NAPOCA,CJ,1373,11,0,0,11,42,3,0,45,68,4,0,72,81,4,0,85,85,4,0,89
54984,51,"LICEUL DE INFORMATICĂ „TIBERIU POPOVICIU”",CLUJ-NAPOCA,CJ,1210,18,0,0,18,54,0,0,54,71,2,0,73,94,3,0,97,100,8,0,108
54984,52,"ASOCIAŢIA ""CARITATEA""",CLUJ-NAPOCA,CJ,2197,12,8,0,20,51,20,0,71,88,36,0,124,141,46,0,187,170,55,0,225
54984,53,"GRADINIŢA ""ZÎNA ZORILOR"", STR.L.PASTEUR NR.12",CLUJ-NAPOCA,CJ,1835,25,0,0,25,66,13,0,79,79,20,0,99,90,27,0,117,107,28,150,285
54984,54,"FACULTATEA DE ARHITECTURĂ ŞI URBANISM, STR.OBSERVATORULUI NR.72",CLUJ-NAPOCA,CJ,1555,9,0,0,9,33,7,0,40,50,21,0,71,59,45,0,104,74,55,0,129
54984,55,"FACULTATEA DE ARHITECTURĂ ŞI URBANISM, STR.OBSERVATORULUI NR.72",CLUJ-NAPOCA,CJ,1433,10,0,0,10,23,13,1,37,33,29,1,63,40,33,1,74,53,44,1,98
54984,56,"FACULTATEA DE ARHITECTURĂ ŞI URBANISM, STR.OBSERVATORULUI NR.72",CLUJ-NAPOCA,CJ,1056,2,0,0,2,10,1,0,11,22,2,0,24,39,4,0,43,46,5,0,51
54984,57,"FACULTATEA DE ARHITECTURĂ ŞI URBANISM, STR.OBSERVATORULUI NR.72",CLUJ-NAPOCA,CJ,1316,6,5,0,11,14,6,0,20,33,8,0,41,40,11,0,51,61,11,0,72
54984,58,"LICEUL INFORMATICA ”T.POPOVICIU”",CLUJ-NAPOCA,CJ,1970,13,3,0,16,47,14,0,61,58,26,0,84,97,42,0,139,118,51,0,169
54984,59,"LICEUL INFORMATICA ”T.POPOVICIU”",CLUJ-NAPOCA,CJ,2675,5,2,0,7,48,9,0,57,95,12,0,107,117,17,0,134,126,18,0,144
54984,60,"LICEUL INFORMATICA ”T.POPOVICIU”",CLUJ-NAPOCA,CJ,1912,9,2,0,11,31,5,0,36,62,8,0,70,75,9,0,84,94,11,0,105
54984,61,"PALATUL COPIILOR",CLUJ-NAPOCA,CJ,1531,18,3,0,21,47,11,0,58,68,32,0,100,83,45,75,203,93,57,75,225
54984,62,"SCOALA""IOAN BOB""",CLUJ-NAPOCA,CJ,1465,10,3,0,13,36,5,0,41,64,16,0,80,65,21,0,86,75,21,0,96
54984,63,"COLEGIUL NAŢIONAL ""G.COŞBUC""",CLUJ-NAPOCA,CJ,1187,10,0,0,10,37,10,0,47,60,16,0,76,76,22,0,98,90,25,0,115
54984,64,"LICEUL TEORETIC ""GH. SINCAI""",CLUJ-NAPOCA,CJ,1566,12,3,0,15,39,6,0,45,78,34,0,112,88,41,0,129,102,47,0,149
54984,65,"LICEUL TEORETIC ""GH. SINCAI""",CLUJ-NAPOCA,CJ,1478,15,0,0,15,58,1,0,59,72,14,0,86,87,19,0,106,88,25,0,113
54984,66,"LICEUL TEORETIC ""GH. SINCAI""",CLUJ-NAPOCA,CJ,1702,16,5,0,21,47,9,0,56,67,19,0,86,97,25,0,122,110,35,0,145
54984,67,"LICEUL TEORETIC ""GH. SINCAI""",CLUJ-NAPOCA,CJ,1186,9,1,0,10,36,1,0,37,45,6,0,51,74,8,0,82,83,10,0,93
54984,68,"LICEUL TEORETIC ""GH. SINCAI""",CLUJ-NAPOCA,CJ,1440,4,0,0,4,32,0,0,32,59,3,0,62,76,8,0,84,92,12,0,104
54984,69,"LICEUL TEORETIC ""GH. SINCAI""",CLUJ-NAPOCA,CJ,1376,14,5,0,19,33,9,0,42,52,9,0,61,69,9,0,78,80,11,0,91
54984,70,"COLEGIUL TEHNIC "" EDMOND NICOLAU"",",CLUJ-NAPOCA,CJ,1884,8,1,0,9,38,3,0,41,58,7,0,65,69,8,0,77,90,11,0,101
54984,71,"COLEGIUL TEHNIC "" EDMOND NICOLAU"",",CLUJ-NAPOCA,CJ,1478,5,1,0,6,34,2,0,36,44,7,0,51,72,8,0,80,80,12,0,92
54984,72,"COLEGIUL TEHNIC "" EDMOND NICOLAU"",",CLUJ-NAPOCA,CJ,1609,12,1,0,13,34,2,0,36,62,5,0,67,86,6,0,92,96,6,0,102
54984,73,"COLEGIUL TEHNIC "" EDMOND NICOLAU"",",CLUJ-NAPOCA,CJ,1511,13,0,0,13,38,0,0,38,54,2,0,56,86,4,0,90,91,5,0,96
54984,74,"ŞCOALA ""LIVIU REBREANU""",CLUJ-NAPOCA,CJ,1594,10,0,0,10,48,7,0,55,76,10,0,86,94,12,0,106,108,12,0,120
54984,75,"ŞCOALA ""LIVIU REBREANU""",CLUJ-NAPOCA,CJ,1618,8,0,0,8,36,0,0,36,51,5,0,56,67,10,0,77,75,12,0,87
54984,76,"ŞCOALA ""LIVIU REBREANU""",CLUJ-NAPOCA,CJ,1605,5,0,0,5,42,0,0,42,61,0,0,61,79,0,0,79,89,0,0,89
54984,77,"GRADINIŢA ""UNIVERSUL COPIILOR"" (FOSTĂNR.71)",CLUJ-NAPOCA,CJ,1470,18,1,0,19,44,4,0,48,65,4,0,69,85,7,0,92,98,11,0,109
54984,78,"ŞCOALA "" LIVIU REBREANU""( FOSTA CONSTANTIN BRÂNCOVEANU),ALEEA RETEZAT NR.4",CLUJ-NAPOCA,CJ,1570,15,0,0,15,39,4,0,43,66,7,0,73,78,8,0,86,86,8,0,94
54984,79,"ŞCOALA "" LIVIU REBREANU"" ( FOSTA CONSTANTIN BRÂNCOVEANU), ALEEA RETEZAT NR.4",CLUJ-NAPOCA,CJ,1135,13,0,0,13,39,1,0,40,63,7,0,70,76,11,0,87,83,11,0,94
54984,80,"ŞCOALA "" LIVIU REBREANU"" ( FOSTA CONSTANTIN BRÂNCOVEANU), ALEEA RETEZAT NR.4",CLUJ-NAPOCA,CJ,1383,13,0,0,13,40,1,0,41,57,2,0,59,68,3,0,71,76,5,0,81
54984,81,"ŞCOALA "" LIVIU REBREANU"" ( FOSTA CONSTANTIN BRÂNCOVEANU), ALEEA RETEZAT NR.4",CLUJ-NAPOCA,CJ,965,10,1,0,11,22,1,0,23,38,2,0,40,55,2,0,57,59,2,0,61
54984,82,"GRADINIŢA"" BUBURUZA"" (FOSTĂ NR. 70),",CLUJ-NAPOCA,CJ,1139,6,4,0,10,22,4,0,26,29,4,0,33,40,9,0,49,51,10,0,61
54984,83,"GRADINIŢA"" BUBURUZA"" (FOSTĂ NR. 70),",CLUJ-NAPOCA,CJ,1587,0,0,0,0,22,0,0,22,47,2,0,49,66,3,0,69,71,3,0,74
54984,84,"GRADINIŢA ""ACADEMIA PITICILOR""(FOSTĂ NR. 72),",CLUJ-NAPOCA,CJ,1765,10,2,0,12,50,8,0,58,79,8,0,87,117,11,0,128,124,14,0,138
54984,85,"GRADINIŢA ""ACADEMIA PITICILOR""(FOSTĂ NR. 72),",CLUJ-NAPOCA,CJ,1491,17,1,0,18,46,1,0,47,59,6,0,65,76,7,0,83,83,7,0,90
54984,86,"FOSTA ŞCOALĂ NR.6,",CLUJ-NAPOCA,CJ,1446,13,0,0,13,35,2,0,37,42,4,1,47,61,4,1,66,66,6,1,73
54984,87,"FOSTA ŞCOALĂ NR.6,",CLUJ-NAPOCA,CJ,1583,10,0,0,10,36,1,0,37,72,7,0,79,101,11,0,112,111,13,0,124
54984,88,"FOSTA ŞCOALĂ NR.6,",CLUJ-NAPOCA,CJ,1583,15,4,0,19,43,10,0,53,73,11,0,84,96,14,0,110,98,14,0,112
54984,89,"FOSTA ŞCOALĂ NR.6,",CLUJ-NAPOCA,CJ,1211,18,0,0,18,50,0,0,50,69,1,0,70,91,1,0,92,98,3,0,101
54984,90,"ŞCOALA ”OCTAVIAN GOGA”",CLUJ-NAPOCA,CJ,1511,2,3,0,5,28,13,0,41,44,26,0,70,76,33,0,109,81,44,0,125
54984,91,"ŞCOALA ”OCTAVIAN GOGA”",CLUJ-NAPOCA,CJ,1484,10,3,0,13,27,12,0,39,44,15,0,59,56,16,0,72,59,20,0,79
54984,92,"ŞCOALA ”OCTAVIAN GOGA”",CLUJ-NAPOCA,CJ,1582,6,1,0,7,27,4,0,31,39,7,0,46,60,13,0,73,62,15,0,77
54984,93,"COLEGIUL NAŢIONAL""GEORGE COŞBUC"",",CLUJ-NAPOCA,CJ,1194,5,3,0,8,40,5,10,55,46,7,10,63,60,7,10,77,74,7,10,91
54984,94,"COLEGIUL NAŢIONAL""GEORGE COŞBUC"",",CLUJ-NAPOCA,CJ,940,4,0,0,4,23,0,0,23,37,2,0,39,48,2,0,50,53,2,0,55
54984,95,"GRADINIŢA ""POIENIŢA"",",CLUJ-NAPOCA,CJ,1641,8,4,0,12,43,7,0,50,83,8,0,91,112,13,0,125,119,16,0,135
54984,96,"GRADINIŢA ""POIENŢA"",",CLUJ-NAPOCA,CJ,2215,5,0,0,5,45,2,0,47,61,2,0,63,97,8,0,105,112,8,0,120
54984,97,"GRADINIŢA ""POIENŢA"",",CLUJ-NAPOCA,CJ,1870,5,7,0,12,26,10,0,36,42,14,0,56,65,20,1,86,69,21,1,91
54984,98,"ŞCOALA “CONSTANTIN BRÂNCUŞI”",CLUJ-NAPOCA,CJ,2000,13,2,0,15,72,5,0,77,103,8,8,119,135,14,8,157,154,14,8,176
54984,99,"ŞCOALA “CONSTANTIN BRÂNCUŞI”",CLUJ-NAPOCA,CJ,1615,12,2,0,14,37,4,0,41,84,4,0,88,104,12,0,116,118,15,0,133
54984,100,"ŞCOALA “CONSTANTIN BRÂNCUŞI”",CLUJ-NAPOCA,CJ,891,7,2,0,9,30,4,0,34,42,8,0,50,65,10,0,75,70,10,0,80
54984,101,"ŞCOALA “CONSTANTIN BRÂNCUŞI”",CLUJ-NAPOCA,CJ,1528,8,7,0,15,52,12,0,64,71,16,0,87,91,19,0,110,98,19,0,117
54984,102,"GRĂDINIŢA ""LUMEA COPIILOR"", STR.SEPTIMIU ALBINI NR 53",CLUJ-NAPOCA,CJ,1006,3,0,0,3,24,1,0,25,37,3,0,40,44,4,0,48,57,9,0,66
54984,103,"CREŞA ""CASTELUL FERMECAT"", STR.SEPTIMIU ALBINI NR.91",CLUJ-NAPOCA,CJ,1498,21,2,0,23,52,3,0,55,75,5,0,80,91,8,0,99,101,12,0,113
54984,104,"CREŞA ""CASTELUL FERMECAT"", STR.SEPTIMIU ALBINI NR.91",CLUJ-NAPOCA,CJ,1547,10,4,0,14,48,4,0,52,67,6,0,73,88,6,0,94,94,7,0,101
54984,105,"GRĂDINIŢA "" LUMEA COPIILOR"" (FOSTĂ NR. 20),",CLUJ-NAPOCA,CJ,1714,11,3,0,14,39,6,0,45,61,12,0,73,79,18,0,97,90,18,0,108
54984,106,"GRĂDINIŢA "" LUMEA COPIILOR"" (FOSTĂ NR. 20),",CLUJ-NAPOCA,CJ,1585,20,7,0,27,58,10,0,68,72,12,0,84,91,16,0,107,97,16,0,113
54984,107,"LICEUL TEORETIC ""LUCIAN BLAGA""",CLUJ-NAPOCA,CJ,1630,18,1,0,19,32,4,0,36,76,5,0,81,92,7,0,99,107,10,0,117
54984,108,"LICEUL TEORETIC ""LUCIAN BLAGA""",CLUJ-NAPOCA,CJ,1317,18,0,0,18,37,0,0,37,69,1,0,70,87,3,0,90,93,4,0,97
54984,109,"LICEUL TEORETIC ""LUCIAN BLAGA""",CLUJ-NAPOCA,CJ,1298,11,0,0,11,60,9,0,69,87,11,0,98,117,14,0,131,119,15,0,134
54984,110,"LICEUL TEORETIC ""LUCIAN BLAGA""",CLUJ-NAPOCA,CJ,1478,10,3,0,13,36,7,0,43,62,13,0,75,85,25,0,110,92,27,0,119
54984,111,"ŞCOALA "" N.TITULESCU""",CLUJ-NAPOCA,CJ,1958,19,5,0,24,65,9,0,74,97,11,0,108,130,14,0,144,138,16,0,154
54984,112,"ŞCOALA "" N.TITULESCU""",CLUJ-NAPOCA,CJ,1478,18,1,0,19,58,9,0,67,88,13,0,101,112,15,0,127,121,19,0,140
54984,113,"LICEUL TEHNOLOGIC ""AL. BORZA""",CLUJ-NAPOCA,CJ,1507,4,0,0,4,26,7,0,33,50,17,0,67,82,26,0,108,94,27,0,121
54984,114,"LICEUL TEHNOLOGIC ""AL. BORZA""",CLUJ-NAPOCA,CJ,1040,5,1,0,6,30,8,0,38,53,21,0,74,64,39,0,103,67,40,0,107
54984,115,"COLEGIUL TEHNIC DE TRANSPORTURI"" TRANSILVANIA""",CLUJ-NAPOCA,CJ,1508,4,7,0,11,31,9,0,40,47,13,0,60,72,14,0,86,83,14,0,97
54984,116,"COLEGIUL TEHNIC DE TRANSPORTURI"" TRANSILVANIA""",CLUJ-NAPOCA,CJ,1887,11,4,0,15,44,4,0,48,67,6,0,73,100,7,0,107,115,8,0,123
54984,117,"COLEGIUL TEHNIC ""ENERGETIC""",CLUJ-NAPOCA,CJ,1590,18,0,0,18,55,3,0,58,85,8,0,93,121,15,1,137,139,19,1,159
54984,118,"UNIVERSITATEA “BABES-BOLYAI” - FACULTATEA DE ŞTIINŢE ECONOMICE ŞI GESTIUNEA AFACERILOR,",CLUJ-NAPOCA,CJ,1906,5,7,0,12,19,17,0,36,42,36,0,78,68,54,0,122,72,66,0,138
54984,119,"UNIVERSITATEA “BABES-BOLYAI” - FACULTATEA DE ŞTIINŢE ECONOMICE ŞI GESTIUNEA AFACERILOR,",CLUJ-NAPOCA,CJ,1312,10,5,0,15,29,15,0,44,45,27,0,72,68,48,0,116,68,48,0,116
54984,120,"ŞCOALA ""ION AGÂRBICEANU"",",CLUJ-NAPOCA,CJ,1270,10,5,0,15,11,17,0,28,42,24,1,67,56,42,1,99,63,48,1,112
54984,121,"ŞCOALA ""ION AGÂRBICEANU"",",CLUJ-NAPOCA,CJ,1397,12,5,0,17,34,17,0,51,51,22,0,73,76,27,0,103,90,30,0,120
54984,122,"ŞCOALA ""ION AGÂRBICEANU"",",CLUJ-NAPOCA,CJ,1491,5,0,0,5,25,4,0,29,38,11,0,49,50,13,0,63,75,15,0,90
54984,123,"ŞCOALA ""ION AGÂRBICEANU"",",CLUJ-NAPOCA,CJ,1404,5,1,0,6,23,13,0,36,35,16,0,51,53,22,0,75,62,30,0,92
54984,124,"ŞCOALA ""ION AGÂRBICEANU"",",CLUJ-NAPOCA,CJ,1418,9,3,0,12,29,6,0,35,46,10,0,56,63,12,0,75,71,14,0,85
54984,125,"ŞCOALA ""ION AGÂRBICEANU"",",CLUJ-NAPOCA,CJ,1412,5,0,0,5,18,1,0,19,30,3,0,33,46,8,0,54,54,13,0,67
54984,126,"ŞCOALA ""ION AGÂRBICEANU"",",CLUJ-NAPOCA,CJ,1055,6,0,0,6,15,0,0,15,32,1,0,33,57,7,0,64,60,9,0,69
54984,127,"GRĂDINŢA ""MĂMARUŢA""(FOSTĂ NR. 42),",CLUJ-NAPOCA,CJ,1629,13,7,0,20,39,21,0,60,51,31,0,82,77,39,0,116,92,40,0,132
54984,128,"COLEGIUL TEHNIC “ANGHEL SALIGNY”,",CLUJ-NAPOCA,CJ,1479,2,0,0,2,28,16,12,56,52,31,12,95,64,47,25,136,71,52,25,148
54984,129,"COLEGIUL TEHNIC “ANGHEL SALIGNY”,",CLUJ-NAPOCA,CJ,1257,9,4,0,13,45,14,0,59,56,20,0,76,74,26,0,100,88,30,0,118
54984,130,"COLEGIUL TEHNIC “ANGHEL SALIGNY”,",CLUJ-NAPOCA,CJ,1553,10,4,0,14,28,5,0,33,51,5,0,56,69,5,62,136,87,6,62,155
54984,131,"COLEGIUL TEHNIC ""ANGHEL SALIGNY""",CLUJ-NAPOCA,CJ,1586,1,2,0,3,22,2,0,24,59,3,0,62,62,3,0,65,68,3,0,71
54984,132,"COLEGIUL DE MUZICĂ ""SIGISMUND TODUŢĂ"" (FOSTUL GRUP SCOLAR DE MATERIAL RULANT- UNIREA)",CLUJ-NAPOCA,CJ,1630,7,3,0,10,32,6,0,38,50,15,0,65,71,23,0,94,96,24,0,120
54984,133,"COLEGIUL DE MUZICĂ ""SIGISMUND TODUŢĂ"" (FOSTUL GRUP SCOLAR DE MATERIAL RULANT- UNIREA)",CLUJ-NAPOCA,CJ,911,1,0,0,1,13,1,0,14,19,5,0,24,35,7,0,42,41,9,0,50
54984,134,"LICEUL TEORETIC ""A. IANCU"",",CLUJ-NAPOCA,CJ,1522,12,0,0,12,35,4,0,39,55,7,0,62,70,14,0,84,76,14,0,90
54984,135,"LICEUL TEORETIC ""VICTOR BABEŞ"" (FOSTA SCOALA ""DAVID PRODAN""),",CLUJ-NAPOCA,CJ,1547,7,1,0,8,20,5,0,25,35,10,0,45,61,15,0,76,65,15,0,80
54984,136,"SEMINARUL TEOLOGIC ORTODOX (FOSTĂ ŞCOALA ""DAVID PRODAN""),",CLUJ-NAPOCA,CJ,1665,9,3,0,12,25,5,0,30,47,7,0,54,61,7,0,68,71,7,0,78
54984,137,"ŞCOALA “HOREA”",CLUJ-NAPOCA,CJ,1544,5,3,0,8,46,6,0,52,64,16,0,80,85,24,0,109,90,26,0,116
54984,138,"LICEUL TEORETIC ""N. BALCESCU"",",CLUJ-NAPOCA,CJ,1427,17,5,0,22,54,32,11,97,86,68,16,170,102,81,16,199,108,95,16,219
54984,139,"LICEULTEORETIC UNITARIAN"" JANOS ZSIGMOND""",CLUJ-NAPOCA,CJ,1342,13,7,0,20,47,20,0,67,74,52,0,126,85,94,0,179,96,100,0,196
54984,140,"PAVILIONUL “EXPO TRANSILVANIA”",CLUJ-NAPOCA,CJ,1751,19,9,0,28,53,27,0,80,81,47,0,128,109,60,0,169,121,64,0,185
54984,141,"PAVILIONUL “EXPO TRANSILVANIA”",CLUJ-NAPOCA,CJ,1086,7,7,0,14,28,17,0,45,49,23,0,72,67,29,0,96,83,32,0,115
54984,142,"PAVILIONUL “EXPO TRANSILVANIA”",CLUJ-NAPOCA,CJ,1587,24,0,0,24,62,1,0,63,89,1,0,90,116,1,0,117,137,2,0,139
54984,143,"PAVILIONUL “EXPO TRANSILVANIA”",CLUJ-NAPOCA,CJ,1441,10,2,0,12,38,5,0,43,51,5,0,56,72,5,0,77,79,5,0,84
54984,144,"PAVILIONUL “EXPO TRANSILVANIA”",CLUJ-NAPOCA,CJ,1374,12,0,0,12,26,1,0,27,30,4,0,34,56,6,1,63,63,6,1,70
54984,145,"PAVILIONUL “EXPO TRANSILVANIA”",CLUJ-NAPOCA,CJ,1583,11,3,0,14,41,5,0,46,53,6,0,59,79,9,0,88,87,9,0,96
54984,146,"PAVILIONUL “EXPO TRANSILVANIA”",CLUJ-NAPOCA,CJ,1472,12,8,0,20,39,9,0,48,55,10,0,65,76,11,0,87,89,11,0,100
54984,147,"GRĂDINIŢA ""DEGEŢICA""(FOSTĂ NR. 53),",CLUJ-NAPOCA,CJ,1564,16,1,0,17,42,4,0,46,59,4,0,63,77,9,0,86,87,9,0,96
54984,148,"GRĂDINIŢA ""DEGEŢICA""(FOSTĂ NR. 53),",CLUJ-NAPOCA,CJ,1553,5,2,0,7,21,4,0,25,35,13,0,48,49,18,0,67,57,18,0,75
54984,149,"ŞCOALA "" AL.VAIDA VOEVOD"",",CLUJ-NAPOCA,CJ,1636,9,0,0,9,16,7,0,23,29,9,0,38,48,14,0,62,58,16,0,74
54984,150,"ŞCOALA "" AL.VAIDA VOEVOD"",",CLUJ-NAPOCA,CJ,1666,11,0,0,11,24,1,0,25,54,3,0,57,83,9,0,92,103,9,0,112
54984,151,"ŞCOALA "" AL.VAIDA VOEVOD"",",CLUJ-NAPOCA,CJ,1470,11,0,0,11,20,0,1,21,36,0,1,37,62,2,1,65,91,4,1,96
54984,152,"ŞCOALA "" AL.VAIDA VOEVOD"",",CLUJ-NAPOCA,CJ,1221,8,1,0,9,32,5,0,37,51,5,0,56,77,11,0,88,81,11,0,92
54984,153,"ŞCOALA "" AL.VAIDA VOEVOD"",",CLUJ-NAPOCA,CJ,1273,7,2,0,9,13,2,0,15,26,2,0,28,45,6,0,51,51,8,0,59
54984,154,"GRUP ŞCOLAR""SAMUS""",CLUJ-NAPOCA,CJ,1696,23,2,0,25,48,4,0,52,69,8,0,77,99,11,0,110,112,12,0,124
54984,155,"GRUP ŞCOLAR""SAMUS""",CLUJ-NAPOCA,CJ,1651,14,1,0,15,34,1,0,35,49,1,0,50,80,3,0,83,101,8,0,109
54984,156,"GRUP ŞCOLAR""SAMUS""",CLUJ-NAPOCA,CJ,1564,8,1,0,9,42,3,0,45,63,3,0,66,86,10,0,96,91,15,0,106
54984,157,"COLEGIUL TEHNIC ""ANA ASLAN""( FOSTUL GRUP SC. CHIMIE IND ""TERAPIA"" ),",CLUJ-NAPOCA,CJ,1609,8,3,10,21,20,5,34,59,37,11,34,82,50,14,34,98,55,16,34,105
54984,158,"COLEGIUL TEHNIC ""ANA ASLAN""( FOSTUL GRUP SC. CHIMIE IND ""TERAPIA"" ),",CLUJ-NAPOCA,CJ,1579,12,1,0,13,40,3,0,43,59,5,0,64,88,6,0,94,97,10,0,107
54984,159,"EPARHIA REFORMATĂ DIN ARDEAL , STR.HOREA NR.51",CLUJ-NAPOCA,CJ,1354,5,1,0,6,25,4,0,29,32,5,0,37,42,9,0,51,51,10,0,61
54984,160,"ŞCOALA ""HOREA"" (FOSTĂ NR.27)",CLUJ-NAPOCA,CJ,1543,8,4,0,12,36,15,0,51,58,15,0,73,70,15,0,85,79,17,0,96
54984,161,"LICEUL TEOLOGIC “EMANUEL”",CLUJ-NAPOCA,CJ,1701,5,0,0,5,31,1,0,32,54,1,0,55,79,2,0,81,91,2,0,93
54984,162,"LICEUL TEOLOGIC “EMANUEL”",CLUJ-NAPOCA,CJ,1576,8,2,0,10,44,3,0,47,65,3,1,69,91,4,2,97,109,4,2,115
54984,163,"GRĂDINIŢA ""NEGHINIŢĂ""",CLUJ-NAPOCA,CJ,1819,19,2,0,21,54,4,0,58,67,6,0,73,102,8,0,110,116,9,0,125
54984,164,"GRĂDINIŢA ""NEGHINIŢĂ""",CLUJ-NAPOCA,CJ,1376,14,0,0,14,16,0,0,16,24,0,0,24,39,0,0,39,46,0,0,46
54984,165,"GRĂDINIŢA ""NEGHINIŢĂ""",CLUJ-NAPOCA,CJ,1685,14,5,0,19,45,8,0,53,73,8,0,81,83,8,0,91,88,8,0,96
54984,166,"GRĂDINIŢA ""NEGHINIŢĂ""",CLUJ-NAPOCA,CJ,1790,12,4,0,16,39,5,0,44,55,6,0,61,74,7,0,81,75,7,0,82
54984,167,"ŞCOALA “EMIL ISAC”",CLUJ-NAPOCA,CJ,1523,13,4,0,17,40,6,0,46,53,7,0,60,99,7,0,106,105,7,0,112
54984,168,"ŞCOALA “EMIL ISAC”",CLUJ-NAPOCA,CJ,998,9,0,0,9,30,3,0,33,35,5,0,40,45,5,0,50,50,9,0,59
54984,169,"ŞCOALA ""NICOLAE IORGA""",CLUJ-NAPOCA,CJ,1618,15,7,0,22,37,7,0,44,49,9,0,58,69,15,0,84,80,20,0,100
54984,170,"ŞCOALA ""NICOLAE IORGA""",CLUJ-NAPOCA,CJ,1668,6,0,0,6,33,10,0,43,51,12,0,63,65,14,0,79,68,14,0,82
54984,171,"ŞCOALA ""NICOLAE IORGA""",CLUJ-NAPOCA,CJ,1717,15,1,0,16,40,2,0,42,68,3,0,71,88,3,34,125,103,3,34,140
54984,172,"ŞCOALA ""NICOLAE IORGA""",CLUJ-NAPOCA,CJ,1783,4,7,0,11,19,8,0,27,35,9,1,45,58,9,1,68,64,10,1,75
54984,173,"LICEUL TEHNOLOGIC NR.1 (FOSTUL GRUP ŞCOLAR TEHNOFRIG), STR.MARAMUREŞULUI NR.165/A",CLUJ-NAPOCA,CJ,1849,5,4,0,9,15,4,0,19,24,7,0,31,36,8,1,45,44,8,1,53
54984,174,"LICEUL TEHNOLOGIC NR.1 (FOSTUL GRUP ŞCOLAR TEHNOFRIG), STR.MARAMUREŞULUI NR.165/A",CLUJ-NAPOCA,CJ,1837,9,1,0,10,27,2,0,29,44,4,0,48,69,5,2,76,73,7,2,82
54984,175,"LICEUL TEHNOLOGIC ""AUREL VLAICU""",CLUJ-NAPOCA,CJ,1253,6,7,0,13,20,11,0,31,25,14,0,39,41,20,0,61,44,20,0,64
54984,176,"LICEUL TEHNOLOGIC""AUREL VLAICU""",CLUJ-NAPOCA,CJ,1737,9,5,0,14,29,6,0,35,48,8,0,56,60,10,0,70,78,11,0,89
54984,177,"GARAJE COMPANIA DE TRANSPORT PUBLIC CLUJ-NAPOCA S.A.",CLUJ-NAPOCA,CJ,1861,8,3,0,11,24,8,0,32,33,11,0,44,43,11,0,54,57,12,0,69
54984,178,"ŞCOALA ""TRAIAN DARJAN""",CLUJ-NAPOCA,CJ,1698,8,3,0,11,31,5,0,36,47,13,0,60,70,14,0,84,82,15,0,97
54984,179,"ŞCOALA ""TRAIAN DARJAN""",CLUJ-NAPOCA,CJ,1846,11,1,0,12,26,1,0,27,49,5,0,54,77,9,0,86,84,9,0,93
54984,180,"ŞCOALA ""TRAIAN DARJAN""",CLUJ-NAPOCA,CJ,1783,4,1,0,5,24,1,0,25,50,1,0,51,82,1,0,83,85,1,0,86
54984,181,"ŞCOALA ""TRAIAN DARJAN""",CLUJ-NAPOCA,CJ,1438,7,1,0,8,21,1,0,22,31,1,0,32,54,1,0,55,64,1,0,65
55366,182,"COLEGIUL TEHNIC ”VICTOR UNGUREANU”","CÂMPIA TURZII",CJ,1239,5,0,0,5,24,0,0,24,33,0,0,33,34,2,0,36,40,2,0,42
55366,183,"COLEGIUL TEHNIC ”VICTOR UNGUREANU”","CÂMPIA TURZII",CJ,1188,6,0,0,6,23,3,0,26,29,3,0,32,43,3,0,46,50,3,0,53
55366,184,"COLEGIUL TEHNIC ”VICTOR UNGUREANU”","CÂMPIA TURZII",CJ,1286,5,0,0,5,22,1,0,23,29,1,0,30,37,1,0,38,44,1,0,45
55366,185,"LICEUL TEORETIC ”PAVEL DAN”","CÂMPIA TURZII",CJ,864,4,1,0,5,23,2,0,25,30,3,0,33,37,3,0,40,47,3,0,50
55366,186,"LICEUL TEORETIC ”PAVEL DAN”","CÂMPIA TURZII",CJ,1021,4,0,0,4,15,0,0,15,31,0,0,31,39,1,0,40,44,4,0,48
55366,187,"LICEUL TEORETIC ”PAVEL DAN”","CÂMPIA TURZII",CJ,1044,9,7,0,16,26,11,0,37,39,12,0,51,48,12,0,60,50,12,0,62
55366,188,"LICEUL TEORETIC ”PAVEL DAN”","CÂMPIA TURZII",CJ,1371,7,0,0,7,14,0,0,14,20,0,0,20,29,0,0,29,33,3,0,36
55366,189,"LICEUL TEORETIC ”PAVEL DAN”","CÂMPIA TURZII",CJ,1083,8,0,0,8,29,1,0,30,38,2,0,40,54,2,0,56,54,2,0,56
55366,190,"LICEUL TEORETIC ”PAVEL DAN”","CÂMPIA TURZII",CJ,1211,8,1,0,9,24,1,0,25,33,1,0,34,52,2,0,54,53,2,0,55
55366,191,"ȘCOALA GIMNAZIALĂ ”AVRAM IANCU”","CÂMPIA TURZII",CJ,1224,12,0,0,12,25,0,0,25,35,0,0,35,54,1,0,55,65,1,0,66
55366,192,"ȘCOALA GIMNAZIALĂ ”AVRAM IANCU”","CÂMPIA TURZII",CJ,1280,12,0,0,12,43,7,0,50,61,10,0,71,64,10,0,74,69,10,0,79
55366,193,"ȘCOALA GIMNAZIALĂ ”AVRAM IANCU”","CÂMPIA TURZII",CJ,1180,8,0,0,8,21,0,0,21,29,0,0,29,37,0,0,37,41,0,0,41
55366,194,"GRĂDINIȚA ”PINOCCHIO”","CÂMPIA TURZII",CJ,1313,20,0,0,20,40,0,0,40,55,0,0,55,70,0,0,70,79,3,0,82
55366,195,"GRĂDINIȚA ”PINOCCHIO”","CÂMPIA TURZII",CJ,1379,6,0,0,6,11,0,0,11,25,0,0,25,32,1,0,33,35,1,0,36
55366,196,"GRĂDINIȚA ”PINOCCHIO”","CÂMPIA TURZII",CJ,1389,13,0,0,13,28,0,0,28,42,1,0,43,74,4,0,78,80,4,0,84
55366,197,"ȘCOALA GIMNAZIALĂ ”MIHAI VITEAZU”","CÂMPIA TURZII",CJ,1119,11,8,0,19,26,10,0,36,31,13,0,44,37,13,0,50,41,13,0,54
55366,198,"ȘCOALA GIMNAZIALĂ ”MIHAI VITEAZU”","CÂMPIA TURZII",CJ,1541,17,0,0,17,38,0,0,38,51,0,0,51,63,1,0,64,66,3,0,69
55366,199,"ȘCOALA GIMNAZIALĂ ”MIHAI VITEAZU”","CÂMPIA TURZII",CJ,1424,8,0,0,8,28,0,0,28,41,0,0,41,57,0,0,57,62,0,0,62
55366,200,"ȘCOALA GIMNAZIALĂ ”MIHAI VITEAZU”","CÂMPIA TURZII",CJ,1222,2,0,0,2,10,1,0,11,17,2,0,19,24,4,0,28,27,4,0,31
55017,201,"S.C. VASROM S.R.L DEJ",DEJ,CJ,1272,13,0,0,13,25,1,0,26,36,2,0,38,54,3,0,57,65,3,0,68
55017,202,"SCOALA GENERALA NR.1 DEJ",DEJ,CJ,1338,2,1,0,3,22,2,0,24,24,4,0,28,30,6,0,36,60,16,0,76
55017,203,"SCOALA MIHAI EMINESCU DEJ",DEJ,CJ,826,7,3,0,10,18,4,0,22,26,4,62,92,35,4,62,101,45,4,62,111
55017,204,"SCOALA MIHAI EMINESCU DEJ",DEJ,CJ,972,8,0,0,8,17,0,0,17,28,0,0,28,41,0,0,41,51,0,0,51
55017,205,"SCOALA MIHAI EMINESCU DEJ",DEJ,CJ,1582,17,1,0,18,67,5,0,72,89,7,0,96,103,8,0,111,126,8,0,134
55017,206,"LICEUL AL.P.ILARIAN DIN DEJ",DEJ,CJ,1539,6,0,0,6,33,0,0,33,53,1,0,54,64,1,0,65,77,1,0,78
55017,207,"GRADINITA JUNIOR DEJ",DEJ,CJ,1522,17,0,0,17,45,3,0,48,66,8,0,74,93,9,0,102,104,11,0,115
55017,208,"OCOLUL SILVIC DEJ",DEJ,CJ,1385,12,1,0,13,34,1,49,84,46,2,49,97,80,3,49,132,84,3,49,136
55017,209,"CLUBUL COPIILOR DEJ",DEJ,CJ,1447,13,0,0,13,40,3,0,43,60,3,0,63,76,3,0,79,79,3,0,82
55017,210,"CAMINUL CULTURAL DEJ",DEJ,CJ,742,1,4,0,5,12,4,0,16,23,4,0,27,38,5,0,43,48,6,0,54
55017,211,"SCOALA GENERALA AVRAM IANCU DEJ",DEJ,CJ,1444,14,1,0,15,43,1,0,44,54,1,0,55,77,1,0,78,83,2,0,85
55017,212,"SCOALA GENERALA AVRAM IANCU DEJ",DEJ,CJ,1530,7,0,0,7,15,0,0,15,33,0,0,33,62,3,0,65,74,3,0,77
55017,213,"SERVICIUL DE ADMINISTRARE AL DOMENIULUI PUBLIC DEJ",DEJ,CJ,1652,6,5,0,11,24,5,0,29,45,5,0,50,63,5,0,68,69,7,0,76
55017,214,"SCOALA GENERALA NR.5 DEJ",DEJ,CJ,1554,14,0,0,14,33,0,0,33,61,2,0,63,80,3,0,83,85,3,0,88
55017,215,"SCOALA GENERALA NR.5 DEJ",DEJ,CJ,1468,13,0,0,13,31,0,0,31,62,0,0,62,109,0,0,109,119,0,0,119
55017,216,"GRADINITA PITICOT DEJ",DEJ,CJ,961,12,0,0,12,26,0,0,26,50,1,0,51,71,1,0,72,81,1,0,82
55017,217,"GRADINITA PITICOT DEJ",DEJ,CJ,1261,11,3,0,14,31,4,0,35,50,5,0,55,73,5,0,78,81,5,0,86
55017,218,"GRADINITA PITICOT DEJ",DEJ,CJ,1410,9,0,0,9,21,0,0,21,44,1,0,45,77,1,0,78,77,1,0,78
55017,219,"GRADINITA PARADISUL PITICILOR DEJ",DEJ,CJ,1256,13,5,0,18,40,6,0,46,48,6,0,54,71,6,0,77,74,6,0,80
55017,220,"SCOALA GENERALA AVRAM IANCU DEJ - CORP B",DEJ,CJ,1399,8,0,0,8,24,0,0,24,37,0,0,37,68,0,0,68,73,0,0,73
55017,221,"SCOALA GENERALA AVRAM IANCU DEJ - CORP B",DEJ,CJ,1437,12,0,0,12,25,0,0,25,41,1,0,42,52,4,0,56,56,6,0,62
55017,222,"SCOALA GENERALA OCNA DEJ",DEJ,CJ,1050,3,0,0,3,8,0,0,8,12,0,0,12,21,0,0,21,28,1,0,29
55017,223,"SCOALA GENERALA OCNA DEJ",DEJ,CJ,1095,4,1,0,5,14,2,0,16,29,2,0,31,38,2,0,40,38,2,0,40
55017,224,"GRADINITA DE COPII LUMEA PITICILOR",DEJ,CJ,1411,5,1,0,6,13,3,0,16,24,3,0,27,41,3,0,44,50,3,0,53
55053,225,"CAMINUL CULTURAL SOMCUTU MIC","ŞOMCUTU MIC",CJ,484,3,0,0,3,8,0,0,8,11,2,0,13,19,4,0,23,21,6,0,27
55044,226,"ŞCOALA GENERALĂ PINTIC",PINTIC,CJ,197,2,3,0,5,6,4,0,10,7,4,0,11,9,4,0,13,9,4,0,13
55393,227,"LICEUL TEORETIC PETRU MAIOR GHERLA",GHERLA,CJ,1561,14,1,0,15,32,2,0,34,45,3,0,48,66,4,0,70,75,4,0,79
55393,228,"LICEUL TEORETIC PETRU MAIOR GHERLA",GHERLA,CJ,1616,5,1,0,6,10,2,0,12,33,3,0,36,52,6,0,58,57,8,0,65
55393,229,"SCOALA GIMNAZIALA NR. 2",GHERLA,CJ,1478,12,0,0,12,37,1,0,38,51,6,0,57,71,7,0,78,77,7,0,84
55393,230,"ŞCOALA GIMNAZIALĂ NR.1",GHERLA,CJ,1081,8,0,0,8,24,0,0,24,32,10,0,42,49,17,0,66,58,18,0,76
55393,231,"SCOALA GIMNAZIALA NR. 1",GHERLA,CJ,1322,8,0,0,8,33,0,0,33,60,16,0,76,64,18,0,82,70,18,0,88
55393,232,"SCOALA GIMNAZIALA NR. 1",GHERLA,CJ,1254,8,0,0,8,30,0,0,30,48,10,0,58,58,14,0,72,68,15,0,83
55393,233,"ŞCOALA GIMNAZIALĂ NR.2",GHERLA,CJ,1780,6,2,0,8,29,3,0,32,57,3,0,60,58,3,0,61,67,3,0,70
55393,234,"ŞCOALA GIMNAZIALĂ NR.2",GHERLA,CJ,876,15,8,0,23,30,8,0,38,42,8,0,50,51,11,0,62,61,11,0,72
55393,235,"LICEUL TEORETIC ANA IPĂTESCU",GHERLA,CJ,1591,12,2,0,14,29,2,0,31,39,3,0,42,47,3,0,50,57,3,0,60
55393,236,"LICEUL TEORETIC ANA IPĂTESCU",GHERLA,CJ,1407,6,2,0,8,28,2,0,30,41,2,0,43,54,3,0,57,83,4,0,87
55393,237,"LICEUL TEORETIC ANA IPATESCU",GHERLA,CJ,1425,7,8,0,15,20,8,0,28,28,13,0,41,42,15,0,57,47,16,0,63
55393,238,"LICEUL TEORETIC ANA IPATESCU",GHERLA,CJ,1449,9,2,0,11,24,3,0,27,32,3,0,35,64,8,0,72,71,8,0,79
55393,239,"CLUBUL COPIILOR GHERLA",GHERLA,CJ,1546,8,1,0,9,22,1,0,23,30,1,0,31,38,3,0,41,50,3,0,53
55393,240,"SCOALA CLS. I - IV BAITA",GHERLA,CJ,403,0,1,0,1,0,1,0,1,1,1,0,2,3,1,0,4,5,1,0,6
55419,241,"ŞCOALA CLS. I - IV HĂŞDATE",HĂŞDATE,CJ,277,0,7,0,7,0,8,0,8,1,8,0,9,3,8,0,11,3,8,0,11
55428,242,"ŞCOALA CLS. I - IV SILIVAŞ",SILIVAŞ,CJ,158,0,0,0,0,0,0,0,0,1,0,0,1,3,0,0,3,3,0,0,3
55268,243,"LICEUL TEORETIC ""JOSIKA MIKLOS""",TURDA,CJ,930,7,0,0,7,34,3,0,37,41,7,0,48,47,8,0,55,50,9,0,59
55268,244,"LICEUL TEORETIC ""JOSIKA MIKLOS""",TURDA,CJ,1206,9,5,0,14,33,5,0,38,41,5,1,47,59,5,1,65,64,5,1,70
55268,245,"SCOALA GIMNAZIALĂ ""TEODOR MURĂŞANU""",TURDA,CJ,1155,15,2,0,17,35,6,0,41,52,6,0,58,63,7,0,70,71,7,0,78
55268,246,"COLEGIUL TEHNIC ""DR.IOAN RAŢIU""",TURDA,CJ,1375,5,4,0,9,11,6,0,17,15,6,0,21,27,6,0,33,31,7,0,38
55268,247,"COLEGIUL TEHNIC ""DR.IOAN RAŢIU""",TURDA,CJ,1033,1,4,0,5,13,4,0,17,19,4,0,23,25,5,0,30,25,5,0,30
55268,248,"COLEGIUL TEHNIC ""DR.IOAN RAŢIU""",TURDA,CJ,1103,6,0,0,6,13,0,0,13,15,0,0,15,20,0,0,20,20,0,0,20
55268,249,"ŞCOALA GIMNAZIALĂ ""TEODOR MURĂŞANU""",TURDA,CJ,1560,9,1,0,10,29,1,0,30,42,1,0,43,68,3,0,71,78,3,0,81
55268,250,"ŞCOALA GIMNAZIALĂ ""TEODOR MURĂŞANU""",TURDA,CJ,1215,9,0,0,9,38,5,0,43,50,5,0,55,66,5,0,71,69,5,0,74
55268,251,"SCOALA GIMNAZIALA ""TEODOR MURĂŞANU""",TURDA,CJ,1131,4,2,0,6,22,2,0,24,43,2,0,45,55,3,0,58,63,3,0,66
55268,252,"COLEGIUL TEHNIC",TURDA,CJ,1222,8,1,0,9,18,6,0,24,32,9,0,41,56,9,0,65,62,9,0,71
55268,253,"COLEGIUL TEHNIC",TURDA,CJ,1162,2,3,0,5,14,4,0,18,25,6,0,31,33,7,0,40,35,8,31,74
55268,254,"COLEGIUL NAŢIONAL ""MIHAI VITEAZU""",TURDA,CJ,1092,6,3,0,9,13,4,0,17,32,4,0,36,42,7,0,49,49,7,0,56
55268,255,"COLEGIUL ""EMIL NEGRUŢIU""",TURDA,CJ,1225,5,0,0,5,9,0,0,9,22,3,0,25,37,5,0,42,46,5,0,51
55268,256,"ŞCOALA GIMNAZIALĂ ""ANDREI ŞAGUNA""",TURDA,CJ,1230,20,0,0,20,34,2,0,36,42,3,0,45,54,9,1,64,55,9,1,65
55268,257,"ŞCOALA GIMNAZIALĂ ""ANDREI ŞAGUNA""",TURDA,CJ,965,7,0,0,7,34,4,0,38,38,5,0,43,51,8,0,59,55,10,0,65
55268,258,"ŞCOALA GIMNAZIALĂ ""ANDREI ŞAGUNA""",TURDA,CJ,1076,8,0,0,8,27,0,0,27,32,0,0,32,50,0,0,50,61,0,0,61
55268,259,"ŞCOALA GIMNAZIALĂ ""AVRAM IANCU""",TURDA,CJ,1010,9,0,0,9,23,0,0,23,34,0,0,34,42,1,1,44,47,2,1,50
55268,260,"ŞCOALA GIMNAZIALĂ""AVRAM IANCU""",TURDA,CJ,1169,9,1,0,10,28,2,0,30,39,5,0,44,46,7,0,53,47,7,0,54
55268,261,"ŞCOALA GIMNAZIALĂ""AVRAM IANCU""",TURDA,CJ,1174,10,0,0,10,38,1,0,39,62,1,0,63,71,2,0,73,79,3,0,82
55268,262,"ŞCOALA GIMNAZIALĂ""AVRAM IANCU""",TURDA,CJ,1247,9,0,0,9,22,0,0,22,32,0,0,32,44,0,0,44,49,0,0,49
55268,263,"ŞCOALA GIMNAZIALĂ ""ION OPRIŞ""",TURDA,CJ,1229,10,1,0,11,30,1,0,31,49,1,0,50,67,1,0,68,71,1,0,72
55268,264,"ŞCOALA GIMNAZIALĂ ""ION OPRIŞ""",TURDA,CJ,1043,9,0,0,9,30,0,0,30,38,0,0,38,56,0,0,56,59,0,0,59
55268,265,"ŞCOALA GIMNAZIALĂ ""ION OPRIŞ""",TURDA,CJ,1343,18,2,0,20,44,3,0,47,58,3,0,61,76,3,0,79,79,3,0,82
55268,266,"LICEUL TEORETIC ""LIVIU REBREANU""",TURDA,CJ,1450,10,2,0,12,20,7,0,27,39,9,0,48,54,9,0,63,61,11,0,72
55268,267,"LICEUL TEORETIC ""LIVIU REBREANU""",TURDA,CJ,1500,5,2,0,7,23,3,0,26,39,5,0,44,57,5,0,62,61,5,0,66
55268,268,"LICEUL TEORETIC ""LIVIU REBREANU""",TURDA,CJ,1412,14,1,0,15,34,1,1,36,53,1,1,55,76,1,1,78,81,2,1,84
55268,269,"LICEUL TEORETIC ""LIVIU REBREANU""",TURDA,CJ,1267,8,1,0,9,17,1,0,18,24,1,0,25,38,1,0,39,40,1,0,41
55268,270,"LICEUL TEORETIC ""LIVIU REBREANU""",TURDA,CJ,1477,11,3,0,14,44,3,0,47,58,3,0,61,72,3,0,75,77,3,0,80
55268,271,"LICEUL TEORETIC ""LIVIU REBREANU""",TURDA,CJ,1094,12,0,0,12,30,0,0,30,42,0,0,42,50,0,0,50,56,1,0,57
55268,272,"ŞCOALA GIMNAZIALĂ ""HOREA CLOŞCA ŞI CRIŞAN""",TURDA,CJ,1411,9,2,0,11,21,3,0,24,36,3,0,39,43,3,0,46,44,3,0,47
55268,273,"ŞCOALA GIMNAZIALĂ ""HOREA CLOŞCA ŞI CRIŞAN""",TURDA,CJ,1401,10,0,0,10,25,0,0,25,40,0,0,40,55,0,0,55,59,0,0,59
55268,274,"ŞCOALA GIMNAZIALĂ ""HOREA CLOŞCA ŞI CRIŞAN""",TURDA,CJ,1352,13,0,0,13,35,0,0,35,50,0,0,50,69,2,0,71,78,2,0,80
55268,275,"ŞCOALA GIMNAZIALĂ ""HOREA CLOŞCA ŞI CRIŞAN""",TURDA,CJ,1364,9,6,0,15,24,6,0,30,32,7,0,39,45,8,0,53,51,8,0,59
55268,276,"ŞCOALA GIMNAZIALĂ ""HOREA CLOŞCA ŞI CRIŞAN""",TURDA,CJ,1230,6,0,0,6,18,0,0,18,28,0,0,28,36,0,0,36,41,1,0,42
55268,277,"ŞCOALA GIMNAZIALĂ ""HOREA CLOŞCA ŞI CRIŞAN""",TURDA,CJ,1209,16,2,0,18,25,3,0,28,41,3,0,44,52,3,0,55,56,3,0,59
55268,278,"ŞCOALA GIMNAZIALĂ ""HOREA CLOŞCA ŞI CRIŞAN""",TURDA,CJ,1386,1,0,0,1,20,0,0,20,36,0,0,36,43,0,0,43,49,0,0,49
55268,279,"ŞCOALA PROFESIONALĂ POIANA",TURDA,CJ,1288,6,2,0,8,28,4,0,32,29,5,0,34,38,5,0,43,43,5,0,48
55268,280,"ŞCOALA PROFESIONALĂ POIANA",TURDA,CJ,1454,8,5,0,13,19,5,0,24,31,5,0,36,37,5,0,42,40,5,0,45
55455,281,"SCOALA NOUA CU 16 SALI DE CLASA",HUEDIN,CJ,1048,3,4,0,7,14,8,0,22,14,8,0,22,26,9,0,35,29,9,0,38
55455,282,"GRUPUL SCOLAR HUEDIN",HUEDIN,CJ,1531,3,2,0,5,13,3,0,16,24,5,0,29,32,5,0,37,36,5,0,41
55455,283,"CASA DE COPII",HUEDIN,CJ,1610,15,3,0,18,34,4,0,38,46,4,0,50,60,4,0,64,73,7,0,80
55455,284,"PRIMARIA ORAS HUEDIN",HUEDIN,CJ,1421,9,6,0,15,16,7,0,23,21,9,0,30,24,11,0,35,26,13,0,39
55455,285,"LICEUL TEORETIC OCTAVIAN GOGA",HUEDIN,CJ,1414,6,3,0,9,14,8,0,22,23,9,0,32,25,9,0,34,28,10,0,38
55455,286,"CAMIN CULTURAL",HUEDIN,CJ,355,2,4,0,6,2,4,0,6,2,4,0,6,2,4,0,6,2,4,0,6
55464,287,"CAMIN CULTURAL",BICĂLATU,CJ,266,1,2,0,3,3,2,0,5,3,2,0,5,4,2,0,6,4,2,0,6
55482,288,"SCOALA GENERALA AGHIRESU",AGHIREŞU,CJ,1078,9,5,0,14,11,7,0,18,12,7,0,19,33,9,0,42,33,9,0,42
55491,289,"SEDIU CONSILIU LOCAL",AGHIREŞU-FABRICI,CJ,1180,2,0,0,2,7,0,0,7,12,0,0,12,14,0,0,14,15,2,0,17
55491,290,"SCOALA GENERALA AGHIRESU-FABRICI",AGHIREŞU-FABRICI,CJ,1388,1,0,0,1,6,0,0,6,13,0,0,13,13,0,0,13,17,0,0,17
55507,291,"CAMIN CULTURALARGHISU",ARGHIŞU,CJ,106,1,0,0,1,2,0,0,2,2,0,0,2,4,2,0,6,4,2,0,6
55516,292,"SCOALA GENERALA BAGARA",BĂGARA,CJ,324,0,0,0,0,0,0,0,0,0,0,0,0,2,0,0,2,2,0,0,2
55525,293,"SCOALA GENERALA DANCU",DÎNCU,CJ,59,0,3,0,3,0,5,0,5,2,7,0,9,2,11,0,13,2,11,0,13
55534,294,"CAMIN CULTURAL DOROLTU",DOROLŢU,CJ,72,0,2,0,2,0,4,0,4,0,4,0,4,0,4,0,4,0,4,0,4
55543,295,"SCOALA GENERALA INUCU",INUCU,CJ,262,1,1,0,2,5,1,0,6,7,2,0,9,8,4,0,12,10,4,0,14
55552,296,"CAMIN CULTURALLEGHIA",LEGHIA,CJ,399,1,0,0,1,1,2,0,3,5,2,0,7,7,2,0,9,7,2,0,9
55561,297,"IMOBIL CONSILIU NR. 7",MACĂU,CJ,514,1,1,0,2,2,2,0,4,4,2,0,6,4,2,0,6,4,2,0,6
55570,298,"SCOALA GENERALA TICU",TICU,CJ,58,2,1,0,3,4,1,0,5,5,1,0,6,6,2,0,8,8,2,0,10
55589,299,"SCOALA GENERALA TICU-COLONIE",TICU-COLONIE,CJ,132,0,4,0,4,1,5,0,6,1,6,0,7,1,6,0,7,1,6,0,7
55605,300,"CAMIN CULTURAL AITON",AITON,CJ,496,3,2,0,5,4,2,0,6,11,2,0,13,15,5,0,20,16,5,0,21
55614,301,"CAMIN CULTURAL REDIU",REDIU,CJ,385,2,0,0,2,3,2,0,5,4,3,0,7,6,7,0,13,7,8,0,15
55632,302,"CAMIN CULTURAL ALUNIS",ALUNIŞ,CJ,443,0,0,0,0,1,0,0,1,1,0,0,1,4,2,0,6,4,2,0,6
55641,303,"CAMIN CULTURAL CORNENI",CORNENI,CJ,108,0,1,0,1,0,1,0,1,0,2,0,2,4,5,0,9,4,5,0,9
55650,304,"SEDIU ADMINISTRATIV GHIROLT",GHIROLT,CJ,317,1,0,0,1,1,0,0,1,2,1,0,3,4,2,0,6,4,2,0,6
55678,305,"CAMIN CULTURAL VALE",VALE,CJ,76,1,1,0,2,1,2,0,3,1,6,0,7,2,7,0,9,3,8,0,11
55696,306,"SALA SPORT LICEU TEHNOLOGIC ""ŞTEFAN PASCU""",APAHIDA,CJ,1778,9,0,0,9,27,1,0,28,38,4,0,42,46,6,0,52,50,8,0,58
55696,307,"SALA SPORT LICEU TEHNOLOGIC ""ŞTEFAN PASCU""",APAHIDA,CJ,1594,0,0,0,0,9,0,0,9,17,0,0,17,29,2,0,31,36,2,0,38
55696,308,"SALA SPORT LICEU TEHNOLOGIC ""ŞTEFAN PASCU""",APAHIDA,CJ,1726,9,0,0,9,22,1,0,23,32,3,0,35,35,5,0,40,40,5,0,45
55696,309,"SALA SPORT LICEU TEHNOLOGIC ""ŞTEFAN PASCU""",APAHIDA,CJ,1403,3,0,0,3,11,0,0,11,15,0,0,15,29,3,0,32,34,3,0,37
55758,310,"CĂMIN CULTURAL SÎNNICOARĂ",SÎNNICOARĂ,CJ,1736,5,1,0,6,36,4,0,40,52,8,0,60,83,17,0,100,110,20,0,130
55730,311,"SEDIU PRIMĂRIE DEZMIR",DEZMIR,CJ,1540,4,0,0,4,21,3,0,24,37,8,0,45,48,8,0,56,48,9,0,57
55749,312,"SEDIU PRIMĂRIE PATA",PATA,CJ,483,1,2,0,3,2,3,0,5,8,4,0,12,14,5,0,19,17,5,0,22
55721,313,"CĂMIN CULTURAL CORPADEA",CORPADEA,CJ,334,0,0,0,0,1,0,0,1,1,0,0,1,2,2,0,4,2,4,0,6
55712,314,"SEDIU SECTOR PISCICOLA",CÎMPENEŞTI,CJ,114,2,2,0,4,2,4,0,6,4,4,0,8,6,6,0,12,6,6,0,12
55785,315,"GRĂDINIŢA AŞCHILEU MARE","AŞCHILEU MARE",CJ,448,2,0,0,2,3,0,0,3,6,0,0,6,11,0,0,11,12,0,0,12
55794,316,"GRĂDINIŢA AŞCHILEU MIC","AŞCHILEU MIC",CJ,238,2,1,0,3,2,3,0,5,4,6,0,10,9,7,0,16,9,7,0,16
55801,317,"GRĂDINIŢA CRISTOREL",CRISTOREL,CJ,305,2,1,0,3,2,1,0,3,3,2,0,5,3,3,0,6,3,4,0,7
55829,318,"ŞCOALA PRIMARĂ FODORA",FODORA,CJ,215,7,0,0,7,8,1,0,9,9,3,0,12,11,3,0,14,11,3,0,14
55847,319,"GRĂDINIȚĂ CU PROGRAM PRELUNGIT (STRUCTURĂ BLOCURI)",BACIU,CJ,1407,2,1,0,3,18,7,0,25,29,10,0,39,32,12,0,44,42,12,0,54
55847,320,"CASA DE CULTURĂ BACIU",BACIU,CJ,1583,4,1,0,5,18,3,0,21,30,8,0,38,53,13,0,66,59,14,0,73
55847,321,"CASA DE CULTURĂ BACIU",BACIU,CJ,1709,7,0,0,7,14,2,0,16,23,2,0,25,44,2,0,46,48,4,0,52
55847,322,"CASA DE CULTURĂ BACIU",BACIU,CJ,1118,4,0,0,4,6,1,0,7,14,1,0,15,19,1,0,20,19,1,0,20
55856,323,"ȘCOALA CORUȘU",CORUŞU,CJ,460,3,0,0,3,7,4,0,11,8,7,0,15,12,9,0,21,14,9,0,23
55865,324,"ȘCOALA MERA",MERA,CJ,1273,4,0,0,4,8,3,0,11,11,3,0,14,11,3,0,14,13,3,0,16
55874,325,"ȘCOALA POPEȘTI",POPEŞTI,CJ,524,1,0,0,1,6,1,0,7,13,1,0,14,15,5,0,20,15,5,0,20
55892,326,"ȘCOALA SĂLIȘTEA NOUĂ","SĂLIŞTEA NOUĂ",CJ,142,10,7,0,17,12,7,0,19,13,8,0,21,19,10,0,29,20,11,0,31
55909,327,"ȘCOALA SUCEAGU",SUCEAGU,CJ,1153,5,0,0,5,6,1,0,7,6,1,0,7,13,1,0,14,17,2,0,19
55927,328,"ŞCOALA GENERALĂ BĂIŞOARA",BĂIŞOARA,CJ,846,5,3,0,8,11,3,0,14,13,8,0,21,19,8,0,27,20,8,0,28
56005,329,"ŞCOALA PRIMARĂ SĂCEL",SĂCEL,CJ,340,1,3,0,4,3,3,0,6,4,3,0,7,10,3,0,13,11,3,0,14
55954,330,"ŞCOALA PRIMARĂ MUNTELE BĂIŞORII","MUNTELE BĂIŞORII",CJ,272,1,4,0,5,3,4,0,7,4,4,0,8,6,4,0,10,6,4,0,10
55972,331,"ŞCOALA PRIMARĂ MUNTELE CACOVEI","MUNTELE CACOVEI",CJ,84,0,0,0,0,1,0,0,1,2,0,0,2,5,2,0,7,5,2,0,7
55990,332,"ŞCOALA PRIMARĂ MUNTELE SĂCELULUI","MUNTELE SĂCELULUI",CJ,58,0,0,0,0,0,1,0,1,0,1,0,1,0,4,0,4,0,4,0,4
55945,333,"GOSPODĂRIA D-NEI. PAŞCA TODORICA, SAT MOARA DE PĂDURE, NR. 24","MOARA DE PĂDURE",CJ,120,0,2,0,2,1,7,0,8,1,7,0,8,1,8,0,9,1,8,0,9
56023,334,"PRIMĂRIA BELIŞ",BELIŞ,CJ,510,10,0,0,10,10,2,0,12,13,3,0,16,16,14,0,30,21,15,0,36
56032,335,"MAGAZINUL SATESC (MAGAZIE DE MANA)",BĂLCEŞTI,CJ,113,1,0,0,1,4,1,0,5,5,3,0,8,9,3,0,12,9,3,0,12
56041,336,"ŞCOALA PRIMARĂDEALU BOTII","DEALU BOTII",CJ,49,0,0,0,0,1,0,0,1,2,0,0,2,2,0,0,2,2,0,0,2
56087,337,"ŞCOALA PRIMARĂ SMIDA",SMIDA,CJ,45,0,0,0,0,3,3,0,6,4,3,0,7,4,3,0,7,4,3,0,7
56069,338,"MAGAZINUL SǍTESC","GIURCUŢA DE SUS",CJ,110,3,0,0,3,3,0,0,3,7,1,0,8,9,1,0,10,9,1,0,10
56078,339,"ŞCOALA PRIMARǍPOIANA HOREA","POIANA HOREA",CJ,300,3,0,0,3,4,0,0,4,5,0,0,5,6,0,0,6,6,0,0,6
56121,340,SCOLAGENERALABABDIU,BĂBDIU,CJ,133,0,2,0,2,1,3,0,4,1,5,0,6,2,8,0,10,4,10,0,14
56103,341,"SCOALA GENERALA BOBÎLNA",BOBÎLNA,CJ,318,1,0,0,1,8,4,0,12,10,6,0,16,10,6,0,16,10,6,0,16
56158,342,"SCOALA GENERALA MAIA",MAIA,CJ,182,1,1,0,2,2,4,0,6,2,4,0,6,3,5,0,8,4,5,0,9
56167,343,"SCOALA GENERALA OSORHEL",OŞORHEL,CJ,106,0,0,0,0,0,0,0,0,0,0,0,0,7,4,0,11,7,4,0,11
56176,344,"CAMINUL CULTURAL PRUNI",PRUNI,CJ,25,0,0,0,0,1,2,0,3,2,2,0,4,3,13,0,16,3,13,0,16
56185,345,"SCOALA GENERALA RAZBUNENI",RĂZBUNENI,CJ,187,6,3,0,9,13,3,0,16,13,3,0,16,19,5,0,24,20,7,0,27
56194,346,"CAMINUL CULTURAL SUARĂŞ",SUARĂŞ,CJ,118,2,5,0,7,2,5,0,7,6,5,0,11,8,9,0,17,9,9,0,18
56201,347,"SCOALA GENERALA VÎLCELELE",VÎLCELELE,CJ,83,0,3,0,3,4,3,0,7,5,3,0,8,6,6,0,12,7,7,0,14
56229,348,"CAMIN CULTURAL BONTIDA",BONŢIDA,CJ,1579,5,0,0,5,9,1,0,10,17,1,0,18,31,1,0,32,32,1,0,33
56229,349,"CLUBUL TINERETULUI",BONŢIDA,CJ,851,7,1,0,8,16,2,0,18,22,4,0,26,22,5,0,27,28,6,0,34
56247,350,"SCOALA GENERALA RASCRUCI",RĂSCRUCI,CJ,1270,10,3,0,13,16,3,0,19,21,4,0,25,33,7,0,40,37,7,0,44
56238,351,"CAMIN CULTURAL COASTA",COASTA,CJ,97,0,3,0,3,1,6,0,7,3,7,0,10,7,11,0,18,7,11,0,18
56256,352,"CAMINUL CULTURALTAUSENI",TĂUŞENI,CJ,40,1,2,0,3,1,5,0,6,2,5,0,7,3,11,0,14,3,11,0,14
56274,353,"CONSILIUL LOCAL BORSA",BORŞA,CJ,886,7,1,0,8,12,4,0,16,20,7,0,27,25,10,0,35,27,10,0,37
56318,354,"CAMINUL CULTURAL GIULA",GIULA,CJ,113,2,5,0,7,2,5,0,7,5,5,0,10,9,5,0,14,10,7,0,17
56309,355,"SCOALA GENERALA CIUMĂFAIA",CIUMĂFAIA,CJ,131,4,7,0,11,5,7,0,12,5,7,0,12,5,9,0,14,5,9,0,14
56336,356,"CAMINUL CULTURAL BUZA",BUZA,CJ,1015,3,0,0,3,8,0,0,8,10,1,0,11,15,1,0,16,19,1,0,20
56381,357,"SCOALA GIMNAZIALA CAIANU MIC","CĂIANU MIC",CJ,611,2,1,0,3,7,1,0,8,7,1,0,8,10,1,0,11,12,2,0,14
56372,358,"CAMINUL CULTURAL BĂRĂI",BĂRĂI,CJ,207,1,3,0,4,4,5,0,9,5,6,0,11,6,6,0,12,7,6,0,13
56390,359,"SCOALA GENERALĂ CĂIANU VAMĂ",CĂIANU-VAMĂ,CJ,459,3,0,0,3,4,2,0,6,4,2,0,6,7,2,0,9,7,3,0,10
56407,360,"SCOALA GIMNAZIALAVAIDA CĂMĂRAS",VAIDA-CĂMĂRAŞ,CJ,715,1,0,0,1,2,0,0,2,3,0,0,3,5,0,0,5,7,0,0,7
56434,361,"GRADINITA CALARASI",CĂLĂRAŞI,CJ,780,6,1,0,7,10,1,0,11,13,1,0,14,15,1,0,16,19,3,0,22
56443,362,"CĂMINUL CULTURAL BOGATA",BOGATA,CJ,937,3,0,0,3,24,1,0,25,29,1,0,30,38,1,0,39,39,1,0,40
56452,363,"CAMINUL CULTURAL CALARASI -GARA",CĂLĂRAŞI-GARĂ,CJ,320,0,0,0,0,2,0,0,2,5,0,0,5,7,0,0,7,9,0,0,9
56470,364,"ŞCOALA DIN CĂLĂŢELE",CĂLĂŢELE,CJ,724,3,0,0,3,7,1,0,8,12,1,0,13,13,1,0,14,14,1,0,15
56470,365,"CAMINUL CULTURAL CĂLĂŢELE PĂDURE",CĂLĂŢELE,CJ,214,2,0,0,2,4,0,0,4,4,1,0,5,5,1,0,6,5,1,0,6
56489,366,SCOALACĂLATA,CĂLATA,CJ,315,0,2,0,2,3,2,0,5,6,5,0,11,13,8,0,21,13,8,0,21
56513,367,CĂMINULCULTURALVĂLENI,VĂLENI,CJ,264,2,3,0,5,2,3,0,5,2,4,0,6,2,4,0,6,2,6,0,8
56504,368,CĂMINULCULTURALFINCIU,FINCIU,CJ,111,6,3,0,9,8,4,0,12,10,4,0,14,17,9,0,26,17,9,0,26
56498,369,"ŞCOALA DIN DEALU NEGRU","DEALU NEGRU",CJ,353,5,0,0,5,8,0,0,8,10,0,0,10,12,0,0,12,15,0,0,15
56531,370,"CAMIN CULTURAL CAMARASU",CĂMĂRAŞU,CJ,1205,4,0,0,4,6,0,0,6,7,0,0,7,7,0,0,7,7,1,0,8
56540,371,"CAMIN CULTURAL NAOIU",NĂOIU,CJ,379,1,0,0,1,4,0,0,4,4,0,0,4,4,0,0,4,4,0,0,4
56559,372,"CAMIN CULTURAL SIMBOLENI",SÎMBOLENI,CJ,478,3,5,0,8,4,6,0,10,4,6,0,10,7,6,0,13,7,7,0,14
56577,373,"CĂMINUL CULTURAL CĂPUŞU MARE","CĂPUŞU MARE",CJ,690,2,3,0,5,2,3,0,5,5,3,0,8,9,3,0,12,10,3,0,13
56602,374,"CENTRUL DE INFORMARE TURISTICĂ","CĂPUŞU MIC",CJ,610,7,2,0,9,11,2,0,13,13,2,0,15,17,4,0,21,19,4,0,23
56586,375,"CĂMINUL CULTURAL",AGÎRBICIU,CJ,375,7,4,0,11,10,4,0,14,13,4,0,17,21,4,0,25,23,4,0,27
56639,376,"FOSTUL SEDIUCAP",DUMBRAVA,CJ,295,3,1,0,4,4,2,0,6,5,4,0,9,6,4,0,10,6,4,0,10
56648,377,"CĂMINUL CLULTURAL",PĂNICENI,CJ,237,6,1,0,7,10,1,0,11,14,2,0,16,14,2,0,16,14,2,0,16
56611,378,"ŞCOLA CU CLASELE I-IV DÎNGĂUL MARE","DÎNGĂU MARE",CJ,391,0,0,0,0,0,3,0,3,0,3,0,3,3,3,0,6,3,3,0,6
56675,379,"CĂMINUL CULTURAL",CĂŞEIU,CJ,1210,7,0,0,7,18,1,0,19,19,1,0,20,24,3,0,27,29,4,0,33
56693,380,"ŞCOALA COPLEAN",COPLEAN,CJ,345,5,0,0,5,5,2,0,7,5,2,0,7,9,6,0,15,12,6,0,18
56746,381,"ŞCOALA GIMNAZIALĂ RUGĂŞEŞTI",RUGĂŞEŞTI,CJ,877,4,1,0,5,11,3,0,14,18,5,0,23,25,7,0,32,32,7,0,39
56728,382,"ŞCOALA GUGA",GUGA,CJ,256,1,1,0,2,6,1,0,7,10,1,0,11,10,2,0,12,10,2,0,12
56719,383,"ŞCOALA GARBĂUL DEJULUI","GÎRBĂU DEJULUI",CJ,184,2,0,0,2,3,0,0,3,7,0,0,7,9,0,0,9,9,0,0,9
56755,384,"ŞCOALA SĂLĂTRUC",SĂLĂTRUC,CJ,120,0,0,0,0,1,0,0,1,1,0,0,1,1,0,0,1,2,0,0,2
56764,385,"ŞCOALA PRIMARĂ URIŞOR",URIŞOR,CJ,817,3,1,0,4,4,1,0,5,16,2,0,18,25,3,0,28,31,6,0,37
56782,386,"PRIMĂRIA COM.CĂTINA",CĂTINA,CJ,918,4,0,0,4,5,0,0,5,5,0,0,5,8,2,0,10,8,2,0,10
56808,387,"ŞCOLA CU CLS.I-IV FELDIOARA",FELDIOARA,CJ,428,6,0,0,6,8,2,0,10,9,2,0,11,12,2,0,14,12,2,0,14
56791,388,"CĂMINUL CULTURAL COPRU",COPRU,CJ,93,0,0,0,0,1,1,0,2,2,1,0,3,2,1,0,3,2,2,0,4
56853,389,"CAMIN CULTURAL CEANU MARE","CEANU MARE",CJ,1154,5,2,0,7,7,6,0,13,9,7,0,16,17,8,0,25,18,8,0,26
56871,390,"GRADINITA BOIAN",BOIAN,CJ,750,2,0,0,2,8,0,0,8,11,0,0,11,12,0,0,12,12,2,0,14
56880,391,"CAMIN CULTURAL BOLDUT",BOLDUŢ,CJ,665,1,0,0,1,6,1,0,7,15,2,0,17,29,4,0,33,33,4,0,37
56933,392,"CAMIN CULTURAL IACOBENI",IACOBENI,CJ,517,10,1,0,11,18,2,0,20,30,3,0,33,38,5,0,43,44,11,0,55
56906,393,"SCOALA DOSU NAPULUI","DOSU NAPULUI",CJ,122,0,0,0,0,1,0,0,1,1,0,0,1,1,0,0,1,1,0,0,1
56997,394,"PRIMĂRIA COMUNEI CHINTENI",CHINTENI,CJ,1311,12,1,0,13,21,7,0,28,25,7,0,32,42,13,0,55,43,13,0,56
57001,395,"ȘCOALA CLS.I-IV DEUȘU",DEUŞU,CJ,597,3,3,0,6,4,4,0,8,8,4,0,12,14,11,0,25,16,11,0,27
57029,396,"ȘCOALA CLS.I-IV MĂCICAȘU",MĂCICAŞU,CJ,348,4,3,0,7,4,4,0,8,7,6,0,13,11,6,0,17,17,6,0,23
57010,397,"PUNCT LUCRU FEIURDENI AL PRIMĂRIEI COMUNEI CHINTENI",FEIURDENI,CJ,385,0,4,0,4,6,5,0,11,7,6,0,13,10,8,0,18,12,8,0,20
57092,398,"SCOALA GIMNAZ. CHIUIESTI",CHIUIEŞTI,CJ,1250,5,0,0,5,17,0,0,17,34,0,0,34,44,2,0,46,53,2,0,55
57127,399,"SCOALA PRIMARA MAGOAJA",MĂGOAJA,CJ,314,2,0,0,2,5,3,0,8,5,4,0,9,9,4,0,13,10,5,0,15
57136,400,"SCOALA PRIMARA STRAMBU",STRÎMBU,CJ,359,3,1,0,4,3,7,0,10,12,10,0,22,29,13,0,42,35,17,0,52
57118,401,"SCOALA PRIMARA HUTA",HUTA,CJ,98,3,0,0,3,3,0,0,3,6,0,0,6,10,0,0,10,12,0,0,12
57172,402,"SCOALA CU CL. I - VIII, CIUCEA",CIUCEA,CJ,747,7,1,0,8,14,3,0,17,16,3,0,19,24,3,0,27,31,5,0,36
57172,403,"SCOALA CLASELE I - IV CALEA LATA",CIUCEA,CJ,209,1,1,0,2,3,1,0,4,3,2,0,5,3,2,0,5,4,3,0,7
57216,404,"SCOALA CLS.I-IV VANATORI",VÂNĂTORI,CJ,357,6,1,0,7,6,3,0,9,6,4,0,10,7,4,0,11,10,6,0,16
57234,405,"CONSILIUL LOCAL CIURILA",CIURILA,CJ,190,0,0,0,0,3,9,0,12,4,9,0,13,6,9,0,15,7,9,0,16
57243,406,"SCOALA GIMNAZIALA","FILEA DE JOS",CJ,238,0,1,0,1,1,2,0,3,1,6,0,7,1,6,0,7,3,8,0,11
57305,407,"SCOALA GIMNAZIALA",ŞUTU,CJ,300,1,1,0,2,2,1,0,3,3,3,0,6,3,5,0,8,3,5,0,8
57289,408,"CĂMINUL CULTURAL SĂLICEA",SĂLICEA,CJ,350,4,0,0,4,6,4,0,10,9,5,0,14,21,11,0,32,29,15,0,44
57298,409,"PAROHIA ORTODOXA SALISTE",SĂLIŞTE,CJ,78,1,0,0,1,1,2,0,3,3,3,0,6,4,5,0,9,4,5,0,9
57323,410,"SCOALA GIMNAZIALA CÎŢCĂU",CÎŢCĂU,CJ,1247,4,2,0,6,12,5,0,17,22,5,0,27,32,5,0,37,36,6,0,42
57332,411,"ŞCOAL GEN. MUNCEL",MUNCEL,CJ,186,0,0,0,0,0,0,0,0,0,0,0,0,4,0,0,4,6,0,0,6
57341,412,"ŞCOALA GEN. SĂLIŞCA",SĂLIŞCA,CJ,463,7,1,0,8,8,1,0,9,9,1,0,10,11,2,0,13,11,2,0,13
57369,413,"ȘCOALA GIMNAZIALĂ COJOCNA SALA NR.4",COJOCNA,CJ,1016,3,4,0,7,4,6,0,10,4,7,0,11,13,11,0,24,19,13,0,32
57369,414,"ȘCOALA GIMNAZIALĂ COJOCNA SALA NR.7",COJOCNA,CJ,885,3,0,0,3,7,0,0,7,7,0,0,7,12,1,0,13,19,2,0,21
57387,415,"ŞCOALA BOJU",BOJU,CJ,347,3,2,0,5,6,3,0,9,7,8,0,15,10,9,0,19,10,9,0,19
57378,416,"MAGAZIN COOPERATIST BOJU CATUN (FOSTUL)",BOJ-CĂTUN,CJ,189,3,0,0,3,6,2,0,8,10,2,0,12,11,2,0,13,14,2,0,16
57396,417,"BIROUL PRIMĂRIEI CARA",CARA,CJ,675,2,2,0,4,6,2,0,8,8,2,0,10,18,5,0,23,21,7,0,28
57412,418,"CĂMINUL CULTURAL IURIU DE CÎMPIE","IURIU DE CÎMPIE",CJ,206,3,0,0,3,3,1,0,4,3,2,0,5,6,6,0,12,6,6,0,12
57476,419,"CĂMIN CULTURAL IGRIŢIA",IGRIŢIA,CJ,34,0,1,0,1,0,3,0,3,1,3,0,4,3,3,0,6,3,3,0,6
57528,420,"CĂMIN CULTURAL TIOCU DE SUS","TIOCU DE SUS",CJ,70,3,2,0,5,6,4,0,10,6,4,0,10,8,5,0,13,9,6,0,15
57519,421,"CĂMIN CULTURAL TIOCU DE JOS","TIOCU DE JOS",CJ,101,4,1,0,5,4,1,0,5,8,2,0,10,9,2,0,11,10,2,0,12
57458,422,"ŞCOALA GIMNAZIALĂ LIA MANOLIU CORNEŞTI",CORNEŞTI,CJ,187,1,0,0,1,2,1,0,3,4,1,0,5,6,1,0,7,7,1,0,8
57500,423,"COOPERATIVA VECHE- STOIANA",STOIANA,CJ,164,4,4,0,8,11,5,0,16,15,8,0,23,18,10,0,28,34,10,0,44
57494,424,"CĂMIN CULTURAL MORĂU",MORĂU,CJ,43,0,1,0,1,2,2,0,4,4,2,0,6,5,2,0,7,5,2,0,7
57485,425,"CENTRUL DE INFORMARE ŞI PROMOVARE TURISTICĂ LUJERDIU",LUJERDIU,CJ,263,4,2,0,6,7,2,0,9,9,2,0,11,11,4,0,15,11,4,0,15
57467,426,"CĂMIN CULTURAL BÎRLEA",BÎRLEA,CJ,131,1,1,0,2,3,1,0,4,6,1,0,7,9,1,0,10,10,1,0,11
57537,427,"CĂMIN CULTURAL TIOLTIUR",TIOLTIUR,CJ,148,0,4,0,4,2,8,0,10,2,9,0,11,9,11,0,20,14,12,0,26
55071,428,"SCOALA GIMNAZIALA CUZDRIOARA",CUZDRIOARA,CJ,909,0,1,0,1,3,1,0,4,12,1,0,13,18,1,0,19,22,1,0,23
55071,429,"SCOALA GIMNAZIALA CUZDRIOARA",CUZDRIOARA,CJ,848,3,0,0,3,6,0,0,6,13,0,0,13,17,0,0,17,22,1,0,23
55080,430,"CĂMINUL CULTURAL",MĂNĂŞTUREL,CJ,693,5,0,0,5,8,0,0,8,10,0,0,10,20,1,0,21,20,5,0,25
57555,431,"ŞCOALA GIMNAZIALĂ CU CLASELE I-VIII “GELU ROMÂNUL”",DĂBÎCA,CJ,543,5,1,0,6,9,5,0,14,13,6,0,19,16,7,0,23,17,7,0,24
57564,432,"ŞCOALA CU CLASELE I-IV LUNA DE JOS","LUNA DE JOS",CJ,532,2,1,0,3,8,2,0,10,8,2,0,10,10,8,0,18,13,8,0,21
57573,433,"CĂMINUL CULTURAL PÎGLIŞA",PÎGLIŞA,CJ,82,5,9,0,14,6,10,0,16,6,11,0,17,8,11,0,19,12,11,0,23
57591,434,"CAMINUL CULTURAL FELEACU DIN LOCALITATEA FELEACU",FELEACU,CJ,1591,6,6,0,12,16,6,0,22,44,7,0,51,52,9,0,61,56,13,0,69
57617,435,"CAMINUL CULTURAL DIN LOCALITATEA GHEORGHENI",GHEORGHIENI,CJ,884,1,0,0,1,3,1,0,4,4,1,0,5,8,1,0,9,8,1,0,9
57635,436,"FOSTUL SEDIU CAP VILCELE DIN LOCALITATEA VILCELE",VÎLCELE,CJ,844,7,7,0,14,13,9,0,22,16,11,0,27,23,11,0,34,24,14,0,38
57653,437,"CAMINUL CULT.FIZESU GHERLII","FIZEŞU GHERLII",CJ,1101,5,2,0,7,6,2,0,8,6,2,0,8,10,2,0,12,11,2,0,13
57680,438,"SCOALA CLS.I-IV",NICULA,CJ,539,4,1,0,5,20,12,0,32,23,14,0,37,38,16,0,54,39,16,0,55
57662,439,"SCOALA CLS.I-IV BONT",BONŢ,CJ,290,1,0,0,1,3,0,0,3,3,0,0,3,3,0,0,3,4,1,0,5
57699,440,"SCOALA CLS.I-IV SACALAIA",SĂCĂLAIA,CJ,205,5,1,0,6,9,1,0,10,10,2,0,12,12,3,0,15,12,5,0,17
57715,441,"PRIMARIA COMUNEI FLORESTI",FLOREŞTI,CJ,1931,11,4,0,15,28,10,0,38,40,14,0,54,56,14,0,70,69,15,0,84
57715,442,"PRIMARIA COMUNEI FLORESTI",FLOREŞTI,CJ,1895,7,0,0,7,26,21,0,47,49,31,0,80,65,43,0,108,71,45,0,116
57715,443,"PRIMARIA COMUNEI FLORESTI",FLOREŞTI,CJ,1321,11,10,0,21,18,14,0,32,36,27,0,63,65,50,0,115,77,58,0,135
57715,444,"ȘCOALA ""GHEORGHE ȘINCAI""",FLOREŞTI,CJ,2639,11,0,0,11,54,0,0,54,79,5,0,84,100,6,0,106,120,6,0,126
57715,445,"SCOALAGH. SINCAI",FLOREŞTI,CJ,2017,5,0,0,5,27,3,0,30,34,6,0,40,55,17,0,72,69,21,0,90
57715,446,"GRADINITA NR.1",FLOREŞTI,CJ,933,15,2,0,17,21,4,0,25,33,8,0,41,47,11,0,58,51,16,0,67
57715,447,"GRADINITA NR.1",FLOREŞTI,CJ,2047,10,1,0,11,32,5,0,37,49,5,0,54,60,8,0,68,69,13,0,82
57715,448,"GRADINITA NR.2",FLOREŞTI,CJ,2918,13,3,0,16,35,8,0,43,60,14,0,74,82,20,0,102,95,22,0,117
57715,449,"GRADINITA NR.2",FLOREŞTI,CJ,2455,17,4,0,21,43,6,0,49,76,11,0,87,96,13,0,109,107,19,0,126
57715,450,"SALA DE SPORT CETATEA FETEI",FLOREŞTI,CJ,1625,3,2,0,5,24,2,0,26,35,3,0,38,52,3,0,55,57,3,0,60
57715,451,"SALA DE SPORT CETATEA FETEI",FLOREŞTI,CJ,1635,2,4,0,6,9,5,0,14,18,5,0,23,47,6,0,53,56,6,0,62
57715,452,"SALA DE SPORT CETATEA FETEI",FLOREŞTI,CJ,2498,21,5,0,26,48,10,0,58,70,14,0,84,94,18,0,112,100,19,0,119
57715,453,"SALA DE SPORT CETATEA FETEI",FLOREŞTI,CJ,2844,12,0,0,12,24,8,0,32,43,15,0,58,79,26,1,106,81,31,1,113
57724,454,"SCOALA LUNA DE SUS","LUNA DE SUS",CJ,797,1,7,0,8,4,9,0,13,10,10,0,20,12,12,0,24,15,12,0,27
57724,455,"SCOALA LUNA DE SUS","LUNA DE SUS",CJ,992,4,0,0,4,13,3,0,16,17,4,0,21,29,6,0,35,35,6,0,41
57733,456,"CAMINUL CULTURAL TAUTI",TĂUŢI,CJ,201,1,1,0,2,2,1,0,3,6,1,0,7,8,4,0,12,8,5,0,13
57751,457,"CAMINUL CULTURAL FRATA",FRATA,CJ,1555,3,0,0,3,6,0,0,6,9,1,0,10,11,1,0,12,27,2,0,29
57760,458,"CAMINUL CULTURAL BERCHIESU",BERCHIEŞU,CJ,516,2,0,0,2,4,0,0,4,7,0,0,7,8,0,0,8,14,0,0,14
57804,459,"CAMINUL CULTURAL POIANA FRATII","POIANA FRĂŢII",CJ,177,0,0,0,0,4,0,0,4,4,0,0,4,5,0,0,5,6,0,0,6
57822,460,"SCOALA GIMNAZIALA SOPORU DE CIMPIE","SOPORU DE CÎMPIE",CJ,982,4,3,0,7,8,3,0,11,10,3,0,13,14,5,0,19,16,5,0,21
57840,461,"CAMIN CULTURAL GEACA",GEACA,CJ,438,1,0,0,1,2,0,0,2,8,0,0,8,10,6,0,16,10,7,0,17
57895,462,"CAMINUL CULTURAL SUCUTARD",SUCUTARD,CJ,291,0,0,0,0,4,1,0,5,4,1,0,5,5,1,0,6,10,3,0,13
57868,463,"CAMINUL CULTURAL LACU",LACU,CJ,231,3,0,0,3,7,0,0,7,8,0,0,8,10,0,0,10,10,0,0,10
57877,464,"CAMINUL CULTURAL LEGII",LEGII,CJ,116,1,0,0,1,1,3,0,4,2,3,0,5,2,5,0,7,2,5,0,7
57859,465,"SCOALA CHIRIS",CHIRIŞ,CJ,67,0,2,0,2,1,2,0,3,1,3,0,4,3,3,0,6,3,4,0,7
57886,466,"CAMINUL CULTURAL PUINI",PUINI,CJ,74,1,0,0,1,3,0,0,3,3,0,0,3,4,0,0,4,4,0,0,4
57911,467,"CASA DE CULTURĂ ""DUMITRU SOPON""",GILĂU,CJ,1858,7,1,0,8,20,2,0,22,31,6,0,37,34,8,0,42,37,8,0,45
57911,468,"CĂMINUL CULTURAL VECHI GILĂU",GILĂU,CJ,1879,10,3,0,13,21,8,0,29,37,10,0,47,44,11,0,55,48,11,0,59
57911,469,"LICEUL TEORETIC ""GELU VOIEVOD"", CLĂDIREA INTERNAT",GILĂU,CJ,1916,7,1,0,8,14,4,0,18,30,5,0,35,32,6,0,38,45,7,0,52
57939,470,"CĂMINUL CULTURAL SOMEȘU RECE","SOMEŞU RECE",CJ,1036,13,3,0,16,24,9,0,33,44,15,0,59,56,16,0,72,82,20,0,102
57939,471,"GRĂDINIȚA - UZINA ELECTRICĂ","SOMEŞU RECE",CJ,525,3,0,0,3,6,0,0,6,11,1,0,12,13,3,0,16,13,18,0,31
57957,472,"CAMINUL CULTURAL GARBAU",GÎRBĂU,CJ,576,2,1,0,3,10,2,0,12,16,2,0,18,24,2,0,26,25,2,0,27
57984,473,"SCOALA PRIMARA VISTEA",VIŞTEA,CJ,603,1,0,0,1,5,4,0,9,9,4,0,13,9,5,0,14,13,5,0,18
57993,474,"SCOALA CU CLASELE I-IV TUREA",TUREA,CJ,426,4,0,0,4,4,0,0,4,4,0,0,4,5,0,0,5,9,0,0,9
57975,475,"CĂMINUL CULTURAL NĂDĂȘELU",NĂDĂŞELU,CJ,208,0,0,0,0,0,0,0,0,2,2,0,4,9,4,0,13,10,10,0,20
57966,476,"CAMINUL CULTURAL CORNESTI",CORNEŞTI,CJ,105,3,7,0,10,3,11,0,14,7,58,0,65,9,58,0,67,9,61,0,70
58026,477,SCOALA,AGRIŞ,CJ,326,0,0,0,0,1,0,0,1,2,0,0,2,6,0,0,6,8,0,0,8
58053,478,SCOALA,"CACOVA IERII",CJ,337,2,2,0,4,4,2,0,6,5,3,0,8,7,4,0,11,7,5,0,12
58062,479,SCOALA,"FĂGETU IERII",CJ,250,5,2,0,7,7,3,0,10,9,3,0,12,10,5,0,15,10,6,0,16
58017,480,SCOALA,IARA,CJ,773,6,1,0,7,12,2,0,14,14,2,0,16,21,3,0,24,26,3,0,29
58017,481,SCOALA,IARA,CJ,881,2,0,0,2,15,0,0,15,22,1,0,23,25,1,0,26,27,1,0,28
58080,482,SCOALA,MAŞCA,CJ,129,1,2,0,3,2,2,0,4,2,2,0,4,2,2,0,4,2,2,0,4
58106,483,SCOALA,OCOLIŞEL,CJ,107,0,1,0,1,0,2,0,2,0,3,0,3,2,4,0,6,3,5,0,8
58115,484,SCOALA,SURDUC,CJ,249,0,0,0,0,0,0,0,0,1,3,0,4,4,3,0,7,4,3,0,7
58133,485,SCOALA,"VALEA VADULUI",CJ,40,0,0,0,0,0,2,0,2,0,2,0,2,0,3,0,3,0,4,0,4
58035,486,"CASA PROPRIETATE PARTICULARA",BORZEŞTI,CJ,52,1,0,0,1,1,1,0,2,2,1,0,3,6,1,0,7,6,2,0,8
58044,487,"CASA PROPRIETATE PARTICULARĂ",BURU,CJ,144,1,0,0,1,5,5,0,10,6,5,0,11,7,5,0,12,7,5,0,12
58071,488,"CASA PROPRIETATE PARTICULARĂ",LUNGEŞTI,CJ,35,0,0,0,0,0,1,0,1,0,1,0,1,1,1,0,2,1,1,0,2
58099,489,"CASA PROPRIETATE PARTICULARĂ","MĂGURA IERII",CJ,24,0,0,0,0,1,0,0,1,1,0,0,1,1,0,0,1,1,0,0,1
58151,490,"CENTRUL CULTURAL ICLOD",ICLOD,CJ,1698,0,0,0,0,3,0,0,3,8,0,0,8,14,1,0,15,17,2,0,19
58160,491,"SCOALA DIN FUNDATURA",FUNDĂTURA,CJ,566,1,1,0,2,2,5,0,7,6,5,0,11,6,5,0,11,6,5,0,11
58188,492,"SCOALA DIN LIVADA",LIVADA,CJ,863,8,2,0,10,15,2,0,17,28,2,0,30,39,4,0,43,48,4,0,52
58197,493,"SCOALA DIN ORMAN",ORMAN,CJ,450,0,1,0,1,2,3,0,5,3,8,0,11,5,10,0,15,6,14,0,20
58222,494,"CĂMINUL CULTURAL",NADĂŞU,CJ,187,4,4,0,8,7,5,0,12,7,5,0,12,10,6,0,16,10,6,0,16
58213,495,"PRIMĂRIA COMUNEI","IZVORU CRIŞULUI",CJ,770,2,1,0,3,4,1,0,5,5,1,0,6,5,1,0,6,5,1,0,6
58240,496,"ŞCOALA GENERALĂ",ŞAULA,CJ,320,1,2,0,3,1,2,0,3,1,2,0,3,1,2,0,3,1,2,0,3
55115,497,"CĂMINUL CULTURAL","JICHIŞU DE JOS",CJ,355,2,0,0,2,5,0,0,5,8,0,0,8,17,1,0,18,18,4,0,22
55124,498,"CĂMINUL CULTURAL",CODOR,CJ,336,7,2,0,9,10,2,0,12,12,2,0,14,12,2,0,14,17,2,0,19
55133,499,"ŞCOALA GENERALĂ","JICHIŞU DE SUS",CJ,190,1,5,0,6,2,8,0,10,2,10,0,12,2,10,0,12,2,10,0,12
55151,500,"ŞCOALA GENERALĂ",TĂRPIU,CJ,89,1,4,0,5,1,5,0,6,1,6,0,7,1,7,0,8,1,7,0,8
55142,501,"ŞCOALA GENERALĂ",ŞIGĂU,CJ,21,0,0,0,0,0,4,0,4,0,6,0,6,2,11,0,13,3,12,0,15
58268,502,"PRIMĂRIA COMUNEI","JUCU DE SUS",CJ,1440,3,0,0,3,15,0,0,15,23,2,0,25,38,4,0,42,41,4,0,45
58295,503,"ŞCOALA PRIMARĂ","JUCU DE MIJLOC",CJ,940,1,0,0,1,3,0,0,3,3,0,0,3,4,0,0,4,7,0,0,7
58277,504,"ŞCOALA PRIMARĂ",GĂDĂLIN,CJ,523,4,3,0,7,8,3,0,11,11,4,0,15,17,4,0,21,17,5,0,22
58302,505,"ŞCOALA PRIMARĂ",VIŞEA,CJ,464,1,0,0,1,5,0,0,5,6,0,0,6,7,0,0,7,7,3,0,10
58286,506,"GRĂDINIŢA CU PROGRAM NORMAL",JUC-HERGHELIE,CJ,364,2,0,0,2,2,0,0,2,6,0,0,6,9,0,0,9,13,0,0,13
58320,507,"CĂMINUL CULTURAL ""PROF. NICOLAE MAZARE"" LUNA",LUNA,CJ,1144,6,0,0,6,9,0,0,9,16,3,0,19,22,3,0,25,23,3,0,26
58320,508,"CĂMINUL CULTURAL ""PROF. NICOLAE MAZARE"" LUNA",LUNA,CJ,1005,2,2,0,4,8,2,0,10,10,2,0,12,21,4,0,25,24,4,0,28
58348,509,"CAMINUL CULTURAL LUNCANI",LUNCANI,CJ,1265,8,1,0,9,15,1,0,16,19,1,0,20,30,3,0,33,31,3,0,34
58339,510,"GRĂDINIŢA GLIGORESTI",GLIGOREŞTI,CJ,467,3,4,0,7,5,6,0,11,9,6,0,15,14,6,0,20,16,6,0,22
58384,511,"CĂMINUL CULTURAL","MUNTELE RECE",CJ,448,2,0,0,2,4,0,0,4,10,1,0,11,12,2,0,14,12,2,0,14
58366,512,"PRIMĂRIA COMUNEI",MĂGURI-RĂCĂTĂU,CJ,710,0,0,0,0,3,0,0,3,8,1,0,9,12,1,0,13,16,1,0,17
58375,513,"ŞCOALA GENERALĂ",MĂGURI,CJ,741,1,2,0,3,5,5,0,10,5,5,0,10,10,5,0,15,12,5,0,17
58400,514,"PRIMĂRIA COMUNEI",MĂNĂSTIRENI,CJ,747,5,3,0,8,14,4,0,18,19,4,0,23,20,8,0,28,22,8,0,30
58428,515,"ŞCOALA GENERALĂ",BEDECIU,CJ,442,2,0,0,2,5,0,0,5,8,0,0,8,16,0,0,16,16,1,0,17
58525,516,"CĂMIN CULTURAL",SCRIND-FRĂSINET,CJ,151,1,2,0,3,3,2,0,5,4,3,0,7,5,4,0,9,8,4,0,12
58491,517,"CĂMIN CULTURAL",BUTENI,CJ,181,0,1,0,1,5,5,0,10,5,5,0,10,6,8,0,14,6,10,0,16
58473,518,"PRIMĂRIA COMUNEI MĂRGĂU",MĂRGĂU,CJ,360,1,1,0,2,3,3,0,6,7,4,0,11,8,4,0,12,8,4,0,12
58516,519,"CĂMIN CULTURAL",RĂCHIŢELE,CJ,604,8,1,0,9,11,4,0,15,12,4,0,16,12,4,0,16,12,4,0,16
58543,520,"ŞCOALA GENERALĂ",MĂRIŞEL,CJ,99,0,0,0,0,0,0,0,0,0,0,0,0,0,2,0,2,1,2,0,3
58543,521,"ŞCOALA GENERALĂ",MĂRIŞEL,CJ,1033,1,0,0,1,9,0,0,9,10,0,0,10,11,0,0,11,19,0,0,19
58543,522,"ŞCOALA GENERALĂ",MĂRIŞEL,CJ,146,0,0,0,0,0,0,0,0,0,0,0,0,0,0,0,0,1,2,0,3
55179,523,"CĂMINUL CULTURAL",MICA,CJ,577,11,2,0,13,14,2,19,35,17,2,19,38,21,5,19,45,21,7,19,47
55197,524,"CĂMINUL CULTURAL",MĂNĂSTIREA,CJ,590,4,0,0,4,8,1,0,9,9,2,0,11,31,5,0,36,31,5,0,36
55204,525,"FOSTUL SEDIU CAP",NIREŞ,CJ,900,0,0,0,0,0,0,0,0,1,0,0,1,1,0,0,1,1,0,0,1
55213,526,"ŞCOALA GENERALĂ",SÎNMĂRGHITA,CJ,885,3,2,0,5,10,2,0,12,11,2,0,13,11,2,0,13,15,2,0,17
55286,527,"ŞCOALA GENERALĂ","MIHAI VITEAZU",CJ,1503,6,2,0,8,21,2,0,23,24,2,0,26,30,8,0,38,34,8,0,42
55295,528,"ŞCOALA GENERALĂ",CHEIA,CJ,467,0,0,0,0,2,0,0,2,3,3,0,6,6,3,0,9,6,3,0,9
55302,529,"ŞCOALA GENERALĂ",CORNEŞTI,CJ,636,5,0,0,5,12,0,0,12,18,0,0,18,22,1,0,23,23,1,0,24
55286,530,"CASĂ DE CULTURĂ","MIHAI VITEAZU",CJ,1334,3,2,0,5,9,2,0,11,13,2,0,15,16,2,0,18,22,4,0,26
55286,531,"SALA DE SPORT","MIHAI VITEAZU",CJ,960,0,0,0,0,6,0,0,6,9,0,0,9,9,0,0,9,11,0,0,11
58561,532,"PRIMĂRIA COMUNEI","MINTIU GHERLII",CJ,1272,17,0,0,17,24,0,0,24,30,0,0,30,36,1,0,37,40,3,0,43
58570,533,"ŞCOALA GENERALĂ",BUNEŞTI,CJ,757,3,0,0,3,3,2,0,5,12,3,0,15,18,10,0,28,20,10,0,30
58589,534,"ŞCOALA GENERALĂ",NIMA,CJ,592,4,0,0,4,10,1,0,11,10,1,0,11,15,1,0,16,17,2,0,19
58598,535,"ŞCOALA GENERALĂ",PĂDURENII,CJ,79,3,0,0,3,4,4,0,8,6,6,0,12,6,6,0,12,6,6,0,12
58605,536,"ŞCOALA GENERALĂ",PETREŞTI,CJ,206,3,0,0,3,6,0,0,6,9,0,0,9,12,2,0,14,12,2,0,14
58614,537,"ŞCOALA GENERALĂ",SALATIU,CJ,225,2,0,0,2,3,0,0,3,6,0,0,6,9,1,0,10,9,1,0,10
58632,538,"CAMIN CULTURAL MOCIU - SALA MICA",MOCIU,CJ,1319,1,0,0,1,5,2,0,7,6,5,0,11,12,8,0,20,14,8,0,22
58650,539,"ŞCOALA ELEMENTARA",CHESĂU,CJ,274,1,0,0,1,2,0,0,2,3,1,0,4,3,1,0,4,13,1,0,14
58669,540,"ŞCOALA GENERALĂ",CRIŞENI,CJ,207,1,0,0,1,2,1,0,3,3,1,0,4,4,3,0,7,6,6,0,12
58687,541,"CLADIRE MULTIFUNCTIONALA","GHIRIŞU ROMÂN",CJ,271,0,0,0,0,2,3,0,5,3,3,0,6,6,3,0,9,6,4,0,10
58712,542,"CLADIRE MULTIFUNCTIONALA","ZORENII DE VALE",CJ,252,1,0,0,1,1,0,0,1,1,0,0,1,2,2,0,4,2,3,0,5
58641,543,"SALĂ MULTIFUNCŢIONALĂ",BOTENI,CJ,177,0,2,0,2,1,2,0,3,1,3,0,4,1,4,0,5,4,4,0,8
58696,544,"CLADIRE MULTIFUNCŢIONALĂ",ROŞIENI,CJ,144,1,0,0,1,2,0,0,2,2,0,0,2,2,0,0,2,3,0,0,3
58730,545,"PRIMĂRIA COMUNEI",MOLDOVENEŞTI,CJ,586,1,0,0,1,2,0,0,2,3,0,0,3,6,0,0,6,7,0,0,7
58730,546,"ŞCOALA CU CLASELE I-VIII",MOLDOVENEŞTI,CJ,414,0,1,0,1,0,1,0,1,1,1,0,2,2,1,0,3,3,1,0,4
58767,547,"ŞCOALA CU CLASELE I-IV",PLĂIEŞTI,CJ,519,0,0,0,0,1,0,0,1,3,0,0,3,6,0,0,6,6,0,0,6
58749,548,"CASA SATULUI",BĂDENI,CJ,570,4,0,0,4,6,1,0,7,6,4,0,10,6,4,0,10,8,4,0,12
58785,549,"CLĂDIREA PRIMĂRIEI",STEJERIŞ,CJ,157,0,0,0,0,0,0,0,0,0,1,0,1,1,1,0,2,1,1,0,2
58758,550,"CĂMINUL CULTURAL",PIETROASA,CJ,110,0,0,0,0,1,0,0,1,1,0,0,1,2,0,0,2,2,0,0,2
58776,551,"ŞCOALA CU CLASELE I-IV",PODENI,CJ,369,1,0,0,1,4,0,0,4,4,2,0,6,10,5,0,15,10,5,0,15
57190,552,"CĂMINUL CULTURAL",NEGRENI,CJ,1331,35,1,0,36,47,2,0,49,57,3,0,60,66,4,0,70,71,4,0,75
57181,553,"CASA DE CULTURĂ",BUCEA,CJ,586,9,0,0,9,17,6,0,23,23,6,0,29,31,7,0,38,44,8,0,52
57207,554,"SCOALA CU CLASELE I-IV",PRELUCELE,CJ,94,0,3,0,3,1,3,0,4,3,3,0,6,3,3,0,6,3,3,0,6
58909,555,"SCOALA PRIMARĂ",SĂRATA,CJ,244,0,0,0,0,2,3,0,5,2,3,0,5,2,4,0,6,3,4,0,7
58865,556,"SCOALĂ GENERALĂ IULIU HAȚIEGANU PANTICEU",PANTICEU,CJ,521,1,0,0,1,3,2,0,5,4,2,0,6,10,4,0,14,10,4,0,14
58883,557,"ŞCOALA CLASELE I-IV","CUBLEŞU SOMEŞAN",CJ,307,1,2,0,3,4,3,0,7,7,7,0,14,7,10,0,17,11,11,0,22
58892,558,"CLADIRE SCOALA",DÎRJA,CJ,170,1,1,0,2,4,1,0,5,4,2,0,6,4,2,0,6,4,3,0,7
58874,559,"CAMIN CULTURAL",CĂTĂLINA,CJ,54,0,1,0,1,0,1,0,1,0,3,0,3,0,5,0,5,0,5,0,5
58801,560,"CĂMINUL CULTURAL PĂLATCA",PĂLATCA,CJ,635,3,0,0,3,6,1,0,7,7,3,0,10,15,3,0,18,16,4,0,20
58847,561,"CĂMINUL CULTURAL SAVA",SAVA,CJ,261,0,0,0,0,4,3,0,7,5,8,0,13,8,9,0,17,8,9,0,17
58981,562,"CĂMINUL CULTURAL",PLAIURI,CJ,102,1,1,0,2,4,3,0,7,4,3,0,7,5,5,0,10,5,5,0,10
58963,563,"ŞCOALA GENERALĂ","PETREŞTII DE MIJLOC",CJ,111,0,1,0,1,2,1,0,3,2,2,0,4,7,2,0,9,6,3,0,9
58945,564,"ŞCOALA GENERALĂ",DELENI,CJ,181,4,0,0,4,6,0,0,6,7,0,0,7,7,5,0,12,9,5,0,14
58936,565,"ŞCOALA GENERALĂ",CRĂEŞTI,CJ,167,0,1,0,1,4,1,0,5,5,1,0,6,7,1,0,8,7,1,0,8
58927,566,"CĂMIN CULTURAL","PETREŞTII DE JOS",CJ,509,0,0,0,0,2,0,0,2,2,0,0,2,3,1,0,4,7,2,0,9
58954,567,"CAMIN CULTURAL LIVADA",LIVADA,CJ,161,3,2,0,5,4,3,0,7,4,5,0,9,5,5,0,10,5,5,0,10
58972,568,"CAMINUL CULTURAL","PETREŞTII DE SUS",CJ,75,1,0,0,1,4,3,0,7,6,3,0,9,6,4,0,10,6,5,0,11
59005,569,"CĂMINUL CULTURAL",PLOSCOŞ,CJ,337,0,0,0,0,0,0,0,0,1,0,0,1,4,3,0,7,6,5,0,11
59032,570,"ŞCOALA CU CLASELE I-IV","VALEA FLORILOR",CJ,224,3,3,0,6,3,3,0,6,5,3,0,8,7,3,0,10,8,4,0,12
59050,571,"PRIMĂRIACOMUNEI POIENI",POIENI,CJ,955,3,0,0,3,12,0,0,12,16,0,0,16,28,1,0,29,32,2,0,34
59069,572,ŞCOALAPRIMARABOLOGA,BOLOGA,CJ,517,4,0,0,4,6,1,0,7,8,1,0,9,12,2,0,14,15,4,0,19
59103,573,ŞCOALAPRIMARAMORLACA,MORLACA,CJ,616,1,1,0,2,6,2,0,8,7,3,0,10,10,10,0,20,10,10,0,20
59087,574,"ŞCOALA HODIŞU",HODIŞU,CJ,306,4,4,0,8,5,5,0,10,8,7,0,15,9,8,0,17,10,12,0,22
59121,575,"ŞCOALA GIMNAZIALA ,,AUREL MUNTEANU""VALEA DRĂGANULUI","VALEA DRĂGANULUI",CJ,1301,11,2,0,13,22,5,0,27,30,9,0,39,35,14,0,49,38,16,0,54
59112,576,ŞCOALATRANIŞU,TRANIŞU,CJ,288,1,0,0,1,1,0,0,1,2,2,0,4,2,2,0,4,2,2,0,4
59096,577,"ŞCOALALUNCA VIŞAGULUI","LUNCA VIŞAGULUI",CJ,186,0,0,0,0,1,1,0,2,2,3,0,5,2,4,0,6,2,4,0,6
59149,578,"SEDIUL PRIMĂRIEI SALA DE SEDINŢE",RECEA-CRISTUR,CJ,549,5,1,0,6,15,3,0,18,19,3,0,22,22,3,0,25,22,3,0,25
59185,579,ŞCOALA,ELCIU,CJ,83,1,0,0,1,3,0,0,3,4,0,0,4,7,0,0,7,9,0,0,9
59229,580,ŞCOALA,PUSTUŢA,CJ,74,4,2,0,6,7,4,0,11,8,4,0,12,9,5,0,14,9,5,0,14
59210,581,ŞCOALA,OSOI,CJ,88,2,3,0,5,5,3,0,8,5,3,0,8,8,3,0,11,14,6,0,20
59176,582,ŞCOALA,CIUBĂNCUŢA,CJ,124,1,0,0,1,5,0,0,5,7,1,0,8,11,2,0,13,12,5,0,17
59167,583,"CAMINUL CULTURAL CIUBANCA",CIUBANCA,CJ,80,1,1,0,2,3,1,0,4,4,1,0,5,6,1,0,7,6,2,0,8
59247,584,"ŞCOALA GIMNAZIALĂCU CLASELE I-VIII",RÎŞCA,CJ,780,3,0,0,3,11,0,0,11,15,0,0,15,15,5,0,20,18,6,0,24
59256,585,"ŞCOALA PRIMARĂ CU CLASELE I-IV","DEALU MARE",CJ,324,4,0,0,4,6,1,0,7,9,1,0,10,18,1,0,19,20,1,0,21
59274,586,"ŞCOALA PRIMARĂ CU CLASELE I-IV",MĂRCEŞTI,CJ,156,5,0,0,5,5,0,0,5,6,2,0,8,9,2,0,11,9,5,0,14
59292,587,"CĂMINUL CULTURAL",SĂCUIEU,CJ,465,7,2,0,9,7,3,0,10,14,9,0,23,15,9,0,24,15,11,0,26
59309,588,"CĂMINUL CULTURAL",ROGOJEL,CJ,530,4,0,0,4,5,2,0,7,8,2,0,10,8,4,0,12,8,4,0,12
59318,589,"ŞCOALA GENERALĂ CU CLASELE I-IV",VIŞAGU,CJ,222,0,0,0,0,0,4,0,4,0,4,0,4,0,4,0,4,0,4,0,4
55320,590,ŞCOALA,SĂNDULEŞTI,CJ,595,3,1,0,4,7,5,0,12,14,7,0,21,23,7,0,30,23,7,0,30
55339,591,"ŞCOALA SIMION BALINT",COPĂCENI,CJ,1131,4,3,0,7,8,4,0,12,14,4,0,18,22,5,0,27,25,5,0,30
59336,592,"CĂMINUL CULTURAL",SĂVĂDISLA,CJ,863,0,2,0,2,2,5,0,7,3,5,0,8,3,5,0,8,3,7,0,10
59363,593,"CĂMINUL CULTURAL",LITA,CJ,253,1,1,0,2,4,1,0,5,7,2,0,9,9,2,0,11,10,3,0,13
59390,594,"CĂMINUL CULTURAL",VĂLIŞOARA,CJ,47,0,1,0,1,0,2,0,2,0,3,0,3,0,3,0,3,0,3,0,3
59407,595,"CĂMINUL CULTURAL",VLAHA,CJ,754,0,0,0,0,6,1,0,7,9,4,0,13,11,4,0,15,11,8,0,19
59354,596,"ŞCOALA CU CLASELE I-VIII",HĂŞDATE,CJ,398,2,2,0,4,3,3,0,6,3,3,0,6,3,3,0,6,4,4,0,8
59345,597,"ŞCOALA CU CLASELE I-VIII",FINIŞEL,CJ,672,11,0,0,11,27,0,0,27,38,0,0,38,46,1,0,47,52,2,0,54
59372,598,"ŞCOALA CU CLASELE I-IV",LITENI,CJ,326,3,5,0,8,4,5,0,9,4,5,0,9,4,6,0,10,4,6,0,10
59381,599,"ŞCOALA CU CLASELE I-IV",STOLNA,CJ,198,2,0,0,2,3,0,0,3,8,1,0,9,13,5,0,18,15,9,0,24
59443,600,"SANCRAIU NR.330 CAMINUL CULTURAL",SÂNCRAIU,CJ,931,8,0,0,8,31,10,0,41,47,10,0,57,55,12,0,67,58,17,0,75
59452,601,"ALUNISU NR.74 CAMINUL CULTURAL",ALUNIŞU,CJ,90,0,0,0,0,0,0,0,0,2,2,0,4,4,2,0,6,4,3,0,7
59470,602,"DOMOSU NR.22 CAMINUL CULTURAL",DOMOŞU,CJ,295,0,0,0,0,2,0,0,2,3,0,0,3,5,4,0,9,8,7,0,15
59504,603,"PRIMARIA SANMARTIN",SÂNMĂRTIN,CJ,198,3,5,0,8,4,5,0,9,4,5,0,9,4,5,0,9,5,5,0,10
59513,604,"SC. PRIM. CEABA",CEABA,CJ,186,5,4,0,9,5,4,0,9,7,4,0,11,14,6,0,20,18,6,0,24
59522,605,"SC. GIMNAZIALA CUTCA",CUTCA,CJ,329,12,2,0,14,12,4,0,16,13,4,0,17,20,4,0,24,20,5,0,25
59568,606,"CAMIN CULT. SAMBOIENI",SÎMBOIENI,CJ,128,2,0,0,2,5,6,0,11,13,6,0,19,18,6,0,24,19,6,0,25
59577,607,"SC. PRIM. TARGUSOR",TÎRGUŞOR,CJ,98,5,3,0,8,6,8,0,14,8,9,0,17,9,18,0,27,9,20,0,29
59559,608,"SC. PRIM. MAHAL",MĂHAL,CJ,72,4,5,0,9,4,5,0,9,9,6,0,15,17,7,0,24,18,8,0,26
59531,609,"SC. PRIM. DIV-MARI","DIVICIORII MARI",CJ,125,1,3,0,4,3,3,0,6,5,9,0,14,6,12,0,18,8,12,0,20
59540,610,"SC. PRIM. DIV-MICI","DIVICIORII MICI",CJ,52,1,2,0,3,6,4,0,10,9,6,0,15,12,6,0,18,13,9,0,22
59425,611,"CAMIN CULTURAL SIC",SIC,CJ,765,1,0,0,1,2,0,0,2,3,0,0,3,4,0,0,4,4,0,0,4
59425,612,"CAMIN CULTURAL SIC",SIC,CJ,1230,0,0,0,0,0,0,0,0,2,0,0,2,8,0,0,8,14,3,0,17
59595,613,"SEDIUL PRIMARIEI",SÎNPAUL,CJ,699,7,0,0,7,11,2,0,13,16,4,0,20,24,6,0,30,25,6,0,31
59639,614,"SEDIUL ŞCOLII GEN SARDU",ŞARDU,CJ,344,6,2,0,8,14,5,0,19,16,6,0,22,21,8,0,29,24,11,0,35
59602,615,"SEDIUL ŞCOLII GEN BERINDU",BERINDU,CJ,359,5,0,0,5,6,1,0,7,11,1,0,12,13,4,0,17,13,4,0,17
59611,616,"CAMINUL CULTURAL MIHAIESTI",MIHĂIEŞTI,CJ,215,1,0,0,1,4,1,0,5,8,2,0,10,9,3,0,12,9,3,0,12
59648,617,MAGAZINULCOOPERAŢIEI,"TOPA MICĂ",CJ,190,0,2,0,2,3,2,0,5,3,5,0,8,5,7,0,12,5,7,0,12
59666,618,"SEDIUL ADMINISTRATIV AL PRIMARIEI SUATU",SUATU,CJ,1069,7,1,0,8,14,2,0,16,15,2,0,17,16,2,0,18,16,2,0,18
59675,619,"SEDIUL ADMINISTRATIV DIN ARUNCUTA",ARUNCUTA,CJ,277,5,2,0,7,5,2,0,7,7,2,0,9,7,3,0,10,9,3,0,12
59700,620,"SCOALA PAVEL DAN","TRITENII DE JOS",CJ,1250,4,1,0,5,6,1,0,7,12,1,0,13,15,1,0,16,18,1,0,19
59746,621,"SCOALA PRIMARA","TRITENII DE SUS",CJ,874,3,0,0,3,5,0,0,5,11,0,0,11,19,0,0,19,20,0,0,20
59728,622,"SCOALA PRIMARA",COLONIA,CJ,398,1,0,0,1,2,0,0,2,4,0,0,4,6,2,0,8,6,2,0,8
59737,623,"CAMIN CULTURAL",PĂDURENI,CJ,986,0,0,0,0,8,1,0,9,10,3,0,13,18,3,0,21,22,3,0,25
59755,624,"SCOALA CU CLS I-IV",TRITENII-HOTAR,CJ,243,0,4,0,4,0,4,0,4,6,5,0,11,6,5,0,11,6,5,0,11
59719,625,"CASA PARTICULARA",CLAPA,CJ,71,1,1,0,2,2,2,0,4,2,3,0,5,2,6,0,8,2,6,0,8
59773,626,"PRIMARIA COMUNEI TURENI , NR. 243",TURENI,CJ,790,2,1,0,3,6,5,0,11,7,8,0,15,7,8,0,15,8,9,0,17
59782,627,"CAMINUL CULTURAL CEANU MIC , NR.184","CEANU MIC",CJ,330,1,4,0,5,3,4,0,7,5,4,0,9,5,4,0,9,6,4,0,10
59791,628,"SCOALA CU CLS. I-IV COMSESTI , NR.111",COMŞEŞTI,CJ,185,0,0,0,0,1,0,0,1,3,3,0,6,4,3,0,7,4,3,0,7
59808,629,"SCOALA CU CLS. I-IV MĂRTINEŞTI ,NR.60",MĂRTINEŞTI,CJ,304,1,2,0,3,2,3,0,5,5,4,0,9,5,4,0,9,5,4,0,9
59817,630,"SCOALA CU CLS. I - IV MICESTI , NR.57",MICEŞTI,CJ,218,3,5,0,8,8,11,0,19,8,11,0,19,8,13,0,21,8,13,0,21
59835,631,"PRIMĂRIA ŢAGA",ŢAGA,CJ,618,5,2,0,7,7,3,0,10,9,3,0,12,10,3,0,13,12,5,0,17
59871,632,"SCOALA I-IV SÎNTIOARA",SÎNTIOANA,CJ,458,2,0,0,2,2,0,0,2,2,0,0,2,4,3,0,7,4,3,0,7
59844,633,"FOSTA ŞCOALA I-IV NĂSAL",NĂSAL,CJ,259,0,2,0,2,1,2,0,3,2,2,0,4,2,6,0,8,3,6,0,9
59853,634,"CĂMINUL CULTURAL SÎNTEJUDE",SÎNTEJUDE,CJ,197,1,1,0,2,1,2,0,3,1,3,0,4,1,6,0,7,1,6,0,7
59899,635,"GRADINITA CU PROGRAM NORMAL",UNGURAŞ,CJ,756,0,3,0,3,4,3,0,7,5,3,0,8,8,3,0,11,16,3,0,19
59899,636,"CAMINUL CULTURAL UNGURAS",UNGURAŞ,CJ,754,1,0,0,1,5,2,0,7,5,2,0,7,5,2,0,7,10,2,0,12
59906,637,"SCOALA GIMNAZIALA BATIN",BATIN,CJ,559,1,1,0,2,5,1,0,6,6,1,0,7,8,1,0,9,8,5,0,13
59933,638,"GRADINIŢA CU PROGRAM NORMAL VALEA UNGURAŞULUI","VALEA UNGURAŞULUI",CJ,168,2,0,0,2,3,0,0,3,3,1,0,4,3,1,0,4,4,1,0,5
59951,639,"CĂMIN CULTURAL VAD",VAD,CJ,267,0,0,0,0,6,2,0,8,9,2,0,11,14,5,0,19,14,5,0,19
59997,640,"ȘCOALA CETAN",CETAN,CJ,477,7,2,0,9,17,3,0,20,23,3,0,26,25,5,0,30,25,5,0,30
59960,641,"CENTRU DE ZI PENTRU COPII","BOGATA DE JOS",CJ,197,2,1,0,3,3,1,0,4,8,1,0,9,12,1,0,13,12,1,0,13
60008,642,"ȘCOALA CURTUIUȘ","CURTUIUŞU DEJULUI",CJ,137,3,1,0,4,12,2,0,14,18,2,0,20,22,2,0,24,22,2,0,24
59979,643,"ȘCOALA BOGATA DE SUS","BOGATA DE SUS",CJ,203,0,1,0,1,0,2,0,2,5,2,0,7,6,4,0,10,6,4,0,10
60017,644,"ȘCOALA VALEA GROȘILOR","VALEA GROŞILOR",CJ,205,4,6,0,10,12,10,0,22,12,10,0,22,14,11,0,25,15,13,0,28
59988,645,"CĂMIN CULTURAL CALNA",CALNA,CJ,110,3,0,0,3,7,0,0,7,12,2,0,14,15,2,0,17,15,2,0,17
60035,646,"ȘCOALA GIMNAZIALĂ VALEA IERII","VALEA IERII",CJ,801,6,1,0,7,8,3,0,11,12,11,0,23,23,12,0,35,26,12,0,38
60071,647,"SCOALA GEN CLS I-VIII",VIIŞOARA,CJ,1395,1,0,0,1,7,3,0,10,11,3,0,14,11,4,0,15,11,4,0,15
60071,648,"SCOLA GEN CLS I-IV",VIIŞOARA,CJ,1360,6,2,0,8,12,3,0,15,27,4,0,31,38,4,0,42,42,5,0,47
60071,649,"SCOLA GEN CLS I-IV",VIIŞOARA,CJ,1270,4,0,0,4,9,0,0,9,19,0,0,19,23,0,0,23,33,2,0,35
60080,650,"SCOALA GEN CLS I-VIII URCA",URCA,CJ,808,4,1,0,5,7,2,0,9,11,2,0,13,15,2,0,17,19,2,0,21
60106,651,"PRIMARIA COMUNEI VULTURENI",VULTURENI,CJ,318,5,1,0,6,5,1,0,6,5,1,0,6,9,1,0,10,12,2,0,14
60115,652,"CASA PAROHIALA BABUTIU",BĂBUŢIU,CJ,179,5,0,0,5,11,1,0,12,13,1,0,14,21,3,0,24,22,3,0,25
60124,653,"CAMINUL CULTURAL BADESTI",BĂDEŞTI,CJ,96,2,3,0,5,4,3,0,7,5,3,0,8,6,3,0,9,7,3,0,10
60133,654,"FUNDATIA KIDE",CHIDEA,CJ,95,0,1,0,1,2,2,0,4,3,2,0,5,3,2,0,5,4,2,0,6
60142,655,"CAMINUL CULTURAL FAURENI",FĂURENI,CJ,144,0,5,0,5,2,7,0,9,4,8,0,12,5,10,0,15,6,10,0,16
60151,656,"SCOALA SOIMENI",ŞOIMENI,CJ,266,4,4,0,8,9,4,0,13,12,5,0,17,12,7,0,19,13,7,0,20
92578,1,"SCOALA GIMNAZIALA CAROL I CALARASI",CĂLĂRAŞI,CL,1435,24,1,0,25,58,1,0,59,79,1,0,80,108,1,0,109,119,1,0,120
92578,2,"SCOALA GIMNAZIALA CAROL I CALARASI",CĂLĂRAŞI,CL,652,10,0,0,10,35,4,3,42,41,5,3,49,49,5,3,57,51,6,3,60
92578,3,"SCOALA GIMNAZIALA CAROL I CALARASI",CĂLĂRAŞI,CL,1016,18,0,0,18,37,1,0,38,57,2,0,59,69,5,0,74,76,6,0,82
92578,4,"SCOALA GIMNAZIALA CAROL I CALARASI",CĂLĂRAŞI,CL,793,3,0,0,3,30,0,0,30,39,2,0,41,53,2,0,55,60,4,0,64
92578,5,"COLEGIUL NAŢIONAL ,,BARBU ŞTIRBEI,,",CĂLĂRAŞI,CL,1122,9,5,0,14,24,5,26,55,31,5,26,62,45,5,27,77,50,5,27,82
92578,6,"COLEGIUL NAŢIONAL ,,BARBU ŞTIRBEI,,",CĂLĂRAŞI,CL,1011,12,4,0,16,22,5,0,27,28,5,0,33,43,6,0,49,48,6,0,54
92578,7,"GRĂDINIŢA CU PR.NORMAL NR.5 CALARASI",CĂLĂRAŞI,CL,1333,14,0,0,14,32,0,0,32,43,0,0,43,47,0,0,47,57,0,0,57
92578,8,"GRĂDINIŢA CU PR.NORMAL NR.4 CALARASI",CĂLĂRAŞI,CL,1555,27,3,0,30,48,3,0,51,62,4,0,66,88,6,0,94,91,6,0,97
92578,9,"GRĂDINIŢA CU PR. PREL.(MICRO6)",CĂLĂRAŞI,CL,1405,18,1,0,19,45,3,0,48,63,3,0,66,86,4,0,90,94,4,0,98
92578,10,"COLEGIUL AGRICOL ,,SANDU ALDEA,, CALARASI",CĂLĂRAŞI,CL,1209,12,2,0,14,31,4,0,35,49,5,0,54,69,10,0,79,69,10,0,79
92578,11,"COLEGIUL AGRICOL ,,SANDU ALDEA,, CALARASI",CĂLĂRAŞI,CL,1062,5,0,0,5,23,5,0,28,33,5,0,38,47,7,0,54,56,7,0,63
92578,12,"COLEGIUL AGRICOL ,,SANDU ALDEA,, CALARASI",CĂLĂRAŞI,CL,1056,8,4,0,12,21,5,0,26,33,5,0,38,38,5,0,43,40,5,0,45
92578,13,"LIC. TEORETIC ,,MIHAI EMINESCU,,",CĂLĂRAŞI,CL,1073,6,1,0,7,23,1,0,24,32,1,0,33,44,3,0,47,52,4,0,56
92578,14,"LIC. TEORETIC ,,MIHAI EMINESCU,,",CĂLĂRAŞI,CL,1465,17,1,0,18,38,4,0,42,50,4,0,54,68,6,0,74,78,6,0,84
92578,15,"LIC. TEORETIC ,,MIHAI EMINESCU,,",CĂLĂRAŞI,CL,1309,10,5,0,15,38,5,0,43,49,6,0,55,61,6,0,67,76,6,0,82
92578,16,"ŞCOALA GIMNAZIALA MIHAI VITEAZUL CALARASI",CĂLĂRAŞI,CL,1307,10,1,0,11,21,1,0,22,37,1,0,38,53,1,0,54,56,1,0,57
92578,17,"ŞCOALA GIMNAZIALA MIHAI VITEAZUL CALARASI",CĂLĂRAŞI,CL,1200,12,0,0,12,29,2,0,31,37,2,0,39,52,2,0,54,58,2,0,60
92578,18,"ŞCOALA GIMNAZIALA MIHAI VITEAZUL CALARASI",CĂLĂRAŞI,CL,1402,9,5,0,14,27,6,0,33,39,7,0,46,54,7,0,61,59,7,0,66
92578,19,"ŞCOALA GIMNAZIALA MIHAI VITEAZUL CALARASI",CĂLĂRAŞI,CL,762,3,0,0,3,15,7,0,22,24,7,0,31,33,7,0,40,36,8,0,44
92578,20,"SALA DE SPORT A SCOLII GIMNAZIALE NICOLAE TITULESCU",CĂLĂRAŞI,CL,805,10,2,0,12,13,2,1,16,17,3,1,21,22,5,1,28,24,6,1,31
92578,21,"SALA DE SPORT A SCOLII GIMNAZIALE NICOLAE TITULESCU",CĂLĂRAŞI,CL,1515,15,0,0,15,35,0,0,35,45,1,0,46,54,1,0,55,56,1,0,57
92578,22,"GRĂDINIŢA CU PR.PREL.NR.1",CĂLĂRAŞI,CL,1139,15,7,0,22,39,8,0,47,54,11,0,65,78,11,0,89,84,11,0,95
92578,23,"GRĂDINIŢA CU PROGRAM NORMAL NR.2 CALARASI",CĂLĂRAŞI,CL,1742,22,5,0,27,46,7,0,53,65,9,0,74,79,9,0,88,84,10,0,94
92578,24,"LICEUL DANUBIUS CALARASI",CĂLĂRAŞI,CL,1609,9,0,0,9,19,0,0,19,31,0,0,31,41,0,0,41,52,0,0,52
92578,25,"LICEUL DANUBIUS CALARASI",CĂLĂRAŞI,CL,1584,9,5,0,14,39,5,0,44,53,5,0,58,62,5,0,67,69,5,0,74
92578,26,"LICEUL DANUBIUS CALARASI",CĂLĂRAŞI,CL,1851,10,0,0,10,36,6,0,42,53,6,0,59,57,6,0,63,59,6,0,65
92578,27,"LICEUL DANUBIUS CALARASI",CĂLĂRAŞI,CL,1499,10,0,0,10,29,2,0,31,38,2,0,40,54,4,0,58,54,4,0,58
92578,28,"CREŞA SĂPTĂMÂNALĂ CU 100 LOCURI",CĂLĂRAŞI,CL,1427,18,2,0,20,41,2,0,43,53,2,0,55,61,2,0,63,64,2,0,66
92578,29,"CREŞA SĂPTĂMÂNALĂ CU 100 LOCURI",CĂLĂRAŞI,CL,804,9,1,0,10,17,1,0,18,24,2,0,26,29,5,0,34,29,5,0,34
92578,30,"ŞCOALA GIMNAZIALA T.VLADIMIRESCU",CĂLĂRAŞI,CL,1451,7,0,0,7,39,0,0,39,54,0,0,54,61,0,0,61,69,0,0,69
92578,31,"ŞCOALA GIMNAZIALA T.VLADIMIRESCU",CĂLĂRAŞI,CL,1245,21,1,0,22,40,1,0,41,54,1,0,55,73,1,0,74,81,1,0,82
92578,32,"ŞCOALA GIMNAZIALA T.VLADIMIRESCU",CĂLĂRAŞI,CL,1339,13,0,0,13,35,5,0,40,49,5,0,54,60,5,0,65,60,5,0,65
92578,33,"ŞCOALA GIMNAZIALA T.VLADIMIRESCU",CĂLĂRAŞI,CL,1412,7,4,0,11,30,4,0,34,43,4,0,47,60,4,0,64,61,4,0,65
92578,34,"SALA DE SPORT DE LA ŞC.12",CĂLĂRAŞI,CL,1293,10,3,0,13,19,3,0,22,30,4,0,34,41,5,0,46,42,5,0,47
92578,35,"SALA DE SPORT DE LA ŞC.12",CĂLĂRAŞI,CL,1152,6,4,0,10,14,9,0,23,23,10,0,33,30,10,0,40,38,10,0,48
92578,36,"ŞCOALA GIMNAZIALA MIRCEA VODĂ",CĂLĂRAŞI,CL,1250,7,1,0,8,19,2,0,21,26,4,0,30,38,5,0,43,47,5,0,52
92578,37,"ŞCOALA GIMNAZIALA MIRCEA VODĂ",CĂLĂRAŞI,CL,1163,6,0,0,6,18,0,0,18,29,0,0,29,42,0,0,42,44,2,0,46
92578,38,"ŞCOALA GIMNAZIALA MIRCEA VODĂ",CĂLĂRAŞI,CL,1551,13,1,0,14,29,2,0,31,43,3,0,46,51,3,0,54,60,3,0,63
92578,39,"ŞCOALA GIMNAZIALA MIRCEA VODĂ",CĂLĂRAŞI,CL,1067,8,1,0,9,29,1,0,30,35,2,0,37,43,2,0,45,45,2,0,47
92578,40,"GRADINITA CU PROGRAM PRELUNGIT NR.9 VOINICEL",CĂLĂRAŞI,CL,1518,20,9,0,29,38,9,0,47,52,9,0,61,69,9,0,78,71,9,0,80
92578,41,"GRADINITA CU PROGRAM PRELUNGIT NR.9 VOINICEL",CĂLĂRAŞI,CL,1108,12,6,0,18,31,6,0,37,47,7,0,54,61,7,0,68,62,7,0,69
92578,42,"GRĂDINIŢA CU PR.PRELUNGIT NR.5 ARICEL CALARASI",CĂLĂRAŞI,CL,810,7,0,0,7,27,5,0,32,36,5,0,41,43,5,0,48,47,5,0,52
92578,43,"COLEGIUL ECONOMIC SEDIUL B",CĂLĂRAŞI,CL,1127,18,0,0,18,30,1,0,31,44,1,0,45,52,1,0,53,53,3,0,56
92578,44,"LICEUL TEHNOLOGIC TRANSPORTURI AUTO CALARASI",CĂLĂRAŞI,CL,1221,0,0,0,0,21,7,7,35,43,8,7,58,50,18,7,75,54,18,7,79
92578,45,"ŞCOALA GIMNAZIALA C-TIN BRÂNCOVEANU",CĂLĂRAŞI,CL,1406,11,0,0,11,29,1,0,30,42,2,0,44,62,2,0,64,65,2,0,67
92578,46,"ŞCOALA GIMNAZIALA C-TIN BRÂNCOVEANU",CĂLĂRAŞI,CL,1103,5,0,0,5,13,6,0,19,23,6,0,29,29,6,0,35,30,7,0,37
92578,47,"ŞCOALA GIMNAZIALA C-TIN BRÂNCOVEANU",CĂLĂRAŞI,CL,1192,9,1,0,10,19,1,0,20,34,2,0,36,43,3,0,46,45,3,0,48
92578,48,"ŞCOALA PRIMARA NR.6",CĂLĂRAŞI,CL,1024,4,0,0,4,14,0,0,14,16,1,0,17,20,1,0,21,21,1,0,22
92578,49,"ŞCOALA PRIMARA NR.6",CĂLĂRAŞI,CL,993,7,3,0,10,10,3,0,13,23,5,0,28,34,5,0,39,37,5,0,42
92578,50,"OBORUL DUMINICAL",CĂLĂRAŞI,CL,610,3,3,0,6,9,4,0,13,11,4,0,15,13,5,0,18,15,5,0,20
92578,51,"COLEGIUL ECONOMIC SEDIU",CĂLĂRAŞI,CL,1468,30,3,0,33,88,7,0,95,109,9,0,118,145,11,0,156,152,11,0,163
100629,52,"GRĂDINIŢA NR.5 (INCINTA ŞCOALA GIMNAZIALĂ ""AL.D.GHICA"")",OLTENIŢA,CL,1920,20,0,0,20,28,5,0,33,42,7,0,49,86,9,0,95,86,9,0,95
100629,53,"CANTINA DE AJUTOR SOCIAL",OLTENIŢA,CL,1282,21,1,0,22,56,3,0,59,76,3,0,79,101,5,0,106,107,5,0,112
100629,54,"ŞCOALA GIMNAZIALĂ ""PROF.LUCIAN PAVEL"" LOCAL NR.1",OLTENIŢA,CL,1218,5,0,0,5,30,4,0,34,43,4,0,47,63,4,0,67,70,4,0,74
100629,55,"ŞCOALA GIMNAZIALĂ ""PROF.LUCIAN PAVEL"" LOCAL NR.2",OLTENIŢA,CL,1504,15,6,0,21,63,8,0,71,86,8,0,94,111,11,0,122,128,12,0,140
100629,56,"PRIMARIA MUNICIPIULUI OLTENITA",OLTENIŢA,CL,1811,30,2,0,32,64,4,28,96,84,6,28,118,121,7,28,156,133,7,28,168
100629,57,"PRIMARIA MUNICIPIULUI OLTENITA",OLTENIŢA,CL,1877,24,0,0,24,65,2,0,67,80,2,0,82,115,3,0,118,137,6,0,143
100629,58,"ŞCOALA GIMNAZIALĂ ""SPIRU HARET""",OLTENIŢA,CL,1884,29,0,0,29,57,3,0,60,83,3,0,86,110,6,0,116,117,6,0,123
100629,59,"LICEUL TEORETIC ""NEAGOE BASARAB""",OLTENIŢA,CL,1836,28,0,0,28,63,2,28,93,86,3,28,117,126,3,28,157,131,6,28,165
100629,60,"ŞCOALA GIMNAZIALĂ ""ALEXANDRU VLAHUŢĂ""",OLTENIŢA,CL,1729,22,3,0,25,47,3,0,50,63,3,0,66,90,3,0,93,101,3,0,104
100629,61,"GRADINITA NR.4",OLTENIŢA,CL,1735,16,0,0,16,40,1,0,41,57,3,0,60,86,6,0,92,95,6,0,101
100629,62,"ŞCOALA GIMNAZIALĂ ""PROF.LUCIAN PAVEL"" LOCAL NR.3",OLTENIŢA,CL,1712,18,1,0,19,37,1,0,38,55,1,0,56,78,2,0,80,88,2,0,90
100629,63,"ŞCOALA CU CLS I-IV ""CONSTANTIN DECULESCU""",OLTENIŢA,CL,1755,12,1,0,13,22,1,0,23,34,1,0,35,52,1,0,53,53,1,0,54
100629,64,"ŞCOALA GIMNAZIALĂ ""MIRCEA ELIADE""",OLTENIŢA,CL,1308,6,0,0,6,19,0,0,19,28,0,0,28,53,8,0,61,54,8,0,62
100629,65,"GRADINITA NR.2",OLTENIŢA,CL,1626,9,2,0,11,27,3,0,30,32,3,0,35,52,3,0,55,57,3,0,60
101467,66,"SCOALA GIMNAZIALA GHEORGHE MANU",BUDEŞTI,CL,1862,7,1,0,8,13,1,0,14,27,1,0,28,34,1,0,35,38,1,0,39
101467,67,"SCOALA GIMNAZIALA GHEORGHE MANU",BUDEŞTI,CL,1931,17,0,0,17,27,0,0,27,46,0,0,46,62,0,0,62,66,0,0,66
101476,68,"SCOALA GIMNAZIALA NR.1APROZI",APROZI,CL,812,4,2,0,6,16,8,0,24,21,13,0,34,32,16,0,48,34,20,0,54
101485,69,"SCOALA PRIMARA NR.2 BUCIUMENI",BUCIUMENI,CL,517,0,3,0,3,11,3,0,14,19,7,0,26,24,13,0,37,27,15,0,42
101500,70,"SCOALA PRIMARA NR.1 GRUIU",GRUIU,CL,602,6,6,0,12,12,8,0,20,14,10,0,24,28,15,0,43,28,15,0,43
103041,71,"LICEUL TEHNOLOGIC NR. 1",FUNDULEA,CL,923,14,0,0,14,18,5,0,23,24,8,0,32,53,11,0,64,55,12,0,67
103041,72,"GRADINITA CU PROGRAM PRELUNGIT",FUNDULEA,CL,1418,7,3,0,10,21,8,0,29,30,12,0,42,47,14,0,61,53,15,0,68
103041,73,"SCOALA GIMNAZIALA MIRCEA NEDELCIU",FUNDULEA,CL,1072,9,4,0,13,21,7,0,28,31,8,0,39,43,12,0,55,46,13,0,59
103041,74,"GRADINITA CU PROGRAM NORMALNR. 2 CRANGU",FUNDULEA,CL,1323,9,1,0,10,15,4,0,19,30,6,0,36,48,8,0,56,54,8,0,62
103078,75,"SCOALA GIMNAZIALA NR. 1 GOSTILELE",GOSTILELE,CL,534,6,4,0,10,7,15,0,22,13,15,0,28,26,15,0,41,31,17,0,48
93897,76,PRIMARIE,LEHLIU-GARĂ,CL,1549,28,6,0,34,60,9,0,69,75,12,0,87,91,13,0,104,95,15,0,110
93897,77,"CASA DE CULTURA",LEHLIU-GARĂ,CL,1606,25,3,0,28,50,9,0,59,63,12,0,75,91,13,0,104,101,14,0,115
93913,78,"SCOALA CU CLS. I-VIII",RĂZVANI,CL,775,14,2,0,16,26,4,0,30,31,5,0,36,45,7,0,52,51,7,0,58
93913,79,"SCOALA CU CLS. I-IV",RĂZVANI,CL,1049,7,1,0,8,14,1,0,15,32,1,0,33,43,4,0,47,55,4,0,59
93904,80,"SCOALA CU CLS. I-IV",BUZOENI,CL,375,7,10,0,17,13,10,0,23,16,11,0,27,22,12,0,34,25,12,0,37
94134,81,"SCOALA GIMNAZIALA NR1 NICOLAE BALCESCU","NICOLAE BĂLCESCU",CL,1022,6,3,0,9,12,5,0,17,24,6,0,30,43,8,0,51,44,8,0,52
94143,82,"SCOALA GIMNAZIALA NR. 2 ALEXANDRU ODOBESCU","ALEXANDRU ODOBESCU",CL,912,2,0,0,2,13,2,0,15,15,2,0,17,25,7,0,32,32,7,0,39
94152,83,"DRAGNEA DANIELA INTREPRINDERE INDIVIDUALA",GĂLĂŢUI,CL,257,9,2,0,11,14,7,0,21,18,11,0,29,25,12,0,37,27,12,0,39
101092,84,"SCOALA GIMNAZIALA NR. 1 BELCIUGATELE",BELCIUGATELE,CL,1286,19,2,0,21,39,12,0,51,57,25,0,82,74,28,0,102,82,29,0,111
101136,85,"SCOALA PRIMARA MARIUTA",MĂRIUŢA,CL,407,12,3,0,15,19,8,0,27,26,13,0,39,39,19,0,58,42,21,0,63
92970,86,"SCOALA GIMNAZIALA NR. 3 BORCEA",BORCEA,CL,1038,11,4,0,15,14,6,0,20,29,8,4,41,52,9,4,65,55,9,4,68
92970,87,"GRADINITA CU PROGRAM NORMAL NR. 3 BORCEA",BORCEA,CL,968,1,4,0,5,5,5,0,10,10,5,0,15,17,8,5,30,21,11,5,37
92970,88,"LICEUL TEHNOLOGIC NR. 1 BORCEA CLASELE I-IV SALA A",BORCEA,CL,1504,1,0,0,1,8,2,0,10,43,11,0,54,57,11,0,68,65,11,0,76
92970,89,"LICEUL TEHNOLOGIC NR. 1 BORCEA CLASELE I-IV SALA B",BORCEA,CL,1651,9,0,0,9,22,1,0,23,37,1,0,38,76,6,0,82,78,6,0,84
92970,90,"SCOALA GIMNAZIALA NR. 2 BORCEA",BORCEA,CL,1665,8,0,0,8,23,6,0,29,48,7,0,55,70,10,0,80,77,10,0,87
101733,91,"CAMINUL CULTURAL",CĂSCIOARELE,CL,1488,17,2,0,19,38,5,0,43,51,8,0,59,73,9,0,82,85,15,0,100
101813,92,"SCOALA CU CLASELE I-VIII, NR.1",CHIRNOGI,CL,1575,13,4,0,17,33,5,0,38,45,5,0,50,67,5,0,72,77,5,0,82
101813,93,"SCOALA CU CLASELE I-VIII, NR.2",CHIRNOGI,CL,1598,12,0,0,12,19,0,0,19,36,0,0,36,53,0,0,53,58,0,0,58
101813,94,"SCOALA CU CLASELE I-VIII, NR.2",CHIRNOGI,CL,1595,4,0,0,4,14,0,0,14,24,0,0,24,28,0,0,28,31,0,0,31
101813,95,"SCOALA CU CLASELE I-VIII, NR.3",CHIRNOGI,CL,1243,7,6,0,13,17,8,0,25,26,8,0,34,42,8,0,50,44,8,0,52
101831,96,"ȘCOALA GIMNAZIALĂ NR. 1",CHISELET,CL,592,2,8,0,10,4,9,0,13,11,13,0,24,21,19,0,40,26,19,0,45
101831,97,"ȘCOALA GIMNAZIALĂ NR. 1",CHISELET,CL,1334,12,0,0,12,19,1,0,20,24,1,0,25,69,3,0,72,86,3,0,89
101831,98,"SPAŢIU COMERCIAL CONSUMCOOP MȂNĂSTIREA",CHISELET,CL,695,6,4,0,10,21,5,0,26,38,7,0,45,57,10,0,67,63,10,0,73
93094,99,"SCOALA SMARDAN",CIOCĂNEŞTI,CL,762,5,0,0,5,6,3,0,9,12,4,0,16,15,7,0,22,17,7,0,24
93094,100,"SCOALA MARGINENI",CIOCĂNEŞTI,CL,698,9,3,11,23,21,3,0,24,21,4,0,25,21,4,0,25,21,4,0,25
93094,101,"GRADINITA NR.1 SARBI",CIOCĂNEŞTI,CL,1056,5,4,0,9,10,9,0,19,14,14,0,28,19,15,0,34,20,16,0,36
93094,102,"SCOALA ANDOLINA",CIOCĂNEŞTI,CL,854,6,4,0,10,9,4,0,13,11,6,0,17,12,7,40,59,12,7,40,59
101494,103,"SCOALAGIMNAZIALA ""NICOLAE PETRESCU""",CRIVĂŢ,CL,815,9,0,0,9,12,5,0,17,16,7,0,23,21,9,0,30,27,9,0,36
101494,104,"SCOALAGIMNAZIALA ""NICOLAE PETRESCU""",CRIVĂŢ,CL,866,8,0,0,8,15,2,0,17,22,3,0,25,27,3,0,30,34,5,0,39
102428,105,"SCOALA NR. 1",CURCANI,CL,1164,4,1,0,5,22,3,0,25,36,4,0,40,74,8,0,82,89,8,0,97
102428,106,"SCOALA NR. 1",CURCANI,CL,998,10,0,0,10,15,3,0,18,30,3,0,33,45,6,0,51,53,7,0,60
102428,107,"SCOALA NR. 1",CURCANI,CL,1151,3,2,0,5,22,3,0,25,37,4,0,41,67,8,0,75,78,10,0,88
102428,108,"SCOALA NR. 2",CURCANI,CL,890,11,3,0,14,16,3,0,19,22,5,0,27,51,7,0,58,56,8,0,64
93290,109,"ŞCOALA CEACU",CEACU,CL,1071,7,0,0,7,16,0,0,16,28,2,0,30,33,4,0,37,37,4,0,41
93316,110,"ŞCOALA CUZA VODĂ","CUZA VODĂ",CL,1682,16,1,0,17,23,6,0,29,26,6,0,32,44,12,0,56,46,13,0,59
93307,111,"ŞCOALA CĂLĂRAŞI VECHI","CĂLĂRAŞII VECHI",CL,547,7,1,0,8,12,5,0,17,21,7,0,28,25,7,0,32,26,7,0,33
93334,112,"ŞC. GIMNAZIALĂ NR.1 DICHISENI",DICHISENI,CL,748,4,3,0,7,9,4,0,13,11,4,0,15,17,4,0,21,19,6,0,25
93343,113,"ŞC. PRIMARĂ NR.1",COSLOGENI,CL,710,5,4,0,9,7,4,0,11,9,4,0,13,26,6,0,32,26,6,0,32
93389,114,"SCOALA NR.2 DOR MARUNT GARA","DOR MĂRUNT",CL,1703,16,2,0,18,30,4,0,34,51,6,0,57,79,8,0,87,81,9,31,121
93389,115,"SCOALA NR.1 DOR MARUNT SAT","DOR MĂRUNT",CL,1149,5,4,0,9,14,11,0,25,18,15,0,33,27,20,20,67,28,21,20,69
93423,116,"PROPRIETATE PRIVATA",OGORU,CL,277,5,1,0,6,8,1,0,9,13,1,0,14,13,1,0,14,14,1,0,15
93414,117,"SCOALA INFRATIREA",ÎNFRĂŢIREA,CL,266,4,1,0,5,7,2,0,9,10,3,0,13,12,5,0,17,15,6,0,21
93432,118,"SCOALA PELINU",PELINU,CL,81,1,4,0,5,1,4,0,5,1,4,0,5,3,4,0,7,3,4,0,7
93405,119,"SCOALA DALGA GARA",DÎLGA-GARĂ,CL,1063,4,0,0,4,15,1,0,16,19,1,0,20,23,3,11,37,23,3,11,37
93398,120,"SCOALA DALGA SAT",DÎLGA,CL,612,7,2,0,9,10,2,0,12,11,4,0,15,16,6,0,22,19,8,9,36
93450,121,"ŞCOALA GIMNAZIALĂ NR. 1 DOROBANȚU, CORP B",DOROBANŢU,CL,1209,1,0,0,1,15,2,0,17,21,7,0,28,26,9,0,35,27,11,0,38
93478,122,"ŞCOALA PRIMARĂ NR. 1 VĂRĂŞTI",VĂRĂŞTI,CL,782,3,3,0,6,7,5,0,12,11,7,0,18,19,9,0,28,19,10,0,29
93469,123,"ŞCOALA DIN SATUL BOŞNEAGU",BOŞNEAGU,CL,314,1,0,0,1,5,1,0,6,9,3,0,12,12,6,0,18,15,7,0,22
93496,124,"SCOALA GIMNAZIALA NR.1 DRAGALINA",DRAGALINA,CL,1161,5,0,0,5,8,5,0,13,10,5,0,15,15,5,0,20,15,5,0,20
93496,125,"SCOALA GIMNAZIALA NR.1 DRAGALINA",DRAGALINA,CL,1277,8,3,0,11,16,3,0,19,17,3,0,20,26,3,0,29,27,3,0,30
93496,126,"SCOALA GIMNAZIALA NR.1 DRAGALINA",DRAGALINA,CL,1365,4,5,0,9,18,6,0,24,27,6,0,33,36,7,0,43,36,7,0,43
93496,127,"SCOALA GIMNAZIALA NR.1 DRAGALINA",DRAGALINA,CL,1081,4,0,0,4,9,0,0,9,15,4,0,19,22,4,0,26,22,4,0,26
93511,128,"SCOALA GIMNAZIALA NR.1 DRAJNA NOUA","DRAJNA NOUĂ",CL,1073,8,3,0,11,14,4,0,18,20,5,0,25,38,7,0,45,42,7,0,49
93502,129,"SCOALA GIMNAZIALA NR.2 CONSTANTIN BRANCOVEANU","CONSTANTIN BRÂNCOVEANU",CL,766,4,1,0,5,10,2,0,12,15,4,0,19,23,9,0,32,23,9,0,32
93548,130,"SCOALA GIMNAZIALA NR.1","DRAGOŞ VODĂ",CL,1030,19,1,0,20,33,7,0,40,44,8,0,52,55,16,0,71,62,16,0,78
93548,131,"SCOALA GIMNAZIALA NR.1","DRAGOŞ VODĂ",CL,1032,7,2,0,9,8,3,0,11,13,3,17,33,23,3,17,43,30,4,17,51
93566,132,"GRADINITA CU PROGRAM NORMAL NR.3",SOCOALELE,CL,183,2,1,0,3,8,4,0,12,9,4,0,13,16,6,8,30,17,6,8,31
102847,133,"SCOALA GIMNAZIALA NR.1 FRASINET",FRĂSINET,CL,878,14,0,0,14,26,3,0,29,44,4,0,48,99,14,0,113,106,17,0,123
102883,134,"SCOALA PRIMARA NR.1 LUPTATORI",LUPTĂTORI,CL,455,7,4,0,11,19,12,0,31,22,17,0,39,31,18,0,49,32,18,0,50
102972,135,"SCOALA GENERALA PASAREA",PASĂREA,CL,598,7,4,0,11,19,9,0,28,34,15,0,49,64,19,3,86,68,29,3,100
102954,136,"SCOALA GENERALA NR 1.FRUMUSANI",FRUMUŞANI,CL,924,4,5,0,9,15,19,0,34,40,33,0,73,49,36,2,87,59,37,2,98
102954,137,"SCOALA GENERALA NR 1.FRUMUSANI",FRUMUŞANI,CL,968,6,1,0,7,8,8,0,16,38,13,0,51,45,15,2,62,48,18,2,68
102981,138,"SCOALA GENERALA PADURISU",PĂDURIŞU,CL,503,8,8,0,16,32,25,0,57,45,29,0,74,73,44,0,117,77,51,0,128
102963,139,"SCOALA GENERALA ORASTI",ORĂŞTI,CL,791,4,10,0,14,12,19,0,31,24,25,0,49,32,41,0,73,35,44,0,79
103023,140,"SCOALA CLASELE 1-8 NR. 1",FUNDENI,CL,1260,20,0,0,20,32,7,0,39,36,12,0,48,49,14,0,63,58,14,0,72
103023,141,"PRIMARIA COMUNEI FUNDENI",FUNDENI,CL,1213,7,8,0,15,18,10,0,28,31,13,0,44,59,18,0,77,62,21,0,83
103023,142,"SCOALA CLASELE 1-4 NR. 3",FUNDENI,CL,1217,16,3,0,19,27,3,0,30,42,7,0,49,52,11,0,63,61,16,0,77
105847,143,"SCOALA NR. 1 GALBINASI",GĂLBINAŞI,CL,1699,17,3,0,20,25,11,0,36,59,13,0,72,89,19,0,108,101,21,0,122
105847,144,"SCOALA NR. 1GALBINASI",GĂLBINAŞI,CL,999,7,1,0,8,14,2,0,16,18,4,0,22,36,6,0,42,38,7,0,45
93673,145,"ŞCOALA VECHE",GRĂDIŞTEA,CL,1775,13,1,0,14,43,2,0,45,63,8,0,71,89,10,0,99,97,12,0,109
93708,146,"ŞCOALA VECHE",RASA,CL,1030,4,2,0,6,7,3,0,10,12,5,0,17,17,5,0,22,18,5,0,23
93691,147,"ŞCOALA CUNEŞTI",CUNEŞTI,CL,722,3,0,0,3,4,1,0,5,5,1,0,6,10,7,0,17,10,7,0,17
93682,148,"ŞCOALA BOGATA",BOGATA,CL,479,3,1,0,4,6,1,0,7,8,3,1,12,15,3,1,19,16,3,1,20
103577,149,"SCOALA GIMNAZIALA NR. 1 GURBANESTI",GURBĂNEŞTI,CL,449,8,1,0,9,31,13,0,44,36,17,0,53,65,21,0,86,66,21,0,87
103595,150,"GRADINITA CU PROGRAM NORMAL COTOFANCA",COŢOFANCA,CL,310,11,5,0,16,18,12,0,30,23,17,0,40,31,21,0,52,32,21,0,53
103620,151,"GRADINITA CU PROGRAM NORMAL VALEA PRESNEI","VALEA PRESNEI",CL,148,2,2,0,4,9,14,0,23,18,32,0,50,23,38,4,65,25,38,4,67
103773,152,"SCOALA ILEANA",ILEANA,CL,785,0,0,0,0,6,5,0,11,8,7,0,15,12,7,0,19,12,7,0,19
103791,153,"SCOALA FLORICA",FLORICA,CL,511,4,0,0,4,10,3,0,13,14,4,0,18,22,5,0,27,24,5,0,29
103844,154,"SCOALA STEFANESTI",ŞTEFĂNEŞTI,CL,619,7,4,0,11,23,10,0,33,31,12,0,43,42,13,0,55,56,18,0,74
103782,155,"SCOALA ARTARI",ARŢARI,CL,497,7,3,0,10,8,7,0,15,12,7,0,19,14,8,0,22,15,8,0,23
93780,156,"GRADINITA DE COPII",INDEPENDENŢA,CL,1796,15,1,0,16,32,1,0,33,41,1,0,42,58,1,0,59,62,1,0,63
93806,157,"GRADINITA DE COPII",VIŞINII,CL,434,4,4,0,8,9,4,0,13,14,6,0,20,15,6,0,21,15,6,0,21
93799,158,"SCOALA GENERALA",POTCOAVA,CL,662,4,2,0,6,12,5,0,17,15,6,0,21,22,10,0,32,22,10,0,32
93824,159,"SCOALA GIMNAZIALA NR. 1",JEGĂLIA,CL,1595,11,2,0,13,21,5,0,26,25,5,0,30,42,5,0,47,50,6,0,56
93833,160,"SCOALA PRIMARA NR. 1",GÎLDĂU,CL,1119,20,6,0,26,49,7,0,56,59,8,0,67,99,14,0,113,102,15,0,117
93842,161,"SCOALA PRIMARA NR. 2",IEZERU,CL,778,11,0,0,11,19,1,0,20,24,4,0,28,26,6,0,32,26,6,0,32
93860,162,"CAMIN CULTURAL",LEHLIU,CL,1411,8,0,0,8,16,1,0,17,24,1,0,25,39,5,0,44,45,9,0,54
93879,163,"SCOALA SAPUNARI",SĂPUNARI,CL,671,7,0,0,7,17,2,0,19,25,5,0,30,30,7,0,37,37,9,0,46
104092,164,"SCOALA CU CLASELE I-VIII LUICA",LUICA,CL,1281,10,1,0,11,26,3,0,29,36,4,0,40,63,4,0,67,74,6,0,80
104109,165,"SCOALA CU CLASELE I-IV VALEA STANII","VALEA STÎNII",CL,436,6,1,0,7,8,2,0,10,16,3,0,19,22,4,0,26,23,4,0,27
93959,166,"GRADINITA CU PROGRAM NORMAL NR.4 NUCETU",NUCETU,CL,521,3,0,0,3,6,4,0,10,18,9,0,27,24,12,0,36,25,12,0,37
93940,167,"GRADINITA CU PROGRAM NORMAL NR.3 LUPSANU",LUPŞANU,CL,504,5,3,0,8,16,5,0,21,19,5,0,24,29,9,0,38,32,9,0,41
93977,168,"SCOALA GIMNAZIALA NR.1 RADU-VODA","RADU VODĂ",CL,968,14,2,0,16,28,2,0,30,34,6,0,40,47,10,0,57,48,10,0,58
93968,169,"SCOALA PRIMARA NR.1 PLEVNA",PLEVNA,CL,523,15,2,0,17,27,9,0,36,37,15,0,52,49,18,0,67,49,18,0,67
104190,170,"LICEUL TEHNOLOGIC MATEI BASARAB",MÂNĂSTIREA,CL,1395,16,3,0,19,36,6,0,42,46,9,0,55,77,9,0,86,82,9,0,91
104190,171,"LICEUL TEHNOLOGIC MATEI BASARAB",MÂNĂSTIREA,CL,1476,15,3,0,18,36,5,0,41,59,5,0,64,81,9,0,90,89,12,0,101
104207,172,"ŞCOALA GENERALĂ COCONI",COCONI,CL,695,40,12,0,52,86,18,0,104,113,21,0,134,147,26,0,173,172,29,0,201
104216,173,"ŞCOALA GIMNAZIALĂ NR. 2 SULTANA",SULTANA,CL,783,3,4,0,7,9,6,0,15,27,13,0,40,40,17,0,57,43,20,0,63
100647,174,"SCOALA GIMNAZIALA NR. 2 MITRENI",MITRENI,CL,1176,7,0,0,7,19,0,0,19,26,0,0,26,56,3,0,59,61,3,0,64
100665,175,"SCOALA GIMNAZIALA NR. 1 VALEA ROSIE","VALEA ROŞIE",CL,1839,11,2,0,13,17,6,0,23,76,13,0,89,130,23,0,153,137,23,16,176
100656,176,"GRADINITA CU PROGRAM NORMAL NR. 3 CLATESTI",CLĂTEŞTI,CL,415,0,4,0,4,4,4,0,8,7,4,0,11,11,7,0,18,11,7,0,18
92596,177,"SCOALA GENERALA NR.1",MODELU,CL,1594,16,0,0,16,48,2,0,50,52,2,0,54,67,2,0,69,68,2,0,70
92596,178,"SCOALA GENERALA NR.1",MODELU,CL,1673,6,6,0,12,16,9,0,25,28,9,0,37,36,9,0,45,42,10,0,52
92596,179,"SCOALA GENERALA NR.1",MODELU,CL,1554,7,1,0,8,27,1,0,28,42,2,0,44,64,2,0,66,74,2,0,76
92596,180,"SCOALA GENERALA NR.2",MODELU,CL,1621,3,0,0,3,20,0,0,20,31,0,0,31,39,0,0,39,45,0,0,45
92630,181,"SCOALA TONEA",TONEA,CL,1608,4,1,0,5,14,1,0,15,26,2,0,28,36,5,0,41,39,5,0,44
104332,182,"SCOALA GIMNAZIALA NR. 1",NANA,CL,1204,17,1,0,18,29,2,0,31,33,2,0,35,56,6,0,62,66,9,0,75
104332,183,"SCOALA GIMNAZIALA NR. 1",NANA,CL,643,12,2,0,14,24,5,0,29,32,5,0,37,49,5,0,54,52,5,0,57
104350,184,"SCOALA CU CLASELE I-VIII","NICOLAE BĂLCESCU",CL,1008,14,2,0,16,26,6,0,32,35,9,0,44,53,17,0,70,63,18,0,81
104369,185,"SCOALA CU CLASELEI-IV","FÎNTÎNA DOAMNEI",CL,220,5,2,0,7,8,5,0,13,9,7,0,16,11,8,0,19,12,9,0,21
94232,186,"CĂMIN CULTURAL PERIŞORU",PERIŞORU,CL,1827,15,4,0,19,26,7,0,33,32,7,0,39,44,9,1,54,54,10,1,65
94232,187,"CĂMIN CULTURAL PERIŞORU",PERIŞORU,CL,1813,6,0,0,6,10,1,0,11,17,1,0,18,30,1,0,31,32,1,0,33
94250,188,"ŞCOALA GIMNAZIALA NR. 2 PERIŞORU","TUDOR VLADIMIRESCU",CL,593,5,2,0,7,7,3,0,10,7,3,0,10,11,4,0,15,15,4,0,19
104644,189,"PRIMĂRIA PLĂTĂREŞTI",PLĂTĂREŞTI,CL,1102,13,9,0,22,42,20,0,62,53,24,0,77,68,31,0,99,71,32,0,103
104662,190,"ŞCOALA PRIMARĂ NR.3 DOROBANȚU",DOROBANŢU,CL,771,2,1,0,3,4,6,0,10,11,17,0,28,31,28,0,59,41,28,0,69
104671,191,"GRĂDINIȚA CU PROGRAM NORMAL NR.5 PODU PITARULUI","PODU PITARULUI",CL,477,2,0,0,2,2,0,0,2,2,0,0,2,3,0,0,3,3,0,0,3
104671,192,"GRĂDINIȚA CU PROGRAM NORMAL NR.5 PODU PITARULUI","PODU PITARULUI",CL,322,5,3,0,8,6,5,0,11,15,13,0,28,28,16,0,44,35,18,0,53
104760,193,"ȘCOALA GIMNAZIALĂ ,,DIMITRIE ION GHICA ,,",RADOVANU,CL,1003,3,0,0,3,9,1,0,10,11,1,0,12,12,4,0,16,21,4,0,25
104760,194,"ȘCOALA GIMNAZIALĂ ,,DIMITRIE ION GHICA ,,",RADOVANU,CL,958,6,1,0,7,10,3,0,13,16,5,0,21,26,5,0,31,29,7,0,36
104760,195,"ȘCOALA CU CLASELE I-IV COADELE",RADOVANU,CL,964,9,1,0,10,18,3,0,21,21,3,0,24,28,3,0,31,30,4,0,34
104779,196,"ȘCOALA CU CLASELE I-IV VALEA POPII","VALEA POPII",CL,469,8,2,0,10,18,2,0,20,39,5,0,44,73,13,25,111,82,13,32,127
94321,197,"SCOALA GENERALA CU CLS I-IV-SECTOR",ROSEŢI,CL,1861,10,4,0,14,28,4,0,32,45,4,0,49,61,6,0,67,65,6,0,71
94321,198,"SCOALA GIMNAZIALA IANCU ROSETTI-CENTRU",ROSEŢI,CL,1262,7,0,0,7,13,0,0,13,23,0,0,23,31,0,0,31,31,0,0,31
94321,199,"SCOALA CU CLS. I-IV-DEAL",ROSEŢI,CL,1851,17,2,0,19,35,3,0,38,55,4,0,59,64,4,0,68,67,4,0,71
104939,200,"GRADINITA CU 4 GRUPE",SĂRULEŞTI-GARĂ,CL,1157,19,2,0,21,33,6,0,39,38,7,0,45,74,16,0,90,95,17,0,112
104920,201,"SCOALA CU CLASELE I-IV",SĂNDULIŢA,CL,475,0,2,0,2,0,3,0,3,1,7,0,8,5,7,0,12,5,7,0,12
104895,202,"SCOALA CU CLASELE I-IV",SĂRULEŞTI,CL,338,1,2,0,3,4,2,0,6,4,4,0,8,5,5,0,10,5,5,0,10
104966,203,"SCOALA CU CLASELE I-IV",SOLACOLU,CL,217,0,0,0,0,1,0,0,1,4,2,0,6,7,3,0,10,7,8,0,15
105231,204,"ȘCOALA GENERALA NR.1",SOHATU,CL,1303,5,5,0,10,19,9,0,28,32,16,0,48,46,25,0,71,54,26,0,80
105240,205,"ȘCOALA GENERALA NR.2",PROGRESU,CL,789,5,2,0,7,16,5,0,21,36,8,0,44,46,10,0,56,49,11,0,60
105268,206,"SCOALA GIMNAZIALANR. 1 SPANTOV",SPANŢOV,CL,834,20,1,0,21,33,5,0,38,42,5,15,62,64,6,15,85,67,6,15,88
105277,207,"GRĂDINIŢA CU PROGRAM NORMAL NR. 3","CETATEA VECHE",CL,714,25,1,0,26,40,3,0,43,58,4,0,62,94,8,2,104,103,8,2,113
105286,208,"ŞCOALA GIMNAZIALĂ NR. 2 STANCEA",STANCEA,CL,1242,13,2,0,15,49,3,0,52,62,4,0,66,105,6,0,111,125,8,0,133
105286,209,"ŞCOALA PRIMARĂ NR. 1 CLINCIU",STANCEA,CL,845,17,1,0,18,43,1,0,44,56,1,0,57,75,6,0,81,86,8,0,94
105393,210,"ŞCOALA GIMNAZIALĂ ,,CONSTANTIN TEODORESCU'' ŞOLDANU",ŞOLDANU,CL,1767,12,1,0,13,44,11,0,55,46,25,0,71,79,31,0,110,91,36,0,127
105400,211,"ŞCOALA PRIMARĂ NR.1 NEGOEŞTI",NEGOEŞTI,CL,823,4,0,0,4,11,4,0,15,22,4,0,26,34,7,10,51,36,7,10,53
94571,212,"SCOALA GIMNAZIALA DRAGOS MARIN","ŞTEFAN CEL MARE",CL,1544,8,0,0,8,15,0,0,15,26,2,0,28,41,2,0,43,48,5,0,53
94571,213,"SCOALA GIMNAZIALA DRAGOS MARIN","ŞTEFAN CEL MARE",CL,1118,7,3,0,10,10,3,0,13,17,4,0,21,25,4,0,29,28,4,0,32
94599,214,"ŞCOALA CU CLS. I-VIII ŞTEFAN VODĂ","ŞTEFAN VODĂ",CL,1069,7,2,0,9,14,3,0,17,18,3,0,21,21,5,0,26,23,7,0,30
94599,215,"ŞCOALA CU CLS. I-VIII ŞTEFAN VODĂ","ŞTEFAN VODĂ",CL,828,5,1,0,6,12,1,0,13,14,2,0,16,14,2,0,16,14,2,0,16
105464,216,"SCOALA GIMNAZIALA NR.1","TĂMĂDĂU MARE",CL,1221,14,4,0,18,20,6,0,26,27,10,0,37,38,10,0,48,41,10,0,51
105491,217,"SCOALA PRIMARA NR.2",PLUMBUITA,CL,729,2,6,0,8,3,10,0,13,6,12,0,18,11,13,0,24,15,14,0,29
105614,218,"SCOALA GIMNAZIALA GRIGORE MOISIL",ULMENI,CL,1321,13,2,0,15,23,2,0,25,39,2,0,41,44,5,0,49,50,7,0,57
105614,219,"SCOALA GIMNAZIALA NR.2 ULMENI",ULMENI,CL,1443,13,0,0,13,38,3,0,41,81,3,0,84,121,5,0,126,129,9,0,138
105614,220,"SCOALA PRIMARA NR.3 ULMENI",ULMENI,CL,1240,13,2,0,15,25,3,0,28,32,7,0,39,64,15,0,79,69,17,0,86
94615,221,"SCOALA CU CLASELE I-VIII ULMU",ULMU,CL,670,3,2,0,5,10,4,0,14,18,4,0,22,21,4,0,25,23,4,0,27
94633,222,"SCOALA CU CLASELE I-IV FAUREI",FĂUREI,CL,344,2,1,0,3,5,6,0,11,7,8,0,15,10,8,0,18,14,8,0,22
94642,223,"FOSTA SCOALA PRIMARA ZIMBRU",ZIMBRU,CL,98,4,4,0,8,8,6,0,14,11,7,0,18,14,9,0,23,14,9,0,23
94660,224,"SCOALA GIMNAZIALA NR 1 (LOCAL LANGA BISERICA)",UNIREA,CL,1093,19,1,0,20,35,2,0,37,41,2,0,43,49,6,0,55,51,6,0,57
94660,225,"SCOALA GIMNAZIALA NR 1 (LOCAL LANGA CAMINUL CULTURAL)",UNIREA,CL,1211,17,3,0,20,25,3,0,28,35,3,0,38,42,5,0,47,45,5,0,50
105721,226,"SCOALA GIMNAZIALA VALEA ARGOVEI","VALEA ARGOVEI",CL,1372,10,0,0,10,19,7,0,26,26,11,0,37,33,18,0,51,34,18,0,52
105758,227,"SCOALA GENERALA SILISTEA",SILIŞTEA,CL,549,6,3,0,9,8,5,0,13,13,7,0,20,24,8,0,32,29,11,0,40
105838,228,"ȘCOALA PROZANIC, CLASELE I-IV",VASILAŢI,CL,983,4,2,0,6,14,4,0,18,16,20,0,36,22,21,0,43,22,26,0,48
105838,229,"ȘCOALA CONSTANTIN BRÂNCOVEANU",VASILAŢI,CL,1748,12,4,0,16,20,4,0,24,31,9,0,40,42,20,0,62,49,24,0,73
105856,230,"ȘCOALA GIMNAZIALA NUCI",NUCI,CL,291,6,3,0,9,6,4,0,10,7,6,0,13,15,8,0,23,18,10,0,28
105865,231,"ȘCOALA GIMNAZIALA POPEȘTI",POPEŞTI,CL,278,4,5,0,9,6,6,0,12,12,7,0,19,14,12,0,26,14,12,0,26
94740,232,"SCOALA GIMNAZIALA FLORENTA ALBUVILCELELE",VÎLCELELE,CL,932,5,0,0,5,17,6,0,23,20,8,0,28,49,10,66,125,58,15,66,139
94759,233,"CONSILIUL LOCAL VILCELELE",FLOROAICA,CL,490,0,3,0,3,4,4,30,38,4,4,30,38,10,6,30,46,11,9,30,50
94777,234,"ȘCOALA VLAD ȚEPEȘ","VLAD ŢEPEŞ",CL,1257,11,4,0,15,19,6,0,25,28,8,0,36,41,12,0,53,43,12,0,55
94786,235,"GRĂDINIȚA MIHAI VITEAZU","MIHAI VITEAZU",CL,425,5,1,0,6,5,4,0,9,7,6,0,13,8,8,0,16,14,10,0,24
50807,1,"ȘCOALA GIMNAZIALĂ NR. 5",REŞIŢA,CS,1230,9,0,0,9,36,1,0,37,45,3,14,62,58,4,14,76,71,4,14,89
50807,2,"CENTRUL DE ZI ”MARIA”",REŞIŢA,CS,610,5,0,0,5,13,0,0,13,19,0,0,19,28,0,0,28,30,0,2,32
50807,3,"GRĂDINIȚA CU PROGRAM NORMAL NR. 2",REŞIŢA,CS,1075,2,5,0,7,19,6,0,25,27,6,0,33,49,9,0,58,52,9,0,61
50807,4,"ȘCOALA GIMNAZIALĂ NR. 1 (BETON)",REŞIŢA,CS,595,2,2,0,4,13,3,0,16,16,3,0,19,19,3,0,22,19,3,0,22
50807,5,"ȘCOALA GIMNAZIALĂ NR. 1 (BETON)",REŞIŢA,CS,1103,9,1,0,10,37,2,0,39,47,2,0,49,65,3,1,69,70,3,1,74
50807,6,"ȘCOALA GIMNAZIALĂ NR. 1 (CASA MUNCITOREASCĂ)",REŞIŢA,CS,1466,16,0,0,16,32,1,0,33,46,2,0,48,60,2,0,62,61,2,0,63
50807,7,"ȘCOALA GIMNAZIALĂ NR. 1 (CASA MUNCITOREASCĂ)",REŞIŢA,CS,1050,5,0,0,5,19,1,0,20,31,1,0,32,56,1,0,57,58,1,0,59
50807,8,"ȘCOALA PRIMARĂ DEALU MARE",REŞIŢA,CS,738,11,0,0,11,15,0,0,15,26,0,0,26,26,0,0,26,26,0,0,26
50807,9,"ȘCOALA PRIMARĂ DEALU MARE",REŞIŢA,CS,849,0,3,0,3,7,3,0,10,8,3,0,11,9,3,0,12,9,3,0,12
50807,10,"ȘCOALA GIMNAZIALĂ NR. 2",REŞIŢA,CS,1059,16,0,0,16,33,0,0,33,50,0,0,50,81,2,0,83,83,2,0,85
50807,11,"ȘCOALA GIMNAZIALĂ NR. 2",REŞIŢA,CS,1223,14,1,0,15,36,2,0,38,65,3,0,68,88,3,0,91,93,3,0,96
50807,12,"ȘCOALA GIMNAZIALĂ NR. 2",REŞIŢA,CS,1203,8,0,0,8,30,2,0,32,48,3,0,51,63,3,0,66,78,3,0,81
50807,13,"COLEGIUL NAȚIONAL ""TRAIAN LALESCU"" - ȘCOALA PRIMARĂ",REŞIŢA,CS,641,4,0,0,4,9,0,0,9,11,0,0,11,17,0,0,17,20,0,0,20
50807,14,"GRĂDINIȚA CU PROGRAM PRELUNGIT ""PALATUL FERMECAT""",REŞIŢA,CS,1004,6,4,0,10,36,6,0,42,64,7,0,71,76,7,0,83,78,7,0,85
50807,15,"GRĂDINIȚA CU PROGRAM PRELUNGIT ""PALATUL FERMECAT""",REŞIŢA,CS,1181,5,3,0,8,32,5,0,37,47,5,0,52,63,5,0,68,70,5,0,75
50807,16,"GRĂDINIȚA CU PROGRAM PRELUNGIT ""PALATUL FERMECAT""",REŞIŢA,CS,1423,8,0,0,8,33,0,0,33,43,0,0,43,62,0,0,62,79,0,0,79
50807,17,"S.C. DRUMURI JUDEȚENE S.A. REȘIȚA AFLAT ÎN PROPRIETATEA CONSILIULUI JUDEȚEAN CARAȘ-SEVERIN",REŞIŢA,CS,1036,9,4,0,13,18,4,0,22,34,4,0,38,51,4,0,55,54,4,0,58
50807,18,"UNIVERSITATEA ”EFTIMIE MURGU”",REŞIŢA,CS,549,6,4,0,10,23,13,0,36,38,13,0,51,47,17,0,64,50,17,0,67
50807,19,"UNIVERSITATEA ""EFTIMIE MURGU""",REŞIŢA,CS,1159,17,3,0,20,44,11,0,55,49,17,0,66,68,17,0,85,81,17,0,98
50807,20,"COLEGIUL NAȚIONAL ""TRAIAN LALESCU""",REŞIŢA,CS,1149,13,0,0,13,34,0,0,34,46,0,0,46,57,1,0,58,58,1,0,59
50807,21,"COLEGIUL NAȚIONAL ""TRAIAN LALESCU""",REŞIŢA,CS,970,5,0,0,5,23,4,0,27,31,5,0,36,45,7,0,52,51,7,0,58
50807,22,"COLEGIUL NAȚIONAL ""TRAIAN LALESCU""",REŞIŢA,CS,1300,11,1,0,12,46,1,0,47,57,1,0,58,66,6,0,72,70,8,0,78
50807,23,"COLEGIUL NAȚIONAL ""TRAIAN LALESCU""",REŞIŢA,CS,774,10,0,0,10,33,0,0,33,45,0,0,45,55,3,0,58,55,3,0,58
50807,24,"ȘCOALA GIMNAZIALĂ ""MIHAI PEIA""",REŞIŢA,CS,891,15,0,0,15,33,3,0,36,46,4,0,50,63,4,0,67,67,4,0,71
50807,25,"ȘCOALA GIMNAZIALĂ ""MIHAI PEIA""",REŞIŢA,CS,774,8,0,0,8,13,1,0,14,31,2,0,33,43,2,0,45,44,2,0,46
50807,26,"ȘCOALA GIMNAZIALĂ ""MIHAI PEIA""",REŞIŢA,CS,928,7,0,4,11,34,0,4,38,51,0,4,55,64,0,4,68,64,0,4,68
50807,27,"COLEGIUL TEHNIC REȘIȚA",REŞIŢA,CS,1217,11,0,0,11,35,0,0,35,44,0,0,44,59,0,0,59,64,0,0,64
50807,28,"COLEGIUL TEHNIC REȘIȚA",REŞIŢA,CS,766,9,0,0,9,31,0,0,31,41,1,1,43,53,2,1,56,53,2,1,56
50807,29,"COLEGIUL TEHNIC REȘIȚA",REŞIŢA,CS,1051,9,5,0,14,24,7,0,31,37,8,0,45,61,8,0,69,63,9,0,72
50807,30,"GRĂDINIŢA CU PROGRAM NORMAL ""CIUPERCUȚA""",REŞIŢA,CS,703,4,1,0,5,21,1,0,22,39,1,0,40,45,2,0,47,46,2,0,48
50807,31,"GRĂDINIȚA CU PROGRAM NORMAL ""DEGEȚICA""",REŞIŢA,CS,1133,7,0,0,7,27,1,0,28,35,2,0,37,49,3,0,52,50,3,0,53
50807,32,"LICEUL TEORETIC ”TRAIAN VUIA”",REŞIŢA,CS,1337,7,1,0,8,27,2,0,29,32,6,0,38,41,7,0,48,46,8,0,54
50807,33,"LICEUL TEORETIC ”TRAIAN VUIA”",REŞIŢA,CS,935,5,0,0,5,14,0,0,14,19,1,0,20,23,2,0,25,23,2,0,25
50807,34,"LICEUL TEORETIC ”TRAIAN VUIA”",REŞIŢA,CS,1471,9,0,0,9,25,1,0,26,34,1,0,35,47,3,0,50,51,3,0,54
50807,35,"LICEUL TEORETIC ”TRAIAN VUIA”",REŞIŢA,CS,1094,5,0,0,5,30,0,0,30,42,0,0,42,62,1,0,63,68,5,0,73
50807,36,"LICEUL TEORETIC ”TRAIAN VUIA”",REŞIŢA,CS,1116,5,1,0,6,14,1,0,15,29,1,0,30,41,1,0,42,43,1,0,44
50807,37,"LICEUL TEORETIC ”TRAIAN VUIA”",REŞIŢA,CS,911,1,0,0,1,13,1,0,14,21,1,0,22,24,1,0,25,25,1,0,26
50807,38,"ȘCOALA GIMNAZIALĂ NR. 8",REŞIŢA,CS,1294,9,1,0,10,33,1,0,34,50,1,0,51,63,3,0,66,68,3,0,71
50807,39,"ȘCOALA GIMNAZIALĂ NR. 8",REŞIŢA,CS,1448,15,2,0,17,43,3,0,46,50,3,0,53,63,4,0,67,65,4,0,69
50807,40,"ȘCOALA GIMNAZIALĂ NR. 8",REŞIŢA,CS,1126,17,0,0,17,33,0,0,33,44,0,0,44,53,0,0,53,55,0,0,55
50807,41,"COLEGIUL NAŢIONAL”MIRCEA ELIADE”REŞIŢA",REŞIŢA,CS,1017,7,0,0,7,46,1,0,47,51,4,0,55,54,4,0,58,55,4,0,59
50807,42,"COLEGIUL NAŢIONAL”MIRCEA ELIADE”,REŞIŢA",REŞIŢA,CS,994,8,0,0,8,17,0,0,17,32,0,0,32,42,1,0,43,44,1,0,45
50807,43,"COLEGIUL TEHNIC CĂRĂŞAN, REȘIȚA",REŞIŢA,CS,1197,5,0,0,5,34,0,0,34,57,1,0,58,61,1,0,62,66,1,0,67
50807,44,"COLEGIUL TEHNIC CĂRĂŞAN, REȘIȚA",REŞIŢA,CS,965,12,5,0,17,26,5,0,31,30,5,0,35,45,7,0,52,48,7,0,55
50807,45,"ȘCOALA GIMNAZIALĂ NR. 7,CORP B",REŞIŢA,CS,1391,8,0,0,8,30,1,0,31,44,1,0,45,60,2,0,62,64,3,0,67
50807,46,"ȘCOALA GIMNAZIALĂ NR. 7,CORP B",REŞIŢA,CS,1170,11,0,0,11,40,0,0,40,56,0,0,56,77,0,0,77,82,0,0,82
50807,47,"ȘCOALA GIMNAZIALĂ NR. 7,CORP B",REŞIŢA,CS,1088,9,0,0,9,34,4,1,39,51,4,1,56,64,4,1,69,71,4,1,76
50807,48,"ȘCOALA GIMNAZIALĂ NR. 7,CORP B",REŞIŢA,CS,844,9,0,0,9,28,0,0,28,34,0,0,34,42,2,0,44,46,2,0,48
50807,49,"ȘCOALA GIMNAZIALĂ NR. 7,CORP A",REŞIŢA,CS,1336,14,0,0,14,37,2,0,39,52,3,0,55,76,6,0,82,82,6,0,88
50807,50,"ȘCOALA GIMNAZIALĂ NR. 7,CORP A",REŞIŢA,CS,1153,9,0,0,9,36,1,0,37,60,2,0,62,71,2,0,73,72,2,0,74
50807,51,"ȘCOALA GIMNAZIALĂ NR. 7,CORP A",REŞIŢA,CS,1534,22,1,0,23,67,1,0,68,93,1,0,94,108,3,0,111,111,3,0,114
50807,52,"ȘCOALA GIMNAZIALĂ NR. 7,CORP A",REŞIŢA,CS,1064,2,0,0,2,24,2,0,26,41,2,0,43,55,3,0,58,56,3,0,59
50807,53,"ȘCOALA GIMNAZIALĂ NR. 9",REŞIŢA,CS,1086,8,0,0,8,29,4,0,33,41,4,0,45,49,4,0,53,53,6,0,59
50807,54,"ȘCOALA GIMNAZIALĂ NR. 9",REŞIŢA,CS,1459,7,0,0,7,36,4,0,40,63,4,0,67,83,7,0,90,84,9,0,93
50807,55,"ȘCOALA GIMNAZIALĂ NR. 9",REŞIŢA,CS,1196,6,1,0,7,26,1,0,27,48,1,0,49,65,1,0,66,70,1,0,71
50807,56,"ȘCOALA GIMNAZIALĂ NR. 9",REŞIŢA,CS,1446,8,0,0,8,31,0,0,31,39,0,0,39,55,0,0,55,63,0,0,63
50807,57,"LICEUL DE ARTE ""SABIN PĂUȚA""",REŞIŢA,CS,988,2,0,0,2,19,4,0,23,28,4,0,32,37,4,0,41,41,4,0,45
50807,58,"LICEUL DE ARTE ""SABIN PĂUȚA""",REŞIŢA,CS,1233,5,0,0,5,25,3,0,28,45,3,0,48,63,3,0,66,70,3,0,73
50807,59,"LICEUL DE ARTE ""SABIN PĂUȚA""",REŞIŢA,CS,1373,16,0,0,16,35,0,0,35,55,0,0,55,80,1,0,81,85,1,0,86
50807,60,"LICEUL DE ARTE ""SABIN PĂUȚA""",REŞIŢA,CS,1114,3,1,0,4,26,1,0,27,43,1,0,44,69,1,0,70,71,1,0,72
50807,61,"ȘCOALA GIMNAZIALĂ NR. 12",REŞIŢA,CS,1185,8,4,0,12,28,4,0,32,38,5,0,43,52,5,0,57,54,5,0,59
50807,62,"ȘCOALA GIMNAZIALĂ NR. 12",REŞIŢA,CS,1364,8,6,0,14,27,6,0,33,35,6,0,41,59,6,0,65,66,6,0,72
50807,63,"ȘCOALA GIMNAZIALĂ NR. 12",REŞIŢA,CS,1199,6,2,0,8,30,3,0,33,39,4,0,43,52,4,0,56,53,4,0,57
50807,64,"ȘCOALA GIMNAZIALĂ NR. 12",REŞIŢA,CS,1018,6,0,0,6,28,2,0,30,36,2,0,38,39,2,0,41,43,2,0,45
50816,65,"COLEGIUL NAȚIONAL ""MIRCEA ELIADE"" - ȘCOALA CÂLNIC (CORP D)",CÎLNIC,CS,1344,6,3,0,9,19,3,0,22,27,3,0,30,37,3,0,40,44,3,0,47
50825,66,"CĂMINUL CULTURAL CUPTOARE",CUPTOARE,CS,286,7,1,0,8,8,2,0,10,13,2,0,15,17,2,0,19,19,2,0,21
50834,67,"GRĂDINIȚA CU PROGRAM NORMAL DOMAN",DOMAN,CS,600,1,0,0,1,3,1,0,4,7,1,0,8,11,3,0,14,11,3,0,14
50843,68,"LICEUL TEORETIC ""DIACONOVICI TIETZ"" - ȘCOALA CU CLS I-IV",SECU,CS,398,7,2,0,9,13,2,0,15,14,2,0,16,19,2,0,21,20,2,0,22
50852,69,"ȘCOALA GIMNAZIALĂ NR. 8 - ȘCOALA PRIMARĂ ȚEROVA",ŢEROVA,CS,455,3,2,0,5,7,2,0,9,11,3,0,14,19,3,0,22,22,3,0,25
50861,70,"COLEGIUL NAȚIONAL ""MIRCEA ELIADE"" - GRĂDINIȚA MONIOM (CORP F)",MONIOM,CS,274,8,2,0,10,11,4,0,15,17,5,0,22,29,5,0,34,32,5,0,37
51029,71,"CLĂDIRE A MUNICIPIULUI CARANSEBEȘ (FOSTA ȘCOALĂ PRIMARĂ)",CARANSEBEŞ,CS,1195,5,0,0,5,33,2,0,35,47,3,0,50,67,3,0,70,69,3,0,72
51029,72,"GRĂDINIȚA CU PROGRAM NORMAL NR. 3",CARANSEBEŞ,CS,514,4,6,0,10,6,7,0,13,11,7,0,18,23,7,0,30,31,8,0,39
51029,73,"MUZEUL DE ETNOGRAFIE ȘI AL REGIMENTULUI DE GRANIȚĂ",CARANSEBEŞ,CS,1439,16,1,0,17,48,7,0,55,70,11,0,81,85,16,0,101,88,16,0,104
51029,74,"ȘCOALA GIMNAZIALĂ NR. 8",CARANSEBEŞ,CS,1130,15,6,0,21,47,10,0,57,57,13,0,70,72,14,0,86,77,16,0,93
51029,75,"LICEUL TEHNOLOGIC ”DACIA”",CARANSEBEŞ,CS,1422,21,0,0,21,60,2,0,62,83,9,0,92,108,11,0,119,112,11,0,123
51029,76,"CASA MUNICIPALĂ DE CULTURĂ ”GEORGE SURU”",CARANSEBEŞ,CS,1195,20,7,0,27,57,13,0,70,74,43,0,117,95,50,0,145,106,57,0,163
51029,77,"GRĂDINIȚA CU PROGRAM NORMAL NR. 1",CARANSEBEŞ,CS,1561,30,1,0,31,79,5,0,84,104,5,0,109,124,7,0,131,132,7,1,140
51029,78,"CLĂDIRE A MUNICIPIULUI CARANSEBEȘ (FOSTA ȘCOALĂ GENERALĂ NR. 7)",CARANSEBEŞ,CS,1300,7,2,0,9,19,2,0,21,55,9,0,64,58,9,24,91,62,9,24,95
51029,79,"CLĂDIRE A MUNICIPIULUI CARANSEBEȘ (FOSTA ȘCOALĂ GENERALĂ NR.7)",CARANSEBEŞ,CS,1139,22,1,0,23,53,1,0,54,72,1,0,73,81,2,0,83,87,8,0,95
51029,80,"CLUBUL SPORTIV ȘCOLAR",CARANSEBEŞ,CS,1197,4,3,0,7,19,4,0,23,37,5,0,42,55,7,0,62,57,7,0,64
51029,81,"GRĂDINIȚA NR. 4",CARANSEBEŞ,CS,1221,13,0,0,13,34,0,0,34,53,0,0,53,67,0,0,67,73,0,0,73
51029,82,"ȘCOALA GIMNAZIALĂ NR. 2",CARANSEBEŞ,CS,1359,13,4,0,17,39,7,0,46,73,8,0,81,83,8,0,91,97,8,0,105
51029,83,"ȘCOALA GIMNAZIALĂ NR. 2",CARANSEBEŞ,CS,1099,15,1,0,16,34,3,0,37,42,3,0,45,58,3,0,61,60,3,0,63
51029,84,"LICEUL TEHNOLOGIC ”DECEBAL”",CARANSEBEŞ,CS,1331,4,5,0,9,28,6,0,34,31,7,0,38,40,8,0,48,46,8,0,54
51029,85,"LICEUL TEHNOLOGIC ”DECEBAL”",CARANSEBEŞ,CS,1392,20,1,0,21,50,1,0,51,68,1,0,69,71,4,0,75,81,6,0,87
51029,86,"LICEUL TEHNOLOGIC ”DECEBAL”",CARANSEBEŞ,CS,1478,13,2,0,15,44,2,0,46,64,5,0,69,76,5,0,81,83,5,0,88
51029,87,"COLEGIUL NAȚIONAL ”C.D. LOGA”",CARANSEBEŞ,CS,1587,13,3,0,16,47,5,0,52,62,6,0,68,74,6,0,80,82,8,0,90
51029,88,"GRĂDINIȚA CU PROGRAM NORMAL NR.5",CARANSEBEŞ,CS,1154,17,4,0,21,20,5,0,25,33,8,0,41,47,9,0,56,54,10,0,64
51029,89,"GRĂDINIȚA CU PROGRAM PRELUNGIT NR. 3",CARANSEBEŞ,CS,736,6,2,0,8,16,4,0,20,26,4,0,30,40,4,0,44,42,4,0,46
51029,90,"ȘCOALA GIMNAZIALĂ NR. 1",CARANSEBEŞ,CS,1113,6,5,0,11,11,5,0,16,16,7,0,23,31,7,0,38,33,7,0,40
51038,91,"ȘCOALA PRIMARĂ",JUPA,CS,473,5,0,0,5,9,1,0,10,12,5,0,17,24,7,0,31,29,7,0,36
50898,92,"LICEUL ”MATHIAS HAMMER”",ANINA,CS,880,11,2,0,13,23,3,0,26,31,5,0,36,35,5,0,40,38,5,0,43
50898,93,"CENTRUL DE AFACERI ANINA",ANINA,CS,874,30,0,0,30,43,0,0,43,51,2,0,53,61,2,1,64,67,5,1,73
50898,94,"ŞCOALA GIMNAZIALĂ NR.1 CELNIC GRĂDINIŢA CU PROGRAM NORMAL NR.1 CELNIC",ANINA,CS,653,15,0,0,15,29,1,0,30,41,1,0,42,46,1,0,47,48,3,0,51
50898,95,"SEDIUL S.C. GOSTRANS S.A.",ANINA,CS,518,5,3,0,8,18,3,0,21,24,3,0,27,27,3,0,30,27,3,0,30
50898,96,"ŞCOALA GIMNAZIALĂ NR.1 CELNIC GRĂDINIŢA CU PROGRAM NORMAL NR. 2 ORAŞUL NOU",ANINA,CS,675,3,2,0,5,15,3,0,18,17,3,0,20,18,3,0,21,20,3,0,23
50898,97,"CENTRUL DE ZI ANINA",ANINA,CS,652,11,6,0,17,21,6,0,27,23,6,0,29,26,6,0,32,28,6,0,34
50898,98,"SEDIUL DEPOZITUL FINAL CÂNTAR",ANINA,CS,651,8,5,0,13,20,5,0,25,25,5,0,30,40,5,0,45,45,6,0,51
50898,99,"ŞCOALA GIMNAZIALĂ NR.1 CELNIC GRĂDINIŢA CU PROGRAM NORMAL NR.4 SIGISMUND",ANINA,CS,578,5,4,0,9,14,4,0,18,21,5,0,26,25,5,0,30,26,5,0,31
50898,100,"LICEUL ""MATHIAS HAMMER"" ANINA ŞCOALA GIMNAZIALĂ NR.2 STEIERDORF",ANINA,CS,1120,15,1,0,16,20,3,0,23,32,3,0,35,34,4,0,38,35,4,0,39
50898,101,"LICEUL""MATHIAS HAMMER"" ANINA GRĂDINIŢA CU PROGRAM NORMAL NR.5 STEIERDORF",ANINA,CS,581,11,3,0,14,17,3,0,20,19,3,0,22,32,3,0,35,32,3,0,35
50898,102,"LICEUL ""MATHIAS HAMMER"" ANINA ŞCOALA GIMNAZIALĂ NR.3 BRĂDET",ANINA,CS,307,5,5,0,10,8,5,0,13,8,5,0,13,12,6,0,18,12,6,0,18
50932,103,"PROTOPOPIAT ORTODOX ROMÂN","BĂILE HERCULANE",CS,257,3,7,0,10,10,22,0,32,13,35,0,48,20,49,0,69,25,52,0,77
50932,104,"LICEUL HERCULES(FOSTA SCOALA GENERALA)","BĂILE HERCULANE",CS,1485,6,46,0,52,22,183,0,205,30,231,0,261,66,385,0,451,67,424,0,491
50932,105,"LICEUL HERCULES","BĂILE HERCULANE",CS,933,8,0,0,8,29,11,0,40,36,19,0,55,55,30,0,85,57,45,0,102
50932,106,"LICEUL HERCULES","BĂILE HERCULANE",CS,1097,12,1,0,13,36,15,0,51,45,26,0,71,55,29,0,84,60,35,0,95
50941,107,"CĂMINUL CULTURAL",PECINIŞCA,CS,505,10,0,0,10,21,1,0,22,23,1,0,24,27,3,0,30,30,3,0,33
50978,108,"ȘCOALA GIMNAZIALĂ NR. 1 BOCŞA",BOCŞA,CS,1330,7,0,0,7,21,1,0,22,37,1,0,38,44,2,0,46,47,2,0,49
50978,109,"ȘCOALA GIMNAZIALĂ NR. 1 BOCŞA",BOCŞA,CS,1208,14,0,0,14,33,0,0,33,54,0,0,54,67,0,0,67,70,0,0,70
50978,110,"ȘCOALA GIMNAZIALĂ NR. 1 BOCŞA",BOCŞA,CS,1292,9,0,0,9,28,0,0,28,45,1,0,46,56,3,0,59,65,3,0,68
50978,111,"LICEUL TEORETIC TATA OANCEA",BOCŞA,CS,1252,25,0,0,25,51,0,0,51,61,1,0,62,82,2,0,84,88,3,0,91
50978,112,"LICEUL TEORETIC TATA OANCEA",BOCŞA,CS,1088,27,0,0,27,57,0,0,57,76,0,0,76,106,1,0,107,116,1,0,117
50978,113,"LICEUL TEORETIC TATA OANCEA",BOCŞA,CS,849,7,0,0,7,24,0,0,24,38,0,0,38,47,1,0,48,50,4,0,54
50978,114,"GRĂDINIȚA CU PROGRAM NORMAL NR. 4 BOCŞA",BOCŞA,CS,1447,21,2,0,23,62,2,0,64,94,2,0,96,124,8,0,132,130,9,0,139
50978,115,"ȘCOALA GIMNAZIALĂ NR. 2 BOCŞA",BOCŞA,CS,1239,12,0,0,12,85,0,0,85,157,2,0,159,222,3,0,225,234,4,0,238
50978,116,"LICEUL TEHNOLOGIC ""CONSTANTIN LUCACI"" BOCSA",BOCŞA,CS,1586,11,4,0,15,40,6,0,46,62,6,0,68,88,7,0,95,97,7,0,104
50978,117,"GRĂDINIȚA CU PROGRAM NORMAL NR. 6 BOCŞA",BOCŞA,CS,1248,13,3,0,16,40,3,0,43,64,6,0,70,76,6,0,82,86,6,0,92
50978,118,"SERVICIU PUBLIC DE GOSPODĂRIE COMUNALĂ",BOCŞA,CS,1248,7,3,0,10,25,5,0,30,39,7,0,46,56,7,0,63,60,7,0,67
50978,119,"CLUBUL ELEVILOR",BOCŞA,CS,1357,14,1,0,15,30,3,0,33,37,3,0,40,56,4,0,60,69,6,0,75
51065,120,"ŞCOALA GIMNAZIALĂ ""ALEXANDRU MOISI""","MOLDOVA NOUĂ",CS,1290,17,1,0,18,53,1,0,54,62,1,0,63,79,2,0,81,86,2,0,88
51065,121,"CASA DE CULTURĂ","MOLDOVA NOUĂ",CS,908,30,1,0,31,52,1,0,53,70,1,0,71,84,1,0,85,92,1,0,93
51065,122,"GRĂDINIŢA CU PROGRAM NORMAL ""BAMBI""","MOLDOVA NOUĂ",CS,512,6,3,0,9,34,3,0,37,38,3,0,41,43,3,0,46,46,3,0,49
51065,123,"ŞCOALA GIMNAZIALĂ ""SOFIA ARCAN""","MOLDOVA NOUĂ",CS,1211,16,7,0,23,38,12,0,50,80,15,0,95,98,19,0,117,108,19,0,127
51065,124,"GRĂDINIŢA CU PROGRAM PRELUNGIT ""SF STELIAN""","MOLDOVA NOUĂ",CS,1101,12,2,0,14,38,5,0,43,54,7,0,61,65,9,0,74,71,9,0,80
51065,125,"LICEUL TEHNOLOGIC ""CLISURA DUNĂRII "" CORP C4- ȘCOALA CU 10 CLASE","MOLDOVA NOUĂ",CS,1344,14,5,0,19,49,5,0,54,61,5,0,66,92,5,0,97,101,6,0,107
51065,126,"LICEUL TEHNOLOGIC ""CLISURA DUNĂRII"" (CICLUL GIMNAZIAL)","MOLDOVA NOUĂ",CS,1012,24,0,0,24,46,7,0,53,61,7,0,68,78,7,0,85,85,7,0,92
51065,127,"GRĂDINIŢA CU PROGRAM PRELUNGIT ""LICURICII""","MOLDOVA NOUĂ",CS,989,7,5,0,12,24,5,0,29,33,5,0,38,35,5,0,40,40,5,24,69
51065,128,"LICEUL TEHNOLOGIC ""CLISURA DUNĂRII"" (CICLUL LICEAL)","MOLDOVA NOUĂ",CS,835,7,1,0,8,18,4,0,22,30,5,0,35,35,5,0,40,42,7,0,49
51074,129,"ŞCOALA PRIMARĂ ""SVETI PETAR I PAVLE/SFÂNTUL PETRU ŞI PAVEL""",MĂCEŞTI,CS,459,7,2,0,9,10,2,0,12,16,2,0,18,31,2,0,33,33,2,0,35
51083,130,"CĂMIN CULTURAL","MOLDOVA VECHE",CS,1284,21,2,0,23,47,5,0,52,70,7,0,77,99,9,0,108,109,9,0,118
51092,131,"CĂMIN CULTURAL",MOLDOVIŢA,CS,180,1,3,0,4,2,4,0,6,11,5,0,16,16,10,0,26,16,10,0,26
51127,132,"ŞCOALA GIMNAZIALĂ NR. 3 ORAVIŢA",ORAVIŢA,CS,1026,3,0,0,3,18,0,0,18,23,0,0,23,35,0,0,35,39,0,0,39
51127,133,"LICEUL TEORETIC ""GENERAL DRAGALINA""",ORAVIŢA,CS,841,6,3,0,9,17,3,0,20,26,14,0,40,36,14,0,50,36,14,0,50
51127,134,"GRĂDINIŢA PN NR. 2",ORAVIŢA,CS,877,8,1,0,9,24,4,0,28,45,6,1,52,59,8,1,68,62,10,1,73
51127,135,"LICEUL TEHNOLOGIC ,, MIHAI NOVAC'' ORAVIŢA",ORAVIŢA,CS,1160,9,3,0,12,36,5,0,41,45,10,0,55,51,10,0,61,55,13,0,68
51127,136,"ŞCOALA GIMNAZIALĂ ,, ROMUL LADEA ''ORAVIŢA",ORAVIŢA,CS,1260,8,2,0,10,33,2,0,35,45,2,0,47,67,2,0,69,79,4,0,83
51127,137,"ŞCOALA GIMNAZIALĂ ,,ROMUL LADEA'' ORAVIŢA",ORAVIŢA,CS,1530,17,4,0,21,36,7,0,43,46,7,0,53,54,12,0,66,64,13,0,77
51127,138,"ŞCOALA GIMNAZIALĂ ,, ROMUL LADEA'' ORAVIŢA",ORAVIŢA,CS,1082,9,2,0,11,28,4,0,32,47,4,0,51,51,6,0,57,55,10,0,65
51127,139,"CREŞA CĂMIN",ORAVIŢA,CS,1091,13,3,0,16,31,4,0,35,39,7,0,46,48,14,0,62,53,14,0,67
51154,140,"ŞCOALA PRIMARĂ AGADICI",AGADICI,CS,156,2,0,0,2,5,0,0,5,9,7,0,16,18,15,0,33,20,16,0,36
51163,141,"ŞCOALA PRIMARĂ BRĂDIŞORU DE JOS","BRĂDIŞORU DE JOS",CS,459,0,0,0,0,3,1,0,4,5,4,0,9,12,8,0,20,15,8,0,23
51172,142,"CĂMIN CULTURAL",BROŞTENI,CS,525,7,4,0,11,24,7,0,31,35,8,0,43,48,10,0,58,51,10,0,61
51136,143,"CĂMIN CULTURAL","CICLOVA MONTANĂ",CS,439,8,1,0,9,14,1,0,15,18,1,0,19,29,1,0,30,36,7,0,43
51181,144,"FOSTA ŞCOALA PRIMARĂ RĂCHITOVA",RĂCHITOVA,CS,309,4,4,0,8,7,7,0,14,11,7,0,18,23,11,0,34,24,11,0,35
51145,145,"CENTRUL ADMINISTRATIV",MARILA,CS,27,1,3,0,4,2,3,0,5,3,8,0,11,4,10,0,14,5,10,0,15
51216,146,"CASA DE CULTURĂ","OŢELU ROŞU",CS,962,24,3,0,27,44,5,0,49,61,5,0,66,82,6,0,88,85,6,0,91
51216,147,"CASA DE CULTURĂ","OŢELU ROŞU",CS,759,14,1,0,15,38,2,0,40,50,3,0,53,58,5,0,63,63,6,0,69
51216,148,"SCOALA GIMNZIALĂ NR. 3","OŢELU ROŞU",CS,1366,11,0,0,11,48,0,0,48,60,0,0,60,81,1,0,82,86,2,0,88
51216,149,"GRĂDINIŢA CU PROGRAM PRELUNGIT NR. 3","OŢELU ROŞU",CS,1131,28,6,0,34,50,8,0,58,65,8,0,73,79,11,0,90,85,11,0,96
51216,150,"CANTINA DE AJUTOR SOCIAL","OŢELU ROŞU",CS,847,7,0,0,7,28,4,0,32,39,4,0,43,52,15,0,67,56,16,0,72
51216,151,"GRĂDINIȚA CU PROGRAM NORMAL NR.2","OŢELU ROŞU",CS,1145,11,1,0,12,30,1,0,31,48,1,0,49,65,3,0,68,72,3,0,75
51216,152,"GRĂDINIŢA CU PROGRAM NORMAL GAI","OŢELU ROŞU",CS,1112,16,0,0,16,45,0,0,45,64,0,0,64,84,0,0,84,88,0,0,88
51216,153,"GRĂDINIŢA CU PROGRAM NORMAL VALEA OHĂBII","OŢELU ROŞU",CS,531,4,3,0,7,7,4,0,11,13,4,0,17,22,4,0,26,24,5,0,29
51216,154,"S.C. ""ROMFLEX"" S.A.","OŢELU ROŞU",CS,328,4,1,0,5,15,2,0,17,16,2,0,18,16,3,0,19,29,3,0,32
51216,155,"S.C. ""ROMFLEX"" S.A.","OŢELU ROŞU",CS,1250,12,0,0,12,27,0,0,27,36,1,0,37,48,2,0,50,53,2,0,55
51216,156,"CĂMINUL CULTURAL CIREȘA","OŢELU ROŞU",CS,644,6,0,0,6,15,0,0,15,23,0,0,23,46,1,0,47,50,2,0,52
51234,157,"CĂMINUL CULTURAL MAL",MAL,CS,297,4,0,0,4,18,9,0,27,26,11,0,37,36,11,0,47,40,11,0,51
51298,158,"CĂMINUL CULTURAL","SUB MARGINE",CS,145,2,0,0,2,2,0,0,2,2,0,0,2,4,1,0,5,5,1,0,6
51252,159,"ŞCOALA GIMNAZIALĂ",ARMENIŞ,CS,1100,9,1,0,10,21,2,0,23,33,2,0,35,42,2,0,44,58,2,0,60
51261,160,"SCOALA PRIMARA FENES",FENEŞ,CS,462,8,2,0,10,15,5,0,20,18,7,0,25,28,8,0,36,35,10,0,45
51289,161,"ŞCOALA PRIMARĂ","SAT BĂTRÎN",CS,301,1,0,0,1,7,0,0,7,9,0,0,9,13,2,0,15,24,2,0,26
51314,162,"CĂMINUL CULTURAL",BĂNIA,CS,950,19,1,0,20,26,3,0,29,36,4,0,40,53,6,0,59,79,6,0,85
51323,163,"FOSTA PRIMARIE",GÎRBOVĂŢ,CS,470,7,0,0,7,13,1,0,14,15,1,0,16,26,1,0,27,26,4,0,30
51341,164,"CASA CULTURALĂ BĂUŢARUL DE JOS",BĂUŢAR,CS,662,11,1,0,12,14,1,0,15,21,2,0,23,32,3,0,35,38,4,0,42
51341,165,"CASA CULTURALĂ BĂUŢARUL DE SUS",BĂUŢAR,CS,674,6,1,0,7,15,5,0,20,19,5,0,24,35,9,0,44,45,9,0,54
51350,166,"ȘCOALA GIMNAZIALĂ BUCOVA",BUCOVA,CS,752,5,2,0,7,9,2,0,11,12,2,0,14,14,2,0,16,17,7,0,24
51396,167,"ŞCOALA GIMNAZIALĂ BERLIŞTE",BERLIŞTE,CS,302,9,2,0,11,14,4,0,18,22,5,0,27,29,6,0,35,31,6,0,37
51403,168,"ŞCOALA PRIMARĂ IAM",IAM,CS,301,0,0,0,0,0,2,0,2,1,2,0,3,4,2,0,6,5,2,0,7
51412,169,"ŞCOALA PRIMARĂ MILCOVENI",MILCOVENI,CS,195,2,1,0,3,3,1,0,4,8,1,0,9,11,4,0,15,19,4,0,23
51421,170,"ŞCOALA PRIMARĂ RUSOVA-NOUĂ","RUSOVA NOUĂ",CS,162,3,2,0,5,6,6,0,12,10,8,0,18,12,11,0,23,12,11,0,23
51458,171,"CASA CULTURALĂ-BERZASCA",BERZASCA,CS,1165,31,4,0,35,125,10,0,135,189,11,0,200,271,19,1,291,332,19,1,352
51467,172,"ŞCOALA GIMNAZIALĂ-BIGAR",BIGĂR,CS,182,3,3,0,6,4,3,0,7,6,3,0,9,31,5,0,36,41,5,0,46
51494,173,"GRADINITA LIUBCOVA",LIUBCOVA,CS,904,66,0,0,66,150,0,0,150,230,2,0,232,290,2,0,292,332,2,0,334
51519,174,"LICEUL TEHNOLOGIC BERZOVIA",BERZOVIA,CS,884,5,2,0,7,17,3,0,20,23,3,0,26,42,8,0,50,44,8,0,52
51519,175,"LICEUL TEHNOLOGIC BERZOVIA",BERZOVIA,CS,862,6,0,0,6,11,0,0,11,15,0,0,15,20,0,0,20,25,0,0,25
51528,176,"ŞCOALA GIMNAZIALA FIZES",FIZEŞ,CS,623,2,1,0,3,11,2,0,13,15,2,0,17,29,6,0,35,29,6,0,35
51537,177,"ŞCOALA PRIMARA GHERTENIS",GHERTENIŞ,CS,789,7,1,0,8,13,1,0,14,16,3,0,19,22,7,0,29,27,7,0,34
51555,178,"CLUBUL TINERETULUI",BOLVAŞNIŢA,CS,387,7,2,0,9,10,2,0,12,11,2,0,13,15,2,0,17,16,3,0,19
51564,179,"CLUBUL TINERETULUI",VÎRCIOROVA,CS,757,5,0,0,5,12,0,0,12,21,0,0,21,22,0,0,22,29,0,0,29
51582,180,"SCOALA CLASELE I-IV",BOZOVICI,CS,1162,15,1,0,16,52,2,0,54,74,4,0,78,92,7,0,99,105,7,0,112
51582,181,"LICEUL TEORETIC BOZOVICI",BOZOVICI,CS,650,9,3,0,12,21,4,0,25,34,4,0,38,46,6,0,52,51,6,0,57
51608,182,"ŞCOALA CU CLASELE I - VIII",PRILIPEŢ,CS,592,15,0,0,15,30,2,0,32,33,3,0,36,43,9,0,52,52,9,0,61
51644,183,"CĂMINUL CULTURAL",APADIA,CS,198,1,0,0,1,4,1,0,5,4,1,0,5,6,3,0,9,6,3,0,9
51635,184,"ŞCOALA GENERALĂ CU CLASELE I - VIII ""SF. IACOB""",BREBU,CS,567,2,1,0,3,7,1,0,8,11,1,0,12,18,2,0,20,18,2,0,20
51653,185,"ŞCOALA CU CLASELE I - IV",VALEADENI,CS,200,4,5,0,9,9,6,0,15,10,7,0,17,13,8,0,21,13,8,0,21
51680,186,"CĂMINUL CULTURAL",GĂRÎNA,CS,269,2,3,0,5,3,9,0,12,3,11,0,14,4,16,0,20,5,17,0,22
51724,187,"CLĂDIREA APARȚINĂTOARE COMUNEI BUCHIN (FOST SEDIU AL PRIMĂRIEI)",POIANA,CS,524,16,0,0,16,25,0,0,25,35,0,0,35,40,0,0,40,40,0,0,40
51706,188,"ŞCOALA CU CLASELE I - IV",BUCHIN,CS,748,12,0,0,12,22,2,0,24,26,4,0,30,42,4,0,46,55,5,0,60
51742,189,GRĂDINIŢA,"VALEA TIMIŞULUI",CS,428,3,0,0,3,8,0,0,8,14,0,0,14,21,0,0,21,24,0,0,24
51760,190,"SCOALA PRIMARA BUCOSNITA",BUCOŞNIŢA,CS,611,3,2,0,5,3,2,0,5,4,2,0,6,15,4,0,19,18,4,0,22
51788,191,"SCOALA GIZMNAZIALA PETROSNITA",PETROŞNIŢA,CS,799,3,2,0,5,19,2,0,21,30,4,0,34,46,6,0,52,60,6,0,66
51779,192,"SCOALA PRIMARA GOLET",GOLEŢ,CS,446,7,0,0,7,15,0,0,15,24,0,0,24,39,2,0,41,47,2,0,49
51797,193,"SCOALA PRIMARA VALISOARA",VĂLIŞOARA,CS,529,2,0,0,2,8,7,0,15,15,7,0,22,17,8,0,25,27,11,0,38
51813,194,"CĂMINUL CULTURAL",CARAŞOVA,CS,866,10,0,0,10,12,0,0,12,15,0,0,15,22,3,0,25,26,3,0,29
51822,195,"ŞCOALA PRIMARĂ IABALCEA",IABALCEA,CS,162,3,0,0,3,6,0,0,6,7,0,0,7,8,0,0,8,9,1,0,10
51831,196,"ŞCOALA PRIMARĂ NERMED",NERMED,CS,439,1,0,0,1,4,0,0,4,5,0,0,5,11,0,0,11,11,0,0,11
51813,197,"GRĂDINIȚA CU PROGRAM NORMAL CARAȘOVA",CARAŞOVA,CS,1053,2,0,0,2,4,0,0,4,8,0,0,8,15,0,0,15,15,0,0,15
51859,198,"ŞCOALA GIMNAZIALĂ",CĂRBUNARI,CS,539,9,2,0,11,31,2,0,33,39,3,0,42,47,6,0,53,49,8,0,57
51868,199,"ŞCOALA PRIMARĂ",ŞTINĂPARI,CS,286,6,3,0,9,19,7,0,26,29,7,0,36,37,14,0,51,43,14,0,57
51957,200,"SCOALA GIMNAZIALA CICLOVA ROMANA","CICLOVA ROMÂNĂ",CS,940,9,2,0,11,28,9,0,37,41,10,0,51,50,10,0,60,51,13,0,64
51966,201,"ŞCOALA PRIMARA ILIDIA",ILIDIA,CS,285,1,0,0,1,3,4,0,7,6,4,0,10,8,5,0,13,9,5,0,14
51975,202,"CADIREA PRIMARIEI(FOSTUL SEDIU AL PRIMARIEI DIN SOCOLARI)",SOCOLARI,CS,116,9,0,0,9,11,3,0,14,13,3,0,16,19,5,0,24,19,5,0,24
51993,203,"CASA DE CULTURĂ",CIUCHICI,CS,425,18,4,0,22,37,6,0,43,46,7,0,53,53,9,0,62,55,9,0,64
52008,204,"CASA DE CULTURĂ",MACOVIŞTE,CS,79,3,0,0,3,7,5,0,12,10,7,0,17,13,7,0,20,17,10,0,27
52026,205,"CASA DE CULTURĂ",PETRILOVA,CS,120,10,4,0,14,12,6,0,18,19,6,0,25,20,10,0,30,22,11,0,33
52017,206,"SEDIUL FOSTEI PRIMĂRII NICOLINŢ",NICOLINŢ,CS,249,1,1,0,2,9,3,0,12,15,3,0,18,28,7,0,35,28,7,0,35
52053,207,"CĂMINUL CULTURAL",JITIN,CS,102,3,0,0,3,4,0,0,4,6,0,0,6,12,0,0,12,14,0,0,14
52044,208,"ŞCOALA GIMNAZIALĂ",CIUDANOVIŢA,CS,412,6,1,0,7,23,4,0,27,27,4,0,31,38,4,0,42,38,5,0,43
51895,209,"ŞCOALA CU CLASELE I - VIII",MACIOVA,CS,392,3,0,0,3,11,2,0,13,15,3,0,18,23,5,0,28,25,5,0,30
51939,210,"ŞCOALA CU CLASELE I - VIII",ZĂGUJENI,CS,452,4,1,0,5,8,1,0,9,8,1,0,9,15,2,0,17,18,2,0,20
51902,211,"ŞCOALA CU CLASELE I - IV","MÎTNICU MARE",CS,310,6,1,0,7,11,3,0,14,12,3,0,15,14,7,0,21,18,8,0,26
51911,212,"ŞCOALA CU CLASELE I - IV",PEŞTERE,CS,181,3,2,0,5,3,3,0,6,3,4,0,7,4,4,0,8,5,5,0,10
51920,213,"ŞCOALA CU CLASELE I - IV",PRISACA,CS,357,4,1,0,5,7,2,0,9,15,3,0,18,16,5,0,21,18,5,0,23
51886,214,"GRĂDINIŢA DIN CADRUL ŞCOLII CU CLASELE I - VIII",CĂVĂRAN,CS,587,2,0,0,2,9,3,0,12,14,3,0,17,19,5,0,24,21,5,0,26
52071,215,"ŞCOALA CU CLASELE I - VIII",COPĂCELE,CS,314,4,0,0,4,12,2,0,14,15,2,0,17,16,3,0,19,16,3,0,19
52080,216,"ŞCOALA CU CLASELE I - IV",OHABA-MÎTNIC,CS,232,8,0,0,8,11,0,0,11,24,4,0,28,37,12,0,49,40,14,0,54
52099,217,"ŞCOALA CU CLASELE I - IV",RUGINOSU,CS,98,2,1,0,3,3,2,0,5,3,2,0,5,3,3,0,6,6,3,0,9
52106,218,"ŞCOALA CU CLASELE I - IV",ZORILE,CS,317,3,0,0,3,7,2,0,9,8,2,0,10,11,2,0,13,11,2,0,13
52124,219,"SCOALAGIMNAZIALA TRAIAN LALESCU CORNEA,CU CLASELE I- VIII",CORNEA,CS,619,4,1,0,5,6,2,0,8,9,2,0,11,15,2,0,17,17,2,0,19
52133,220,"GRADINITA CU PROGRAM NORMAL PRICHINDELUL CRUSOVAT",CRUŞOVĂŢ,CS,370,4,1,0,5,17,3,0,20,21,3,0,24,26,5,0,31,30,6,0,36
52142,221,"SCOALA GIMNAZIALA CU CLASELE I-VIII CUPTOARE-STRUCTURA",CUPTOARE,CS,503,3,0,0,3,6,0,0,6,15,0,0,15,28,0,0,28,38,0,0,38
52179,222,"CENTRU DE ZI AFTER SCHOOL CORNEREVA",CORNEREVA,CS,466,12,1,0,13,14,3,0,17,15,3,0,18,21,4,10,35,24,4,10,38
52197,223,"ŞCOALA PRIMARĂ BOGÎLTIN",BOGÎLTIN,CS,334,2,1,0,3,4,1,0,5,5,1,0,6,7,2,0,9,9,3,0,12
52286,224,"ŞCOALA PRIMARĂ DOBRAIA",DOBRAIA,CS,64,0,0,0,0,1,0,0,1,1,1,0,2,5,2,0,7,7,2,0,9
52295,225,"ŞCOALA PRIMARĂ DOLINA",DOLINA,CS,648,7,2,0,9,11,2,0,13,13,3,0,16,17,3,1,21,21,3,1,25
52302,226,"ŞCOALA GIMNAZIALĂ NR. 2 GRUNI",GRUNI,CS,786,5,1,0,6,14,1,0,15,17,1,0,18,22,1,0,23,29,1,0,30
52339,227,"ŞCOALA PRIMARĂINELEȚ",INELEŢ,CS,84,1,0,0,1,2,0,0,2,3,0,0,3,6,0,0,6,7,2,0,9
53504,228,"CĂMINUL CULTURAL","SFÎNTA ELENA",CS,451,12,2,0,14,21,2,0,23,35,3,0,38,41,3,0,44,52,3,0,55
53498,229,"ŞCOALA GIMNAZIALA CORONINI",CORONINI,CS,1147,70,4,0,74,112,6,0,118,167,10,0,177,250,12,0,262,306,18,0,324
52589,230,"CĂMINUL CULTURAL-DALBOSET",DALBOŞEŢ,CS,847,10,0,0,10,23,1,0,24,36,3,0,39,57,5,0,62,57,5,0,62
52641,231,"ȘCOALA PRIMARĂ ȘOPOTU VECHI","ŞOPOTU VECHI",CS,526,12,0,0,12,25,1,0,26,28,3,0,31,40,6,0,46,49,7,0,56
52669,232,"ŞCOALA PRIMARĂ DOCLIN",DOCLIN,CS,425,6,0,0,6,15,2,0,17,20,5,0,25,21,5,0,26,24,5,0,29
52678,233,"ŞCOALA PRIMARĂ BINIŞ",BINIŞ,CS,653,7,1,0,8,21,1,0,22,26,1,0,27,37,3,0,40,39,3,0,42
52687,234,"ŞCOALA GIMNAZIALĂ TIROL",TIROL,CS,542,2,2,0,4,4,3,0,7,4,5,0,9,5,6,0,11,6,6,0,12
52712,235,"CĂMINUL CULTURAL",CALINA,CS,79,1,5,0,6,1,5,0,6,1,5,0,6,3,5,0,8,5,7,0,12
52703,236,"SCOALA GIMNAZIALA DOGNECEA",DOGNECEA,CS,964,6,1,0,7,20,4,0,24,43,7,0,50,54,7,0,61,58,11,0,69
52703,237,"SCOALA GIMNAZIALA",DOGNECEA,CS,580,4,1,0,5,10,2,0,12,25,2,0,27,52,3,0,55,68,3,0,71
52730,238,"CĂMINUL CULTURAL",DOMAŞNEA,CS,801,11,3,0,14,17,5,0,22,26,6,0,32,33,8,0,41,33,9,0,42
52749,239,"CĂMINUL CULTURAL",CĂNICEA,CS,307,0,2,0,2,2,2,0,4,4,2,0,6,4,2,0,6,7,2,0,9
53719,240,"CĂMINUL CULTURAL","EFTIMIE MURGU",CS,1330,30,0,0,30,59,3,0,62,83,6,0,89,126,7,0,133,157,10,0,167
52767,241,"ȘCOALA GIMNAZIALĂ”AUREL PEIA”",EZERIŞ,CS,540,0,1,0,1,4,1,0,5,4,1,0,5,6,1,0,7,6,1,0,7
52776,242,"CASA DE CULTURA SOCENI",SOCENI,CS,540,1,0,0,1,3,0,0,3,5,0,0,5,8,1,0,9,8,2,0,10
52794,243,"ŞCOALA GIMNAZIALĂ FÎRLIUG",FÎRLIUG,CS,647,6,0,0,6,10,0,0,10,16,0,0,16,24,0,0,24,26,1,0,27
52801,244,"CENTRUL AGRICOL DEZEŞTI",DEZEŞTI,CS,149,3,0,0,3,8,2,0,10,9,3,0,12,13,5,0,18,14,5,0,19
52810,245,"CĂMINUL CULTURAL",DULEU,CS,163,3,0,0,3,5,1,0,6,7,4,0,11,10,9,0,19,10,10,0,20
52838,246,"CĂMINUL CULTURAL",SCĂIUŞ,CS,236,6,2,0,8,8,3,0,11,9,3,0,12,13,3,0,16,17,3,0,20
52847,247,"CĂMINUL CULTURAL","VALEA MARE",CS,93,1,1,0,2,2,2,0,4,2,2,0,4,6,2,0,8,6,3,0,9
52829,248,"ŞCOALA PRIMARĂ REMETEA-POGĂNICI",REMETEA-POGĂNICI,CS,172,6,0,0,6,6,0,0,6,8,0,0,8,9,2,0,11,9,2,0,11
52883,249,"ŞCOALA PRIMARĂ",COMORÎŞTE,CS,464,4,0,0,4,11,1,0,12,14,2,0,16,28,5,0,33,34,5,0,39
52892,250,"ŞCOALA PRIMARĂ","SURDUCU MARE",CS,364,3,0,0,3,4,1,0,5,6,3,0,9,13,7,0,20,16,7,0,23
52865,251,"ŞCOALA GIMNAZIALĂ ""PETRU OALLDE""",FOROTIC,CS,566,4,0,0,4,11,1,0,12,14,3,0,17,21,5,0,26,26,7,0,33
52918,252,"CASA CULTURALĂ ""PETR GLASER""",GÎRNIC,CS,397,2,0,0,2,2,0,0,2,3,0,0,3,3,0,0,3,6,0,0,6
52927,253,"CASA CULTURALA PADINA-MATEI","PADINA MATEI",CS,739,12,1,0,13,23,1,0,24,29,1,0,30,44,1,0,45,56,2,0,58
52945,254,"CĂMINUL CULTURAL",GLIMBOCA,CS,1544,14,1,0,15,61,2,0,63,91,6,0,97,123,7,0,130,150,10,0,160
52963,255,"CĂMINUL CULTURAL",GORUIA,CS,312,1,0,0,1,7,0,0,7,12,0,0,12,20,1,0,21,22,1,0,23
52972,256,"ŞCOALA CU CLASELE I - IV",GIURGIOVA,CS,128,3,1,0,4,6,5,0,11,7,5,0,12,7,5,0,12,9,6,0,15
52981,257,"DISPENSARUL MEDICAL",GÎRLIŞTE,CS,216,1,3,0,4,2,7,0,9,9,10,0,19,13,16,0,29,14,16,0,30
53005,258,"ŞCOALA GIMNAZIALA PAVEL BORDAN",GRĂDINARI,CS,872,14,2,0,16,23,3,0,26,33,4,0,37,40,7,0,47,44,7,0,51
53014,259,"CLADIRE PRIMARIE GREONI",GREONI,CS,794,10,0,0,10,22,4,0,26,22,5,0,27,27,5,0,32,32,5,0,37
53032,260,"CĂMINUL CULTURAL",IABLANIŢA,CS,613,17,0,0,17,26,0,0,26,36,4,0,40,42,5,0,47,47,5,0,52
53041,261,"ŞCOALA PRIMARĂ","GLOBU CRAIOVEI",CS,546,13,5,0,18,33,8,0,41,38,9,0,47,50,12,0,62,54,13,0,67
53050,262,"ŞCOALA PRIMARĂ",PETNIC,CS,618,7,0,0,7,12,4,0,16,19,6,0,25,26,8,0,34,41,8,0,49
53078,263,"CLĂDIREA AFTER SCHOOL",LĂPUŞNICEL,CS,397,7,6,0,13,16,10,0,26,21,11,0,32,35,25,0,60,40,26,0,66
53087,264,"ŞCOALA GIMNAZIALA",PÎRVOVA,CS,355,25,4,0,29,32,4,0,36,51,8,0,59,61,14,0,75,69,14,0,83
53096,265,"ŞCOALA GIMNAZIALA",ŞUMIŢA,CS,70,5,0,0,5,12,0,0,12,22,0,0,22,26,0,0,26,27,0,0,27
53112,266,"CĂMINUL CULTURAL","LĂPUŞNICU MARE",CS,902,12,1,0,13,49,4,0,53,52,5,0,57,81,7,0,88,86,7,0,93
53121,267,"CĂMINUL CULTURAL",MOCERIŞ,CS,471,2,0,0,2,11,3,0,14,19,5,0,24,28,6,0,34,29,6,0,35
53149,268,"GRADINITA CU PROGRAM NORMALLUNCAVITA",LUNCAVIŢA,CS,671,8,0,0,8,8,0,0,8,13,1,0,14,13,1,0,14,13,1,0,14
53158,269,"SCOALA GIMNAZIALA VERENDIN",VERENDIN,CS,1332,6,0,0,6,7,0,0,7,8,0,0,8,13,0,0,13,15,0,0,15
53176,270,"ŞCOALA GIMNAZIALA LUPAC",LUPAC,CS,743,1,0,0,1,2,0,0,2,7,0,0,7,12,1,0,13,17,1,0,18
53185,271,"ŞCOALA GIMNAZIALA CLOCOTICI",CLOCOTICI,CS,705,5,3,0,8,14,5,0,19,16,6,0,22,21,6,0,27,24,7,0,31
53194,272,"ŞCOALA PRIMARA RAFNIC",RAFNIC,CS,437,7,1,0,8,8,1,0,9,9,1,0,10,16,1,0,17,16,1,0,17
53201,273,"ŞCOALA PRIMARA VODNIC",VODNIC,CS,344,2,3,0,5,4,3,0,7,4,3,0,7,4,4,0,8,4,4,0,8
53229,274,"CĂMINUL CULTURAL",MARGA,CS,908,15,0,0,15,49,3,0,52,64,4,0,68,87,4,0,91,100,5,0,105
53256,275,"CĂMINUL CULTURAL",MĂURENI,CS,1501,17,0,0,17,41,1,0,42,46,1,0,47,55,1,0,56,63,1,0,64
53265,276,"CĂMIN CULTURAL",ŞOŞDEA,CS,684,6,1,0,7,7,1,0,8,14,2,0,16,24,4,0,28,29,4,0,33
53292,277,"ŞCOALA GENERALĂ",GLOBURĂU,CS,196,4,2,0,6,7,2,0,9,7,2,0,9,8,2,0,10,8,2,0,10
53309,278,"ŞCOALA GENERALĂ",PLUGOVA,CS,670,6,0,0,6,13,2,0,15,16,3,0,19,23,4,0,27,25,4,0,29
53318,279,"ŞCOALA GENERALĂ","VALEA BOLVAŞNIŢA",CS,560,15,3,0,18,24,6,0,30,32,10,0,42,43,10,0,53,50,13,0,63
53283,280,"LICEUL TEHNOLOGIC ""NICOLAE STOICA DE HATEG""",MEHADIA,CS,1157,10,2,0,12,21,4,0,25,29,6,0,35,41,6,0,47,45,6,0,51
53283,281,"LICEUL TEHNOLOGIC ""NICOLAE STOICA DE HATEG""",MEHADIA,CS,834,4,0,0,4,7,0,0,7,18,0,0,18,26,3,0,29,34,3,0,37
53336,282,"ŞCOALA GENERALĂ CU CLASELE I - VIII",MEHADICA,CS,584,3,0,0,3,17,0,0,17,22,0,0,22,23,1,0,24,32,3,0,35
53363,283,"CĂMINUL CULTURAL",LESCOVIŢA,CS,212,5,2,0,7,11,2,0,13,12,3,0,15,14,5,0,19,21,6,0,27
53354,284,"PRIMĂRIA VECHE",NAIDĂŞ,CS,664,10,2,0,12,24,3,0,27,27,6,0,33,38,6,0,44,42,6,0,48
53381,285,"SCOALA GIMNAZIALA OBREJA",OBREJA,CS,1482,18,5,0,23,35,6,0,41,56,6,0,62,75,7,0,82,106,8,0,114
53390,286,"SCOALA PRIMARA CIUTA",CIUTA,CS,299,9,1,0,10,18,4,0,22,30,5,0,35,35,7,0,42,35,7,0,42
53407,287,"SCOALA PRIMARA IAZ",IAZ,CS,592,10,4,0,14,31,5,0,36,45,5,0,50,65,10,0,75,70,10,0,80
53416,288,"SCOALA PRIMARA VAR",VAR,CS,325,2,2,0,4,7,4,0,11,12,4,0,16,21,8,0,29,26,10,0,36
50996,289,"ŞCOALA GIMNAZIALĂ","OCNA DE FIER",CS,591,13,4,0,17,22,7,0,29,37,7,0,44,44,7,0,51,47,7,0,54
53434,290,"CĂMINUL CULTURAL",PĂLTINIŞ,CS,570,16,0,0,16,23,1,0,24,31,2,0,33,40,2,0,42,46,2,0,48
53461,291,"CĂMINUL CULTURAL",OHABIŢA,CS,65,1,0,0,1,1,1,0,2,1,2,0,3,1,3,0,4,3,5,0,8
53443,292,"ŞCOALA GIMNAZIALĂ CORNUȚEL",CORNUŢEL,CS,846,8,4,0,12,11,4,0,15,17,6,0,23,27,7,0,34,32,7,0,39
53452,293,"ŞCOALA GIMNAZIALĂ DELINEȘTI",DELINEŞTI,CS,353,2,3,0,5,2,3,0,5,4,3,0,7,4,5,0,9,11,6,0,17
53470,294,GRĂDINIȚA,RUGI,CS,221,5,1,0,6,5,1,0,6,5,1,0,6,5,1,0,6,6,1,0,7
53522,295,"ŞCOALA GIMNAZIALA ""ATANASIE COJOCARU"" POJEJENA",POJEJENA,CS,925,9,1,0,10,30,2,0,32,43,2,0,45,56,6,0,62,69,6,0,75
53531,296,"ŞCOALA GIMNAZIALA ""BORISLAV CRISTICI"" BELOBREȘCA",BELOBREŞCA,CS,498,10,2,0,12,26,2,0,28,37,2,0,39,48,2,0,50,48,2,0,50
53559,297,"GRĂDINIŢA CU PROGRAM NORMAL RADIMNA",RADIMNA,CS,444,5,2,0,7,19,2,0,21,31,2,0,33,47,3,0,50,54,3,0,57
53540,298,"GRĂDINIŢA CU PROGRAM NORMAL DIVICI",DIVICI,CS,215,3,0,0,3,9,3,0,12,16,4,0,20,20,8,0,28,21,12,0,33
53568,299,"GRĂDINIŢA CU PROGRAM NORMAL ŞUȘCA",ŞUŞCA,CS,377,21,0,0,21,40,0,0,40,58,4,0,62,78,6,0,84,85,6,0,91
53602,300,"CĂMINUL CULTURAL","BORLOVENII VECHI",CS,374,8,2,0,10,29,9,0,38,36,10,0,46,50,10,0,60,59,10,0,69
53595,301,"ŞCOALA GENERALĂ","BORLOVENII NOI",CS,340,8,3,0,11,9,6,0,15,13,6,0,19,17,6,0,23,25,6,0,31
53611,302,"ŞCOALA GENERALĂ",PĂTAŞ,CS,439,8,0,0,8,9,1,0,10,12,1,0,13,21,2,0,23,30,2,0,32
53620,303,"ŞCOALA GENERALĂ",PUTNA,CS,135,5,1,0,6,6,4,0,10,10,6,0,16,12,6,0,18,16,8,0,24
53586,304,"CLADIRE PRIMARIE (ŞCOALA VECHE)",PRIGOR,CS,750,7,2,0,9,21,9,0,30,29,10,0,39,33,10,0,43,45,10,0,55
53648,305,"ŞCOALA GIMNAZIALĂ RAMNA",RAMNA,CS,976,11,1,0,12,21,2,0,23,28,2,0,30,34,3,0,37,37,3,0,40
53666,306,"ŞCOALA CU CLASELE I - IV - VALEAPAI",VALEAPAI,CS,336,4,0,0,4,12,1,0,13,18,5,0,23,27,7,0,34,28,7,0,35
53684,307,"CĂMINUL CULTURAL",RĂCĂŞDIA,CS,1340,11,2,0,13,22,2,0,24,38,3,0,41,50,4,0,54,59,5,0,64
53693,308,"CLĂDIREA FOSTEI PRIMĂRII VRĂNIUŢ",VRĂNIUŢ,CS,297,1,1,0,2,5,4,0,9,6,5,0,11,10,7,0,17,10,8,0,18
53737,309,"ŞCOALA GIMNAZIALĂ ŞTEFAN VELOVAN","RUSCA MONTANĂ",CS,1326,19,1,0,20,30,2,0,32,35,2,0,37,40,2,0,42,40,2,0,42
53746,310,"GRĂDINIŢA CU PROGRAM NORMAL",RUŞCHIŢA,CS,283,9,1,0,10,13,1,0,14,17,2,0,19,18,2,0,20,18,2,0,20
53782,311,"GRĂDINIȚA CU PROGRAM NORMAL TINCOVA",TINCOVA,CS,364,1,2,0,3,5,2,0,7,9,2,0,11,15,6,0,21,15,6,0,21
53764,312,"CLUB CĂMIN CULTURAL",SACU,CS,662,4,0,0,4,6,0,0,6,9,0,0,9,13,3,0,16,13,4,0,17
53773,313,"CĂMINUL CULTURAL SĂLBĂGELU NOU","SĂLBĂGELU NOU",CS,205,6,2,0,8,11,2,0,13,18,2,0,20,26,2,0,28,26,4,0,30
53817,314,"CĂMINUL CULTURAL",BOGODINŢ,CS,83,0,2,0,2,7,8,0,15,7,11,0,18,7,11,0,18,8,18,0,26
53835,315,"CĂMINUL CULTURAL","SASCA ROMÂNĂ",CS,284,10,2,0,12,20,3,0,23,20,3,0,23,20,4,0,24,20,4,0,24
53844,316,"CĂMINUL CULTURAL",SLATINA-NERA,CS,294,6,2,0,8,53,5,0,58,99,21,0,120,108,24,0,132,109,25,0,134
53808,317,"SCOALA GIMNAZIALA ,,MIHAI NOVAC"" SASCA MONTANA","SASCA MONTANĂ",CS,404,1,0,0,1,8,5,0,13,13,6,0,19,27,8,0,35,31,10,0,41
53826,318,"ŞCOALA PRIMARA POTOC",POTOC,CS,215,3,2,0,5,10,2,0,12,13,6,0,19,18,8,0,26,24,8,0,32
53942,319,"GRĂDINIŢA CU PROGRAM NORMAL GORNEA",GORNEA,CS,457,25,5,0,30,36,8,0,44,45,8,0,53,54,8,0,62,57,8,0,65
53862,320,"CAMIN CULTURAL SICHEVITA",SICHEVIŢA,CS,1262,20,2,0,22,36,2,0,38,46,2,0,48,62,2,0,64,74,2,0,76
53951,321,"CENTRU DE INFORMARE TURISTICA COMUNA SICHEVITA",LIBORAJDEA,CS,85,0,1,0,1,1,6,0,7,1,7,0,8,1,9,0,10,1,10,0,11
54065,322,"SCOALAPRIMARA SLATINA -TIMIS",SLATINA-TIMIŞ,CS,1407,20,2,0,22,33,2,0,35,47,3,0,50,58,6,0,64,63,6,0,69
54074,323,SCOALAPRIMARAILOVA,ILOVA,CS,617,6,0,0,6,15,2,0,17,17,2,0,19,26,2,0,28,32,3,0,35
54083,324,"SCOALA PRIMARA SADOVA-NOUA","SADOVA NOUĂ",CS,193,1,0,0,1,7,0,0,7,10,0,0,10,11,1,0,12,11,3,0,14
54092,325,"GRADINITACU PROGRAMNORMAL SADOVA-VECHE","SADOVA VECHE",CS,313,3,1,0,4,8,1,0,9,8,3,0,11,15,3,0,18,15,3,0,18
54118,326,"ŞCOALA GIMNAZIALĂ ""SF. SAVA"" - SOCOL",SOCOL,CS,597,12,1,0,13,19,1,0,20,23,1,0,24,34,2,0,36,44,3,0,47
54127,327,"CĂMINUL CULTURAL - BAZIAȘ",BAZIAŞ,CS,47,2,4,0,6,2,4,0,6,2,8,0,10,2,10,0,12,2,10,0,12
54136,328,"ŞCOALA PRIMARĂ CÎMPIA",CÎMPIA,CS,463,2,2,0,4,14,2,0,16,17,2,0,19,24,2,0,26,30,3,0,33
54154,329,"ŞCOALA GIMNAZIALĂ- ZLATITA",ZLATIŢA,CS,617,11,2,0,13,30,3,0,33,43,3,0,46,76,8,0,84,89,8,0,97
54172,330,"CĂMINUL CULTURAL-SOPOTU NOU","ŞOPOTU NOU",CS,275,3,0,0,3,7,2,0,9,10,2,0,12,30,11,0,41,39,11,0,50
54216,331,"CĂMINUL CULTURAL-RAVENSCA",RAVENSCA,CS,113,0,0,0,0,3,0,0,3,6,0,0,6,9,0,0,9,9,0,0,9
54225,332,"ŞCOALA PRIMARA - RACHITA",RĂCHITA,CS,100,0,0,0,0,1,0,0,1,1,1,0,2,5,1,0,6,5,1,0,6
54234,333,"CAMININUL CULTURAL-STANCILOVADE JOS",STĂNCILOVA,CS,88,0,0,0,0,3,0,0,3,8,2,0,10,15,2,0,17,16,4,0,20
54234,334,"CAMINNUL CULTURAL STANCILOVA DE SUS",STĂNCILOVA,CS,131,5,3,0,8,9,3,0,12,9,5,0,14,9,5,0,14,12,5,0,17
54261,335,"CĂMINUL CULTURAL-VALEA ROSIE","VALEA ROŞIE",CS,212,1,0,0,1,8,0,0,8,15,0,0,15,24,4,0,28,28,4,0,32
54289,336,"CĂMINUL CULTURAL",TEREGOVA,CS,1217,10,0,0,10,20,0,0,20,27,0,0,27,45,0,0,45,52,0,0,52
54289,337,"LICEUL TEHNOLOGIC ""SF. DIMITRIE""",TEREGOVA,CS,1121,8,0,0,8,24,4,0,28,36,4,0,40,45,4,0,49,47,5,0,52
54298,338,"OFICIUL PRIMĂRIEI",RUSCA,CS,975,7,1,0,8,16,2,0,18,22,2,0,24,25,3,0,28,26,4,0,30
54323,339,"ŞCOALA CU CLASELE I - IV",CÎRNECEA,CS,260,0,0,0,0,0,0,0,0,3,0,0,3,5,3,0,8,8,7,0,15
54332,340,"ŞCOALA CU CLASELE I - IV",SECĂŞENI,CS,298,1,2,0,3,3,2,0,5,7,2,0,9,11,5,0,16,13,6,0,19
54341,341,"ŞCOALA CU CLASELE I - IV","TICVANIU MIC",CS,268,0,3,0,3,5,4,0,9,7,4,0,11,17,5,0,22,19,6,0,25
54314,342,"CASA DE CULTURĂ ""VIRGIL BIROU""","TICVANIU MARE",CS,699,6,0,0,6,8,3,0,11,9,4,0,13,12,5,0,17,12,5,0,17
54369,343,"ŞCOALA GIMNAZIALĂ TÎRNOVA",TÎRNOVA,CS,1373,3,0,0,3,12,1,0,13,19,3,0,22,40,7,0,47,52,7,0,59
54396,344,"CĂMINUL CULTURAL",TOPLEŢ,CS,1159,10,0,0,10,27,3,0,30,44,3,0,47,58,4,2,64,61,4,2,67
54403,345,"ŞCOALA PRIMARA BÎRZA",BÎRZA,CS,1037,15,3,0,18,27,6,0,33,40,6,0,46,46,8,0,54,53,8,0,61
54421,346,"CĂMINUL CULTURAL TURNU RUIENI","TURNU RUIENI",CS,704,8,3,0,11,14,4,0,18,19,5,0,24,24,5,0,29,34,5,0,39
54430,347,"CĂMINUL CULTURAL-BORLOVA",BORLOVA,CS,1172,30,1,0,31,75,4,0,79,100,6,0,106,129,22,0,151,155,23,0,178
54458,348,"ŞCOALA PRIMARA DALCI",DALCI,CS,216,2,0,0,2,5,1,0,6,7,1,0,8,12,3,0,15,13,3,0,16
54467,349,"CĂMINUL CULTURAL ZERVESTI",ZERVEŞTI,CS,441,10,1,0,11,18,2,0,20,26,6,0,32,31,6,0,37,39,7,0,46
54476,350,"CĂMINUL CULTURAL-ZLAGNA",ZLAGNA,CS,255,6,0,0,6,15,0,0,15,20,2,0,22,29,2,0,31,31,2,0,33
54494,351,"ŞCOALA GIMNAZIALĂ ""PETRE SAVA BĂLEAN""",VĂLIUG,CS,657,4,1,0,5,6,4,0,10,9,5,0,14,14,6,0,20,14,6,0,20
54519,352,"PRIMĂRIA COMUNEI VĂRĂDIA, SALA DE ȘEDINȚĂ A CONSILIULUI LOCAL VĂRĂDIA",VĂRĂDIA,CS,647,19,3,0,22,37,4,0,41,44,7,0,51,57,9,0,66,62,10,0,72
54528,353,"CLĂDIREA ADMINISTRAŢIEI LOCALE",MERCINA,CS,475,2,2,0,4,3,3,0,6,8,5,0,13,14,5,0,19,20,7,0,27
54555,354,"ŞCOALA PRIMARĂ ERSIG",ERSIG,CS,250,1,0,0,1,2,2,0,4,7,4,0,11,8,4,0,12,10,4,0,14
54564,355,"ŞCOALA PRIMARĂ IZGAR",IZGAR,CS,244,1,4,0,5,1,6,0,7,2,6,0,8,7,6,0,13,9,6,0,15
54546,356,"SALA DE SPORT",VERMEŞ,CS,799,6,2,0,8,17,3,0,20,24,4,0,28,33,8,0,41,33,8,0,41
54582,357,"ȘCOALA GIMNAZIALĂ VRANI",VRANI,CS,705,10,1,0,11,14,5,0,19,27,7,0,34,33,13,0,46,35,15,0,50
54591,358,"SCOALA PRIMARA CIORTEA",CIORTEA,CS,143,2,1,0,3,10,1,0,11,15,3,0,18,19,3,0,22,19,5,0,24
54626,359,"CĂMINUL CULTURAL-ZAVOI",ZĂVOI,CS,1493,18,0,0,18,34,0,0,34,67,0,0,67,79,0,0,79,80,7,0,87
54635,360,"ŞCOALA PRIMARĂ MĂGURA",MĂGURA,CS,447,3,2,0,5,13,2,0,15,21,2,0,23,29,2,0,31,31,2,0,33
54644,361,"ŞCOALA GIMNAZIALA MĂRU",MĂRU,CS,890,8,1,0,9,15,3,0,18,18,3,0,21,34,5,0,39,36,8,0,44
54653,362,"OCOLUL SILVIC","POIANA MĂRULUI",CS,59,0,0,0,0,3,5,0,8,3,6,0,9,4,10,0,14,4,10,0,14
54671,363,"ŞCOALA PRIMARĂ VOISLOVA",VOISLOVA,CS,481,1,0,0,1,8,1,0,9,11,2,0,13,22,2,0,24,24,3,0,27
54715,364,"CĂMINUL CULTURAL",ZORLENCIOR,CS,112,3,1,0,4,4,3,0,7,9,11,0,20,16,13,0,29,16,15,0,31
54706,365,"ŞCOALA GIMNAZIALA ZORLENTU MARE","ZORLENŢU MARE",CS,681,3,0,0,3,5,0,0,5,6,2,0,8,11,6,0,17,13,18,0,31
60428,1,"COLEGIUL NATIONAL "" MIHAI EMINESCU""",CONSTANŢA,CT,833,7,0,0,7,18,7,0,25,22,10,0,32,32,11,0,43,36,11,0,47
60428,2,"COLEGIUL NATIONAL "" MIHAI EMINESCU""",CONSTANŢA,CT,662,7,3,0,10,16,17,0,33,31,20,0,51,35,24,0,59,36,28,0,64
60428,3,"ŞCOALA GIMNAZIALA NR.2",CONSTANŢA,CT,945,10,0,0,10,29,2,0,31,36,2,0,38,50,5,0,55,53,5,0,58
60428,4,"COLEGIUL NAŢIONAL MIRCEA CEL BĂTRÂN",CONSTANŢA,CT,620,13,0,0,13,34,2,0,36,43,10,0,53,47,20,0,67,51,20,0,71
60428,5,"COLEGIUL NAŢIONAL MIRCEA CEL BĂTRÂN",CONSTANŢA,CT,608,7,0,0,7,22,10,0,32,35,18,0,53,50,20,0,70,52,20,0,72
60428,6,"ŞCOALA GIMNAZIALA NR.28 "" DAN BARBILIAN""",CONSTANŢA,CT,450,8,2,0,10,13,4,0,17,27,4,0,31,35,5,0,40,37,5,0,42
60428,7,"COLEGIUL COMERCIAL ""CAROL I""",CONSTANŢA,CT,1441,11,0,0,11,50,3,0,53,74,4,0,78,86,7,0,93,90,7,0,97
60428,8,"COLEGIUL COMERCIAL ""CAROL I""",CONSTANŢA,CT,896,7,3,0,10,30,3,0,33,40,3,0,43,52,3,0,55,54,3,0,57
60428,9,"COLEGIUL NATIONAL PEDAGOGIC ""CONSTANTIN BRĂTESCU""",CONSTANŢA,CT,1626,15,0,0,15,42,2,0,44,59,2,0,61,68,5,0,73,71,5,0,76
60428,10,"COLEGIUL NATIONAL PEDAGOGIC ""CONSTANTIN BRĂTESCU""",CONSTANŢA,CT,1255,17,0,0,17,47,1,0,48,54,2,0,56,85,2,0,87,91,2,0,93
60428,11,"COLEGIUL NATIONAL PEDAGOGIC ""CONSTANTIN BRĂTESCU""",CONSTANŢA,CT,1277,12,1,0,13,40,2,0,42,52,2,1,55,84,8,1,93,88,8,1,97
60428,12,"LICEUL TEHNOLOGIC ""IOAN N.ROMAN"" (ŞCOALA NR.25)",CONSTANŢA,CT,1238,4,2,0,6,34,2,0,36,57,2,0,59,62,2,0,64,64,2,0,66
60428,13,"LICEUL TEHNOLOGIC ""IOAN N.ROMAN"" (ŞCOALA NR.25)",CONSTANŢA,CT,1163,8,5,0,13,24,5,0,29,27,5,0,32,56,6,0,62,58,6,0,64
60428,14,"TEATRUL DE STAT CONSTANȚA (TEATRUL ""FANTASIO"" )",CONSTANŢA,CT,690,5,0,0,5,29,1,0,30,44,2,0,46,58,3,0,61,60,3,0,63
60428,15,"TEATRUL DE STAT CONSTANȚA (TEATRUL ""FANTASIO"" )",CONSTANŢA,CT,818,9,0,0,9,33,3,0,36,51,3,0,54,58,3,0,61,58,3,0,61
60428,16,"LICEUL TEORETIC ”TRAIAN”",CONSTANŢA,CT,844,10,0,0,10,33,4,0,37,51,4,0,55,62,4,0,66,65,6,0,71
60428,17,"LICEUL TEORETIC ”TRAIAN”",CONSTANŢA,CT,453,3,0,0,3,13,2,0,15,18,3,0,21,29,8,0,37,30,8,0,38
60428,18,"LICEUL TEORETIC ”TRAIAN”",CONSTANŢA,CT,1288,6,0,0,6,33,2,0,35,67,5,0,72,89,11,0,100,93,11,0,104
60428,19,"ŞCOALAGIMNAZIALA NR. 24 ”ION JALEA”",CONSTANŢA,CT,1260,2,0,0,2,22,0,0,22,46,0,0,46,65,0,0,65,74,0,0,74
60428,20,"ŞCOALAGIMNAZIALA NR. 24 ”ION JALEA”",CONSTANŢA,CT,1162,8,1,0,9,48,2,0,50,69,2,0,71,92,2,0,94,105,3,0,108
60428,21,"ŞCOALAGIMNAZIALA NR. 24 ”ION JALEA”",CONSTANŢA,CT,1377,16,2,0,18,46,2,0,48,72,5,0,77,89,8,0,97,101,9,0,110
60428,22,"LICEUL CU PROGRAM SPORTIV ""NICOLAE ROTARU "" (ŞCOALA NR.34)",CONSTANŢA,CT,1445,21,0,0,21,54,0,0,54,74,1,0,75,110,1,0,111,118,1,0,119
60428,23,"LICEUL CU PROGRAM SPORTIV ""NICOLAE ROTARU "" (ŞCOALA NR.34)",CONSTANŢA,CT,1201,11,0,0,11,46,0,0,46,71,0,0,71,81,0,0,81,84,0,0,84
60428,24,"LICEUL CU PROGRAM SPORTIV ""NICOLAE ROTARU "" (ŞCOALA NR.34)",CONSTANŢA,CT,1284,14,1,0,15,40,3,0,43,62,6,0,68,85,6,0,91,92,8,0,100
60428,25,"LICEUL CU PROGRAM SPORTIV ""NICOLAE ROTARU "" (ŞCOALA NR.34)",CONSTANŢA,CT,1506,30,3,0,33,68,4,0,72,111,4,0,115,132,4,0,136,135,4,0,139
60428,26,"COLEGIUL NAȚIONALDE ARTE ”REGINA MARIA” (ȘCOALA NR. 42)",CONSTANŢA,CT,991,8,1,0,9,36,1,0,37,47,7,0,54,64,7,0,71,67,9,0,76
60428,27,"COLEGIUL NAȚIONALDE ARTE ”REGINA MARIA” (ȘCOALA NR. 42)",CONSTANŢA,CT,920,14,2,0,16,36,2,0,38,47,2,0,49,65,3,0,68,68,3,0,71
60428,28,"COLEGIUL NAȚIONALDE ARTE ”REGINA MARIA” (ȘCOALA NR. 42)",CONSTANŢA,CT,1072,11,0,0,11,24,0,0,24,42,1,0,43,49,2,0,51,57,3,0,60
60428,29,"COLEGIUL NAȚIONALDE ARTE ”REGINA MARIA” (ȘCOALA NR. 42)",CONSTANŢA,CT,594,7,1,0,8,27,1,0,28,38,1,0,39,58,1,0,59,65,1,0,66
60428,30,"LICEUL TEORETIC""OVIDIUS""",CONSTANŢA,CT,1565,17,4,0,21,34,4,0,38,60,4,0,64,73,5,0,78,76,5,0,81
60428,31,"LICEUL TEORETIC""OVIDIUS""",CONSTANŢA,CT,1192,7,1,0,8,48,8,0,56,65,12,0,77,97,13,0,110,102,13,0,115
60428,32,"ANEXĂ ŞCOALA GIMNAZIALĂ NR.8",CONSTANŢA,CT,963,6,1,0,7,19,1,0,20,32,1,0,33,47,5,0,52,50,9,0,59
60428,33,"ANEXĂ ŞCOALA GIMNAZIALĂ NR.8",CONSTANŢA,CT,1726,13,0,0,13,54,3,0,57,76,3,0,79,101,3,0,104,105,4,0,109
60428,34,"ANEXĂ ŞCOALA GIMNAZIALĂ NR.8",CONSTANŢA,CT,1445,25,0,0,25,46,0,0,46,62,0,0,62,78,0,0,78,81,0,0,81
60428,35,"ANEXĂ ŞCOALA GIMNAZIALĂ NR.8",CONSTANŢA,CT,1338,21,0,0,21,41,5,0,46,62,9,0,71,82,9,0,91,84,9,0,93
60428,36,"ANEXĂ ŞCOALA GIMNAZIALĂ NR.8",CONSTANŢA,CT,1328,15,1,0,16,38,2,0,40,55,3,0,58,64,5,0,69,67,5,0,72
60428,37,"ANEXĂ ŞCOALA GIMNAZIALĂ NR.8",CONSTANŢA,CT,1725,23,0,0,23,48,0,0,48,74,0,0,74,93,0,0,93,100,0,0,100
60428,38,"LICEUL TEHNOLOGIC”C.A.ROSETTI”",CONSTANŢA,CT,1106,16,0,0,16,37,1,0,38,60,6,0,66,72,9,0,81,76,11,0,87
60428,39,"LICEUL TEHNOLOGIC”C.A.ROSETTI”",CONSTANŢA,CT,1212,10,0,0,10,39,2,0,41,59,2,0,61,78,4,0,82,89,4,0,93
60428,40,"LICEUL TEHNOLOGIC ”C.A.ROSETTI”",CONSTANŢA,CT,1122,10,2,0,12,27,3,0,30,32,3,0,35,41,5,0,46,43,5,0,48
60428,41,"LICEUL TEHNOLOGIC ”C.A.ROSETTI”",CONSTANŢA,CT,900,9,3,0,12,37,3,0,40,53,3,0,56,68,3,0,71,71,4,0,75
60428,42,"ŞCOALA GIMNAZIALA NR. 16 ""MARIN IONESCU DOBROGIANU""",CONSTANŢA,CT,1627,17,2,0,19,46,2,0,48,81,5,0,86,118,6,0,124,123,7,0,130
60428,43,"ŞCOALA GIMNAZIALA NR. 16 ""MARIN IONESCU DOBROGIANU""",CONSTANŢA,CT,1657,18,2,0,20,35,2,0,37,68,2,0,70,87,3,0,90,94,3,0,97
60428,44,"ŞCOALA GIMNAZIALA NR. 16 ""MARIN IONESCU DOBROGIANU""",CONSTANŢA,CT,1701,10,2,0,12,41,2,0,43,67,2,0,69,87,2,0,89,93,2,0,95
60428,45,"ŞCOALA GIMNAZIALA NR. 16 ""MARIN IONESCU DOBROGIANU""",CONSTANŢA,CT,1547,17,3,0,20,40,3,0,43,59,3,0,62,78,4,0,82,83,6,0,89
60428,46,"ŞCOALA GIMNAZIALA NR. 16 ""MARIN IONESCU DOBROGIANU""",CONSTANŢA,CT,1552,11,0,0,11,50,2,0,52,68,3,0,71,93,4,0,97,96,5,0,101
60428,47,"LICEUL TEORETIC ” LUCIAN BLAGA”",CONSTANŢA,CT,1874,14,1,0,15,41,2,0,43,73,3,0,76,103,4,0,107,105,4,0,109
60428,48,"COLEGIUL TEHNIC DE MARINĂ ”ALEXANDRU IOAN CUZA” (LICEUL DE MARINA)",CONSTANŢA,CT,1811,8,0,0,8,33,0,0,33,59,0,0,59,74,1,0,75,79,1,0,80
60428,49,"COLEGIUL TEHNIC DE MARINĂ ”ALEXANDRU IOAN CUZA” (LICEUL DE MARINA)",CONSTANŢA,CT,1582,8,0,0,8,50,2,0,52,71,2,0,73,84,3,0,87,86,3,0,89
60428,50,"COLEGIUL TEHNIC DE MARINĂ ”ALEXANDRU IOAN CUZA” (LICEUL DE MARINA)",CONSTANŢA,CT,1615,12,3,0,15,41,5,0,46,49,5,0,54,75,6,0,81,84,6,0,90
60428,51,"COLEGIUL TEHNIC DE MARINĂ ”ALEXANDRU IOAN CUZA” (LICEUL DE MARINA)",CONSTANŢA,CT,1668,12,0,0,12,28,0,0,28,53,0,0,53,71,2,0,73,80,2,0,82
60428,52,"COLEGIUL TEHNIC DE MARINĂ ”ALEXANDRU IOAN CUZA” (LICEUL DE MARINA)",CONSTANŢA,CT,1568,14,0,0,14,31,0,0,31,47,0,0,47,76,0,0,76,80,0,0,80
60428,53,"COLEGIUL TEHNIC DE MARINĂ ”ALEXANDRU IOAN CUZA” (LICEUL DE MARINA)",CONSTANŢA,CT,1466,18,1,0,19,33,1,0,34,58,2,0,60,79,2,0,81,95,2,0,97
60428,54,"SCOALA GIMNAZIALA ""GRIGORE ANTIPA"" (ŞCOALA NR. 15 )",CONSTANŢA,CT,1512,13,3,0,16,32,5,0,37,42,5,0,47,65,6,0,71,73,6,0,79
60428,55,"SCOALA GIMNAZIALA ""GRIGORE ANTIPA"" (ŞCOALA NR. 15 )",CONSTANŢA,CT,1754,16,0,0,16,33,0,0,33,53,3,0,56,60,3,0,63,65,3,0,68
60428,56,"SCOALA GIMNAZIALA ""GRIGORE ANTIPA"" (ŞCOALA NR. 15 )",CONSTANŢA,CT,839,14,2,0,16,20,2,0,22,27,2,0,29,34,2,0,36,35,3,0,38
60428,57,"ŞCOALA GIMNAZIALA NR. 17 ”ION MINULESCU”",CONSTANŢA,CT,1774,6,0,0,6,31,2,0,33,57,2,0,59,70,4,0,74,71,4,0,75
60428,58,"ŞCOALA GIMNAZIALA NR. 17 ”ION MINULESCU”",CONSTANŢA,CT,1878,14,0,0,14,43,0,0,43,64,0,0,64,95,3,0,98,101,3,0,104
60428,59,"ŞCOALA GIMNAZIALA NR. 17 ”ION MINULESCU”",CONSTANŢA,CT,1762,5,0,0,5,38,3,0,41,65,3,0,68,90,5,0,95,98,6,0,104
60428,60,"ŞCOALA GIMNAZIALA NR. 17 ”ION MINULESCU”",CONSTANŢA,CT,1732,17,4,0,21,50,5,0,55,76,7,0,83,99,7,0,106,106,7,0,113
60428,61,"ŞCOALA GIMNAZIALA NR. 33 ""ANGHEL SALIGNY""",CONSTANŢA,CT,1280,12,0,0,12,29,0,0,29,48,2,0,50,63,2,0,65,63,4,0,67
60428,62,"ŞCOALA GIMNAZIALA NR. 33 ""ANGHEL SALIGNY""",CONSTANŢA,CT,1681,25,0,0,25,63,0,0,63,88,0,0,88,116,1,0,117,122,1,0,123
60428,63,"ŞCOALA GIMNAZIALA NR. 33 ""ANGHEL SALIGNY""",CONSTANŢA,CT,969,8,0,0,8,30,0,0,30,40,0,0,40,58,2,0,60,60,3,0,63
60428,64,"ŞCOALA GIMNAZIALA NR. 33 ""ANGHEL SALIGNY""",CONSTANŢA,CT,1263,11,0,0,11,53,0,0,53,72,1,0,73,87,1,0,88,94,1,0,95
60428,65,"ŞCOALA GIMNAZIALANR. 37",CONSTANŢA,CT,1215,16,4,0,20,43,7,0,50,56,8,0,64,69,10,0,79,77,10,0,87
60428,66,"ŞCOALA GIMNAZIALANR. 37",CONSTANŢA,CT,1344,28,0,0,28,69,0,0,69,86,0,0,86,103,0,0,103,104,0,0,104
60428,67,"ŞCOALA GIMNAZIALANR. 37",CONSTANŢA,CT,1311,23,0,0,23,71,0,0,71,98,6,0,104,108,8,0,116,111,8,0,119
60428,68,"ŞCOALA GIMNAZIALA NR. 18 ""JEAN BART""",CONSTANŢA,CT,1312,9,0,0,9,38,4,0,42,68,4,0,72,85,5,0,90,87,5,0,92
60428,69,"ŞCOALA GIMNAZIALA NR. 18 ""JEAN BART""",CONSTANŢA,CT,1834,5,0,0,5,28,0,0,28,48,0,0,48,69,0,0,69,71,1,0,72
60428,70,"ŞCOALA GIMNAZIALA NR. 18 ""JEAN BART""",CONSTANŢA,CT,1283,7,2,0,9,15,3,0,18,32,3,0,35,48,5,0,53,53,5,0,58
60428,71,"ŞCOALA GIMNAZIALA NR. 18 ""JEAN BART""",CONSTANŢA,CT,1064,7,1,0,8,28,3,0,31,40,8,0,48,57,8,0,65,59,8,0,67
60428,72,"LICEUL TEHNOLOGIC ""GHEORGHE MIRON COSTIN"" (INDUSTRIE ALIMENTARA)",CONSTANŢA,CT,1336,5,0,0,5,22,0,0,22,35,3,0,38,52,5,0,57,56,6,0,62
60428,73,"LICEUL TEHNOLOGIC ""GHEORGHE MIRON COSTIN"" (INDUSTRIE ALIMENTARA)",CONSTANŢA,CT,1607,8,0,0,8,19,0,0,19,28,0,0,28,37,0,0,37,42,0,0,42
60428,74,"LICEUL TEHNOLOGIC""DIMITRIE LEONIDA""",CONSTANŢA,CT,1794,9,2,0,11,23,5,0,28,36,6,0,42,63,7,0,70,77,7,0,84
60428,75,"LICEUL TEHNOLOGIC""DIMITRIE LEONIDA""",CONSTANŢA,CT,1769,10,2,0,12,33,2,0,35,56,2,0,58,74,3,0,77,79,3,0,82
60428,76,"ŞCOALA GIMNAZIALA NR. 40 ""AUREL VLAICU""",CONSTANŢA,CT,1620,11,10,0,21,32,11,0,43,41,12,0,53,55,16,0,71,57,16,0,73
60428,77,"ŞCOALA GIMNAZIALA NR. 40 ""AUREL VLAICU""",CONSTANŢA,CT,853,9,0,0,9,19,0,0,19,26,0,0,26,36,0,0,36,38,0,0,38
60428,78,"ŞCOALA GIMNAZIALA NR. 40 ""AUREL VLAICU""",CONSTANŢA,CT,1455,12,1,0,13,45,12,0,57,50,12,0,62,68,14,0,82,72,14,0,86
60428,79,"ŞCOALA GIMNAZIALA NR. 40 ""AUREL VLAICU""",CONSTANŢA,CT,1653,18,0,0,18,45,0,0,45,76,1,0,77,95,2,0,97,103,2,0,105
60428,80,"ŞCOALA GIMNAZIALA NR. 40 ""AUREL VLAICU""",CONSTANŢA,CT,860,3,0,0,3,17,1,0,18,29,2,0,31,37,2,0,39,40,2,0,42
60428,81,"ŞCOALA GIMNAZIALA NR. 40 ""AUREL VLAICU""",CONSTANŢA,CT,896,5,0,0,5,17,2,0,19,33,3,0,36,46,4,0,50,58,4,0,62
60428,82,"ŞCOALA GIMNAZIALA NR. 40 ""AUREL VLAICU""",CONSTANŢA,CT,1280,6,0,0,6,23,0,0,23,35,0,0,35,37,0,0,37,43,0,0,43
60428,83,"ŞCOALA GIMNAZIALA NR. 19",CONSTANŢA,CT,1663,12,0,0,12,34,0,0,34,41,0,0,41,56,2,0,58,60,2,0,62
60428,84,"ŞCOALA GIMNAZIALA NR. 19",CONSTANŢA,CT,1330,8,3,0,11,27,3,0,30,30,3,0,33,51,3,0,54,56,3,0,59
60428,85,"ŞCOALA GIMNAZIALA NR. 31",CONSTANŢA,CT,1624,7,0,0,7,21,1,0,22,34,3,0,37,47,5,0,52,49,5,0,54
60428,86,"ŞCOALA GIMNAZIALA NR. 31",CONSTANŢA,CT,1246,9,0,0,9,26,0,0,26,35,0,0,35,39,0,0,39,41,0,0,41
60428,87,"ŞCOALA GIMNAZIALA NR. 31",CONSTANŢA,CT,1306,5,0,0,5,18,0,0,18,27,0,0,27,36,1,0,37,37,1,0,38
60428,88,"LICEUL TEHNOLOGIC”GHEORGHE DUCA”",CONSTANŢA,CT,1627,10,1,0,11,28,3,0,31,42,3,0,45,55,3,0,58,62,4,0,66
60428,89,"ŞCOALA GIMNAZIALA ""MARIN SORESCU"" (SCOALA NR. 20 )",CONSTANŢA,CT,888,5,0,0,5,12,0,0,12,17,0,0,17,24,0,0,24,29,0,0,29
60428,90,"ŞCOALAGIMNAZIALA NR. 22 ""I.C.BRATIANU""",CONSTANŢA,CT,1833,21,1,0,22,50,1,0,51,57,1,0,58,69,2,0,71,72,2,0,74
60428,91,"ŞCOALAGIMNAZIALA NR. 22 ""I.C.BRATIANU""",CONSTANŢA,CT,1280,13,1,0,14,30,1,0,31,47,1,0,48,62,5,0,67,64,5,0,69
60428,92,"CENTRUL SCOLAR PENTRU EDUCATIE INCLUZIVA""MARIA MONTESSORI"" (ŞCOALA AJUTATOARE NR. 2)",CONSTANŢA,CT,1686,7,1,0,8,32,1,0,33,46,2,0,48,65,4,0,69,70,4,0,74
60428,93,"CENTRUL SCOLAR PENTRU EDUCATIE INCLUZIVA""MARIA MONTESSORI"" (ŞCOALA AJUTATOARE NR. 2)",CONSTANŢA,CT,767,8,1,0,9,18,3,0,21,31,3,0,34,40,3,0,43,43,3,0,46
60428,94,"CENTRUL SCOLAR PENTRU EDUCATIE INCLUZIVA""MARIA MONTESSORI"" (ŞCOALA AJUTATOARE NR. 2)",CONSTANŢA,CT,1149,11,0,0,11,26,0,0,26,41,2,0,43,55,3,0,58,61,3,0,64
60428,95,"CENTRUL SCOLAR PENTRU EDUCATIE INCLUZIVA""MARIA MONTESSORI"" (ŞCOALA AJUTATOARE NR. 2)",CONSTANŢA,CT,897,4,0,0,4,9,0,0,9,17,0,0,17,29,0,0,29,29,0,0,29
60428,96,"ŞCOALA GIMNAZIALA NR. 8",CONSTANŢA,CT,1936,20,0,0,20,45,2,0,47,61,5,0,66,92,7,0,99,101,7,0,108
60428,97,"ŞCOALA GIMNAZIALA NR. 8",CONSTANŢA,CT,1503,10,4,0,14,39,5,0,44,58,6,0,64,80,7,0,87,80,7,0,87
60428,98,"ŞCOALA GIMNAZIALA NR. 8",CONSTANŢA,CT,1633,8,0,0,8,25,2,0,27,39,2,0,41,53,2,0,55,57,2,0,59
60428,99,"ŞCOALA GIMNAZIALA NR. 8",CONSTANŢA,CT,1504,10,0,0,10,61,3,0,64,80,3,0,83,109,7,0,116,114,8,0,122
60428,100,"ŞCOALA GIMNAZIALA NR.23 ”CONSTANTIN BRÂNCOVEANU”",CONSTANŢA,CT,1565,7,0,0,7,32,22,0,54,53,28,0,81,68,29,0,97,76,29,0,105
60428,101,"ŞCOALA GIMNAZIALA NR.23 ”CONSTANTIN BRÂNCOVEANU”",CONSTANŢA,CT,1144,8,2,0,10,25,19,0,44,36,21,0,57,58,23,0,81,58,26,0,84
60428,102,"ŞCOALA GIMNAZIALA NR.23 ”CONSTANTIN BRÂNCOVEANU”",CONSTANŢA,CT,2117,14,1,0,15,35,13,0,48,47,13,0,60,78,16,0,94,83,16,0,99
60428,103,"ŞCOALA GIMNAZIALA NR. 39 ""NICOLAE TONITZA""",CONSTANŢA,CT,1811,19,1,0,20,39,2,0,41,76,3,0,79,110,3,0,113,113,3,0,116
60428,104,"ŞCOALA GIMNAZIALA NR. 39 ""NICOLAE TONITZA""",CONSTANŢA,CT,1565,10,1,0,11,37,1,0,38,57,3,0,60,76,3,0,79,78,3,0,81
60428,105,"ŞCOALA GIMNAZIALA NR. 39 ""NICOLAE TONITZA""",CONSTANŢA,CT,1728,17,6,0,23,50,9,0,59,68,10,0,78,85,11,0,96,90,12,0,102
60428,106,"ŞCOALA GIMNAZIALA NR. 39 ""NICOLAE TONITZA""",CONSTANŢA,CT,1898,12,1,0,13,55,2,0,57,71,2,0,73,101,2,0,103,111,3,0,114
60428,107,"CENTRUL DE PERFECȚIONARE AL MARINEI CIVILE",CONSTANŢA,CT,1943,16,0,0,16,43,5,0,48,61,9,0,70,79,10,0,89,83,12,0,95
60428,108,"CENTRUL DE PERFECȚIONARE AL MARINEI CIVILE",CONSTANŢA,CT,1922,15,1,0,16,44,3,0,47,55,3,0,58,76,5,0,81,88,6,0,94
60428,109,"CENTRUL DE PERFECȚIONARE AL MARINEI CIVILE",CONSTANŢA,CT,1499,5,0,0,5,21,0,0,21,32,0,0,32,38,0,0,38,45,0,0,45
60428,110,"ŞCOALA GIMNAZIALANR. 10”MIHAIL KOICIU”",CONSTANŢA,CT,1474,5,0,0,5,17,0,0,17,43,0,0,43,68,0,0,68,68,2,0,70
60428,111,"ŞCOALA GIMNAZIALANR. 10”MIHAIL KOICIU”",CONSTANŢA,CT,1210,19,0,0,19,48,0,0,48,66,0,0,66,84,0,0,84,84,0,0,84
60428,112,"ŞCOALA GIMNAZIALANR. 10”MIHAIL KOICIU”",CONSTANŢA,CT,1876,10,0,0,10,28,0,0,28,48,0,0,48,71,2,0,73,77,2,0,79
60428,113,"ŞCOALA GIMNAZIALANR. 10”MIHAIL KOICIU”",CONSTANŢA,CT,1570,9,0,0,9,31,1,0,32,47,1,0,48,62,1,0,63,62,1,0,63
60428,114,"ŞCOALA GIMNAZIALA NR. 10”MIHAIL KOICIU”",CONSTANŢA,CT,1553,11,0,0,11,47,1,0,48,63,3,0,66,90,4,0,94,93,4,0,97
60428,115,"CENTRUL ȘCOLAR ”ALBATROS”",CONSTANŢA,CT,1155,10,4,0,14,27,4,0,31,38,4,0,42,62,4,0,66,69,5,0,74
60428,116,"CENTRUL ȘCOLAR ”ALBATROS”",CONSTANŢA,CT,1697,14,0,0,14,60,0,0,60,76,0,0,76,100,0,0,100,106,0,0,106
60428,117,"CENTRUL ȘCOLAR ”ALBATROS”",CONSTANŢA,CT,989,9,1,0,10,18,1,0,19,28,6,0,34,38,8,0,46,39,10,0,49
60428,118,"CENTRUL ȘCOLAR ”ALBATROS”",CONSTANŢA,CT,1044,5,2,0,7,21,4,0,25,35,4,0,39,51,4,0,55,52,4,0,56
60428,119,"CENTRUL ȘCOLAR ”ALBATROS”",CONSTANŢA,CT,779,8,0,0,8,13,1,0,14,25,1,0,26,40,1,0,41,42,1,0,43
60428,120,"CENTRUL SCOLAR PENTRU EDUCATIE INCLUZIVA""DELFINUL"" (ŞCOALA AJUTATOARE NR. 1)",CONSTANŢA,CT,1665,18,1,0,19,64,1,0,65,73,1,0,74,89,2,0,91,99,5,0,104
60428,121,"CENTRUL SCOLAR PENTRU EDUCATIE INCLUZIVA""DELFINUL"" (ŞCOALA AJUTATOARE NR. 1)",CONSTANŢA,CT,1808,10,0,0,10,30,0,0,30,45,2,0,47,66,3,0,69,76,3,0,79
60428,122,"ŞCOALA GIMNAZIALA NR. 12 “B. P. HASDEU”",CONSTANŢA,CT,1801,15,0,0,15,54,0,0,54,80,0,0,80,120,0,0,120,126,0,0,126
60428,123,"ŞCOALA GIMNAZIALA NR. 12 “B. P. HASDEU”",CONSTANŢA,CT,1504,9,2,0,11,27,3,0,30,31,4,0,35,46,5,0,51,62,7,0,69
60428,124,"ŞCOALA GIMNAZIALA “DIMITRIE ȘTIUBEI” (ŞCOALA NR.36 )",CONSTANŢA,CT,1153,9,5,0,14,26,6,0,32,37,7,0,44,52,10,0,62,53,10,0,63
60428,125,"SCOALA GIMNAZIALA “DIMITRIE ȘTIUBEI” (ŞCOALA NR.36)",CONSTANŢA,CT,1698,20,0,0,20,58,0,0,58,97,3,0,100,113,5,0,118,122,5,0,127
60428,126,"SCOALA GIMNAZIALA “DIMITRIE ȘTIUBEI” (ŞCOALA NR.36)",CONSTANŢA,CT,1873,16,0,0,16,60,0,0,60,94,0,0,94,119,3,0,122,130,3,0,133
60428,127,"SCOALA GIMNAZIALA “DIMITRIE ȘTIUBEI” (ŞCOALA NR.36)",CONSTANŢA,CT,1173,17,0,0,17,32,0,0,32,52,0,0,52,83,0,0,83,89,0,0,89
60428,128,"SCOALA GIMNAZIALA “DIMITRIE ȘTIUBEI” (ŞCOALA NR.36)",CONSTANŢA,CT,1957,18,2,0,20,51,4,0,55,77,4,0,81,102,4,0,106,117,4,0,121
60428,129,"GRĂDINIŢA CU PROGRAM PRELUNGIT ”MUGUREL” (GRĂDINIŢA NR. 43)",CONSTANŢA,CT,1432,17,3,0,20,49,3,0,52,64,7,0,71,91,8,0,99,96,8,0,104
60428,130,"GRĂDINIŢA CU PROGRAM PRELUNGIT ”MUGUREL” (GRĂDINIŢA NR. 43)",CONSTANŢA,CT,1579,22,1,0,23,60,1,0,61,80,1,0,81,105,4,0,109,110,5,0,115
60428,131,"GRĂDINIŢA CU PROGRAM NORMAL NR. 51",CONSTANŢA,CT,1550,20,3,0,23,43,4,0,47,81,4,0,85,85,5,0,90,90,6,0,96
60428,132,"GRĂDINIŢA CU PROGRAM NORMAL NR. 51",CONSTANŢA,CT,1550,20,1,0,21,48,1,0,49,68,6,1,75,99,6,1,106,107,6,1,114
60428,133,"AGENȚIA FISCALĂ NR.1-4",CONSTANŢA,CT,1683,10,0,0,10,47,0,0,47,77,6,0,83,100,6,0,106,112,8,0,120
60428,134,"AGENȚIA FISCALĂ NR.1-4",CONSTANŢA,CT,1486,14,2,0,16,56,3,0,59,67,5,0,72,94,8,0,102,103,9,0,112
60428,135,"LICEUL TEORETIC”GEORGE CĂLINESCU”",CONSTANŢA,CT,1140,10,2,0,12,42,2,0,44,62,2,0,64,94,7,0,101,99,7,0,106
60428,136,"LICEUL TEORETIC”GEORGE CĂLINESCU”",CONSTANŢA,CT,1076,23,1,0,24,59,2,0,61,70,3,0,73,106,4,0,110,118,4,0,122
60428,137,"LICEUL TEORETIC”GEORGE CĂLINESCU”",CONSTANŢA,CT,1077,14,0,0,14,41,0,0,41,51,1,0,52,67,1,0,68,69,3,0,72
60428,138,"ŞCOALA GIMNAZIALA NR.14",CONSTANŢA,CT,1748,13,1,0,14,35,4,0,39,60,6,0,66,78,7,0,85,92,7,0,99
60428,139,"ŞCOALA GIMNAZIALA NR.14",CONSTANŢA,CT,1953,7,2,0,9,20,2,0,22,30,2,0,32,44,3,0,47,51,3,0,54
60428,140,"ŞCOALA GIMNAZIALA NR.14",CONSTANŢA,CT,922,2,0,0,2,11,1,0,12,17,2,0,19,24,3,0,27,25,3,0,28
60428,141,"ŞCOALAGIMNAZIALA NR. 38 ”DIMITRIE CANTEMIR”",CONSTANŢA,CT,994,15,5,0,20,53,8,0,61,68,9,0,77,81,11,0,92,85,12,0,97
60428,142,"ŞCOALAGIMNAZIALA NR. 38 ”DIMITRIE CANTEMIR”",CONSTANŢA,CT,1034,20,3,0,23,57,3,0,60,71,4,0,75,90,4,0,94,100,4,0,104
60428,143,"LICEUL TEORETIC ”DECEBAL”",CONSTANŢA,CT,948,9,0,0,9,40,0,0,40,54,0,0,54,73,1,0,74,79,2,0,81
60428,144,"LICEUL TEORETIC ”DECEBAL”",CONSTANŢA,CT,611,9,0,0,9,25,0,0,25,34,2,0,36,37,2,0,39,37,3,0,40
60428,145,"LICEUL TEORETIC ”DECEBAL”",CONSTANŢA,CT,729,12,2,0,14,32,3,0,35,41,3,0,44,44,3,0,47,53,3,0,56
60428,146,"LICEUL TEORETIC ”DECEBAL”",CONSTANŢA,CT,913,10,0,0,10,29,0,0,29,44,0,0,44,52,0,0,52,57,0,0,57
60428,147,"LICEUL TEHNOLOGIC “VIRGIL MADGEARU” (ŞCOALA NR.35)",CONSTANŢA,CT,838,15,2,0,17,34,3,0,37,45,3,0,48,53,12,0,65,54,13,0,67
60428,148,"LICEUL TEHNOLOGIC “VIRGIL MADGEARU” (ŞCOALA NR.35)",CONSTANŢA,CT,1146,9,0,0,9,34,0,0,34,59,1,0,60,69,2,0,71,73,3,0,76
60428,149,"LICEUL TEHNOLOGIC “VIRGIL MADGEARU” (ŞCOALA NR.35)",CONSTANŢA,CT,813,13,0,0,13,34,3,0,37,52,4,0,56,67,4,0,71,73,4,0,77
60428,150,"GRĂDINIŢA CU PROGRAM PRELUNGIT”AMICII” (GRĂDINIŢANR.12 )",CONSTANŢA,CT,1209,20,1,0,21,60,4,0,64,83,10,0,93,111,12,0,123,112,12,0,124
60428,151,"ŞCOALA GIMNAZIALA NR. 29 ”MIHAI VITEAZUL”",CONSTANŢA,CT,695,8,3,0,11,32,4,0,36,41,4,0,45,51,4,0,55,52,4,0,56
60428,152,"ŞCOALA GIMNAZIALA NR. 29 ”MIHAI VITEAZUL”",CONSTANŢA,CT,758,17,2,0,19,35,3,0,38,42,3,0,45,55,3,0,58,61,4,0,65
60428,153,"ŞCOALA GIMNAZIALA NR. 29 ”MIHAI VITEAZUL”",CONSTANŢA,CT,1269,14,1,0,15,46,4,0,50,60,6,0,66,85,7,0,92,90,8,0,98
60428,154,"ŞCOALA NR. 29 ”MIHAI VITEAZU”",CONSTANŢA,CT,683,13,0,0,13,42,5,0,47,63,7,0,70,75,11,0,86,82,11,0,93
60428,155,"ŞCOALA GIMNAZIALA NR. 7 ”REMUS OPREANU”",CONSTANŢA,CT,1261,20,0,0,20,63,0,0,63,92,0,0,92,111,0,0,111,112,1,0,113
60428,156,"ŞCOALA GIMNAZIALA NR. 7 ”REMUS OPREANU”",CONSTANŢA,CT,786,3,0,0,3,17,0,0,17,24,1,0,25,31,1,0,32,35,2,0,37
60428,157,"ŞCOALA GIMNAZIALA NR. 7 ”REMUS OPREANU”",CONSTANŢA,CT,1327,18,1,0,19,68,2,0,70,99,3,0,102,116,5,0,121,120,6,0,126
60428,158,"ŞCOALA GIMNAZIALA NR. 7 ”REMUS OPREANU”",CONSTANŢA,CT,1432,23,3,0,26,59,6,0,65,73,6,2,81,114,8,2,124,118,8,2,128
60428,159,"ŞCOALA GIMNAZIALA NR. 7 ”REMUS OPREANU”",CONSTANŢA,CT,1225,11,0,0,11,61,4,0,65,88,4,0,92,124,9,0,133,126,12,0,138
60428,160,"ŞCOALA GIMNAZIALA NR.6 ”NICOLAE TITULESCU”",CONSTANŢA,CT,970,8,4,0,12,35,5,0,40,52,7,0,59,83,7,1,91,93,7,1,101
60428,161,"ŞCOALA GIMNAZIALA NR.6 ”NICOLAE TITULESCU”",CONSTANŢA,CT,1127,16,0,0,16,40,0,0,40,60,0,0,60,75,0,0,75,80,0,0,80
60428,162,"ŞCOALA GIMNAZIALA NR.6 ”NICOLAE TITULESCU”",CONSTANŢA,CT,1020,11,2,0,13,20,2,0,22,41,4,0,45,52,4,0,56,56,6,0,62
60428,163,"ŞCOALA GIMNAZIALA NR.6 ”NICOLAE TITULESCU”",CONSTANŢA,CT,1069,8,0,0,8,26,0,0,26,41,1,0,42,48,1,0,49,51,3,0,54
60428,164,"GRĂDINIŢA CU PROGRAM PRELUNGIT ""NOROCEL""(GRĂDINIŢA NR.13)",CONSTANŢA,CT,904,14,0,0,14,47,2,0,49,60,4,0,64,73,5,0,78,80,5,0,85
60428,165,"GRĂDINIŢA CU PROGRAM PRELUNGIT ""NOROCEL""(GRĂDINIŢA NR.13)",CONSTANŢA,CT,1017,10,0,0,10,36,1,0,37,57,2,0,59,79,2,0,81,84,2,0,86
60428,166,"PALATUL COPIILOR",CONSTANŢA,CT,740,1,0,0,1,16,1,0,17,25,6,0,31,41,6,0,47,41,6,0,47
60428,167,"PALATUL COPIILOR",CONSTANŢA,CT,598,6,0,0,6,15,0,0,15,19,0,0,19,21,0,0,21,21,0,0,21
60428,168,"SCOALA GIMNAZIALA ”SPECTRUM” (ŞCOALA NR.27)",CONSTANŢA,CT,1378,8,1,0,9,30,4,0,34,55,5,0,60,78,8,0,86,91,10,0,101
60428,169,"COLEGIUL TEHNIC “TOMIS”",CONSTANŢA,CT,1015,3,1,0,4,34,3,0,37,45,3,0,48,56,3,0,59,58,3,0,61
60428,170,"COLEGIUL TEHNIC “TOMIS”",CONSTANŢA,CT,969,10,0,0,10,40,0,0,40,49,0,0,49,61,0,0,61,64,0,0,64
60428,171,"COLEGIUL TEHNIC “TOMIS”",CONSTANŢA,CT,659,2,1,0,3,19,2,0,21,36,2,0,38,49,3,0,52,51,3,0,54
60428,172,"COLEGIUL TEHNIC “TOMIS”",CONSTANŢA,CT,1040,5,2,0,7,37,3,0,40,56,6,0,62,69,6,0,75,72,6,0,78
60428,173,"SCOALA GIMNAZIALA”SPECTRUM” (ŞCOALA NR.27)",CONSTANŢA,CT,1602,7,1,0,8,34,3,0,37,46,3,0,49,66,3,0,69,87,3,0,90
60428,174,"ŞCOALA GIMNAZIALA NR.30 “GHEORGHE ŢIŢEICA”",CONSTANŢA,CT,1274,9,0,0,9,23,0,0,23,35,3,0,38,52,4,0,56,53,4,0,57
60428,175,"CENTRUL JUDEŢEAN DE RESURSE ŞI ASISTENŢĂ EDUCAŢIONALĂ",CONSTANŢA,CT,1208,5,2,0,7,11,3,0,14,18,9,0,27,26,10,0,36,29,10,0,39
60428,176,"CENTRUL JUDEŢEAN DE RESURSE ŞI ASISTENŢĂ EDUCAŢIONALĂ",CONSTANŢA,CT,968,6,0,0,6,28,0,0,28,43,0,0,43,62,0,0,62,67,0,0,67
60428,177,"CENTRUL JUDEŢEAN DE RESURSE ŞI ASISTENŢĂ EDUCAŢIONALĂ",CONSTANŢA,CT,1040,9,0,0,9,28,0,0,28,41,0,0,41,55,0,0,55,58,1,0,59
60428,178,"CĂMINUL DE PENSIONARI",CONSTANŢA,CT,1177,14,3,0,17,44,9,0,53,56,9,0,65,64,9,0,73,76,10,0,86
60428,179,"CĂMINUL DE PENSIONARI",CONSTANŢA,CT,1689,12,46,0,58,40,72,0,112,61,88,0,149,88,91,0,179,96,91,0,187
60428,180,"COLEGIUL TEHNIC ENERGETIC",CONSTANŢA,CT,1211,9,2,0,11,34,4,0,38,43,5,0,48,72,5,0,77,74,5,0,79
60428,181,"COLEGIUL TEHNIC ENERGETIC",CONSTANŢA,CT,718,6,0,0,6,18,7,0,25,22,7,0,29,32,14,0,46,32,15,0,47
60428,182,"COLEGIUL TEHNIC ENERGETIC",CONSTANŢA,CT,1289,10,0,0,10,29,0,0,29,50,6,0,56,55,6,0,61,61,7,0,68
60428,183,"COLEGIUL TEHNIC ENERGETIC",CONSTANŢA,CT,1714,14,0,0,14,44,0,0,44,58,1,2,61,91,2,3,96,91,2,3,96
60428,184,"ŞCOALA GIMNAZIALANR. 3 ""CIPRIAN PORUMBESCU""",CONSTANŢA,CT,1403,19,0,0,19,38,0,0,38,54,4,0,58,71,4,0,75,75,4,0,79
60428,185,"ŞCOALA GIMNAZIALANR. 3 ""CIPRIAN PORUMBESCU""",CONSTANŢA,CT,1194,11,0,0,11,23,0,0,23,32,5,0,37,44,7,0,51,46,7,0,53
60428,186,"ŞCOALA GIMNAZIALANR. 3 ""CIPRIAN PORUMBESCU""",CONSTANŢA,CT,1084,14,0,0,14,32,0,0,32,43,0,0,43,64,1,0,65,66,1,0,67
60428,187,"GRĂDINIŢA CU PROGRAM PRELUNGIT NR.45",CONSTANŢA,CT,878,6,4,0,10,21,4,0,25,32,7,0,39,41,9,0,50,42,12,0,54
60428,188,"UNIVERSITATEA ""OVIDIUS""",CONSTANŢA,CT,1806,5,0,0,5,37,0,0,37,52,4,0,56,63,6,0,69,68,6,0,74
60428,189,"UNIVERSITATEA ""OVIDIUS""",CONSTANŢA,CT,1076,4,0,0,4,11,4,0,15,21,5,0,26,39,8,0,47,44,8,0,52
60428,190,"UNIVERSITATEA ""OVIDIUS""",CONSTANŢA,CT,1141,3,2,0,5,15,5,30,50,26,6,30,62,36,7,30,73,43,7,30,80
60428,191,"UNIVERSITATEA ""OVIDIUS""",CONSTANŢA,CT,223,2,2,0,4,3,7,0,10,4,7,0,11,5,9,0,14,6,9,0,15
60428,192,"ŞCOALA GIMNAZIALA NR. 43”FERDINAND”",CONSTANŢA,CT,662,6,2,0,8,13,3,0,16,23,4,0,27,30,7,0,37,31,8,0,39
60428,193,"ŞCOALA GIMNAZIALANR.5 ""NICOLAE IORGA""",CONSTANŢA,CT,1464,14,0,0,14,27,0,0,27,51,1,0,52,83,4,0,87,79,4,0,83
60428,194,"ŞCOALA GIMNAZIALANR.5 ""NICOLAE IORGA""",CONSTANŢA,CT,763,6,0,0,6,11,1,0,12,26,1,0,27,38,1,0,39,41,1,0,42
60428,195,"ŞCOALA GIMNAZIALANR.5 ""NICOLAE IORGA""",CONSTANŢA,CT,501,7,4,0,11,24,7,0,31,31,9,0,40,36,9,0,45,40,9,0,49
60428,196,"ANEXĂ LA COLEGIUL NAŢIONAL ""MIRCEA CEL BĂTRÂN""",CONSTANŢA,CT,621,10,7,0,17,39,8,0,47,53,8,0,61,63,8,0,71,63,8,0,71
60428,197,"ANEXĂ LA COLEGIUL NAŢIONAL ""MIRCEA CEL BĂTRÂN""",CONSTANŢA,CT,594,10,0,0,10,19,0,0,19,31,0,0,31,38,0,0,38,39,0,0,39
60428,198,"GRĂDINIŢA CU PROGRAM PRELUNGIT NR. 8 (TOMIS II)",CONSTANŢA,CT,797,16,0,0,16,41,2,0,43,60,5,0,65,76,5,0,81,83,7,0,90
60428,199,"ATELIER ŞCOALĂ",CONSTANŢA,CT,733,9,1,0,10,33,1,0,34,41,1,0,42,49,1,0,50,53,1,0,54
60428,200,"GRĂDINIŢA CU PROGRAM PRELUNGIT NR.6",CONSTANŢA,CT,779,17,1,0,18,43,2,0,45,67,2,0,69,79,4,0,83,83,4,0,87
60428,201,"ŞCOALA GIMNAZIALANR.30 “GHEORGHE ŢIŢEICA”",CONSTANŢA,CT,878,6,3,0,9,22,4,0,26,35,4,0,39,48,4,0,52,48,4,0,52
60428,202,"ŞCOALA GIMNAZIALANR.30 “GHEORGHE ŢIŢEICA”",CONSTANŢA,CT,858,5,2,0,7,25,2,0,27,46,2,0,48,57,2,0,59,64,3,0,67
60428,203,"ŞCOALA GIMNAZIALA NR. 11 ”DR.CONSTANTIN ANGELESCU”",CONSTANŢA,CT,1254,10,1,0,11,32,3,0,35,61,4,0,65,87,8,0,95,98,8,0,106
60428,204,"ŞCOALA GIMNAZIALA NR. 11 ”DR.CONSTANTIN ANGELESCU”",CONSTANŢA,CT,1504,27,0,0,27,61,2,0,63,87,3,0,90,109,3,0,112,111,3,0,114
60428,205,"LICEUL TEHNOLOGIC DE ELECTROTEHNICA SI TELECOMUNICAȚII",CONSTANŢA,CT,1276,5,0,0,5,36,0,0,36,64,4,0,68,84,5,0,89,89,6,0,95
60428,206,"UNIVERSITATEA “ANDREI ŞAGUNA”",CONSTANŢA,CT,802,3,0,0,3,15,3,0,18,35,6,0,41,54,8,0,62,62,8,0,70
60428,207,"CARTIER TOMIS PLUS",CONSTANŢA,CT,1816,3,0,0,3,20,4,0,24,41,6,0,47,66,12,0,78,80,14,0,94
60437,208,"HOTEL VENUS",MAMAIA,CT,277,0,0,0,0,0,5,0,5,2,12,0,14,8,16,0,24,9,17,0,26
60428,209,"ȘCOALA GIMNAZIALANR. 23”CONSTANTIN BRÂNCOVEANU”",CONSTANŢA,CT,1087,7,0,0,7,35,0,0,35,47,0,0,47,58,0,0,58,59,0,0,59
60428,210,"CAMPUS SOCIAL ""HENRI COANDĂ""",CONSTANŢA,CT,1691,43,0,0,43,89,0,0,89,148,0,0,148,184,1,0,185,202,1,0,203
60491,211,"CASA MUNICIPALĂ DE CULTURĂ",MANGALIA,CT,1525,27,9,0,36,85,22,0,107,109,47,0,156,136,51,0,187,136,55,0,191
60491,212,"GRUP ȘCOLAR ECONOMIC",MANGALIA,CT,1414,12,2,0,14,24,5,0,29,41,11,0,52,60,11,0,71,60,13,0,73
60491,213,"GRUP ȘCOLAR INDUSTRIAL ""ION BĂNESCU""",MANGALIA,CT,1203,5,1,0,6,12,1,0,13,15,3,0,18,23,4,0,27,25,4,0,29
60491,214,"GRUP ȘCOLAR INDUSTRIAL ""ION BĂNESCU""",MANGALIA,CT,1426,11,4,0,15,30,4,0,34,52,4,0,56,69,4,0,73,77,4,0,81
60491,215,"BAZA SPOTIVĂ PESCĂRUȘ",MANGALIA,CT,1187,6,1,0,7,29,2,0,31,46,3,0,49,60,6,0,66,64,6,0,70
60491,216,"ȘCOALA GENERALĂ NR.3",MANGALIA,CT,1513,19,1,0,20,47,3,0,50,65,5,0,70,86,7,0,93,86,8,0,94
60491,217,"ȘCOALA GENERALĂ NR.3",MANGALIA,CT,1584,23,0,0,23,46,1,0,47,60,3,0,63,77,3,0,80,80,4,0,84
60491,218,"GRĂDINIȚA NR.3",MANGALIA,CT,1588,9,1,0,10,30,1,0,31,43,2,0,45,66,4,0,70,67,4,0,71
60491,219,"ȘCOALA GENERALĂ NR.1",MANGALIA,CT,1166,4,5,0,9,11,5,0,16,14,7,0,21,23,9,0,32,26,10,0,36
60491,220,"ȘCOALA GENERALĂ NR.1",MANGALIA,CT,1364,15,5,0,20,26,6,0,32,31,6,0,37,44,6,0,50,47,6,0,53
60491,221,"ȘCOALA GENERALĂ NR.2",MANGALIA,CT,1460,18,1,0,19,39,1,0,40,60,3,0,63,66,3,0,69,68,6,0,74
60491,222,"ȘCOALA GENERALĂ NR.2",MANGALIA,CT,1673,22,5,0,27,45,6,0,51,69,7,0,76,87,8,0,95,93,8,0,101
60491,223,"SEDIU S.C. ECO GOLD S.A.",MANGALIA,CT,2049,15,0,0,15,50,0,0,50,70,0,0,70,106,2,0,108,126,2,0,128
60491,224,"GRĂDINIȚA NR. 4",MANGALIA,CT,1235,9,7,0,16,26,8,0,34,38,9,0,47,51,9,0,60,52,11,0,63
60491,225,"FUNDAȚIA PENTRU TINERET MANGALIA",MANGALIA,CT,1182,1,5,0,6,3,5,0,8,5,5,0,10,6,5,0,11,8,5,0,13
60491,226,"FUNDATIA PENTRU TINERET",MANGALIA,CT,1401,8,0,0,8,33,1,0,34,47,2,0,49,56,2,0,58,61,2,0,63
60491,227,"ȘCOALA GENERALĂ NR.5",MANGALIA,CT,1201,4,4,0,8,20,8,0,28,30,9,0,39,46,14,0,60,47,16,0,63
60491,228,"ȘCOALA GENERALĂ NR.5",MANGALIA,CT,1272,22,4,0,26,38,10,0,48,61,13,0,74,72,14,0,86,73,14,0,87
60491,229,"FUNDAȚIA PENTRU TINERET",MANGALIA,CT,1266,9,1,0,10,38,4,0,42,58,4,0,62,67,4,0,71,71,4,0,75
60491,230,"HOTEL MANGALIA",MANGALIA,CT,1294,19,18,0,37,55,36,0,91,68,67,0,135,91,70,0,161,100,74,0,174
60491,231,"CLUB SPITAL MANGALIA",MANGALIA,CT,931,14,0,0,14,48,10,0,58,55,16,0,71,70,16,0,86,73,16,0,89
60491,232,"GRĂDINIȚA CALLATIS",MANGALIA,CT,1175,8,4,0,12,35,4,0,39,49,4,0,53,60,6,0,66,63,6,0,69
60491,233,"LICEUL CALLATIS",MANGALIA,CT,1201,12,0,0,12,35,0,0,35,46,4,0,50,62,7,0,69,66,10,0,76
60491,234,"LICEUL CALLATIS",MANGALIA,CT,1070,12,0,0,12,29,2,0,31,44,2,0,46,47,2,0,49,48,2,0,50
63205,235,"GRADINITA NR. 5 NEPTUN",NEPTUN,CT,1385,9,0,0,9,21,2,0,23,30,26,0,56,38,34,0,72,38,34,0,72
63205,236,"GRĂDINIȚA NR. 5 NEPTUN",NEPTUN,CT,492,0,1,0,1,4,5,0,9,6,7,0,13,6,8,0,14,6,8,0,14
60856,237,"CASA DE CULTURĂ“I.N.ROMAN”",MEDGIDIA,CT,831,14,0,0,14,43,6,0,49,58,6,0,64,71,10,0,81,73,10,0,83
60856,238,"GRĂDINIŢA NR.1 -BILINGVĂ ROMANO-TURCA",MEDGIDIA,CT,790,10,3,0,13,23,4,0,27,35,5,0,40,42,5,0,47,42,5,0,47
60856,239,"GRADINITA NR.1",MEDGIDIA,CT,848,8,0,0,8,14,0,0,14,21,1,0,22,25,1,0,26,27,4,0,31
60856,240,"ŞCOALA ""MIHAIL SADOVEANU""",MEDGIDIA,CT,925,1,2,0,3,6,2,0,8,12,2,0,14,27,4,0,31,29,4,0,33
60856,241,"ŞCOALA ""MIHAIL SADOVEANU""",MEDGIDIA,CT,1472,4,5,0,9,10,5,0,15,18,5,0,23,23,5,0,28,24,5,0,29
60856,242,"SALA DE SPORT -ŞCOALA ""MIHAIL SADOVEANU""",MEDGIDIA,CT,1130,1,4,0,5,5,4,0,9,14,4,0,18,20,4,0,24,20,5,0,25
60856,243,"GRĂDINIŢA NR.8",MEDGIDIA,CT,1374,6,0,0,6,23,0,0,23,29,0,0,29,43,0,0,43,44,0,0,44
60856,244,"LICEUL TEHNOLOGIC ""DRAGOMIR HURMUZESCU""",MEDGIDIA,CT,1280,12,3,0,15,24,3,0,27,41,3,0,44,52,3,0,55,54,3,0,57
60856,245,"ŞCOALA “CONSTANTIN BRÂNCUŞI”",MEDGIDIA,CT,1028,8,0,0,8,23,0,0,23,28,0,0,28,33,0,0,33,33,0,0,33
60856,246,"ŞCOALA “CONSTANTIN BRÂNCUŞI”",MEDGIDIA,CT,1022,13,2,0,15,35,5,0,40,43,5,0,48,60,5,0,65,63,6,0,69
60856,247,"LICEUL TEORETIC “NICOLAE BĂLCESCU”",MEDGIDIA,CT,844,10,0,0,10,19,0,0,19,23,0,0,23,29,0,0,29,33,0,0,33
60856,248,"LICEUL TEORETIC “NICOLAE BĂLCESCU”",MEDGIDIA,CT,788,7,3,0,10,19,3,0,22,27,3,0,30,36,3,0,39,41,3,0,44
60856,249,"SCOALA ""MIRCEA DRAGOMIRESCU""",MEDGIDIA,CT,844,13,2,0,15,40,2,0,42,60,3,0,63,68,3,0,71,70,4,0,74
60856,250,"ŞCOALA “MIRCEA DRAGOMIRESCU”",MEDGIDIA,CT,797,10,0,0,10,18,3,0,21,26,4,0,30,36,4,0,40,39,5,0,44
60856,251,"ŞCOALA GIMNAZIALĂ ""MIRCEA DRAGOMIRESCU""",MEDGIDIA,CT,1248,5,0,0,5,41,0,0,41,49,0,0,49,59,0,0,59,62,0,0,62
60856,252,"GRĂDINIŢA NR.2",MEDGIDIA,CT,901,12,0,0,12,28,0,0,28,41,0,0,41,52,0,0,52,52,0,0,52
60856,253,"GRĂDINIŢA NR.11",MEDGIDIA,CT,774,15,1,0,16,46,1,0,47,58,2,0,60,64,2,0,66,70,2,0,72
60856,254,"COLEGIUL ""KEMAL ATATURK""",MEDGIDIA,CT,964,9,4,0,13,22,7,0,29,28,8,0,36,32,8,0,40,36,8,0,44
60856,255,"HOTEL ""STADION""",MEDGIDIA,CT,879,8,0,0,8,22,0,0,22,33,0,0,33,41,0,0,41,44,0,0,44
60856,256,"HOTEL ""STADION""",MEDGIDIA,CT,903,11,3,0,14,19,3,0,22,33,4,0,37,44,4,0,48,49,4,0,53
60856,257,"HOTEL ""STADION""",MEDGIDIA,CT,1065,6,0,0,6,23,0,0,23,31,0,0,31,68,0,0,68,68,0,0,68
60856,258,"ANEXA - COLEGIUL ""KEMAL ATATURK""",MEDGIDIA,CT,937,10,1,0,11,23,1,0,24,35,1,0,36,42,1,0,43,45,1,0,46
60856,259,"ANEXA - COLEGIUL ""KEMAL ATATURK""",MEDGIDIA,CT,771,12,2,0,14,29,3,0,32,30,3,0,33,38,4,0,42,38,4,0,42
60856,260,"ŞCOALA “LUCIAN GRIGORESCU”",MEDGIDIA,CT,1076,18,0,0,18,39,1,0,40,49,5,0,54,55,5,0,60,57,5,0,62
60856,261,"ŞCOALA “LUCIAN GRIGORESCU”",MEDGIDIA,CT,636,8,3,0,11,33,3,0,36,39,3,0,42,47,3,0,50,47,3,0,50
60856,262,"PF AGIOMER MUZECHIR",MEDGIDIA,CT,707,6,3,0,9,12,3,0,15,18,3,0,21,24,3,0,27,29,4,0,33
60856,263,"ŞCOALA “I.L.CARAGIALE”",MEDGIDIA,CT,1008,5,5,0,10,14,8,0,22,31,8,0,39,55,10,0,65,63,10,0,73
60856,264,"SCOALA ""I.L.CARAGIALE""",MEDGIDIA,CT,1068,8,0,0,8,20,0,0,20,35,0,0,35,44,0,0,44,44,0,0,44
60856,265,"SCOALA ""I.L.CARAGIALE""",MEDGIDIA,CT,1039,3,1,0,4,20,2,0,22,41,4,0,45,56,4,0,60,56,4,0,60
60856,266,"COLEGIUL TEHNIC ""NICOLAE TITULESCU""",MEDGIDIA,CT,1017,12,0,0,12,31,0,0,31,50,0,0,50,72,0,0,72,80,1,0,81
60856,267,"COLEGIUL TEHNIC ""NICOLAE TITULESCU""",MEDGIDIA,CT,1273,9,1,0,10,21,1,0,22,35,1,0,36,62,1,0,63,73,1,0,74
60856,268,"ŞCOALA “SPIRU HARET”",MEDGIDIA,CT,1057,8,1,0,9,20,1,0,21,40,3,0,43,56,3,0,59,57,3,0,60
60856,269,"ŞCOALA “SPIRU HARET”",MEDGIDIA,CT,1218,4,0,0,4,19,0,0,19,33,2,0,35,52,3,1,56,53,5,1,59
60856,270,"ŞCOALA “SPIRU HARET”",MEDGIDIA,CT,1253,15,2,0,17,35,3,0,38,47,3,0,50,53,3,0,56,59,3,0,62
60856,271,"GRADINIŢA NR.7",MEDGIDIA,CT,1353,10,1,0,11,31,2,0,33,51,2,0,53,84,4,0,88,86,4,0,90
60874,272,"ŞCOALA “IULIU PRODAN”","VALEA DACILOR",CT,1244,10,3,0,13,19,3,0,22,25,5,0,30,31,5,0,36,31,5,0,36
60865,273,"S.C. ""MAXICOMP"" SRL","REMUS OPREANU",CT,295,7,1,0,8,12,2,0,14,15,2,0,17,22,3,0,25,24,3,0,27
61078,274,"ȘCOALA GENERALĂ NR 1 BĂNEASA",BĂNEASA,CT,1014,4,4,0,8,9,6,0,15,22,6,0,28,22,6,0,28,22,6,0,28
61078,275,"LICEUL TEORETIC BĂNEASA",BĂNEASA,CT,1741,6,4,0,10,16,7,0,23,23,7,0,30,34,8,0,42,40,9,0,49
61096,276,"ȘCOALA GENERALĂ NEGURENI",NEGURENI,CT,575,1,3,0,4,2,5,0,7,2,8,0,10,5,8,0,13,6,8,0,14
61087,277,"ȘCOALA GENERALĂ FĂUREI",FĂUREI,CT,976,0,0,0,0,2,1,0,3,3,1,0,4,17,1,0,18,22,1,0,23
60785,278,"ŞCOALA GIMNAZIALĂNR. 1",CERNAVODĂ,CT,1725,8,0,0,8,23,0,0,23,32,0,0,32,43,0,0,43,45,1,0,46
60785,279,"ŞCOALA GIMNAZIALĂ NR. 1",CERNAVODĂ,CT,1380,8,1,0,9,20,1,0,21,27,5,0,32,39,8,0,47,40,8,0,48
60785,280,"GRĂDINIŢA CU PROGRAM PRELUNGIT ,,PANSELUŢA''",CERNAVODĂ,CT,1606,17,0,0,17,29,0,0,29,29,0,0,29,46,2,0,48,50,2,0,52
60785,281,"ŞCOALA GIMNAZIALĂ NR. 2",CERNAVODĂ,CT,1420,6,4,0,10,20,4,0,24,25,4,0,29,38,4,0,42,47,4,0,51
60785,282,"LICEUL TEORETIC ANGHEL SALIGNY",CERNAVODĂ,CT,1591,10,0,0,10,28,0,0,28,32,0,0,32,38,0,0,38,38,0,0,38
60785,283,"LICEUL TEORETIC ANGHEL SALIGNY",CERNAVODĂ,CT,1572,20,2,0,22,37,6,0,43,38,8,0,46,54,13,0,67,57,13,0,70
60785,284,"GRĂDINIŢA CU PROGRAM PRELUNGIT NR. 4",CERNAVODĂ,CT,1407,9,0,0,9,17,1,0,18,20,1,0,21,28,1,0,29,29,1,0,30
60785,285,"CREŞA DIN STRADA TUDOR VLADIMIRESCU",CERNAVODĂ,CT,1000,4,0,0,4,12,3,0,15,17,3,0,20,28,3,0,31,35,3,0,38
60785,286,"LICEUL TEHNOLOGIC AXIOPOLIS CERNAVODĂ",CERNAVODĂ,CT,1489,6,4,0,10,17,4,0,21,25,5,0,30,43,7,0,50,48,8,0,56
60785,287,"LICEUL TEHNOLOGIC AXIOPOLIS CERNAVODĂ",CERNAVODĂ,CT,1212,9,0,0,9,19,0,0,19,29,1,0,30,34,2,0,36,37,2,0,39
60785,288,"ŞCOALA GIMNAZIALĂ MIRCEA ELIADE",CERNAVODĂ,CT,1135,4,4,0,8,20,10,0,30,27,12,0,39,38,12,0,50,41,12,0,53
60464,289,"LICEUL CARMEN SILVA EFORIE SUD","EFORIE SUD",CT,1465,6,2,0,8,18,3,0,21,25,5,0,30,32,12,0,44,34,17,0,51
60464,290,"SEDIUL POLITIEI LOCALE EFORIE SUD","EFORIE SUD",CT,1573,11,10,0,21,22,13,0,35,39,16,0,55,51,26,0,77,54,30,0,84
60464,291,"GRĂDINIȚA DE COPII EFORIE SUD","EFORIE SUD",CT,1003,18,3,0,21,40,10,0,50,49,11,0,60,58,11,0,69,61,11,0,72
60473,292,"HOTEL ”TRAIAN” EFORIE NORD","EFORIE NORD",CT,1402,7,53,0,60,20,92,0,112,35,115,0,150,48,124,0,172,48,125,0,173
60473,293,"SALA DE SPORTEFORIE NORD","EFORIE NORD",CT,1550,8,6,0,14,28,17,0,45,42,22,0,64,66,25,0,91,73,30,0,103
60473,294,"ȘCOALA GENERALĂ EFORIE NORD","EFORIE NORD",CT,1610,10,17,0,27,36,49,0,85,55,68,0,123,61,95,0,156,64,96,0,160
60473,295,"ȘCOALA GENERALĂ EFORIE NORD","EFORIE NORD",CT,693,11,6,0,17,16,8,0,24,21,11,0,32,32,17,0,49,34,17,0,51
60810,296,"CASA DE CULTURA",HÂRŞOVA,CT,803,8,2,0,10,22,2,0,24,27,2,0,29,41,3,0,44,42,3,0,45
60810,297,"LICEUL TEORETIC ""IOAN COTOVU""",HÂRŞOVA,CT,1336,11,2,0,13,18,2,0,20,26,2,0,28,32,3,0,35,33,3,0,36
60810,298,"CENTRUL PERMANENT PENTRU PERSOANE ABUZATE",HÂRŞOVA,CT,1230,11,2,0,13,33,2,0,35,43,3,0,46,53,3,0,56,58,3,0,61
60810,299,"ŞCOALA PORT HÂRŞOVA",HÂRŞOVA,CT,1185,5,0,0,5,17,0,0,17,18,0,0,18,23,0,0,23,23,0,0,23
60810,300,"ŞCOALA GIMNAZIALĂ NR. 1",HÂRŞOVA,CT,1155,3,0,0,3,12,5,0,17,15,6,0,21,18,6,0,24,20,6,0,26
60810,301,"R.A. ROMSILVA - OCOLUL SILVIC HÎRȘOVA",HÂRŞOVA,CT,1430,14,0,0,14,19,0,0,19,21,0,0,21,29,2,0,31,31,2,0,33
60810,302,"GRADINIŢA VAROŞ",HÂRŞOVA,CT,1288,5,4,0,9,10,4,0,14,14,4,0,18,21,4,0,25,22,4,0,26
60829,303,"ŞCOALA PRIMARĂ VADU OII","VADU OII",CT,316,5,3,0,8,6,3,0,9,7,3,0,10,7,3,0,10,7,3,0,10
62379,304,"LICEUL TEORETIC MURFATLAR",MURFATLAR,CT,1417,13,0,0,13,33,0,0,33,45,0,0,45,61,0,0,61,71,0,0,71
62379,305,"LICEUL TEORETIC MURFATLAR",MURFATLAR,CT,1193,15,3,0,18,28,3,0,31,33,3,0,36,50,4,0,54,55,4,0,59
62379,306,"SALA DE SPORT",MURFATLAR,CT,1214,5,3,0,8,15,3,0,18,26,3,0,29,40,3,0,43,40,5,0,45
62379,307,"ȘCOALA GENERALĂ NR.2 MURFATLAR",MURFATLAR,CT,1789,12,2,0,14,40,3,0,43,50,3,0,53,63,6,0,69,68,6,0,74
62379,308,"CLUB TINERET MURFATLAR",MURFATLAR,CT,1528,21,3,0,24,37,3,0,40,47,3,0,50,71,3,0,74,75,3,0,78
62379,309,"S.C.U.G S.A. MURFATLAR",MURFATLAR,CT,1009,6,3,0,9,12,3,0,15,25,3,0,28,28,3,0,31,28,3,0,31
62388,310,"CĂMIN CULTURAL SIMINOC",SIMINOC,CT,996,4,0,0,4,15,1,0,16,30,1,0,31,36,1,0,37,40,1,0,41
60516,311,"GRĂDINIȚA ,,PEȘTIȘORUL DE AUR""",NĂVODARI,CT,1608,23,0,0,23,51,1,0,52,74,2,0,76,89,2,0,91,103,2,0,105
60516,312,"LICEUL TEHNOLOGIC „LAZĂR EDELEANU""",NĂVODARI,CT,1366,6,0,0,6,29,0,0,29,45,1,0,46,57,3,0,60,63,3,0,66
60516,313,"LICEUL TEHNOLOGIC „LAZĂR EDELEANU""",NĂVODARI,CT,1242,7,11,0,18,12,12,0,24,22,12,0,34,30,13,0,43,33,14,0,47
60516,314,"LICEUL TEHNOLOGIC „LAZĂR EDELEANU""",NĂVODARI,CT,1791,11,0,0,11,33,3,0,36,43,3,0,46,66,3,0,69,70,3,0,73
60516,315,"LICEUL TEHNOLOGIC „LAZĂR EDELEANU""",NĂVODARI,CT,1567,20,0,0,20,38,0,0,38,60,0,0,60,71,2,0,73,74,2,0,76
60516,316,"ŞCOALA GIMNAZIALĂ „GEORGE ENESCU""",NĂVODARI,CT,1659,16,1,0,17,48,4,0,52,71,5,0,76,87,6,0,93,89,7,0,96
60516,317,"ŞCOALA GIMNAZIALĂ „GEORGE ENESCU""",NĂVODARI,CT,1723,15,1,0,16,34,4,0,38,45,4,0,49,71,4,0,75,73,4,0,77
60516,318,"ŞCOALA GIMNAZIALĂ „GEORGE ENESCU""",NĂVODARI,CT,1679,4,0,0,4,27,2,0,29,48,2,0,50,72,2,0,74,78,3,0,81
60516,319,"ŞCOALA GIMNAZIALĂ „GRIGORE MOISIL""",NĂVODARI,CT,1635,6,0,0,6,33,2,0,35,48,3,0,51,59,4,0,63,62,4,0,66
60516,320,"ŞCOALA GIMNAZIALĂ „GRIGORE MOISIL""",NĂVODARI,CT,1325,6,0,0,6,19,1,0,20,20,1,0,21,33,1,0,34,34,1,0,35
60516,321,"ŞCOALA GIMNAZIALĂ „GRIGORE MOISIL""",NĂVODARI,CT,1349,8,1,0,9,23,1,0,24,43,2,0,45,58,3,0,61,67,3,0,70
60516,322,"GRĂDINIȚA„ALBATROS""",NĂVODARI,CT,1677,11,3,0,14,34,4,0,38,55,10,0,65,62,11,0,73,65,12,0,77
60516,323,"CLUBUL SINDICATULUI „PETROCHIMISTUL""",NĂVODARI,CT,1446,17,2,0,19,39,2,0,41,43,2,0,45,59,3,0,62,61,4,0,65
60516,324,"ŞCOALA GIMNAZIALĂ „TUDOR ARGHEZI""",NĂVODARI,CT,988,2,5,0,7,9,5,0,14,16,6,0,22,24,6,0,30,28,7,0,35
60516,325,"ŞCOALA GIMNAZIALĂ „TUDOR ARGHEZI""",NĂVODARI,CT,1065,8,1,0,9,17,3,0,20,25,3,0,28,31,5,0,36,34,5,0,39
60516,326,CASACĂSĂTORIILOR,NĂVODARI,CT,1516,14,0,0,14,35,0,0,35,62,0,0,62,69,0,0,69,74,0,0,74
60516,327,"CASA DE CULTURĂ",NĂVODARI,CT,1544,9,5,0,14,27,5,0,32,51,5,0,56,61,6,0,67,66,7,0,73
60516,328,"CASA DE CULTURĂ",NĂVODARI,CT,1803,16,4,0,20,38,5,0,43,52,9,0,61,66,11,0,77,67,11,0,78
60516,329,"CREȘA NR. 20 NĂVODARI",NĂVODARI,CT,1853,19,0,0,19,44,0,0,44,59,0,0,59,78,1,0,79,80,1,0,81
60516,330,"CLUBUL PENSIONARILOR",NĂVODARI,CT,439,6,3,0,9,13,5,0,18,21,5,0,26,26,8,0,34,26,8,0,34
60516,331,"CLĂDIRE SEDIU ADMINISTRATIV „COLOANA AUTO""",NĂVODARI,CT,1896,8,0,0,8,29,4,0,33,48,5,0,53,77,5,0,82,80,5,0,85
60516,332,"ȘCOALA PRIMARĂ NR.1 PENINSULA NĂVODARI",NĂVODARI,CT,506,3,6,0,9,12,6,0,18,20,8,0,28,31,8,0,39,32,8,0,40
60516,333,"DISPENSARUL NR.2",NĂVODARI,CT,994,19,0,0,19,45,3,0,48,57,7,0,64,63,9,0,72,68,9,0,77
60516,334,"DISPENSARUL NR.1",NĂVODARI,CT,1942,16,0,0,16,42,2,0,44,68,2,0,70,82,6,0,88,87,7,0,94
62404,335,"CASA DE CULTURĂ","NEGRU VODĂ",CT,1231,4,1,0,5,12,1,0,13,24,1,0,25,29,1,0,30,35,1,0,36
62404,336,"ŞCOALA GENERALĂ","NEGRU VODĂ",CT,1109,7,0,0,7,20,4,0,24,26,4,0,30,32,4,0,36,32,4,0,36
62404,337,"CLUB PENSIONARI","NEGRU VODĂ",CT,1260,12,1,0,13,29,3,0,32,37,3,0,40,44,3,0,47,46,8,0,54
62404,338,"GRĂDINIŢA CU PROGRAM NORMAL","NEGRU VODĂ",CT,129,0,0,0,0,1,0,0,1,3,0,0,3,3,2,0,5,3,2,0,5
62413,339,"SEDIU ADMINISTRATIV AL PRIMARIEI",DARABANI,CT,611,3,1,0,4,8,1,0,9,16,1,0,17,25,4,0,29,29,4,0,33
62431,340,"SCOALA GENERALĂ CLASELE I-IV",VÎLCELELE,CT,196,1,0,0,1,1,0,0,1,9,3,0,12,10,4,0,14,10,4,0,14
60696,341,"LICEUL TEORETIC OVIDIU",OVIDIU,CT,1914,6,4,0,10,19,4,0,23,25,5,0,30,40,5,0,45,47,5,0,52
60696,342,"LICEUL TEORETIC OVIDIU",OVIDIU,CT,1908,8,0,0,8,30,3,0,33,41,3,0,44,62,3,0,65,64,3,0,67
60696,343,"ŞCOALA NR. 2 OVIDIU",OVIDIU,CT,1694,8,0,0,8,22,4,0,26,35,5,0,40,56,6,0,62,62,7,0,69
60696,344,"ŞCOALA NR. 2 OVIDIU",OVIDIU,CT,1744,7,3,0,10,25,3,0,28,29,3,0,32,35,4,0,39,38,4,0,42
60696,345,"ŞCOALA NR. 2 OVIDIU",OVIDIU,CT,1805,8,0,0,8,31,0,0,31,47,1,0,48,61,2,0,63,63,4,0,67
60696,346,"CENTRUL CULTURAL OVIDIU",OVIDIU,CT,1834,15,0,0,15,31,6,0,37,43,7,0,50,52,8,0,60,59,11,0,70
60712,347,"CENTRUL CULTURAL ""GABRIEL COTABIȚĂ"" POIANA",POIANA,CT,862,7,0,0,7,10,1,0,11,13,1,0,14,21,2,0,23,29,3,0,32
63349,348,"SCOALA GENERALA DIN SATUL CULMEA",CULMEA,CT,1041,6,5,0,11,20,5,0,25,34,7,0,41,52,9,0,61,58,10,0,68
60543,349,"SALA DE SPORT",TECHIRGHIOL,CT,1831,15,20,0,35,47,70,0,117,67,100,0,167,83,110,0,193,90,123,0,213
60543,350,"GRĂDINIȚA NR.1",TECHIRGHIOL,CT,1677,14,0,0,14,29,6,0,35,43,9,0,52,59,9,0,68,64,9,0,73
60543,351,"GRĂDINIȚA NR.2",TECHIRGHIOL,CT,1890,1,0,0,1,25,0,0,25,36,2,0,38,53,3,0,56,64,5,0,69
60543,352,"LICEUL ”EMIL RACOVIȚĂ”",TECHIRGHIOL,CT,1397,7,2,0,9,15,9,0,24,23,11,0,34,32,11,0,43,38,11,0,49
60605,353,"ŞCOALA CU CLASELE I-VIII, LOCALITATEA 23 AUGUST","23 AUGUST",CT,1284,6,0,0,6,13,2,0,15,21,2,0,23,31,2,0,33,36,2,0,38
60605,354,"ŞCOALA CU CLASELE I-VIII, LOCALITATEA 23 AUGUST","23 AUGUST",CT,1280,9,0,0,9,13,0,0,13,22,0,0,22,29,0,0,29,29,0,0,29
60614,355,"ŞCOALA CU CLASELE I-VIII, LOCALITATEA DULCEŞTI",DULCEŞTI,CT,1124,6,2,0,8,11,3,0,14,12,3,0,15,22,3,0,25,24,3,0,27
60623,356,"ŞCOALA CU CLASELE I-VIII, LOCALITATEA MOŞNENI",MOŞNENI,CT,1048,2,0,0,2,3,0,0,3,6,2,0,8,12,2,0,14,12,2,0,14
60892,357,"LICEUL TEHNOLOGIC ''JEAN DINU''",ADAMCLISI,CT,962,9,0,0,9,23,0,0,23,34,2,0,36,46,3,0,49,48,9,0,57
60936,358,"CĂMIN CULTURAL ZORILE",ZORILE,CT,497,0,0,0,0,2,2,0,4,4,2,0,6,10,2,0,12,11,2,0,13
60927,359,"ȘCOALA GENERALĂ URLUIA",URLUIA,CT,288,0,2,0,2,4,2,0,6,8,2,0,10,10,4,0,14,10,4,0,14
60909,360,"ȘCOALA GENERALĂ ABRUD",ABRUD,CT,112,0,0,0,0,106,0,6,112,7,2,0,9,8,2,0,10,8,2,0,10
63269,361,"SCOALA ION BORCEA- LABORATORUL DE ISTORIE",AGIGEA,CT,1173,10,5,0,15,31,10,0,41,54,10,0,64,62,12,0,74,65,13,0,78
63269,362,"SCOALA ION BORCEA- LABORATORUL DECHIMIE",AGIGEA,CT,1182,11,4,0,15,41,6,0,47,57,14,0,71,70,17,0,87,75,18,0,93
63269,363,"GRADINITA AGIGEA-GRUPA FLUTURASILOR",AGIGEA,CT,1117,8,0,0,8,22,1,0,23,31,1,0,32,52,2,0,54,63,2,0,65
63269,364,"GRADINITA AGIGEA-GRUPA RATUSTELOR",AGIGEA,CT,1258,13,3,0,16,26,6,0,32,58,9,0,67,84,10,0,94,88,10,0,98
63269,365,"GRĂDINIŢA ""RIŢA GĂRGĂRIŢA"" AGIGEA",AGIGEA,CT,462,3,1,0,4,9,2,0,11,15,2,0,17,23,2,0,25,26,7,0,33
60589,366,"GRADINITA LAZU",LAZU,CT,1604,18,3,0,21,43,15,0,58,60,20,2,82,73,24,2,99,83,24,2,109
60954,367,"ȘCOALA GIMNAZIALĂ""ION CREANGĂ"" ALBEȘTI",ALBEŞTI,CT,1277,8,0,0,8,13,1,0,14,18,1,0,19,26,1,0,27,28,1,0,29
60963,368,"ȘCOALA PRIMARĂ NR. 2 ARSA",ARSA,CT,511,3,1,0,4,7,2,0,9,8,3,0,11,9,3,0,12,9,4,0,13
60981,369,"SCOALA GIMNAZIALĂ NR. 1COTU-VAII","COTU VĂII",CT,895,10,0,0,10,13,2,0,15,17,3,0,20,18,3,0,21,19,3,0,22
60972,370,SCOALAPRIMARĂCOROANA,COROANA,CT,95,0,0,0,0,0,0,0,0,2,1,0,3,4,3,0,7,4,3,0,7
60990,371,"ȘCOALAPRIMARĂ NR.3VÎRTOP",VÎRTOP,CT,218,4,1,0,5,5,1,0,6,9,1,0,10,12,2,0,14,12,2,0,14
61014,372,"SCOALA GIMNAZIALA ""DAN SPATARU"" ALIMAN",ALIMAN,CT,661,1,1,0,2,7,4,0,11,11,4,0,15,13,4,0,17,18,4,0,22
61032,373,"SCOALA GIMNAZIALA NR. 1 DUNARENI",DUNĂRENI,CT,1126,1,0,0,1,7,0,0,7,13,0,0,13,16,1,0,17,24,1,0,25
61050,374,"SCOALA PRIMARA NR.2 VLAHII",VLAHII,CT,408,1,0,0,1,4,0,0,4,6,0,0,6,8,0,0,8,10,1,0,11
63090,375,"ȘCOALA AMZACEA",AMZACEA,CT,1186,3,1,0,4,11,1,0,12,18,1,0,19,22,3,0,25,23,3,0,26
61489,376,"ȘCOALA GENERALĂ GENERAL SCĂRIȘOREANU","GENERAL SCĂRIŞOREANU",CT,790,4,3,0,7,7,3,0,10,14,5,0,19,16,6,0,22,16,6,0,22
61470,377,"CĂMIN CULTURAL CASICEA",CASICEA,CT,353,3,0,0,3,10,0,0,10,20,0,0,20,29,0,0,29,31,0,0,31
61648,378,"ȘCOALA GIMNAZIALĂ ”EMIL GÂRLEANU” BĂRĂGANU",BĂRĂGANU,CT,928,7,0,0,7,16,1,0,17,21,2,0,23,30,3,0,33,42,3,0,45
62164,379,"ȘCOALA GIMNAZIALĂ ”EMIL GÂRLEANU” BĂRĂGANU - ȘCOALA PRIMARĂ NR. 1 LANURILE",LANURILE,CT,749,3,0,0,3,6,1,0,7,6,1,0,7,6,1,0,7,6,1,0,7
61130,380,"CĂMINUL CULTURAL",CASTELU,CT,1155,11,2,0,13,20,2,0,22,29,2,0,31,34,2,0,36,35,2,0,37
61130,381,"CĂMINUL CULTURAL",CASTELU,CT,1357,10,1,0,11,19,1,0,20,28,1,0,29,34,1,0,35,39,3,0,42
61158,382,"CĂMIN CULTURAL",NISIPARI,CT,1560,5,6,0,11,14,12,0,26,25,12,0,37,34,13,0,47,40,13,0,53
61176,383,"CĂMINUL CULTURAL CERCHEZU",CERCHEZU,CT,416,3,0,0,3,11,1,0,12,13,3,0,16,23,5,0,28,25,5,0,30
61185,384,"CĂMINUL CULTURAL CĂSCIOARELE",CĂSCIOARELE,CT,228,1,0,0,1,8,2,0,10,15,2,0,17,21,2,0,23,21,2,0,23
61201,385,"CĂMINUL CULTURAL VIROAGA",VIROAGA,CT,389,0,0,0,0,0,1,0,1,2,6,0,8,3,7,0,10,3,7,0,10
61194,386,"CASA AGRONOMULUI MĂGURA",MĂGURA,CT,70,5,0,0,5,6,0,0,6,11,0,0,11,15,2,0,17,15,2,0,17
61229,387,"ȘCOALA GIMNAZIALĂNR.1 CHIRNOGENI",CHIRNOGENI,CT,1506,3,0,0,3,6,3,0,9,8,3,0,11,21,5,0,26,35,5,0,40
61247,388,"ȘCOALA GIMNAZIALĂ NR.2 PLOPENI",PLOPENI,CT,865,0,2,0,2,7,2,0,9,9,2,0,11,10,2,0,12,12,2,0,14
61238,389,"ŞCOALA PRIMARĂ NR.3 CREDINŢA",CREDINŢA,CT,246,2,1,0,3,2,1,0,3,4,2,0,6,7,5,0,12,8,5,0,13
61265,390,"LICEUL TEHNOLOGIC CIOBANU -SALA CLASA 1",CIOBANU,CT,1238,3,0,0,3,12,2,0,14,16,4,0,20,29,5,0,34,30,7,0,37
61265,391,"LICEUL TEHNOLOGIC CIOBANU -SALA CLASA 2",CIOBANU,CT,1296,5,0,0,5,11,0,0,11,14,0,0,14,23,0,0,23,27,0,0,27
61274,392,"SCOALA GENERALA MIORIȚA",MIORIŢA,CT,260,6,0,0,6,8,2,0,10,9,2,0,11,11,2,0,13,11,3,0,14
61292,393,"CĂMIN CULTURAL SAT CIOCÎRLIA",CIOCÎRLIA,CT,1256,18,0,0,18,33,4,0,37,46,6,0,52,52,7,0,59,57,7,0,64
61309,394,"CĂMIN CULTURAL SAT CIOCÎRLIA DE SUS","CIOCÎRLIA DE SUS",CT,1175,14,3,0,17,27,4,0,31,33,4,0,37,42,6,0,48,43,7,0,50
61327,395,"CĂMIN CULTURAL COBADIN",COBADIN,CT,1916,3,2,0,5,10,4,0,14,21,6,0,27,24,6,0,30,28,7,0,35
61327,396,"ȘCOALA TĂTARĂ COBADIN",COBADIN,CT,1792,6,1,0,7,10,1,0,11,20,6,0,26,28,8,0,36,28,8,0,36
61327,397,"SCOALA ROMANA",COBADIN,CT,1730,2,1,0,3,4,1,0,5,10,1,0,11,14,1,0,15,14,1,0,15
61336,398,"ȘCOALA GENERALĂ CONACU",CONACU,CT,290,0,0,0,0,0,0,0,0,0,1,0,1,1,1,0,2,1,1,0,2
61354,399,"CĂMIN CULTURAL NEGREȘTI",NEGREŞTI,CT,373,1,1,0,2,6,1,0,7,13,1,0,14,18,1,0,19,19,1,0,20
61363,400,"GRĂDINIȚA VIIȘOARA",VIIŞOARA,CT,1294,11,3,0,14,22,5,0,27,27,6,0,33,30,6,0,36,32,6,0,38
61381,401,"GRĂDINIȚA CU ORAR NORMAL COGEALAC",COGEALAC,CT,1587,7,1,0,8,12,4,0,16,18,5,0,23,28,5,0,33,35,5,0,40
61381,402,"SCOALA GIMNAZIALA "" CRISTEA CARAMAN""COGEALAC",COGEALAC,CT,1325,6,4,0,10,16,6,0,22,20,9,0,29,24,9,0,33,40,12,0,52
61443,403,"ȘCOALA GIMNAZIALA NUMARUL 2TARIVERDE",TARIVERDE,CT,847,5,0,0,5,9,0,0,9,14,0,0,14,16,5,0,21,16,5,0,21
61425,404,"ȘCOALA GIMNAZIALA NUMARUL 1RÂMNICU DE JOS","RÎMNICU DE JOS",CT,690,0,0,0,0,4,3,0,7,6,4,0,10,14,4,0,18,14,4,0,18
61461,405,"SCOALA CU CLASELE I-VIII COMANA",COMANA,CT,804,8,0,0,8,22,1,0,23,27,1,0,28,35,1,0,36,37,1,0,38
61504,406,"ȘCOALA GENERALĂ”NEGIP HAGI FAZAL” TĂTARU",TĂTARU,CT,531,3,0,0,3,4,0,0,4,4,0,0,4,6,0,0,6,9,0,0,9
61498,407,"ŞCOALA CU CLS. I - IV PELINU",PELINU,CT,232,1,0,0,1,2,0,0,2,2,4,0,6,4,4,0,8,4,4,0,8
61522,408,"ȘCOALA GIMNAZIALĂ ”GHEORGHE LAZĂR”",CORBU,CT,1490,9,4,0,13,20,5,0,25,43,8,0,51,51,8,0,59,54,10,0,64
61522,409,"GRĂDINIȚA CU PROGRAM NORMAL NR. 1",CORBU,CT,1389,9,1,0,10,22,4,0,26,28,4,0,32,33,9,0,42,33,9,0,42
61522,410,"CĂMIN CULTURAL CORBU DE SUS",CORBU,CT,1675,7,1,0,8,14,4,0,18,36,8,0,44,48,8,0,56,53,9,0,62
61540,411,"SCOALA PRIMARA VADU",VADU,CT,537,3,3,0,6,3,4,0,7,4,6,0,10,8,7,0,15,19,8,0,27
60749,412,"ŞCOALA GIMNAZIALĂ ""MIHAIEMINESCU"" COSTINEŞTI",COSTINEŞTI,CT,958,4,0,0,4,25,0,0,25,38,0,0,38,49,0,0,49,49,2,0,51
60758,413,"ŞCOALA PRIMARA"" ION CREANGA"" SCHITU",SCHITU,CT,1758,11,2,0,13,30,8,0,38,43,10,0,53,57,11,0,68,62,11,0,73
61568,414,"CAMIN CULTURAL CRUCEA",CRUCEA,CT,921,3,0,0,3,11,2,0,13,14,3,0,17,15,3,0,18,27,6,0,33
61595,415,"CAMIN CULTURALGĂLBIORI",GĂLBIORI,CT,254,0,0,0,0,0,0,0,0,1,0,0,1,5,0,0,5,7,0,0,7
61577,416,"ŞCOALAPRIMARĂ NR.1 BĂLTĂGEŞTI",BĂLTĂGEŞTI,CT,323,5,1,0,6,5,1,0,6,5,1,0,6,6,1,0,7,6,1,0,7
61586,417,"ŞCOALA PRIMARĂ NR.2 CRIŞAN",CRIŞAN,CT,291,1,0,0,1,4,0,0,4,4,0,0,4,6,0,0,6,6,0,0,6
61602,418,"ŞCOALA PRIMARĂ NR.4 STUPINA",STUPINA,CT,559,4,2,0,6,9,2,0,11,9,2,0,11,15,2,0,17,17,2,0,19
61611,419,"ŞCOALA PRIMARĂ NR.3 ŞIRIU",ŞIRIU,CT,175,1,0,0,1,1,0,0,1,2,0,0,2,3,0,0,3,3,0,0,3
61639,420,"LICEUL TEHNOLOGIC ""NICOLAE DUMITRESCU""",CUMPĂNA,CT,1514,15,5,0,20,34,8,0,42,50,12,0,62,63,14,0,77,65,17,0,82
61639,421,"LICEUL TEHNOLOGIC ""NICOLAE DUMITRESCU""",CUMPĂNA,CT,1855,8,4,0,12,28,13,0,41,42,13,0,55,60,14,0,74,60,14,0,74
61639,422,"LICEUL TEHNOLOGIC ""NICOLAE DUMITRESCU""",CUMPĂNA,CT,1554,16,0,0,16,50,1,0,51,63,4,0,67,76,6,0,82,76,6,0,82
61639,423,"SALA DE SPORT 1",CUMPĂNA,CT,1589,11,3,0,14,29,3,0,32,49,8,0,57,59,11,0,70,62,11,0,73
61639,424,"SALA DE SPORT 1",CUMPĂNA,CT,1940,11,0,0,11,29,1,0,30,38,1,0,39,60,1,0,61,62,4,0,66
61639,425,"GRĂDINIȚA ”FLORILOR”",CUMPĂNA,CT,1633,8,0,0,8,21,1,0,22,26,1,1,28,37,2,1,40,39,2,1,42
61639,426,"ANEXA LICEULUI TEHNOLOGIC ""NICOLAE DUMITRESCU""",CUMPĂNA,CT,1704,10,4,0,14,20,6,0,26,35,7,0,42,44,9,0,53,51,10,0,61
61149,427,"ȘCOALA GIMNAZIALĂ NR. 1","CUZA VODĂ",CT,1473,1,0,0,1,5,0,0,5,7,0,0,7,12,0,0,12,17,0,0,17
61149,428,"ŞCOALA GIMNAZIALĂ NR. 1","CUZA VODĂ",CT,1635,3,1,0,4,8,1,0,9,11,1,0,12,15,1,0,16,21,2,0,23
61684,429,"LICEUL NICOLAE ISTRATOIU",DELENI,CT,328,9,0,0,9,15,1,0,16,21,1,0,22,24,1,0,25,26,1,0,27
61700,430,"FOST SEDIU C.A.P. PIETRENI",PIETRENI,CT,692,9,0,0,9,17,0,0,17,19,0,0,19,29,1,0,30,31,1,0,32
61728,431,"SCOALA GENERALAȘIPOTELE",ŞIPOTELE,CT,424,3,1,0,4,6,1,0,7,8,1,0,9,15,3,0,18,18,3,0,21
61693,432,FOSTSEDIUC.A.P.PETROŞANI,PETROŞANI,CT,455,7,1,0,8,12,1,0,13,17,4,0,21,35,5,0,40,41,5,0,46
61746,433,"CĂMINUL CULTURAL DOBROMIR -",DOBROMIR,CT,715,5,1,0,6,11,1,0,12,42,1,0,43,115,1,0,116,127,2,0,129
61764,434,"ȘCOALA GEN CU CLS. I - IV DOBROMIR DEAL","DOBROMIRU DIN DEAL",CT,264,2,3,0,5,5,3,0,8,6,3,0,9,6,5,0,11,6,5,0,11
61773,435,"ȘCOALA GEN CU CLS. I - IV LESPEZI",LESPEZI,CT,373,3,0,0,3,11,0,0,11,26,0,0,26,68,0,0,68,76,0,0,76
61791,436,"ȘCOALA GEN CU CLS. I - IV VĂLENI",VĂLENI,CT,618,0,0,0,0,8,0,0,8,17,0,0,17,141,6,0,147,147,6,0,153
61782,437,"ȘCOALA GEN CU CLS. I - IV PĂDURENI",PĂDURENI,CT,117,0,0,0,0,0,0,0,0,1,2,0,3,1,2,0,3,1,3,0,4
61755,438,"SCOALA GENERALA SAT CETATEA",CETATEA,CT,177,1,0,0,1,2,0,0,2,6,0,0,6,9,0,0,9,10,0,0,10
61899,439,"CĂMINUL CULTURAL DUMBRĂVENI",DUMBRĂVENI,CT,376,6,4,0,10,10,4,0,14,14,4,0,18,19,13,0,32,21,13,0,34
61915,440,"GRĂDINIȚA DE COPII FURNICA",FURNICA,CT,52,2,1,0,3,8,2,0,10,10,5,0,15,10,13,0,23,11,14,0,25
61407,441,"ȘCOALAGIMNAZIALA NR.1 FÂNTÂNELE",FÎNTÎNELE,CT,1310,8,1,0,9,19,1,0,20,26,2,0,28,28,3,0,31,30,4,0,34
61817,442,"CENTRUL CULTURAL DUNĂREA VECHE DIN COMUNA GÂRLICIU",GÂRLICIU,CT,1298,1,1,0,2,5,2,0,7,7,2,0,9,10,2,0,12,19,2,0,21
61853,443,"SCOALA GIMNAZIALA ""SA ESENIN"" GHINDARESTI",GHINDĂREŞTI,CT,1132,4,1,0,5,6,1,0,7,6,3,0,9,9,3,0,12,9,3,0,12
61853,444,"SCOALA GIMNAZIALA ""SA ESENIN"" GHINDARESTI",GHINDĂREŞTI,CT,1105,4,1,0,5,5,1,0,6,5,1,0,6,9,1,0,10,12,1,0,13
63027,445,"GRĂDINIȚA P+M GRĂDINA",GRĂDINA,CT,583,7,0,0,7,10,0,0,10,24,0,0,24,34,0,0,34,40,1,0,41
63018,446,"GRADINITA CU PROGRAM NORMALCHEIA",CHEIA,CT,295,8,0,0,8,13,2,0,15,15,6,0,21,18,6,0,24,18,6,0,24
61835,447,"CĂMIN CULTURAL HORIA",HORIA,CT,698,3,1,0,4,5,13,0,18,8,13,0,21,13,17,0,30,16,17,0,33
61862,448,"ȘCOALA SAT TICHILEȘTI CORP B (NOU)",TICHILEŞTI,CT,274,4,0,0,4,6,1,0,7,8,2,0,10,10,3,0,13,10,3,0,13
61880,449,"LICEUL TEHNOLOGIC",INDEPENDENŢA,CT,980,0,0,0,0,7,1,0,8,8,1,0,9,10,1,0,11,10,1,0,11
61924,450,"SCOALA GENERALĂ","MOVILA VERDE",CT,507,0,0,0,0,4,0,0,4,6,0,0,6,9,0,0,9,10,0,0,10
61933,451,"SCOALA GENERALĂ",OLTENI,CT,315,8,1,0,9,9,2,0,11,10,2,0,12,10,2,0,12,10,2,0,12
61942,452,"SCOALA GENERALĂ",TUFANI,CT,266,0,0,0,0,3,0,0,3,7,2,0,9,10,2,0,12,11,2,0,13
61906,453,"SCOALA GENERALĂ","FÎNTÎNA MARE",CT,291,4,0,0,4,8,0,0,8,8,0,0,8,10,0,0,10,10,0,0,10
61960,454,"ŞCOALA GIMNAZIALĂ NR.1 ION CORVIN, LOC. ION CORVIN","ION CORVIN",CT,504,11,3,0,14,16,4,0,20,17,7,0,24,21,7,0,28,23,10,0,33
62011,455,"ŞCOALA GIMNAZIALĂ NR. 2 VIILE, LOC. VIILE",VIILE,CT,787,8,0,0,8,13,0,0,13,24,1,2,27,28,2,2,32,32,2,2,36
62002,456,"GRĂDINIȚA CU PROGRAM NORMAL RARIȘTEA, LOC. RARIȘTEA",RARIŞTEA,CT,195,0,2,0,2,0,3,0,3,4,4,0,8,5,4,0,9,5,4,0,9
61988,457,"ŞCOALA CRÎNGU",CRÎNGU,CT,78,3,0,0,3,7,3,0,10,7,3,0,10,10,3,0,13,10,3,0,13
62039,458,"ȘCOALA GIMNAZIALĂ NR. 1ISTRIA",ISTRIA,CT,1109,8,1,0,9,13,3,0,16,22,4,0,26,30,4,0,34,31,4,0,35
62048,459,"ȘCOALA GIMNAZIALĂ NR. 2 NUNTAȘI",NUNTAŞI,CT,868,1,0,0,1,2,0,0,2,10,0,0,10,18,3,0,21,18,3,0,21
60641,460,"SCOALA GENERALĂ CU CLS. I – VIII LIMANU",LIMANU,CT,1366,5,0,0,5,12,0,0,12,18,0,0,18,22,1,0,23,22,3,0,25
60641,461,"SCOALA GENERALĂ CU CLS. I – VIII LIMANU",LIMANU,CT,1403,6,0,0,6,19,0,0,19,24,0,0,24,33,2,0,35,36,3,0,39
60669,462,"SCOALA GENERALĂ CU CLS. I – VIII 2MAI","2 MAI",CT,1251,2,0,0,2,7,1,0,8,12,2,0,14,23,9,0,32,28,9,0,37
60669,463,"SCOALA GENERALĂ CU CLS. I – VIII 2MAI","2 MAI",CT,1446,12,0,0,12,21,4,0,25,22,4,0,26,27,5,0,32,31,5,0,36
62066,464,"CAMIN CULTURAL LIPNITA",LIPNIŢA,CT,766,2,5,0,7,4,7,0,11,14,15,0,29,15,15,0,30,16,15,0,31
62093,465,"ȘCOALA CU CLASELE I - VIII COSLUGEA",COSLUGEA,CT,616,7,1,0,8,8,2,0,10,9,2,0,11,11,2,0,13,13,2,0,15
62075,466,"CĂMINUL CULTURAL CANLIA",CANLIA,CT,424,2,2,0,4,5,2,0,7,12,2,0,14,15,2,0,17,16,2,0,18
62084,467,"ȘCOALA GENERALĂ CARVĂN",CARVĂN,CT,338,2,2,0,4,3,3,0,6,4,3,0,7,7,5,0,12,7,5,0,12
62128,468,"ȘCOALA GENERALĂ CU CLASELEI - IVIZVOARELE",IZVOARELE,CT,96,8,2,0,10,8,2,0,10,11,8,0,19,12,10,0,22,13,10,0,23
62119,469,"ȘCOALA GENERALĂ CU CLASELEI - IVGORUNI",GORUNI,CT,80,5,3,0,8,6,3,0,9,8,3,0,11,10,3,0,13,10,3,0,13
62100,470,"ȘCOALA GENERALĂ CU CLASELEI - IVCUIUGIUC",CUIUGIUC,CT,153,1,0,0,1,2,0,0,2,5,5,0,10,12,5,0,17,12,5,0,17
60703,471,"ȘCOALA VECHE LUMINA",LUMINA,CT,1975,5,1,0,6,33,4,0,37,42,7,0,49,56,7,0,63,59,8,0,67
60703,472,"ȘCOALA NOUĂLUMINA",LUMINA,CT,1985,6,0,0,6,23,0,0,23,25,0,0,25,39,1,0,40,42,1,0,43
60703,473,"GRĂDINIȚA LUMINA",LUMINA,CT,1937,8,0,0,8,20,4,0,24,30,10,0,40,37,11,0,48,41,11,0,52
60703,474,"CĂMINUL CULTURAL LUMINA",LUMINA,CT,1940,3,3,0,6,14,8,0,22,26,15,0,41,43,16,0,59,45,17,0,62
62217,475,"ȘCOALA OITUZ",OITUZ,CT,693,5,1,0,6,5,1,0,6,9,1,0,10,9,1,0,10,9,1,0,10
62244,476,"ȘCOALA SIBIOARA",SIBIOARA,CT,349,11,1,0,12,18,1,0,19,19,3,0,22,23,4,0,27,23,4,0,27
62146,477,"SCOALA GIMNAZIALA NICHITA STANESCU",MERENI,CT,1110,10,1,0,11,12,1,0,13,15,1,0,16,22,1,0,23,23,1,0,24
62182,478,"ŞCOALACU CLASELEI - VIII",OSMANCEA,CT,474,2,0,0,2,8,0,0,8,10,0,0,10,17,0,0,17,18,0,0,18
62155,479,"ŞCOALACU CLASELE I -IV",CIOBĂNIŢA,CT,227,1,0,0,1,8,2,0,10,13,2,0,15,14,4,0,18,14,4,0,18
62262,480,"LICEULTEHNOLOGIC ,, MIHAI VITEAZUL""","MIHAI VITEAZU",CT,1560,4,0,0,4,10,0,0,10,17,0,0,17,22,0,0,22,22,0,0,22
62271,481,"SCOALA CU CLASELE I-VII SINOE",SINOIE,CT,1172,6,1,0,7,8,1,0,9,18,1,0,19,21,1,0,22,21,1,0,22
62208,482,"GRĂDINIŢA DOMINO","MIHAIL KOGĂLNICEANU",CT,1359,4,3,0,7,13,3,0,16,21,6,0,27,28,8,0,36,29,8,0,37
62208,483,"GRĂDINIŢA PINOCHIO","MIHAIL KOGĂLNICEANU",CT,1151,3,0,0,3,9,0,0,9,10,1,0,11,16,1,0,17,20,1,0,21
62208,484,"ŞCOALA GENERALĂ NR.2","MIHAIL KOGĂLNICEANU",CT,1248,9,0,0,9,19,3,0,22,27,6,0,33,32,6,0,38,32,6,0,38
62208,485,"LICEUL TEORETIC MIHAIL KOGĂLNICEANU","MIHAIL KOGĂLNICEANU",CT,1418,7,3,0,10,18,4,0,22,27,4,0,31,31,4,0,35,35,4,0,39
62208,486,"GRĂDINIŢA PITICOT","MIHAIL KOGĂLNICEANU",CT,800,11,0,0,11,16,3,0,19,20,4,0,24,25,4,0,29,26,4,0,30
62208,487,"GRĂDINIŢA PITICOT","MIHAIL KOGĂLNICEANU",CT,779,13,0,0,13,22,1,0,23,28,1,0,29,46,1,0,47,51,1,0,52
62208,488,"ŞCOALA GENERALĂ CERES","MIHAIL KOGĂLNICEANU",CT,383,3,0,0,3,8,1,0,9,10,1,0,11,13,1,0,14,13,1,0,14
62235,489,"UNITATEA AGRICOLĂ SIBIOARA, CENTRUL PENTRU TINERET",PIATRA,CT,256,2,0,0,2,3,0,0,3,4,0,0,4,4,0,0,4,5,0,0,5
62235,490,"CĂMINUL CULTURAL",PIATRA,CT,701,0,2,0,2,3,3,0,6,6,3,0,9,8,4,0,12,8,4,0,12
62226,491,"ŞCOALA GENERALĂ","PALAZU MIC",CT,266,1,0,0,1,1,4,0,5,1,5,0,6,2,6,0,8,2,6,0,8
62299,492,"ŞCOALA GIMNAZIALĂ NR.1 MIRCEA VODĂ","MIRCEA VODĂ",CT,1691,8,0,0,8,19,0,0,19,29,1,0,30,50,3,0,53,54,3,0,57
62333,493,"ȘCOALA GIMNAZIALĂ NR.2 SATU NOU","SATU NOU",CT,1016,4,0,0,4,8,1,0,9,12,2,0,14,23,2,0,25,28,2,0,30
62333,494,"ȘCOALA GIMNAZIALĂ NR.2 SATU NOU","SATU NOU",CT,1261,13,0,0,13,22,0,0,22,25,0,0,25,41,1,0,42,41,1,0,42
62459,495,"LICEUL ”I.C. BRĂTIANU” NICOLAE BĂLCESCU","NICOLAE BĂLCESCU",CT,1314,6,0,0,6,17,1,0,18,20,1,0,21,29,1,0,30,30,1,0,31
62459,496,"LICEUL ”I.C. BRĂTIANU” NICOLAE BĂLCESCU","NICOLAE BĂLCESCU",CT,1481,8,1,0,9,15,1,0,16,21,4,0,25,33,5,0,38,33,6,0,39
62468,497,"ȘCOALA GENERALĂ DOROBANȚU",DOROBANŢU,CT,1516,3,0,0,3,21,0,0,21,32,0,0,32,36,0,0,36,36,0,0,36
62495,498,"ȘCOALAGIMNAZIALĂNR. 1 OLTINA",OLTINA,CT,1426,10,0,0,10,14,4,0,18,23,5,0,28,28,7,0,35,31,8,0,39
62501,499,"ȘCOALA GIMNAZIALĂ NR. 2RĂZOARELE",RĂZOARELE,CT,507,0,0,0,0,2,0,0,2,5,0,0,5,10,8,0,18,12,8,0,20
62510,500,"ȘCOALA CU CLS. I - IVSATU NOU","SATU NOU",CT,161,1,1,0,2,4,1,0,5,4,1,0,5,6,1,0,7,6,1,0,7
62547,501,"LICEUL ""REGELE CAROL I"" OSTROV",OSTROV,CT,963,0,0,0,0,4,0,0,4,9,0,0,9,14,0,0,14,16,0,0,16
62547,502,"LICEUL ""REGELE CAROL I""OSTROV",OSTROV,CT,1122,4,0,0,4,12,6,0,18,18,8,0,26,27,11,0,38,29,11,0,40
62556,503,"CĂMIN CULTURAL ALMĂLĂU",ALMĂLĂU,CT,684,2,3,0,5,10,3,0,13,14,3,0,17,18,6,0,24,18,6,0,24
62574,504,"ȘCOALA GENERALĂ ESECHIOI",ESECHIOI,CT,191,1,1,0,2,5,3,0,8,6,3,0,9,12,3,0,15,14,3,0,17
62592,505,"CĂMIN CULTURAL GÎRLIȚA",GÎRLIŢA,CT,241,4,0,0,4,11,0,0,11,16,1,0,17,23,2,0,25,25,2,0,27
62583,506,"CĂMIN CULTURAL GALIȚA",GALIŢA,CT,559,3,3,0,6,9,3,0,12,17,6,0,23,26,7,0,33,28,7,0,35
62565,507,"CAMIN CULTURAL BUGEAC",BUGEAC,CT,155,2,2,0,4,8,2,0,10,8,3,0,11,8,3,0,11,8,3,0,11
62618,508,"ȘCOALA GIMNAZIALĂ NR.1PANTELIMON",PANTELIMON,CT,590,6,0,0,6,13,0,0,13,15,0,0,15,17,0,0,17,20,0,0,20
62645,509,"ȘCOALA CU CLS. I - IV PANTELIMON DE JOS","PANTELIMON DE JOS",CT,217,3,1,0,4,3,1,0,4,5,1,0,6,5,1,0,6,5,1,0,6
62654,510,"ȘCOALA CU CLS. I - IVRUNCU",RUNCU,CT,347,1,0,0,1,6,2,0,8,8,2,0,10,12,2,0,14,15,3,0,18
62636,511,"ȘCOALA CU CLS. I - IVNISTOREȘTI",NISTOREŞTI,CT,233,0,0,0,0,2,1,0,3,4,2,0,6,6,2,0,8,6,2,0,8
62681,512,"CĂMIN CULTURAL PECINEAGA",PECINEAGA,CT,1298,6,4,0,10,14,4,0,18,21,5,0,26,30,5,0,35,31,5,0,36
62681,513,"ŞCOALA GIMNAZIALĂ NR.1PECINEAGA",PECINEAGA,CT,1369,7,0,0,7,13,0,0,13,16,1,0,17,19,7,0,26,24,8,0,32
62716,514,"ŞCOALA PEŞTERA-SALA DE SPORT",PEŞTERA,CT,1544,9,0,0,9,11,0,0,11,18,0,0,18,30,3,0,33,35,5,0,40
62725,515,"CAMIN CULTURAL IVRINEZU MARE","IVRINEZU MARE",CT,710,3,0,0,3,6,2,0,8,8,4,0,12,12,4,0,16,15,5,0,20
62743,516,"SCOALA PRIMARA NR.3","IZVORU MARE",CT,593,3,0,0,3,12,5,0,17,18,7,0,25,24,8,0,32,26,8,0,34
62770,517,"SCOALA PUBLICA NR. 1 CLASA IB","POARTA ALBĂ",CT,1514,12,0,0,12,24,2,0,26,28,2,134,164,40,2,134,176,49,2,134,185
62770,518,"SCOALA PUBLICA NR. 1 CLASA IA","POARTA ALBĂ",CT,1410,1,1,0,2,9,2,0,11,17,4,192,213,30,4,192,226,30,4,192,226
62770,519,"COLEGIUL AGRICOL POARTA ALBĂ CORP B CLASA A IV A","POARTA ALBĂ",CT,1001,3,0,0,3,11,1,0,12,26,4,151,181,41,5,151,197,45,5,151,201
62789,520,"SCOALA PRIMARA",NAZARCEA,CT,424,0,0,0,0,5,0,0,5,9,0,0,9,20,0,0,20,20,0,0,20
62805,521,"SCOALA GIMNAZIALA NR.2 RASOVA",RASOVA,CT,1095,5,0,0,5,8,0,0,8,10,0,0,10,12,0,0,12,14,0,0,14
62805,522,"SCOALA GIMNAZIALA NR.2 RASOVA",RASOVA,CT,929,3,0,0,3,6,0,0,6,8,0,0,8,12,0,0,12,12,0,0,12
62814,523,"SCOALA GIMNAZIALA COCHIRLENI",COCHIRLENI,CT,927,9,2,0,11,11,2,0,13,13,2,0,15,17,2,0,19,18,2,0,20
62306,524,"SCOALA PRIMARA NR 2 FACLIA",FĂCLIA,CT,695,8,1,0,9,15,3,0,18,18,4,0,22,22,4,0,26,23,4,0,27
62324,525,"ȘCOALA GIMNAZIALA NR 1 SALIGNY",SALIGNY,CT,705,5,0,0,5,18,3,0,21,24,3,0,27,30,4,0,34,35,5,0,40
62342,526,"ȘCOALA PRIMARA NR 3 STEFAN CEL MARE","ŞTEFAN CEL MARE",CT,447,6,1,0,7,10,6,0,16,10,7,0,17,10,7,0,17,11,7,0,18
62832,527,"ȘCOALA GIMNAZIALĂ ”NICOLAE MARALOI” SARAIU",SARAIU,CT,614,8,2,0,10,32,2,0,34,73,9,0,82,132,18,0,150,146,19,0,165
62850,528,"ȘCOALA PRIMARĂ NR. 1 DULGHERU",DULGHERU,CT,445,9,4,0,13,14,4,0,18,28,8,0,36,30,9,0,39,33,9,0,42
62887,529,"ȘCOALAGIMNAZIALĂ ""A.GHENCEA""",SĂCELE,CT,1923,19,1,0,20,35,2,0,37,41,2,0,43,65,2,0,67,70,3,0,73
62930,530,"SCOALA CU CLS. I-IV SEIMENII MICI","SEIMENII MICI",CT,721,7,0,0,7,9,0,0,9,11,0,0,11,12,1,0,13,21,1,0,22
62912,531,"ŞCOALA CU CLS I-VIII SEIMENI",SEIMENI,CT,460,6,1,0,7,8,1,0,9,14,2,0,16,14,2,0,16,20,2,0,22
62921,532,"GRĂDINIŢA SAT DUNĂREA",DUNĂREA,CT,559,5,0,0,5,12,0,0,12,18,1,0,19,19,5,0,24,27,6,0,33
62958,533,"SCOALA GIMNAZIALA NR. 1",SILIŞTEA,CT,549,7,2,0,9,14,5,0,19,21,11,0,32,26,11,0,37,29,11,0,40
62976,534,"CAMIN CULTURAL","TEPEŞ VODĂ",CT,612,21,2,0,23,37,4,0,41,50,4,0,54,68,5,0,73,78,5,0,83
62994,535,"CONSILIULUI LOCAL TÎRGUȘOR",TÂRGUŞOR,CT,1080,14,0,0,14,27,1,0,28,38,6,0,44,43,8,0,51,47,12,0,59
63036,536,"ȘCOALA PRIMARĂ NR.2MIREASA",MIREASA,CT,265,0,1,0,1,4,5,0,9,6,7,0,13,8,7,0,15,16,8,0,24
63054,537,"ȘCOALA GENERALĂ TOPALU",TOPALU,CT,1415,12,5,0,17,25,6,0,31,29,6,0,35,33,8,0,41,37,9,0,46
63081,538,"LICEUL TEHNOLOGIC TOPRAISAR",TOPRAISAR,CT,1367,1,0,0,1,11,5,0,16,18,7,0,25,22,7,0,29,37,8,0,45
63081,539,"ȘCOALA VECHE TOPRAISAR",TOPRAISAR,CT,1546,12,4,0,16,24,5,0,29,35,6,0,41,44,8,0,52,55,8,0,63
63107,540,"ȘCOALA I-VIII BIRUINȚA",BIRUINŢA,CT,644,8,0,0,8,13,1,0,14,13,1,0,14,14,1,0,15,16,1,0,17
63116,541,"ȘCOALA I-VIII MOVILIȚA",MOVILIŢA,CT,916,4,1,0,5,8,1,0,9,11,2,0,13,19,2,0,21,21,2,0,23
61657,542,"ȘCOALA I-IV POTÂRNICHEA",POTÎRNICHEA,CT,400,5,4,0,9,14,5,0,19,16,8,0,24,24,10,0,34,24,12,0,36
62967,543,"CĂMINUL CULTURAL TORTOMAN",TORTOMAN,CT,1462,17,3,0,20,27,3,0,30,33,3,0,36,39,4,0,43,43,4,0,47
60730,544,GRADINITAVECHE,TUZLA,CT,1169,5,5,0,10,20,8,0,28,27,10,0,37,29,12,0,41,30,12,0,42
60730,545,"ŞCOALA MICĂ TUZLA",TUZLA,CT,1736,13,2,0,15,27,2,0,29,37,8,0,45,51,8,0,59,53,10,0,63
60730,546,"ŞCOALA MARE TUZLA",TUZLA,CT,1708,7,1,0,8,18,1,0,19,31,5,0,36,43,6,0,49,48,6,0,54
60730,547,"GRĂDINIŢĂ NOUĂ",TUZLA,CT,1368,7,1,0,8,20,2,0,22,30,4,0,34,42,4,0,46,42,4,0,46
63134,548,SALADESPORT,"VALU LUI TRAIAN",CT,1646,12,0,0,12,23,0,0,23,39,1,0,40,54,1,0,55,61,1,0,62
63134,549,"ŞCOALA GIMNAZIALĂ NR.1","VALU LUI TRAIAN",CT,1909,5,0,0,5,14,1,0,15,26,3,0,29,33,3,0,36,33,5,0,38
63134,550,"GRĂDINIŢA CU PROGRAM PRELUNGIT NR.3","VALU LUI TRAIAN",CT,1735,5,1,0,6,17,1,0,18,21,2,0,23,48,5,0,53,53,7,0,60
63134,551,COMPLEX,"VALU LUI TRAIAN",CT,1892,12,6,0,18,25,9,0,34,34,11,0,45,64,11,0,75,66,11,0,77
63134,552,"CLĂDIRE VESTIARE TEREN FOTBAL (STADION)","VALU LUI TRAIAN",CT,1296,4,0,0,4,5,0,0,5,11,0,0,11,20,0,0,20,20,0,0,20
63134,553,"ŞCOALA GIMNAZIALĂ ""VICEAMIRAL IOAN MURGESCU""","VALU LUI TRAIAN",CT,1153,2,0,0,2,8,3,0,11,18,6,0,24,28,6,0,34,28,6,0,34
63134,554,"GRĂDINIŢA CUPROGRAMNORMALNR.2","VALU LUI TRAIAN",CT,1676,6,0,0,6,28,1,129,158,44,3,129,176,56,5,129,190,59,5,129,193
63134,555,"CENTRU DE TINERET","VALU LUI TRAIAN",CT,1304,5,0,0,5,15,0,0,15,24,1,0,25,27,3,0,30,33,3,0,36
62663,556,"CAMIN CULTURAL VULTURU",VULTURU,CT,574,9,0,0,9,11,0,0,11,13,0,0,13,13,0,0,13,15,0,0,15
63401,1,"CASA DE CULTURĂ ""KÓNYA ÁDÁM""","SFÎNTU GHEORGHE",CV,1201,0,0,0,0,7,0,0,7,11,1,0,12,18,1,0,19,18,1,0,19
63401,2,"LICEUL TEHNOLOGIC""KÓS KÁROLY""","SFÎNTU GHEORGHE",CV,650,0,0,0,0,6,6,0,12,8,9,0,17,11,9,0,20,12,9,0,21
63401,3,"LICEUL TEHNOLOGIC ""KÓS KÁROLY""","SFÎNTU GHEORGHE",CV,1354,3,0,0,3,16,0,0,16,25,0,0,25,35,0,0,35,41,0,0,41
63401,4,"LICEUL TEORETIC ""SZÉKELY MIKÓ""","SFÎNTU GHEORGHE",CV,739,3,0,0,3,11,2,0,13,18,3,0,21,20,4,0,24,23,4,0,27
63401,5,"DIRECŢIA FINANŢE PUBLICE MUNICIPALE","SFÎNTU GHEORGHE",CV,751,4,0,0,4,13,0,0,13,18,0,0,18,25,0,0,25,27,1,0,28
63401,6,"LICEUL TEHNOLOGIC ECONOMIC, ADMINISTRATIV ""BERDE ÁRON""","SFÎNTU GHEORGHE",CV,678,1,4,0,5,3,4,0,7,6,4,0,10,11,5,0,16,12,5,0,17
63401,7,"LICEUL TEHNOLOGIC ECONOMIC, ADMINISTRATIV ""BERDE ÁRON""","SFÎNTU GHEORGHE",CV,1635,7,0,0,7,16,0,0,16,20,2,0,22,34,4,0,38,39,4,0,43
63401,8,"LICEUL TEHNOLOGIC ECONOMIC, ADMINISTRATIV ""BERDE ÁRON""","SFÎNTU GHEORGHE",CV,986,0,1,0,1,6,5,0,11,8,7,0,15,11,7,0,18,14,7,0,21
63401,9,"LICEUL TEORETIC ""MIKES KELEMEN""","SFÎNTU GHEORGHE",CV,654,0,0,0,0,5,0,0,5,10,0,0,10,17,1,0,18,19,2,0,21
63401,10,"GRĂDINIŢA CU PROGRAM PRELUNGIT ""GULLIVER""","SFÎNTU GHEORGHE",CV,1402,4,0,0,4,10,5,0,15,13,5,0,18,19,5,0,24,19,5,0,24
63401,11,"GRĂDINIŢA CU PROGRAM PRELUNGIT ""GULLIVER""","SFÎNTU GHEORGHE",CV,994,2,0,0,2,16,1,0,17,21,1,0,22,27,1,0,28,29,1,0,30
63401,12,"GRĂDINIŢA CU PROGRAM PRELUNGIT ""GULLIVER""","SFÎNTU GHEORGHE",CV,1014,0,2,0,2,6,2,0,8,8,2,0,10,14,2,0,16,19,2,0,21
63401,13,"GRĂDINIŢA CU PROGRAM PRELUNGIT ""GULLIVER""","SFÎNTU GHEORGHE",CV,1358,6,0,0,6,24,0,0,24,27,0,0,27,32,0,0,32,37,0,0,37
63401,14,"COLEGIUL NAŢIONAL ""MIHAI VITEAZUL""","SFÎNTU GHEORGHE",CV,979,3,5,0,8,12,5,0,17,19,5,0,24,23,5,0,28,23,5,0,28
63401,15,"COLEGIUL NAŢIONAL ""MIHAI VITEAZUL""","SFÎNTU GHEORGHE",CV,916,2,2,0,4,4,2,0,6,8,4,0,12,13,5,0,18,14,6,0,20
63401,16,"COLEGIUL NAŢIONAL ""MIHAI VITEAZUL""","SFÎNTU GHEORGHE",CV,861,2,0,0,2,11,0,0,11,17,1,0,18,20,1,0,21,21,1,0,22
63401,17,"SALA DE SPORT","SFÎNTU GHEORGHE",CV,1548,3,5,0,8,9,5,0,14,19,7,0,26,26,7,0,33,36,7,0,43
63401,18,"GRADINIŢA CU PROGRAM PRELUNGIT ""HÓFEHÉRKE""","SFÎNTU GHEORGHE",CV,804,0,0,0,0,2,0,0,2,6,0,0,6,12,0,0,12,12,0,0,12
63401,19,"ŞCOALA GIMNAZIALĂ ""VÁRADI JÓZSEF""","SFÎNTU GHEORGHE",CV,545,2,0,0,2,3,1,0,4,5,8,0,13,8,8,0,16,9,8,0,17
63401,20,"ŞCOALA GIMNAZIALĂ ""VÁRADI JÓZSEF""","SFÎNTU GHEORGHE",CV,1276,4,0,0,4,17,0,0,17,19,3,0,22,23,4,0,27,23,4,0,27
63401,21,"LICEUL DE ARTE ""PLUGOR SÁNDOR""","SFÎNTU GHEORGHE",CV,753,4,0,0,4,12,0,0,12,18,2,0,20,29,2,0,31,31,2,0,33
63401,22,"LICEUL DE ARTE ""PLUGOR SÁNDOR""","SFÎNTU GHEORGHE",CV,1138,0,0,0,0,7,0,0,7,9,0,0,9,9,0,0,9,11,0,0,11
63401,23,"ŞCOALA AJUTĂTOARE","SFÎNTU GHEORGHE",CV,696,3,3,0,6,5,3,0,8,7,4,0,11,16,4,0,20,20,5,0,25
63401,24,"GRĂDINIŢA CU PROGRAM PRELUNGIT ""ÁRVÁCSKA""","SFÎNTU GHEORGHE",CV,1246,6,0,0,6,12,0,0,12,21,0,0,21,26,0,0,26,30,0,0,30
63401,25,"GRĂDINIŢA CU PROGRAM PRELUNGIT ""ÁRVÁCSKA""","SFÎNTU GHEORGHE",CV,846,2,0,0,2,4,0,0,4,10,1,0,11,12,3,0,15,13,4,0,17
63401,26,"ŞCOALA GIMNAZIALĂ ""GÖDRI FERENC""","SFÎNTU GHEORGHE",CV,1363,3,7,0,10,8,7,0,15,12,9,0,21,21,10,0,31,22,11,0,33
63401,27,"ŞCOALA GIMNAZIALĂ ""GÖDRI FERENC""","SFÎNTU GHEORGHE",CV,898,2,0,0,2,10,1,0,11,11,1,0,12,19,2,0,21,20,4,0,24
63401,28,"CĂMINUL ""ZATHURECZKY BERTA""","SFÎNTU GHEORGHE",CV,1284,5,0,0,5,11,4,0,15,12,5,0,17,16,5,0,21,18,5,0,23
63401,29,"CĂMINUL ""ZATHURECZKY BERTA""","SFÎNTU GHEORGHE",CV,1686,10,0,0,10,25,0,0,25,34,1,0,35,44,2,0,46,50,2,0,52
63401,30,"CREŞA CU PROGRAM DE LUCRU ZILNIC","SFÎNTU GHEORGHE",CV,679,2,0,0,2,7,0,0,7,11,0,0,11,12,6,0,18,12,6,0,18
63401,31,"CREŞA CU PROGRAM DE LUCRU ZILNIC","SFÎNTU GHEORGHE",CV,1161,4,2,0,6,7,2,0,9,20,2,0,22,32,2,0,34,35,2,0,37
63401,32,"GRĂDINIŢA CU PROGRAM PRELUNGIT ""PINOCCHIO""","SFÎNTU GHEORGHE",CV,1728,0,0,0,0,6,1,0,7,13,1,0,14,24,1,0,25,30,1,0,31
63401,33,"GRĂDINIŢA CU PROGRAM PRELUNGIT ""PINOCCHIO""","SFÎNTU GHEORGHE",CV,1255,3,1,0,4,8,8,0,16,16,8,0,24,21,8,0,29,23,8,0,31
63401,34,"GRĂDINIŢA CU PROGRAM PRELUNGIT ""BENEDEK ELEK""","SFÎNTU GHEORGHE",CV,1586,9,1,0,10,26,1,0,27,43,1,0,44,57,4,0,61,68,4,0,72
63401,35,"FOSTUL CENTRU DE INFORMARE PENTRU CETĂŢENI","SFÎNTU GHEORGHE",CV,1244,8,0,0,8,25,0,0,25,40,0,0,40,48,0,0,48,50,0,0,50
63401,36,"LICEUL TEHNOLOGIC ""PUSKÁS TIVADAR""","SFÎNTU GHEORGHE",CV,1488,10,4,0,14,21,5,0,26,30,5,0,35,33,5,0,38,38,5,0,43
63401,37,"LICEUL TEHNOLOGIC ""PUSKÁS TIVADAR""","SFÎNTU GHEORGHE",CV,1351,8,3,0,11,22,4,0,26,31,5,0,36,39,5,0,44,41,7,0,48
63401,38,"ŞCOALA GIMNAZIALĂ ""NICOLAE COLAN""","SFÎNTU GHEORGHE",CV,1123,7,5,0,12,12,7,0,19,17,7,0,24,25,8,0,33,31,8,0,39
63401,39,"ŞCOALA GIMNAZIALĂ ""NICOLAE COLAN""","SFÎNTU GHEORGHE",CV,1089,4,0,0,4,6,0,0,6,15,0,0,15,20,0,0,20,22,0,0,22
63401,40,"ŞCOALA GIMNAZIALĂ ""NICOLAE COLAN""","SFÎNTU GHEORGHE",CV,1196,7,1,0,8,18,1,0,19,24,1,0,25,24,2,0,26,30,3,0,33
63401,41,"ŞTRAND MUNICIPAL SFÂNTU GHEORGHE","SFÎNTU GHEORGHE",CV,1234,6,0,0,6,18,0,0,18,30,1,0,31,37,1,0,38,41,1,0,42
63401,42,"ŞTRAND MUNICIPAL SFÂNTU GHEORGHE","SFÎNTU GHEORGHE",CV,1326,4,0,0,4,19,0,0,19,25,0,0,25,33,1,0,34,37,1,0,38
63401,43,"ŞCOALA GIMNAZIALĂ ""ADY ENDRE""","SFÎNTU GHEORGHE",CV,809,3,0,0,3,9,0,0,9,13,0,0,13,19,0,0,19,21,0,0,21
63401,44,"ŞCOALA GIMNAZIALĂ ""ADY ENDRE""","SFÎNTU GHEORGHE",CV,840,3,0,0,3,7,0,0,7,11,0,0,11,21,0,0,21,21,0,0,21
63401,45,"ŞCOALA GIMNAZIALĂ ""ADY ENDRE""","SFÎNTU GHEORGHE",CV,1315,6,1,0,7,14,1,0,15,15,1,0,16,18,3,0,21,19,3,0,22
63401,46,"GRĂDINIŢA CU PROGRAM PRELUNGIT ""NAPSUGÁR""","SFÎNTU GHEORGHE",CV,1123,7,0,0,7,12,1,0,13,16,1,0,17,23,1,0,24,24,1,0,25
63401,47,"GRĂDINIŢA CU PROGRAM PRELUNGIT ""NAPSUGÁR""","SFÎNTU GHEORGHE",CV,1149,5,0,0,5,16,0,0,16,18,0,0,18,26,0,0,26,30,0,0,30
63401,48,"FOSTA ŞCOALA GENERALĂ CÂMPUL FRUMOS","SFÎNTU GHEORGHE",CV,334,3,0,0,3,5,0,0,5,6,0,0,6,11,0,0,11,11,0,0,11
63410,49,"CĂMIN CULTURAL",CHILIENI,CV,730,4,0,0,4,6,0,0,6,9,0,0,9,12,0,0,12,12,0,0,12
63429,50,"CĂMIN CULTURAL",COŞENI,CV,422,1,0,0,1,1,0,0,1,4,0,0,4,5,0,0,5,5,0,0,5
63759,51,"CASA MUNICIPALĂ DE CULTURĂ ""VIGADÓ"" TÂRGU SECUIESC","TÂRGU SECUIESC",CV,1343,0,1,0,1,8,1,0,9,13,1,0,14,13,1,0,14,15,1,0,16
63759,52,"LICEUL TEORETIC ""NAGY MÓZES"" TÂRGU SECUIESC","TÂRGU SECUIESC",CV,1108,0,0,0,0,2,0,0,2,2,0,0,2,3,0,0,3,3,0,0,3
63759,53,"LICEUL PEDAGOGIC ""BOD PÉTER"" TÂRGU SECUIESC","TÂRGU SECUIESC",CV,1212,1,0,0,1,9,1,0,10,13,1,0,14,15,1,0,16,17,1,0,18
63759,54,"LICEUL VOCAŢIONAL REFORMAT TÂRGU SECUIESC","TÂRGU SECUIESC",CV,1221,0,0,0,0,5,0,0,5,6,0,0,6,14,0,0,14,14,0,0,14
63759,55,"GRĂDINIŢA CU PROGRAM NORMAL ""BENEDEK ELEK"" TÂRGU SECUIESC","TÂRGU SECUIESC",CV,1362,4,0,0,4,7,1,0,8,11,1,0,12,17,1,0,18,20,1,0,21
63759,56,"ŞCOALA GIMNAZIALĂ ""PETŐFI SÁNDOR"" TÂRGU SECUIESC","TÂRGU SECUIESC",CV,1262,3,2,0,5,9,2,0,11,12,2,0,14,16,2,0,18,16,3,0,19
63759,57,"GRĂDINIŢA CU PROGRAM PRELUNGIT ""CSIPKERÓZSIKA"" TÂRGU SECUIESC","TÂRGU SECUIESC",CV,1357,4,0,0,4,11,0,0,11,14,0,0,14,18,1,0,19,19,1,0,20
63759,58,"ŞCOALA GIMNAZIALĂ ""TUROCZI MÓZES"" TÂRGU SECUIESC","TÂRGU SECUIESC",CV,1339,2,0,0,2,8,0,0,8,10,0,0,10,14,0,0,14,15,0,0,15
63759,59,"GRĂDINIŢA CU PROGRAM PRELUNGIT ""MANÓCSKA"" TÂRGU SECUIESC","TÂRGU SECUIESC",CV,1359,4,1,0,5,9,1,0,10,10,2,0,12,12,2,0,14,12,2,0,14
63759,60,"GRĂDINIŢA CU PROGRAM NORMAL NR. 3 TÂRGU SECUIESC","TÂRGU SECUIESC",CV,883,2,0,0,2,4,0,0,4,6,1,0,7,8,1,0,9,10,1,0,11
63759,61,"LICEUL TEHNOLOGIC ""GÁBOR ÁRON"" TÂRGU SECUIESC","TÂRGU SECUIESC",CV,1177,1,0,0,1,4,1,0,5,4,1,0,5,4,1,0,5,4,1,0,5
63759,62,"ŞCOALA GIMNAZIALĂ ""MOLNÁR JOZSIÁS"" TÂRGU SECUIESC","TÂRGU SECUIESC",CV,1238,1,0,0,1,5,0,0,5,10,0,0,10,12,0,0,12,12,0,0,12
63759,63,"ŞCOALA PRIMARĂ RUSENI, TÂRGU SECUIESC","TÂRGU SECUIESC",CV,533,0,2,0,2,2,3,0,5,3,3,0,6,3,3,0,6,3,3,0,6
63768,64,"CĂMINUL CULTURAL TINOASA",LUNGA,CV,323,0,0,0,0,1,0,0,1,2,2,0,4,3,2,0,5,3,2,0,5
63768,65,"CĂMINUL CULTURAL LUNGA",LUNGA,CV,975,5,0,0,5,6,0,0,6,7,0,0,7,10,1,0,11,10,1,0,11
63465,66,"ŞCOALA GENERALĂ GAAL MOZES BARAOLT",BIBORŢENI,CV,592,2,0,0,2,4,0,0,4,12,0,0,12,14,0,0,14,15,0,0,15
63474,67,"CĂMIN CULTURAL BODOŞ",BODOŞ,CV,347,0,0,0,0,1,0,0,1,5,5,0,10,5,5,0,10,5,5,0,10
63483,68,"ŞCOALA GENERALĂ GAAL MOZES BARAOLT",CĂPENI,CV,875,0,0,0,0,0,0,0,0,0,1,0,1,0,1,0,1,0,1,0,1
63508,69,"CĂMIN CULTURAL RACOŞUL DE SUS","RACOŞUL DE SUS",CV,738,0,0,0,0,3,1,0,4,4,2,0,6,9,3,0,12,11,3,0,14
63456,70,"PRIMĂRIAORAŞULUI BARAOLT",BARAOLT,CV,1109,3,0,0,3,4,0,0,4,6,0,0,6,11,0,0,11,11,0,0,11
63456,71,"CASA DE CULTURĂ BARAOLT",BARAOLT,CV,1173,0,2,0,2,4,3,0,7,4,4,0,8,5,6,0,11,7,6,0,13
63456,72,"ŞCOALA GIMNAZIALĂ GAÁL MÓZES BARAOLT",BARAOLT,CV,1210,1,0,0,1,6,0,0,6,8,0,0,8,12,0,0,12,14,0,0,14
63456,73,"GRĂDINIŢA CU PROGRAM PRELUNGIT ""CIMBORA""",BARAOLT,CV,1210,4,0,0,4,13,0,0,13,13,0,0,13,14,0,0,14,22,0,0,22
63492,74,"GRĂDINIŢA CU PROGRAM NORMAL MICLOŞOARA",MICLOŞOARA,CV,366,1,0,0,1,1,1,0,2,1,2,0,3,3,2,0,5,4,2,0,6
63544,75,"CASA DE CULTURĂ-CHIURUŞ",CHIURUŞ,CV,404,0,0,0,0,3,0,0,3,4,0,0,4,4,0,0,4,4,0,0,4
63535,76,"GRĂDINIŢA CU PROGRAM PRELUNGIT NR.1 COVASNA",COVASNA,CV,1317,3,8,0,11,4,30,0,34,9,34,0,43,9,48,0,57,17,49,0,66
63535,77,"CLUBUL ORĂȘENESC- COVASNA",COVASNA,CV,1329,4,18,0,22,17,107,0,124,23,181,0,204,24,225,0,249,25,225,0,250
63535,78,"LICEUL ""KŐRÖSI CSOMA SÁNDOR"" -CORP A- COVASNA",COVASNA,CV,1138,3,16,0,19,10,57,0,67,15,69,0,84,19,85,0,104,20,87,0,107
63535,79,"LICEUL ""KŐRÖSI CSOMA SÁNDOR"" -CORP B- COVASNA",COVASNA,CV,1216,6,3,0,9,14,10,0,24,17,19,0,36,25,22,0,47,25,22,0,47
63535,80,"GRĂDINIŢA CU PROGRAM PRELUNGIT NR. 2 COVASNA",COVASNA,CV,1549,3,1,0,4,10,4,0,14,16,4,0,20,17,5,0,22,18,5,0,23
63535,81,"ȘCOALA GIMNAZIALĂ ""AVRAM IANCU""- COVASNA -PRI.",COVASNA,CV,1258,2,19,0,21,9,37,0,46,15,45,0,60,21,48,0,69,24,48,0,72
63535,82,"ȘCOALA GIMNAZIALĂ ""AVRAM IANCU""-COVASNA- GIM",COVASNA,CV,1098,3,19,0,22,6,43,0,49,14,62,0,76,17,76,0,93,18,77,0,95
63599,83,"ŞCOALA GIMNAZIALĂ""MIHAIL SADOVEANU"" ÎNTORSURA BUZĂULUI","ÎNTORSURA BUZĂULUI",CV,1129,6,2,0,8,43,2,0,45,56,2,0,58,61,2,0,63,62,5,0,67
63599,84,"ŞCOALA GIMNAZIALĂ""MIHAIL SADOVEANU"" ÎNTORSURA BUZĂULUI","ÎNTORSURA BUZĂULUI",CV,1178,8,3,0,11,15,4,0,19,27,4,0,31,37,6,0,43,46,8,0,54
63599,85,"CASA DE CULTURĂ ÎNTORSURA BUZĂULUI","ÎNTORSURA BUZĂULUI",CV,973,4,0,0,4,17,4,0,21,25,5,0,30,30,8,0,38,31,11,0,42
63599,86,"DISTRICTULDRUMURI NAȚIONALE ÎNTORSURA BUZĂULUI","ÎNTORSURA BUZĂULUI",CV,1205,8,4,0,12,20,5,0,25,26,6,0,32,32,6,0,38,32,6,0,38
63599,87,"ȘCOALA PRIMARĂ ÎNTORSURA BUZĂULUI","ÎNTORSURA BUZĂULUI",CV,746,0,0,0,0,3,0,0,3,5,0,0,5,12,0,0,12,14,0,0,14
63606,88,"ȘCOALA GIMNAZIALĂ ""GHEORGHE ZAHARIA"" BRĂDET",BRĂDET,CV,957,3,0,0,3,10,0,0,10,10,0,0,10,15,0,0,15,16,0,0,16
63615,89,"CĂMIN CULTURAL FLOROAIA",FLOROAIA,CV,1173,4,0,0,4,8,0,0,8,15,1,0,16,20,2,0,22,21,2,0,23
63786,90,"SEDIUL PRIMĂRIEI COMUNEI AITA MARE","AITA MARE",CV,723,1,0,0,1,1,0,0,1,1,0,0,1,3,1,0,4,3,1,0,4
63795,91,"CĂMINUL CULTURAL AITA MEDIE","AITA MEDIE",CV,630,1,0,0,1,1,0,0,1,3,0,0,3,5,0,0,5,5,0,0,5
64924,92,"SEDIUL CONSILIULUI LOCAL ARCUŞ",ARCUŞ,CV,1314,1,0,0,1,2,0,0,2,4,0,0,4,5,0,0,5,6,0,0,6
63642,93,"CĂMINUL CULTURALBARCANI",BARCANI,CV,963,9,4,0,13,21,5,0,26,23,5,0,28,25,5,0,30,26,5,0,31
63642,94,"CĂMINUL CULTURALBARCANI",BARCANI,CV,1010,9,1,0,10,31,5,0,36,40,6,0,46,43,6,0,49,46,6,0,52
63651,95,"ŞCOALA GIMNAZIALĂ LĂDĂUŢI",LĂDĂUŢI,CV,546,1,0,0,1,7,0,0,7,7,3,0,10,13,6,0,19,14,6,0,20
63660,96,"ŞCOALA GIMNAZIALĂ SĂRĂMAŞ",SĂRĂMĂŞ,CV,574,1,3,0,4,5,4,0,9,9,4,0,13,13,4,0,17,17,4,0,21
63811,97,"CLĂDIRE PRIMARIEI CĂMINUL CULTURAL BAŢANII MARI","BĂŢANII MARI",CV,1636,1,0,0,1,3,0,0,3,4,2,0,6,10,2,0,12,12,2,0,14
63839,98,"CĂMINUL CULTURAL BAŢANII MICI","BĂŢANII MICI",CV,452,0,3,0,3,1,3,0,4,1,3,0,4,3,3,0,6,3,3,0,6
63848,99,"SEDIUL DE DEPLASARE AL PRIMARIEI ÎN SATUL HERCULIAN",HERCULIAN,CV,875,2,0,0,2,2,3,0,5,6,4,0,10,8,4,0,12,8,4,0,12
63820,100,"SEDIUL DE DEPLASARE AL PRIMARIEI ÎN AITA SEACĂ","AITA SEACĂ",CV,555,0,1,0,1,3,1,0,4,3,1,0,4,3,1,0,4,4,1,0,5
63875,101,"ŞCOALA GIMNAZIALĂ ""BÖLÖNI FARKAS SÁNDOR""",BELIN,CV,1070,4,1,0,5,5,2,0,7,10,2,0,12,12,3,0,15,15,3,0,18
63884,102,"CENTRUL MULTIFUNCŢIONAL BELIN VALE",BELIN-VALE,CV,1054,0,2,0,2,2,4,0,6,2,4,0,6,3,4,0,7,6,4,0,10
64522,103,"CENTRUL DE STUDII ȘI PERFECȚIONARE AL PRIMĂRIEI",BIXAD,CV,1423,3,0,0,3,8,0,0,8,10,0,0,10,21,0,0,21,25,1,0,26
63900,104,"CĂMINUL CULTURAL DIN BODOC",BODOC,CV,945,4,2,0,6,5,2,0,7,6,2,0,8,6,4,0,10,8,6,0,14
63928,105,"ŞCOALAPRIMARĂ ""DÁVID JÓZSEF"" ZĂLAN",ZĂLAN,CV,522,0,0,0,0,2,0,0,2,2,2,0,4,2,2,0,4,4,3,0,7
63919,106,"IMOBILUL PRIMĂRIEI DIN OLTENI",OLTENI,CV,528,1,0,0,1,5,1,0,6,5,1,0,6,5,1,0,6,5,3,0,8
63955,107,"CONSILIUL LOCAL BOROSNEU MARE","BOROŞNEU MIC",CV,1252,1,1,0,2,2,1,0,3,2,1,0,3,5,2,0,7,5,2,0,7
63955,108,"ŞCOALA PRIMARĂ BOROŞNEU MIC","BOROŞNEU MIC",CV,353,2,6,0,8,5,6,0,11,5,6,0,11,5,6,0,11,5,6,0,11
63964,109,"SCOLA PRIMARĂ DOBOLII DE SUS","DOBOLII DE SUS",CV,188,1,1,0,2,1,1,0,2,1,1,0,2,1,1,0,2,1,1,0,2
63973,110,"ŞCOALA PRIMARĂLEŢ",LEŢ,CV,517,0,0,0,0,0,0,0,0,0,1,0,1,0,1,0,1,0,1,0,1
63982,111,"CĂMINUL CULTURAL ŢUFALAU",ŢUFALĂU,CV,175,0,0,0,0,0,1,0,1,2,1,0,3,2,1,0,3,2,1,0,3
64014,112,"SALA DE FESTIVITĂŢI ACONSILIULUILOCAL BRATEŞ",BRATEŞ,CV,463,1,0,0,1,1,0,0,1,1,0,0,1,2,0,0,2,2,0,0,2
64032,113,"CĂMINUL CULTURAL TELECHIA",TELECHIA,CV,458,0,0,0,0,0,0,0,0,4,0,0,4,5,0,0,5,5,1,0,6
64023,114,"CĂMINUL CULTURAL PACHIA",PACHIA,CV,265,0,0,0,0,0,0,0,0,0,0,0,0,0,0,0,0,0,0,0,0
64050,115,"CLUBUL CĂMINULUI CULTURAL BRĂDUŢ",BRĂDUŢ,CV,724,2,0,0,2,5,0,0,5,7,0,0,7,8,0,0,8,11,0,0,11
64087,116,"CĂMINUL CULTURAL TĂLIŞOARA",TĂLIŞOARA,CV,611,2,0,0,2,3,2,0,5,4,2,0,6,5,2,0,7,5,2,0,7
64069,117,"CLUBUL CĂMINULUI CULTURALDOBOŞENI",DOBOŞENI,CV,1410,2,2,0,4,4,2,0,6,6,2,0,8,8,2,0,10,9,2,0,11
64078,118,"CLUBUL CĂMINULUI CULTURAL FILIA",FILIA,CV,975,4,1,0,5,16,1,0,17,18,1,0,19,21,1,0,22,22,1,0,23
64103,119,"CENTRUL CULTURAL BREŢCU",BREŢCU,CV,1168,8,0,0,8,13,0,0,13,14,0,0,14,19,0,0,19,19,0,0,19
64103,120,"CENTRUL CULTURAL BREŢCU",BREŢCU,CV,873,3,0,0,3,8,0,0,8,13,1,0,14,18,1,0,19,23,1,0,24
64112,121,"ŞCOALA PRIMARĂ MĂRTĂNUŞ",MĂRTĂNUŞ,CV,618,1,1,0,2,4,1,0,5,6,1,0,7,9,4,0,13,13,5,0,18
64121,122,"ŞCOALA GIMNAZIALĂ OITUZ",OITUZ,CV,258,1,0,0,1,3,0,0,3,5,0,0,5,5,0,0,5,5,0,0,5
64149,123,"CĂMINUL CULTURAL CATALINA",CATALINA,CV,1117,2,0,0,2,4,0,0,4,5,0,0,5,6,0,0,6,7,0,0,7
64167,124,"SCOALA PRIMARA IMENI",IMENI,CV,250,1,0,0,1,1,0,0,1,1,0,0,1,3,0,0,3,3,0,0,3
64158,125,"CĂMINUL CULTURAL HĂTIUCA",HĂTUICA,CV,386,0,0,0,0,1,1,0,2,2,1,0,3,4,1,0,5,4,2,0,6
64176,126,"CASA COMUNALA MĂRTINENI",MĂRTINENI,CV,505,0,0,0,0,0,1,0,1,1,4,0,5,1,5,0,6,2,6,0,8
64185,127,"CĂMINUL CULTURAL MĂRCUŞA",MĂRCUŞA,CV,511,0,0,0,0,1,0,0,1,4,0,0,4,5,0,0,5,6,0,0,6
64201,128,"BIBLIOTECA COMUNALĂ CERNAT",CERNAT,CV,649,0,0,0,0,0,4,0,4,0,4,0,4,0,4,0,4,0,4,0,4
64201,129,"ŞCOALA GIMNAZIALĂ ""VÉGH ANTAL"" CERNAT",CERNAT,CV,1190,2,0,0,2,9,7,0,16,10,7,0,17,16,8,0,24,16,8,0,24
64201,130,"ŞCOALA GIMNAZIALĂ ""BOD PÉTER"" CERNAT",CERNAT,CV,887,0,1,0,1,3,1,0,4,4,2,0,6,5,2,0,7,5,3,0,8
64210,131,"CLĂDIREA CONSILIULUI LOCAL CERNAT, ALBIŞ",ALBIŞ,CV,335,0,0,0,0,2,0,0,2,4,0,0,4,4,0,0,4,4,0,0,4
64229,132,"CASA MULTIFUNCȚIONALĂ ICAFĂLĂU",ICAFALĂU,CV,213,1,1,0,2,1,1,0,2,4,4,0,8,5,4,0,9,5,4,0,9
64247,133,"CĂMINUL CULTURAL CHICHIŞ",CHICHIŞ,CV,870,1,0,0,1,3,0,0,3,8,0,0,8,16,4,0,20,17,4,0,21
64256,134,"ŞCOALA GIMNAZIALĂ BĂCEL",BĂCEL,CV,444,5,0,0,5,7,2,0,9,10,2,0,12,13,3,0,16,18,3,0,21
63562,135,"SEDIUL PRIMARIEI COMANDĂU",COMANDĂU,CV,820,0,0,0,0,1,0,0,1,3,2,0,5,4,5,0,9,4,5,0,9
64586,136,"CĂMINUL CULTURAL DALNIC",DALNIC,CV,740,1,3,0,4,4,4,0,8,5,4,0,9,7,4,0,11,7,4,0,11
64274,137,"CĂMINUL CULTURAL DOBÂRLĂU",DOBÎRLĂU,CV,885,2,0,0,2,9,2,0,11,14,4,0,18,16,5,0,21,21,5,0,26
64309,138,"ŞCOALA PRIMARĂ VALEA DOBÂRLĂULUI","VALEA DOBÎRLĂULUI",CV,251,0,0,0,0,4,0,0,4,6,0,0,6,6,0,0,6,7,0,0,7
64292,139,"ŞCOALA PRIMARĂ MĂRCUŞ",MĂRCUŞ,CV,332,4,0,0,4,7,1,0,8,9,1,0,10,18,4,0,22,21,5,0,26
64283,140,"ŞCOALA PRIMARĂ LUNCA MĂRCUŞULUI","LUNCA MĂRCUŞULUI",CV,295,4,1,0,5,7,2,0,9,15,2,0,17,21,6,0,27,22,7,0,29
64755,141,"CĂMINUL CULTURAL ESTELNIC",ESTELNIC,CV,668,3,3,0,6,9,4,0,13,14,4,0,18,17,4,0,21,18,5,0,23
64764,142,"CĂMINUL CULTURAL VALEA SCURTĂ","VALEA SCURTĂ",CV,206,0,0,0,0,2,2,0,4,3,2,0,5,3,4,0,7,3,5,0,8
64327,143,"ŞCOALA GIMNAZIALĂ ""JANCSÓ BENEDEK"" GHELINŢA",GHELINŢA,CV,1462,2,0,0,2,7,0,0,7,8,0,0,8,9,0,0,9,10,0,0,10
64327,144,"ŞCOALA GIMNAZIALĂ ""JANCSÓ BENEDEK"" GHELINŢA",GHELINŢA,CV,1383,2,0,0,2,4,0,0,4,5,0,0,5,9,0,0,9,11,0,0,11
64327,145,"ŞCOALA PRIMARĂ NR.2 GHELINŢA",GHELINŢA,CV,1080,0,0,0,0,2,0,0,2,3,0,0,3,8,0,0,8,8,0,0,8
64336,146,"ŞCOALA PRIMARĂ HARALE",HARALE,CV,199,0,0,0,0,0,0,0,0,0,0,0,0,0,0,0,0,0,0,0,0
64354,147,"CĂMINUL CULTURAL DIN SATUL GHIDFALĂU",GHIDFALĂU,CV,917,1,2,0,3,4,2,0,6,5,2,0,7,7,2,0,9,8,2,0,10
64363,148,"CLĂDIRE AFLATĂ ÎN DOMENIUL PUBLIC AL COMUNEI GHIDFALĂU, SAT ANGHELUŞ",ANGHELUŞ,CV,538,1,0,0,1,2,0,0,2,2,0,0,2,2,1,0,3,7,1,0,8
64381,149,"CLĂDIRE AFLATĂ ÎN DOMENIUL PRIVAT AL COMUNEI GHIDFALĂU, SAT ZOLTAN",ZOLTAN,CV,349,1,0,0,1,1,0,0,1,1,0,0,1,3,0,0,3,4,0,0,4
64372,150,"CĂMINUL CULTURAL DIN SATUL FOTOŞ",FOTOŞ,CV,300,1,0,0,1,1,0,0,1,1,0,0,1,1,0,0,1,1,0,0,1
64407,151,"CĂMINUL CULTURAL HĂGHIG",HĂGHIG,CV,1363,7,5,0,12,10,7,0,17,17,9,0,26,24,9,0,33,25,9,0,34
64416,152,"CENTRUL DE ZI PENTRU COPII IARĂȘ",IARĂŞ,CV,347,0,6,0,6,1,6,0,7,1,6,0,7,4,6,0,10,4,6,0,10
64434,153,"CĂMINUL CULTURAL ILIENI",ILIENI,CV,877,3,0,0,3,4,1,0,5,7,1,0,8,8,1,0,9,12,3,0,15
64452,154,"GRĂDINIŢA CU PROGRAM NORMAL SÂNCRAIU",SÎNCRAIU,CV,344,1,0,0,1,1,0,0,1,2,0,0,2,2,0,0,2,2,0,0,2
64443,155,"ŞCOALA PRIMARĂ ""BODA-POPOVICI"" DOBOLII DE JOS","DOBOLII DE JOS",CV,438,0,3,0,3,1,3,0,4,2,3,0,5,2,5,0,7,2,6,0,8
64470,156,"SEDIUL PRIMĂRIEI LEMNIA",LEMNIA,CV,703,2,0,0,2,3,0,0,3,4,0,0,4,4,0,0,4,6,0,0,6
64470,157,"ŞCOALA PRIMARĂ NR.2 LEMNIA DE SUS",LEMNIA,CV,856,4,0,0,4,4,0,0,4,7,0,0,7,8,0,0,8,11,0,0,11
64531,158,"SEDIUL PRIMĂRIEI",MALNAŞ,CV,418,4,0,0,4,4,0,0,4,4,0,0,4,4,0,0,4,4,0,0,4
64540,159,"ŞCOALA PRIMARĂMALNAŞ BĂI",MALNAŞ-BĂI,CV,358,1,1,0,2,7,2,0,9,8,8,0,16,10,8,0,18,10,8,0,18
64559,160,"ŞCOALA PRIMARĂVALEA ZĂLANULUI","VALEA ZĂLANULUI",CV,104,1,2,0,3,2,2,0,4,6,4,0,10,6,5,0,11,6,5,0,11
64498,161,"CĂMINUL CULTURAL MERENI",MERENI,CV,720,1,2,0,3,7,2,0,9,8,2,0,10,9,2,0,11,9,2,0,11
64489,162,"CĂMINUL CULTURAL LUTOASA",LUTOASA,CV,353,1,2,0,3,3,2,0,5,5,2,0,7,6,3,0,9,6,3,0,9
64513,163,"CĂMINUL CULTURAL MICFALĂU",MICFALĂU,CV,1484,5,0,0,5,17,0,0,17,22,1,0,23,24,1,0,25,25,1,0,26
64577,164,"ŞCOALA GIMNAZIALĂ ""ORBAN BALAZS"" MOACŞA",MOACŞA,CV,561,0,0,0,0,2,1,0,3,2,1,0,3,3,1,0,4,3,1,0,4
64577,165,"CLĂDIREA FOSTEI ŞCOLI GENERALE CU CLASELE I-IV ERESTEGHIN",MOACŞA,CV,179,1,1,0,2,2,1,0,3,3,1,0,4,3,1,0,4,3,1,0,4
64595,166,"CĂMINUL CULTURAL PĂDURENI",PĂDURENI,CV,261,1,0,0,1,2,4,0,6,3,4,0,7,5,6,0,11,5,6,0,11
64611,167,"CĂMINUL CULTURAL ''ZSÖGÖN ZOLTÁN'' OJDULA CLUBUL TINERETULUI",OJDULA,CV,1382,1,0,0,1,3,0,0,3,4,0,0,4,6,0,0,6,6,0,0,6
64611,168,"CĂMINUL CULTURAL ''ZSÖGÖN ZOLTÁN'' OJDULA SALA MARE",OJDULA,CV,1333,2,0,0,2,3,1,0,4,10,1,0,11,14,1,0,15,15,1,0,16
64620,169,"CĂMINUL CULTURAL HILIB",HILIB,CV,205,2,6,0,8,2,6,0,8,3,7,0,10,4,7,0,11,4,7,0,11
64648,170,"CĂMINUL CULTURAL OZUN",OZUN,CV,951,3,1,0,4,5,1,0,6,6,1,0,7,9,2,0,11,9,2,0,11
64648,171,"CENTRUL DE INFORMARE ASUPRA UNIUNII EUROPENE OZUN",OZUN,CV,1237,2,1,0,3,4,2,0,6,7,3,0,10,7,3,0,10,10,3,0,13
64700,172,"ŞCOALA PRIMARĂ ""BERDE MOZSA"" SÎNTIONLUNCA",SÎNTIONLUNCA,CV,615,0,0,0,0,2,0,0,2,2,1,0,3,2,1,0,3,2,4,0,6
64666,173,"CĂMINUL CULTURALLISNĂU",LISNĂU,CV,443,5,1,0,6,7,1,0,8,7,3,0,10,7,5,0,12,7,5,0,12
64657,174,"ȘCOALA PRIMARĂBICFALĂU",BICFALĂU,CV,281,0,0,0,0,3,0,0,3,3,0,0,3,3,1,0,4,3,1,0,4
64693,175,"CĂMINUL CULTURAL MĂGHERUȘ",MĂGHERUŞ,CV,87,0,0,0,0,0,1,0,1,1,1,0,2,2,3,0,5,2,3,0,5
64684,176,"CLĂDIRE ADMINISTRATIVĂ (FOSTUL SEDIU AL ŞCOLII) LUNCA OZUNULUI","LUNCA OZUNULUI",CV,148,1,0,0,1,2,0,0,2,2,0,0,2,3,1,0,4,3,1,0,4
64728,177,"PRIMĂRIA COMUNEI POIAN",POIAN,CV,1011,0,0,0,0,6,0,0,6,8,0,0,8,10,0,0,10,10,0,0,10
64737,178,"ŞCOALA PRIMARĂ ""TUZSON JÁNOS"" BELANI",BELANI,CV,392,1,3,0,4,2,5,0,7,4,5,0,9,4,5,0,9,5,5,0,10
64782,179,"CĂMINUL CULTURAL RECI",RECI,CV,1167,1,0,0,1,3,1,0,4,3,4,0,7,6,5,0,11,6,5,0,11
64791,180,"ŞCOALA PRIMARĂ-ANINOASA",ANINOASA,CV,334,0,0,0,0,1,1,0,2,1,3,0,4,1,3,0,4,1,3,0,4
64808,181,"ŞCOALA PRIMARĂ BITA",BITA,CV,229,0,3,0,3,0,4,0,4,0,6,0,6,0,6,0,6,0,6,0,6
64817,182,"CĂMINUL CULTURAL SACIOVA",SACIOVA,CV,105,105,0,0,105,2,2,0,4,2,2,0,4,3,2,0,5,3,2,0,5
63697,183,"PRIMĂRIA SITA BUZĂULUI","SITA BUZĂULUI",CV,1240,13,2,0,15,41,6,0,47,55,22,0,77,65,25,0,90,65,25,0,90
63697,184,"ŞCOALA GIMNAZIALĂNR.2 SITA BUZĂULUI","SITA BUZĂULUI",CV,820,3,2,0,5,8,5,0,13,10,7,0,17,22,8,0,30,24,9,0,33
63697,185,"ŞCOALA GIMNAZIALĂ NR.3 SITA BUZĂULUI","SITA BUZĂULUI",CV,875,0,0,0,0,3,0,0,3,11,0,0,11,16,0,0,16,22,3,0,25
63722,186,"ŞCOALA GIMNAZIALĂ ZĂBRĂTĂU",ZĂBRĂTĂU,CV,445,3,2,0,5,10,3,0,13,12,3,0,15,13,7,0,20,14,8,0,22
63704,187,"TABĂRA CRASNA",CRASNA,CV,459,3,2,0,5,7,3,0,10,11,5,0,16,12,5,0,17,12,9,0,21
64835,188,"BIROUL IFOTURISM",SÎNZIENI,CV,1221,1,0,0,1,2,1,0,3,3,4,0,7,6,4,0,10,8,5,0,13
64835,189,"CLUBUL CĂMINULUICULTURAL SÂNZIENI",SÎNZIENI,CV,989,0,0,0,0,1,0,0,1,1,3,0,4,3,6,0,9,3,6,0,9
64844,190,"CĂMINUL CULTURAL CASINU MIC","CAŞINU MIC",CV,225,0,1,0,1,0,1,0,1,0,1,0,1,0,1,0,1,1,1,0,2
64853,191,"CĂMINUL CULTURAL PETRICENI",PETRICENI,CV,746,1,4,0,5,1,4,0,5,2,4,0,6,5,5,0,10,5,6,0,11
64862,192,"GRĂDINIȚA DE COPII (PARTER)","VALEA SEACĂ",CV,515,1,0,0,1,5,0,0,5,5,0,0,5,6,1,0,7,6,1,0,7
64880,193,"CĂMINUL CULTURAL TURIA",TURIA,CV,990,0,0,0,0,1,0,0,1,1,0,0,1,2,0,0,2,2,0,0,2
64880,194,"ŞCOALA PRIMARĂ ""JÓKAI MÓR"" TURIA",TURIA,CV,678,3,5,0,8,4,5,0,9,6,5,0,11,7,5,0,12,7,5,0,12
64880,195,"ŞCOALA PRIMARĂ NR.3 TURIA",TURIA,CV,1228,1,0,0,1,3,0,0,3,3,0,0,3,4,0,0,4,4,0,0,4
64899,196,"ŞCOALA PRIMARĂ ""REMÉNYIK SÁNDOR"" ALUNGENI",ALUNGENI,CV,239,1,0,0,1,6,0,0,6,6,0,0,6,6,0,0,6,6,0,0,6
64915,197,"PRIMĂRIA COMUNEI VALEA CRIŞULUI","VALEA CRIŞULUI",CV,1402,0,0,0,0,11,0,0,11,15,0,0,15,15,0,0,15,15,0,0,15
64933,198,"ŞCOALA PRIMARĂ ""DR. BEDŐ ALBERT"" CALNIC",CALNIC,CV,430,0,1,0,1,0,1,0,1,1,1,0,2,1,1,0,2,1,1,0,2
63679,199,"CLĂDIREA CĂMINULUI CULTURAL VALEA MARE","VALEA MARE",CV,935,1,0,0,1,8,5,0,13,12,5,0,17,19,5,0,24,19,5,0,24
64951,200,"SEDIUL PRIMĂRIEI ÎN SATUL ARACI-CORPUL A",ARACI,CV,916,2,0,0,2,10,0,0,10,13,4,0,17,18,5,0,23,19,5,0,24
64951,201,"SEDIUL PRIMĂRIEI ÎN SATUL ARACI-CORPUL B",ARACI,CV,580,0,1,0,1,5,1,0,6,7,1,0,8,8,1,0,9,10,1,0,11
64960,202,"ŞCOALA PRIMARĂ ARIUŞD",ARIUŞD,CV,360,6,1,0,7,7,3,0,10,10,4,0,14,10,4,0,14,10,4,0,14
64979,203,"ŞCOALA PRIMARĂ HETEA",HETEA,CV,241,0,0,0,0,0,0,0,0,0,0,0,0,5,0,0,5,5,0,0,5
64988,204,"ŞCOALA GIMNAZIALĂ VÂLCELE",VÎLCELE,CV,1006,8,1,0,9,11,6,0,17,40,15,0,55,45,15,0,60,47,15,0,62
65002,205,"CĂMINUL CULTURAL VÎRGHIŞ",VÎRGHIŞ,CV,1500,7,3,0,10,10,3,0,13,12,3,0,15,17,3,0,20,19,3,0,22
65020,206,"CĂMINUL CULTURAL NR.1 ZAGON",ZAGON,CV,1647,4,3,0,7,10,5,0,15,12,5,0,17,16,6,0,22,18,6,0,24
65020,207,"ŞCOALA PRIMARĂ ""GEORGE COŞBUC"" ZAGON",ZAGON,CV,1549,5,0,0,5,10,3,0,13,12,3,0,15,15,3,0,18,16,3,0,19
65039,208,"CĂMINUL CULTURAL PĂPĂUŢI",PĂPĂUŢI,CV,1026,3,3,0,6,5,3,0,8,9,5,0,14,10,6,0,16,17,7,0,24
65057,209,"CĂMINUL CULTURAL ZĂBALA",ZĂBALA,CV,1275,0,0,0,0,5,3,0,8,8,3,0,11,10,3,0,13,10,3,0,13
65057,210,"CLUBUL NR. 2 ZĂBALA",ZĂBALA,CV,823,6,3,0,9,10,3,0,13,12,3,0,15,16,3,0,19,17,3,0,20
65057,211,"CĂMINUL CULTURAL ZĂBALA (PAVA)",ZĂBALA,CV,698,1,0,0,1,2,1,0,3,2,1,0,3,2,1,0,3,3,1,0,4
65084,212,"CĂMINUL CULTURAL TAMAŞFALĂU",TAMAŞFALĂU,CV,422,0,0,0,0,0,0,0,0,0,2,0,2,0,2,0,2,0,2,0,2
65075,213,"CĂMINUL CULTURAL SURCEA",SURCEA,CV,502,2,0,0,2,3,0,0,3,4,0,0,4,6,0,0,6,7,0,0,7
65066,214,"CĂMINUL CULTURAL PETENI",PETENI,CV,121,0,0,0,0,0,0,0,0,0,0,0,0,0,1,0,1,0,1,0,1
65351,1,"CASA CORPULUI DIDACTIC",TÎRGOVIŞTE,DB,1469,16,0,0,16,48,12,0,60,69,13,0,82,89,16,0,105,97,16,0,113
65351,2,"CASA CORPULUI DIDACTIC",TÎRGOVIŞTE,DB,1593,10,0,0,10,44,0,0,44,67,0,0,67,87,0,1,88,98,1,0,99
65351,3,"GRĂDINIȚA NR. 2",TÎRGOVIŞTE,DB,1546,7,0,0,7,36,0,0,36,51,0,0,51,70,0,0,70,75,1,1,77
65351,4,"ȘCOALA ”RADU CEL MARE”",TÎRGOVIŞTE,DB,1184,10,0,0,10,26,1,0,27,50,3,0,53,58,4,0,62,66,4,0,70
65351,5,"ȘCOALA ”RADU CEL MARE”",TÎRGOVIŞTE,DB,1307,19,2,0,21,52,3,0,55,61,8,0,69,83,9,0,92,86,9,0,95
65351,6,"ȘCOALA ”RADU CEL MARE”",TÎRGOVIŞTE,DB,1314,9,0,0,9,44,3,0,47,52,3,0,55,66,6,0,72,74,6,0,80
65351,7,"ȘCOALA ”RADU CEL MARE”",TÎRGOVIŞTE,DB,1398,25,1,0,26,74,2,0,76,94,4,0,98,116,8,0,124,126,11,0,137
65351,8,"LICEUL TEHNOLOGIC ”SPIRU HARET”",TÎRGOVIŞTE,DB,1170,10,0,0,10,35,2,0,37,44,2,0,46,55,2,0,57,58,3,0,61
65351,9,"LICEUL TEHNOLOGIC ”SPIRU HARET”",TÎRGOVIŞTE,DB,987,10,0,0,10,36,1,0,37,49,1,0,50,60,2,0,62,66,2,0,68
65351,10,"LICEUL TEHNOLOGIC ”SPIRU HARET”",TÎRGOVIŞTE,DB,1294,16,4,0,20,55,4,0,59,68,4,0,72,76,5,0,81,77,5,0,82
65351,11,"LICEUL DE ARTE ”BĂLAȘA DOAMNA”",TÎRGOVIŞTE,DB,1112,12,5,0,17,48,6,0,54,64,7,0,71,77,10,0,87,86,10,0,96
65351,12,"LICEUL TEORETIC ”PETRU CERCEL”",TÎRGOVIŞTE,DB,1727,8,0,0,8,35,3,0,38,55,5,0,60,77,6,0,83,85,10,0,95
65351,13,"COLEGIUL NAȚIONAL ”CONSTANTIN CARABELLA”",TÎRGOVIŞTE,DB,1157,19,4,0,23,56,4,0,60,85,8,0,93,123,9,0,132,123,10,0,133
65351,14,"ȘCOALA ”MATEI BASARAB”",TÎRGOVIŞTE,DB,920,4,0,0,4,24,2,0,26,31,3,0,34,38,3,0,41,43,3,0,46
65351,15,"ȘCOALA ”MATEI BASARAB”",TÎRGOVIŞTE,DB,883,4,0,0,4,23,0,0,23,36,0,0,36,50,0,0,50,60,0,0,60
65351,16,"ȘCOALA ”MATEI BASARAB”",TÎRGOVIŞTE,DB,1429,10,0,0,10,32,0,0,32,53,0,0,53,77,4,0,81,82,5,0,87
65351,17,"ȘCOALA ”TUDOR VLADIMIRESCU”",TÎRGOVIŞTE,DB,1427,9,3,0,12,29,3,0,32,46,5,0,51,55,5,0,60,60,5,0,65
65351,18,"ȘCOALA ”TUDOR VLADIMIRESCU”",TÎRGOVIŞTE,DB,1212,15,1,0,16,36,1,0,37,53,1,0,54,77,2,0,79,83,2,0,85
65351,19,"LICEUL TEHNOLOGIC ”CONSTANTIN BRÂNCOVEANU”",TÎRGOVIŞTE,DB,824,9,2,0,11,21,2,0,23,31,3,0,34,39,4,0,43,41,9,0,50
65351,20,"LICEUL TEHNOLOGIC ”CONSTANTIN BRÂNCOVEANU”",TÎRGOVIŞTE,DB,887,5,0,0,5,14,2,0,16,28,4,0,32,40,4,0,44,40,4,0,44
65351,21,"LICEUL TEHNOLOGIC ”CONSTANTIN BRÂNCOVEANU”",TÎRGOVIŞTE,DB,1444,16,1,0,17,47,3,0,50,60,4,0,64,76,4,0,80,84,4,0,88
65351,22,"LICEUL TEHNOLOGIC ”CONSTANTIN BRÂNCOVEANU”",TÎRGOVIŞTE,DB,796,5,2,0,7,16,2,0,18,27,3,0,30,35,4,0,39,35,4,0,39
65351,23,"LICEUL TEHNOLOGIC ”CONSTANTIN BRÂNCOVEANU”",TÎRGOVIŞTE,DB,748,5,0,0,5,16,0,0,16,25,3,0,28,29,3,0,32,32,3,0,35
65351,24,"CANTINA DE AJUTOR SOCIAL",TÎRGOVIŞTE,DB,1030,3,0,0,3,22,0,0,22,35,0,0,35,50,1,106,157,54,4,106,164
65351,25,"ȘCOALA ”PAUL BANICĂ”",TÎRGOVIŞTE,DB,1154,8,4,0,12,21,5,0,26,32,7,0,39,41,9,0,50,44,9,0,53
65351,26,"ȘCOALA ”PAUL BANICĂ”",TÎRGOVIŞTE,DB,1078,7,0,0,7,24,3,0,27,36,4,0,40,44,4,0,48,46,4,0,50
65351,27,"LICEUL TEORETIC ”ION HELIADE RĂDULESCU”",TÎRGOVIŞTE,DB,921,4,1,0,5,33,3,0,36,42,4,0,46,53,5,0,58,60,5,0,65
65351,28,"LICEUL TEORETIC ”ION HELIADE RĂDULESCU”",TÎRGOVIŞTE,DB,1149,10,0,0,10,39,0,0,39,56,3,0,59,82,5,0,87,91,7,0,98
65351,29,"BIROURI PRIMĂRIE - SERVICIUL TAXE ȘI IMPOZITE, BLOC E4",TÎRGOVIŞTE,DB,855,19,5,0,24,39,6,0,45,45,6,0,51,60,6,0,66,62,9,0,71
65351,30,"BIROURI PRIMĂRIE - SERVICIUL TAXE ȘI IMPOZITE (PUNCT TERMIC)",TÎRGOVIŞTE,DB,869,11,2,0,13,42,2,0,44,53,5,0,58,62,6,0,68,69,6,0,75
65351,31,"BIROURI PRIMĂRIE - CORP B (SALA CĂSĂTORII)",TÎRGOVIŞTE,DB,1116,13,1,0,14,34,7,0,41,48,9,0,57,58,13,0,71,66,16,0,82
65351,32,"COLEGIUL ECONOMIC ”ION GHICA”",TÎRGOVIŞTE,DB,1044,8,2,0,10,33,3,0,36,53,5,0,58,66,5,0,71,78,5,0,83
65351,33,"COLEGIUL ECONOMIC ”ION GHICA”",TÎRGOVIŞTE,DB,1202,14,1,0,15,48,2,0,50,67,9,0,76,77,13,0,90,91,14,0,105
65351,34,"COLEGIUL NAȚIONAL ”IENĂCHIȚĂ VĂCĂRESCU”",TÎRGOVIŞTE,DB,1564,34,0,0,34,69,2,0,71,92,2,0,94,102,4,0,106,106,5,0,111
65351,35,"ȘCOALA ”ION ALEXANDRU BRĂTESCU-VOINEȘTI”",TÎRGOVIŞTE,DB,1110,16,1,0,17,34,4,0,38,62,7,0,69,76,10,0,86,83,11,0,94
65351,36,"ȘCOALA ”ION ALEXANDRU BRĂTESCU-VOINEȘTI”",TÎRGOVIŞTE,DB,911,15,1,0,16,28,3,0,31,50,6,0,56,67,9,0,76,74,9,0,83
65351,37,"ȘCOALA ”ION ALEXANDRU BRĂTESCU-VOINEȘTI”",TÎRGOVIŞTE,DB,910,5,0,0,5,19,0,0,19,22,0,0,22,33,0,0,33,35,0,0,35
65351,38,"LICEUL ”VOIEVOUL MIRCEA”",TÎRGOVIŞTE,DB,1551,14,0,0,14,50,1,32,83,70,2,32,104,76,2,32,110,85,2,32,119
65351,39,"ȘCOALA ”CORESI”",TÎRGOVIŞTE,DB,1211,20,2,0,22,60,4,0,64,83,10,5,98,98,19,5,122,108,21,5,134
65351,40,"LICEUL TEHNOLOGIC DE TRANSPORTURI AUTO",TÎRGOVIŞTE,DB,1193,8,6,0,14,28,6,0,34,41,6,0,47,53,6,0,59,61,6,0,67
65351,41,"LICEUL TEHNOLOGIC DE TRANSPORTURI AUTO",TÎRGOVIŞTE,DB,1756,18,2,0,20,43,2,0,45,57,4,0,61,85,5,0,90,95,5,0,100
65351,42,"LICEUL TEHNOLOGIC DE TRANSPORTURI AUTO",TÎRGOVIŞTE,DB,1335,8,1,0,9,30,2,0,32,40,2,0,42,55,3,0,58,66,3,0,69
65351,43,"LICEUL TEHNOLOGIC DE TRANSPORTURI AUTO",TÎRGOVIŞTE,DB,1383,6,2,0,8,19,2,0,21,40,2,0,42,71,2,0,73,78,2,0,80
65351,44,"LICEUL TEHNOLOGIC DE TRANSPORTURI AUTO",TÎRGOVIŞTE,DB,1335,14,3,0,17,44,3,0,47,58,3,0,61,74,3,0,77,74,3,0,77
65351,45,"LICEUL TEHNOLOGIC ”NICOLAE CIORĂNESCU”",TÎRGOVIŞTE,DB,1326,8,0,0,8,40,0,0,40,47,0,0,47,56,2,0,58,59,2,0,61
65351,46,"LICEUL TEHNOLOGIC ”NICOLAE CIORĂNESCU”",TÎRGOVIŞTE,DB,1200,32,1,0,33,66,3,0,69,90,3,0,93,112,4,0,116,123,4,0,127
65351,47,"LICEUL TEHNOLOGIC ”NICOLAE CIORĂNESCU”",TÎRGOVIŞTE,DB,846,11,3,0,14,39,7,0,46,50,8,0,58,56,10,0,66,61,11,0,72
65351,48,"LICEUL TEHNOLOGIC ”NICOLAE CIORĂNESCU”",TÎRGOVIŞTE,DB,820,12,2,0,14,32,3,0,35,46,4,0,50,58,5,0,63,64,5,0,69
65351,49,"ȘCOALA ”MIHAI VITEAZUL”",TÎRGOVIŞTE,DB,1198,12,4,0,16,43,5,0,48,59,6,1,66,74,6,1,81,83,9,1,93
65351,50,"ȘCOALA ”MIHAI VITEAZUL”",TÎRGOVIŞTE,DB,1188,12,0,0,12,42,1,0,43,62,1,0,63,83,1,0,84,83,1,0,84
65351,51,"COLEGIUL NAȚIONAL ”CONSTANTIN CANTACUZINO”",TÎRGOVIŞTE,DB,1336,18,1,0,19,37,4,0,41,47,6,0,53,60,8,0,68,67,8,0,75
65351,52,"COLEGIUL NAȚIONAL ”CONSTANTIN CANTACUZINO”",TÎRGOVIŞTE,DB,1472,12,1,0,13,29,1,0,30,47,1,0,48,68,4,0,72,74,6,0,80
65351,53,"COLEGIUL NAȚIONAL ”CONSTANTIN CANTACUZINO”",TÎRGOVIŞTE,DB,720,8,0,0,8,20,0,0,20,31,0,0,31,38,0,0,38,39,0,0,39
65351,54,"COLEGIUL NAȚIONAL ”CONSTANTIN CANTACUZINO”",TÎRGOVIŞTE,DB,865,9,0,0,9,18,1,0,19,31,1,0,32,37,1,0,38,40,3,0,43
65351,55,"ȘCOALA ”GRIGORE ALEXANDRESCU”",TÎRGOVIŞTE,DB,1414,13,5,0,18,42,6,0,48,58,7,0,65,74,7,0,81,78,7,0,85
65351,56,"ȘCOALA ”GRIGORE ALEXANDRESCU”",TÎRGOVIŞTE,DB,1315,18,0,0,18,41,0,0,41,55,0,0,55,68,0,0,68,72,0,0,72
65351,57,"ȘCOALA ”GRIGORE ALEXANDRESCU”",TÎRGOVIŞTE,DB,805,7,3,0,10,22,5,0,27,29,5,0,34,41,5,0,46,42,5,0,47
65351,58,"ȘCOALA ”GRIGORE ALEXANDRESCU”",TÎRGOVIŞTE,DB,784,4,0,0,4,19,0,0,19,25,2,0,27,31,2,0,33,41,2,0,43
65351,59,"ȘCOALA ”SMARANDA GHEORGHIU”",TÎRGOVIŞTE,DB,1532,8,3,0,11,26,4,0,30,49,5,0,54,79,7,0,86,86,8,0,94
65351,60,"ȘCOALA ”SMARANDA GHEORGHIU”",TÎRGOVIŞTE,DB,1636,18,1,0,19,51,3,0,54,83,5,0,88,93,7,0,100,110,7,0,117
65351,61,"ȘCOALA ”SMARANDA GHEORGHIU”",TÎRGOVIŞTE,DB,1375,8,1,0,9,42,1,0,43,91,5,0,96,95,5,0,100,97,7,0,104
65351,62,"ȘCOALA ”SMARANDA GHEORGHIU”",TÎRGOVIŞTE,DB,788,7,0,0,7,15,0,0,15,26,0,0,26,47,0,0,47,54,0,0,54
65351,63,"ȘCOALA ”SMARANDA GHEORGHIU”",TÎRGOVIŞTE,DB,1141,5,0,0,5,12,0,0,12,23,0,0,23,36,0,0,36,39,0,0,39
65351,64,"CĂMINUL CULTURAL ”MATEI VOIEVOD”",TÎRGOVIŞTE,DB,1492,10,0,0,10,30,3,0,33,42,3,1,46,57,3,1,61,63,3,1,67
65351,65,"GRĂDINIȚA ”PRISEACA”",TÎRGOVIŞTE,DB,1000,10,2,0,12,22,2,0,24,39,3,0,42,53,3,0,56,61,3,0,64
65850,66,ŞCOALAGIMNAZIALĂNR.2,MORENI,DB,1101,2,1,0,3,13,1,0,14,22,3,0,25,41,4,0,45,42,5,0,47
65850,67,"CLUB CRISTIAN ( UZINA AUTOMECANICĂ MORENI )",MORENI,DB,717,4,0,0,4,5,0,0,5,14,0,0,14,30,2,0,32,33,3,0,36
65850,68,"GRĂDINIŢACU PROGRAM NORMALNR.7ŢUICANI",MORENI,DB,415,4,0,0,4,5,0,0,5,10,0,0,10,16,2,0,18,16,3,0,19
65850,69,"GRĂDINIŢA CU PROGRAM NORMAL NR.2",MORENI,DB,753,19,5,0,24,43,5,0,48,53,5,4,62,66,5,4,75,68,5,4,77
65850,70,CLUBFLACĂRANR.2,MORENI,DB,813,10,0,0,10,31,0,0,31,44,2,0,46,53,2,0,55,56,3,0,59
65850,71,"GRĂDINIŢA CU PROGRAM NORMAL TISA",MORENI,DB,508,9,3,0,12,18,5,0,23,27,7,0,34,37,7,0,44,45,8,0,53
65850,72,"ŞCOALAGIMNAZIALĂ NR.3",MORENI,DB,1270,11,0,0,11,45,0,0,45,58,1,0,59,68,1,0,69,72,1,0,73
65850,73,"ŞCOALAGIMNAZIALĂ NR.3",MORENI,DB,801,4,5,0,9,18,6,0,24,28,7,0,35,45,7,0,52,47,7,0,54
65850,74,"ŞCOALAGIMNAZIALĂ NR.3",MORENI,DB,763,3,0,0,3,24,1,0,25,35,2,0,37,41,2,0,43,42,2,0,44
65850,75,"ŞCOALAGIMNAZIALĂ NR.3",MORENI,DB,960,5,0,0,5,27,1,0,28,37,1,0,38,49,1,0,50,54,1,0,55
65850,76,"ŞCOALAGIMNAZIALĂ NR.3",MORENI,DB,993,5,3,0,8,19,3,0,22,27,6,0,33,36,6,0,42,38,6,0,44
65850,77,"ŞCOALAGIMNAZIALĂ NR.4",MORENI,DB,1013,6,1,0,7,28,1,0,29,48,2,0,50,64,3,0,67,71,4,0,75
65850,78,"ŞCOALAGIMNAZIALĂ NR.4",MORENI,DB,685,4,0,0,4,17,0,0,17,22,0,0,22,25,0,0,25,29,1,0,30
65850,79,"ŞCOALAGIMNAZIALĂ NR.4",MORENI,DB,898,8,2,0,10,23,2,0,25,31,2,0,33,36,2,0,38,40,2,0,42
65850,80,"ŞCOALAGIMNAZIALĂ NR.4",MORENI,DB,938,4,1,0,5,17,1,0,18,35,1,0,36,49,2,0,51,53,2,0,55
65850,81,"ŞCOALAGIMNAZIALĂ NR.4",MORENI,DB,845,11,0,0,11,22,1,0,23,34,1,0,35,41,2,0,43,45,2,0,47
65850,82,"SALA DE SPORT",MORENI,DB,736,11,0,0,11,33,2,0,35,38,5,0,43,44,5,0,49,48,5,0,53
65850,83,SALADESPORT,MORENI,DB,646,10,1,0,11,23,2,0,25,28,2,0,30,46,6,0,52,47,6,0,53
65850,84,"LICEULTEORETIC ""ION LUCA CARAGIALE""",MORENI,DB,726,8,0,0,8,21,2,0,23,22,3,16,41,32,5,16,53,34,5,16,55
65850,85,LICEULTEHNOLOGICDEPETROL,MORENI,DB,1410,8,0,0,8,36,1,0,37,52,1,0,53,59,1,0,60,63,1,0,64
65636,86,"GRĂDINIȚA ""PINOCHIO"" COSTEȘTI",COSTEŞTI,DB,662,7,2,0,9,19,2,0,21,37,2,0,39,50,4,0,54,58,5,0,63
65627,87,"GRĂDINIȚA ""PITICII"" BEREVOIEȘTI",BEREVOEŞTI,DB,556,8,0,0,8,17,0,0,17,31,1,0,32,57,3,0,60,62,3,0,65
65618,88,"ȘCOALA GENERALĂ ""DIACONU CORESI"" FIENI",FIENI,DB,1581,16,0,0,16,37,2,0,39,60,4,0,64,89,6,1,96,102,8,1,111
65618,89,"GRUP ŞCOLAR INDUSTRIAL ""INGINER AUREL RAINU"" FIENI",FIENI,DB,1523,25,1,0,26,62,2,0,64,82,4,0,86,101,5,0,106,108,5,0,113
65618,90,"GRUP ȘCOLAR INDUSTRIAL ""INGINER AUREL RAINU"" FIENI",FIENI,DB,1534,23,1,0,24,33,1,0,34,46,1,0,47,63,1,0,64,75,1,0,76
65618,91,"GRĂDINIŢA ""DUMBRAVA MINUNATĂ"" FIENI",FIENI,DB,626,5,0,0,5,22,0,0,22,29,0,0,29,37,0,0,37,39,0,0,39
65690,92,"ȘCOALA GIMNAZIALĂ NR.1",GĂEŞTI,DB,913,11,0,0,11,28,4,0,32,41,7,0,48,62,7,0,69,69,9,0,78
65690,93,"ȘCOALA GIMNAZIALĂ NR.1",GĂEŞTI,DB,875,13,0,0,13,32,0,183,215,45,6,183,234,59,7,183,249,68,7,183,258
65690,94,"LICEUL TEHNOLOGIC ,, DOCTOR CONSTANTIN ANGELESCU,,",GĂEŞTI,DB,1250,17,1,0,18,34,1,0,35,48,1,0,49,87,1,0,88,91,2,0,93
65690,95,"COLEGIUL NAȚIONAL ,, VLADIMIR STREINU,,",GĂEŞTI,DB,1465,18,4,0,22,37,10,0,47,52,14,0,66,67,16,0,83,67,16,0,83
65690,96,"ȘCOALA GIMNAZIALĂ ,,ȘERBAN CIOCULESCU,,",GĂEŞTI,DB,1344,13,2,0,15,47,4,0,51,61,6,0,67,78,8,0,86,84,9,0,93
65690,97,"ȘCOALA GIMNAZIALĂ ,,ȘERBAN CIOCULESCU,,",GĂEŞTI,DB,856,7,2,0,9,25,3,0,28,33,4,0,37,38,4,0,42,42,4,0,46
65690,98,"ȘCOALA GIMNAZIALĂ ,,ȘERBAN CIOCULESCU,,",GĂEŞTI,DB,1225,18,4,0,22,44,4,0,48,64,5,0,69,93,5,0,98,99,5,0,104
65690,99,"ȘCOALA GIMNAZIALĂ ,,ȘERBAN CIOCULESCU,,",GĂEŞTI,DB,1372,10,0,0,10,36,0,0,36,49,1,0,50,78,2,0,80,88,2,0,90
65690,100,"ȘCOALA GIMNAZIALĂ ,,RADU CEL MARE,,",GĂEŞTI,DB,729,6,3,0,9,20,6,0,26,23,8,0,31,31,9,0,40,37,10,0,47
65690,101,"ȘCOALA GIMNAZIALĂ ,,RADU CEL MARE,,",GĂEŞTI,DB,1132,24,2,0,26,49,2,0,51,60,4,0,64,74,5,0,79,85,6,0,91
65690,102,"ȘCOALA GIMNAZIALĂ ,,RADU CEL MARE,,",GĂEŞTI,DB,1574,19,0,0,19,47,5,0,52,68,7,0,75,79,8,11,98,85,8,11,104
65930,103,"ȘCOALA GENERALĂ NR.2 PUCIOASA",PUCIOASA,DB,1275,10,0,0,10,22,3,0,25,39,5,0,44,56,5,0,61,58,5,0,63
65958,104,"GRĂDINIȚA DIACONEȘTI NR.9",DIACONEŞTI,DB,844,2,0,0,2,9,2,0,11,13,2,0,15,20,5,0,25,22,5,0,27
65930,105,"ȘCOALA GIMNAZIALĂ ,,MIHAI VITEAZUL'' PUCIOASA",PUCIOASA,DB,1053,17,12,0,29,52,26,0,78,67,57,0,124,89,66,0,155,96,66,0,162
65930,106,"ȘCOALA GIMNAZIALĂ ,,MIHAI VITEAZUL'' PUCIOASA",PUCIOASA,DB,1174,9,3,0,12,40,15,0,55,45,17,0,62,59,20,0,79,68,22,0,90
65930,107,"GRĂDINIȚA NR. 1 PUCIOASA",PUCIOASA,DB,882,11,5,0,16,52,10,0,62,70,20,0,90,87,24,0,111,89,24,0,113
65930,108,"ȘCOALA GIMNAZIALĂ ,,DONICI ELENA CANTACUZINO'' PUCIOASA",PUCIOASA,DB,1321,11,0,0,11,40,1,0,41,49,3,0,52,66,8,0,74,69,8,0,77
65930,109,"COLEGIUL NAȚIONAL ,,NICOLAE TITULESCU'' PUCIOASA",PUCIOASA,DB,1176,10,0,0,10,30,5,0,35,36,7,0,43,51,9,0,60,55,9,0,64
65930,110,"GRĂDINIȚA NR.2 PUCIOASA",PUCIOASA,DB,1127,13,1,0,14,37,1,0,38,48,2,0,50,81,3,0,84,88,3,0,91
65930,111,"GRĂDINIȚA NR. 3 PUCIOASA",PUCIOASA,DB,1149,11,3,0,14,29,3,0,32,44,4,0,48,58,5,1,64,62,7,1,70
65930,112,"ȘCOALA GIMNAZIALĂ NR. 3 PUCIOASA",PUCIOASA,DB,1249,15,0,0,15,41,5,0,46,51,5,0,56,65,8,0,73,72,8,0,80
65967,113,"ȘCOALA GIMNAZIALĂ NR. 5 GLODENI",GLODENI,DB,1036,5,0,0,5,11,0,0,11,15,4,0,19,24,7,0,31,31,11,0,42
65976,114,"ȘCOALA GIMNAZIALĂ MALURI",MALURILE,DB,105,7,1,0,8,14,2,0,16,15,2,0,17,16,2,0,18,16,2,0,18
65994,115,"ȘCOALA GIMNAZIALĂ PUCIOASA-SAT",PUCIOASA-SAT,DB,349,7,1,0,8,13,1,0,14,17,1,0,18,24,1,0,25,24,1,0,25
68636,116,"LICEUL TEORETIC ""ION GHICA"" RĂCARI",RĂCARI,DB,868,22,7,0,29,46,13,0,59,54,14,38,106,82,30,38,150,96,34,38,168
68636,117,"LICEUL TEORETIC"" ION GHICA"" RACARI",RĂCARI,DB,827,20,0,0,20,43,10,0,53,60,17,46,123,92,22,46,160,99,25,46,170
68663,118,"ȘCOALA GENERALĂ GHERGANI",GHERGANI,DB,604,16,4,0,20,32,12,0,44,39,18,30,87,51,24,30,105,56,25,30,111
68681,119,"GRĂDINIȚA MAVRODIN",MAVRODIN,DB,807,13,2,0,15,42,15,0,57,55,19,0,74,99,26,28,153,112,29,28,169
68672,120,"CĂMINUL CULTURAL GHIMPAȚI",GHIMPAŢI,DB,636,9,2,0,11,29,13,0,42,52,21,0,73,67,24,0,91,84,25,0,109
68654,121,"ȘCOALA GENERALĂ COLACU",COLACU,DB,709,17,3,0,20,38,14,0,52,56,24,0,80,79,38,70,187,92,45,70,207
68690,122,"GRĂDINIȚA SĂBIEȘTI",SĂBIEŞTI,DB,637,29,17,0,46,92,45,0,137,144,49,0,193,194,71,41,306,200,73,41,314
66090,123,"ȘCOALA GIMNAZIALA NR. 2 TITU",TITU,DB,1273,15,4,0,19,35,10,0,45,62,16,0,78,78,19,0,97,85,20,0,105
66090,124,"ȘCOALA GIMNAZIALANR. 2 TITU",TITU,DB,1031,22,0,0,22,50,1,0,51,62,1,0,63,96,6,0,102,109,6,0,115
66090,125,"ȘCOALA SĂLCUȚA",TITU,DB,1128,18,5,0,23,34,7,0,41,50,9,0,59,71,13,0,84,75,13,0,88
66090,126,"ȘCOALA GIMNAZIALA PICTOR NICOLAE GRIGORESCU",TITU,DB,1318,31,4,0,35,50,5,0,55,63,7,0,70,86,13,0,99,89,15,0,104
66090,127,"LICEUL TEORETIC IANCU C.VISARION",TITU,DB,1168,12,2,0,14,46,2,0,48,61,2,0,63,83,2,0,85,94,2,0,96
66090,128,"LICEUL TEORETIC IANCU .C.VISARION",TITU,DB,1292,23,0,0,23,42,0,0,42,63,0,0,63,84,0,0,84,88,0,0,88
66090,129,"LICEUL TEORETIC IANCU .C.VISARION",TITU,DB,1205,9,1,0,10,26,1,0,27,35,1,0,36,56,3,0,59,70,4,0,74
65388,130,"ŞCOALA GIMNAZIALĂ ANINOASA",ANINOASA,DB,1040,12,1,0,13,29,4,0,33,47,6,0,53,63,13,0,76,70,13,0,83
65388,131,"ŞCOALA GIMNAZIALĂ ANINOASA",ANINOASA,DB,966,7,0,0,7,17,1,0,18,30,1,0,31,49,2,0,51,53,3,0,56
65404,132,"ŞCOALA GIMNAZIALĂ ANINOASA",VIFORÎTA,DB,1020,15,2,0,17,55,7,0,62,76,11,0,87,119,12,18,149,119,14,18,151
65404,133,"ŞCOALA GIMNAZIALĂANINOASA",VIFORÎTA,DB,977,5,0,0,5,29,8,0,37,36,10,0,46,74,16,0,90,80,17,0,97
65397,134,"ŞCOALA GIMNAZIALĂ ANINOASA",SĂTENI,DB,1288,24,4,0,28,48,4,0,52,60,4,0,64,124,4,0,128,133,4,0,137
66205,135,"ŞCOALA PROFESIONALĂ BĂLENI",BĂLENI-ROMÂNI,DB,1546,10,0,0,10,27,2,0,29,41,2,0,43,59,4,0,63,61,5,0,66
66205,136,"LICEUL TEHNOLOGIC UDREA BĂLEANU",BĂLENI-ROMÂNI,DB,1458,8,1,0,9,16,3,0,19,34,4,0,38,45,5,0,50,49,6,0,55
66214,137,"LICEUL TEHNOLOGIC UDREA BĂLEANU",BĂLENI-SÎRBI,DB,919,11,0,0,11,18,0,0,18,22,0,0,22,37,1,0,38,37,1,0,38
66214,138,"CĂMINUL CULTURAL BĂLENI SÂRBI",BĂLENI-SÎRBI,DB,1391,22,0,0,22,29,1,0,30,48,1,0,49,67,3,0,70,73,5,0,78
66214,139,"FOSTA PRIMĂRIE BĂLENI SÂRBI",BĂLENI-SÎRBI,DB,1374,5,0,0,5,13,2,0,15,26,4,0,30,35,6,1,42,43,10,1,54
66232,140,"ŞCOALA GIMNAZIALĂ CU CLASELE I-VIII GURA BĂRBULEȚULUI","GURA BĂRBULEŢULUI",DB,461,11,0,0,11,14,15,0,29,19,19,0,38,26,21,0,47,55,21,0,76
66250,141,"ŞCOALA GIMNAZIALĂ CU CLASELE I-VIII BĂRBULEȚU",BĂRBULEŢU,DB,1350,7,4,0,11,16,5,0,21,20,5,0,25,56,5,0,61,77,6,0,83
66349,142,"ŞCOALA GIMNAZIALĂ ,,GRIGORE RĂDULESCU"" BEZDEAD",BEZDEAD,DB,1526,7,1,0,8,23,3,0,26,34,8,0,42,39,8,0,47,43,8,0,51
66349,143,"ŞCOALA GIMNAZIALĂ ,,VASILE VOICULESCU"" BEZDEAD",BEZDEAD,DB,1400,2,1,0,3,6,2,0,8,7,2,0,9,13,6,0,19,16,6,0,22
66376,144,"ŞCOALA MĂGURA",MĂGURA,DB,838,4,0,0,4,23,6,0,29,48,9,0,57,69,12,0,81,70,14,0,84
66410,145,"CĂMINUL CULTURAL",BILCIUREŞTI,DB,1480,33,10,0,43,73,22,0,95,116,34,0,150,157,43,0,200,162,43,0,205
66161,146,"ŞCOALA ""SPIRU HARET"" BRANIŞTEA, CLASELE I-IV,SALA DE CLASA NR. 1",BRANIŞTEA,DB,1226,13,2,0,15,34,2,0,36,51,4,0,55,83,7,0,90,90,8,0,98
66161,147,"ŞCOALA ""SPIRU HARET"" BRANIŞTEA, CLASELE I-IV,SALA DE CLASA NR. 2",BRANIŞTEA,DB,1130,13,1,0,14,23,5,0,28,43,9,0,52,60,11,0,71,67,13,0,80
66170,148,"ŞCOALA ""SPIRU HARET"" BRANIŞTEA, CLASELE I-IV, SALA DE CLASA NR. 1",DÎMBOVICIOARA,DB,882,5,0,0,5,12,1,0,13,21,3,0,24,48,6,0,54,59,6,0,65
66189,149,"CLĂDIREA ADMINISTRATIVĂ A CONSILIULUI LOCAL BRANIŞTEA",SĂVEŞTI,DB,134,15,5,0,20,15,5,0,20,16,6,0,22,24,6,0,30,24,6,0,30
66018,150,"CENTRUL DE CULTURĂ ŞI TRADIŢIE POPULARĂ BRĂNEŞTI",BRĂNEŞTI,DB,1315,23,0,0,23,42,7,0,49,66,8,0,74,79,10,0,89,81,12,0,93
66018,151,"ŞCOALA GIMNAZIALĂ BRĂNEŞTI",BRĂNEŞTI,DB,1477,12,0,0,12,46,6,0,52,66,8,0,74,99,9,0,108,109,13,0,122
66018,152,"GRĂDINIŢA CU PROGRAM NORMAL PRIBOIU",BRĂNEŞTI,DB,816,8,0,0,8,20,0,0,20,30,3,0,33,45,8,0,53,46,8,0,54
101350,153,"ȘCOALA GIMNAZIALĂ BREZOAELE",BREZOAELE,DB,1113,20,1,0,21,60,8,0,68,88,8,0,96,144,16,0,160,162,18,0,180
101369,154,"ȘCOALA GIMNAZIALĂ BREZOAIA",BREZOAIA,DB,799,25,2,0,27,48,3,0,51,66,6,8,80,98,15,8,121,105,15,8,128
101369,155,"ȘCOALA GIMNAZIALĂ BREZOAIA",BREZOAIA,DB,995,20,6,0,26,36,8,0,44,61,14,0,75,134,18,0,152,141,21,0,162
66447,156,"GRĂDINIṬA CU PROGRAM NORMAL",BUCIUMENI,DB,1510,8,1,0,9,23,4,0,27,27,4,0,31,37,6,0,43,48,8,0,56
66456,157,"ṢCOALA GENERALĂ","DEALU MARE",DB,1192,18,0,0,18,25,1,0,26,35,3,0,38,44,6,0,50,45,6,0,51
66465,158,"ṢCOALA PRIMARĂ ṢI GRĂDINIṬA CU PROGRAM NORMAL","VALEA LEURZII",DB,1052,14,0,0,14,31,3,0,34,60,3,0,63,74,3,0,77,77,3,0,80
66483,159,"ȘCOALA GIMNAZIALĂ ”DORA DALLES” BUCȘANI",BUCŞANI,DB,1490,17,0,0,17,29,0,0,29,43,0,0,43,49,0,0,49,54,0,0,54
66483,160,"ȘCOALA GIMNAZIALĂ ”DORA DALLES” BUCȘANI",BUCŞANI,DB,1486,11,4,0,15,31,4,0,35,48,6,0,54,64,6,0,70,76,7,0,83
66492,161,"ȘCOALA GENERALĂ HĂBENI",HĂBENI,DB,1136,9,0,0,9,22,1,0,23,28,2,0,30,42,2,0,44,47,2,0,49
66508,162,"ȘCOALA GENERALĂ RACOVIȚA",RACOVIŢA,DB,1037,7,0,0,7,10,0,0,10,19,0,0,19,31,0,0,31,32,0,0,32
66517,163,"ȘCOALA GENERALĂ RĂȚOAIA",RĂŢOAIA,DB,396,6,0,0,6,10,1,0,11,12,1,0,13,23,3,0,26,24,3,0,27
101573,164,"ȘCOALA GIMNAZIALĂ BUTIMANU",BUTIMANU,DB,1425,21,7,0,28,48,16,0,64,82,24,0,106,125,32,0,157,131,35,0,166
101591,165,"ȘCOALA GIMNAZIALĂ LUCIANCA",LUCIANCA,DB,400,0,0,0,0,11,1,0,12,17,3,0,20,26,6,0,32,27,8,0,35
101859,166,"ȘCOALA CU CLASELE I-VIII CIOCĂNEȘTI",CIOCĂNEŞTI,DB,740,3,5,0,8,7,8,0,15,11,10,0,21,21,10,0,31,25,10,0,35
101859,167,"ȘCOALA CU CLASELE I - VIII CIOCĂNEȘTI",CIOCĂNEŞTI,DB,914,7,0,0,7,11,2,0,13,17,3,0,20,24,4,0,28,27,4,0,31
101877,168,"GRĂDINIȚA DE COPII",DECINDEA,DB,397,0,2,0,2,4,3,0,7,6,7,0,13,9,7,0,16,11,9,0,20
101886,169,"ȘCOALA CU CLASELE I-VIII URZICEANCA",URZICEANCA,DB,1172,7,5,0,12,29,11,0,40,48,22,0,70,60,26,0,86,63,27,0,90
101895,170,"ȘCOALA CU CLASELE I-VIII VIZUREȘTI",VIZUREŞTI,DB,827,8,1,0,9,42,6,0,48,83,8,0,91,136,25,0,161,177,35,0,212
66535,171,"CĂMIN CULTURAL CÎNDEȘTI VALE",CÎNDEŞTI-VALE,DB,999,9,6,0,15,19,6,0,25,22,12,0,34,25,12,0,37,25,13,0,38
66562,172,"CĂMINUL CULTURAL DRAGODĂNEȘTI",DRAGODĂNEŞTI,DB,640,9,2,0,11,12,3,0,15,13,8,0,21,34,9,0,43,45,10,0,55
66553,173,"CĂMIN CULTURAL CÎNDEȘTI DEAL","CÎNDEŞTI DEAL",DB,170,2,4,0,6,2,4,0,6,2,4,0,6,2,5,0,7,2,5,0,7
66571,174,"ȘCOALA CU CLASELE I-IV VALEA MARE","VALEA MARE",DB,108,2,0,0,2,6,0,0,6,6,0,0,6,7,2,0,9,7,2,0,9
66562,175,"ȘCOALA CU CLASELE I-IV STURZENI",DRAGODĂNEŞTI,DB,412,4,2,0,6,7,3,0,10,9,3,0,12,12,4,0,16,17,6,0,23
66688,176,"ŞCOALA MĂNĂSTIREA",MĂNĂSTIREA,DB,409,6,3,0,9,21,6,0,27,41,6,0,47,54,6,0,60,64,6,0,70
66599,177,"ȘCOALA GHERGHIȚEȘTI",GHERGHIŢEŞTI,DB,924,10,0,0,10,31,1,0,32,52,4,0,56,74,5,0,79,86,6,0,92
66679,178,"GRĂDINIŢA MISLEA",MISLEA,DB,649,6,2,0,8,24,2,0,26,38,2,0,40,46,7,0,53,46,7,0,53
66651,179,"ŞCOALA FRASIN DEAL","FRASIN DEAL",DB,567,17,4,0,21,48,6,0,54,56,6,0,62,64,8,0,72,71,9,0,80
66704,180,"ŞCOALA GIMNAZIALĂ COJASCA",COJASCA,DB,920,22,4,0,26,45,14,0,59,75,17,0,92,110,25,0,135,123,26,0,149
66704,181,"ŞCOALA GIMNAZIALĂ COJASCA",COJASCA,DB,634,1,2,0,3,22,4,0,26,42,5,0,47,68,10,0,78,103,16,0,119
66722,182,"ŞCOALA CU CLASELE I-IV IAZU",IAZU,DB,1345,5,1,0,6,45,1,0,46,105,3,0,108,134,7,0,141,149,7,0,156
66722,183,"ŞCOALA CU CLASELE I-IV IAZU",IAZU,DB,730,6,0,0,6,19,0,0,19,47,0,0,47,157,1,0,158,164,1,0,165
66713,184,"ŞCOALA GIMNAZIALĂ FÎNTÎNELE",FÎNTÎNELE,DB,982,30,10,0,40,90,14,0,104,148,24,0,172,265,27,0,292,283,28,0,311
66713,185,"ŞCOALA GIMNAZIALĂ FÎNTÎNELE",FÎNTÎNELE,DB,886,30,6,0,36,69,9,0,78,139,15,0,154,242,19,0,261,264,21,0,285
66759,186,"CAMINUL CULTURAL",LAZURI,DB,1540,28,11,0,39,79,23,0,102,119,31,0,150,156,36,0,192,192,38,0,230
66740,187,"GRADINITA COMISANI",COMIŞANI,DB,1360,14,0,0,14,42,8,0,50,55,9,0,64,68,11,0,79,78,13,0,91
66740,188,"SCOALA GENERALA I-IV COMISANI(STR.HELESTEULUI NR.2)",COMIŞANI,DB,1440,13,2,0,15,23,7,0,30,42,10,0,52,58,12,0,70,84,13,0,97
66777,189,"ŞCOALA CU CLASELE I-IV CONŢEŞTI, LOCALITATEA CONŢEŞTI, STRADA PRIMĂRIEI, NR. 444",CONŢEŞTI,DB,723,47,10,0,57,69,16,0,85,95,22,0,117,127,33,0,160,135,36,0,171
66777,190,"SALĂ FESTIVITĂŢI, LOCALITATEA CONŢEŞTI, STRADA GĂRII, NR. 183",CONŢEŞTI,DB,442,4,3,0,7,10,14,0,24,29,18,0,47,42,20,0,62,51,21,0,72
66795,191,"ŞCOALA CU CLASELE I-IV BOTENI, LOCALITATEA BOTENI, STRADA AEROPORTULUI, NR. 308G",BOTENI,DB,703,11,5,0,16,37,13,0,50,52,17,0,69,100,22,0,122,111,22,3,136
66786,192,"CĂMIN CULTURAL BĂLTENI, LOCALITATEA BĂLTENI, STRADA EROILOR, NR. 66",BĂLTENI,DB,662,1,3,0,4,8,3,0,11,22,7,0,29,53,7,0,60,79,9,0,88
66786,193,"GRĂDINIŢA BĂLTENI, LOCALITATEA BĂLTENI, STRADA EROILOR, NR. 235",BĂLTENI,DB,827,20,8,0,28,41,15,0,56,69,25,0,94,121,28,0,149,122,28,0,150
66866,194,"ŞCOALA GIMNAZIALĂ CORBII MARI","CORBII MARI",DB,1387,16,4,0,20,43,14,0,57,78,16,0,94,131,26,0,157,163,35,0,198
66946,195,"ŞCOALA PRIMARĂ VADU STANCHII","VADU STANCHII",DB,365,0,1,0,1,7,3,0,10,13,9,0,22,27,11,0,38,27,11,0,38
66900,196,"ŞCOALA GIMNAZIALĂ PETREŞTI",PETREŞTI,DB,956,8,5,0,13,22,6,0,28,38,10,0,48,70,20,0,90,95,22,0,117
66884,197,"ŞCOALA GIMNAZIALĂ GROZĂVEŞTI I",GROZĂVEŞTI,DB,624,14,2,0,16,17,3,0,20,32,3,0,35,99,11,0,110,132,14,0,146
66884,198,"GRĂDINIŢA DE COPII GROZĂVEŞTI, NR. 2",GROZĂVEŞTI,DB,989,7,1,0,8,29,8,0,37,59,18,0,77,133,22,0,155,147,23,0,170
66937,199,"GRĂDINIŢA CU PROGRAM NORMAL UNGURENI",UNGURENI,DB,863,17,1,0,18,38,5,0,43,62,9,0,71,113,13,0,126,133,14,0,147
66937,200,"ŞCOALA GIMNAZIALĂ UNGURENI",UNGURENI,DB,640,9,1,0,10,23,2,0,25,38,3,0,41,56,8,0,64,63,11,0,74
66928,201,"ŞCOALA PRIMARĂ SATU NOU","SATU NOU",DB,390,5,0,0,5,22,3,0,25,42,4,0,46,67,11,0,78,75,11,0,86
66964,202,"ŞCOALA CU CLASELE I - VIII CORNĂŢELU",CORNĂŢELU,DB,299,22,20,0,42,32,27,0,59,41,29,0,70,63,33,0,96,64,35,0,99
66982,203,"ŞCOALA CU CLASELE I - IV BOLOVANI",BOLOVANI,DB,520,21,12,0,33,45,21,0,66,67,32,0,99,79,39,0,118,89,44,0,133
66973,204,"ŞCOALA CU CLASELE I - IV ALUNIŞU",ALUNIŞU,DB,260,5,1,0,6,12,3,0,15,13,4,0,17,24,7,0,31,24,7,0,31
67032,205,"ŞCOALA PRIMARĂBUJOREANCA",BUJOREANCA,DB,365,6,5,0,11,7,5,0,12,13,7,0,20,14,7,0,21,17,7,0,24
67041,206,"ŞCOALAGIMNAZIALĂ CĂTUNU",CĂTUNU,DB,678,14,3,0,17,32,8,0,40,49,16,0,65,64,19,0,83,71,20,0,91
67023,207,"ŞCOALA GIMNAZIALĂ CORNEŞTI",CORNEŞTI,DB,1343,19,5,0,24,59,19,0,78,98,24,0,122,145,30,0,175,154,39,0,193
67069,208,"ŞCOALA PRIMARĂ CRIVĂŢU",CRIVĂŢU,DB,210,3,0,0,3,5,1,0,6,7,2,0,9,10,4,0,14,10,4,0,14
67078,209,"ŞCOALA GIMNAZIALĂ FRASINU",FRASINU,DB,499,3,0,0,3,6,5,0,11,9,7,0,16,20,10,0,30,23,11,0,34
67096,210,"ŞCOALA PRIMARĂ IBRIANU",IBRIANU,DB,609,1,0,0,1,13,3,0,16,17,3,0,20,28,6,0,34,32,11,0,43
67103,211,"ŞCOALA PRIMARĂ""GRIGORE STĂNESCU "" POSTÎRNACU",POSTÎRNACU,DB,697,4,3,0,7,15,5,0,20,17,7,0,24,23,9,0,32,23,10,0,33
67112,212,"ŞCOALA PRIMARĂ UNGURENI",UNGURENI,DB,699,7,0,0,7,17,0,0,17,26,1,0,27,30,3,0,33,33,3,0,36
67130,213,"GRĂDINIȚA CU PROGRAM NORMAL NR. 1 COSTEȘTII DIN VALE","COSTEŞTII DIN VALE",DB,423,6,1,0,7,30,2,0,32,52,8,0,60,77,13,0,90,85,13,0,98
67130,214,"ȘCOALA GIMNAZIALĂ COSTEȘTII DIN VALE","COSTEŞTII DIN VALE",DB,1266,18,3,0,21,55,4,0,59,103,5,0,108,190,9,0,199,220,9,0,229
67158,215,"ȘCOALA GIMNAZIALĂ TOMȘANI",TOMŞANI,DB,1041,11,0,0,11,34,11,0,45,81,20,0,101,141,30,0,171,164,36,0,200
102295,216,"ŞCOALA GENERALĂ CREVEDIA",CREVEDIA,DB,1271,6,0,0,6,22,6,0,28,35,12,0,47,54,18,0,72,58,20,0,78
102295,217,"CĂMIN CULTURAL",CREVEDIA,DB,647,12,2,0,14,28,4,0,32,32,8,0,40,40,11,0,51,48,18,0,66
102311,218,"ŞCOALA GIMNAZIALĂ DÂRZA",DÎRZA,DB,1421,10,7,0,17,32,14,0,46,43,17,0,60,82,28,0,110,89,31,0,120
102339,219,"GRĂDINIŢA CU PROGRAM NORMAL",SAMURCAŞI,DB,1209,13,8,0,21,27,21,0,48,38,27,0,65,54,35,0,89,61,39,0,100
102302,220,"ŞCOALA CU CLASELE I-IV",COCANI,DB,369,4,3,0,7,10,12,0,22,15,12,0,27,31,15,0,46,32,16,0,48
67176,221,"ŞCOALA GENERALĂ BĂDULEŞTI",BĂDULEŞTI,DB,1144,14,1,0,15,67,13,0,80,101,16,0,117,128,28,0,156,135,34,0,169
67210,222,"ŞCOALA GIMNAZIALĂ PĂTROAIA VALE","PĂTROAIA VALE",DB,902,26,3,0,29,59,12,0,71,71,17,0,88,102,22,0,124,107,22,0,129
67247,223,"ŞCOALA PRIMARĂ VOIA",VOIA,DB,559,4,0,0,4,16,0,0,16,46,1,0,47,86,6,0,92,121,9,0,130
67265,224,"ȘCOALA DĂRMĂNEȘTI",DĂRMĂNEŞTI,DB,1374,12,3,0,15,35,3,0,38,49,6,0,55,63,7,0,70,67,7,0,74
67265,225,"CĂMIN CULTURAL",DĂRMĂNEŞTI,DB,1627,21,1,0,22,43,2,0,45,68,2,0,70,84,4,0,88,91,5,0,96
67274,226,"ȘCOALA MĂRGINENII DE SUS","MĂRGINENII DE SUS",DB,887,15,1,0,16,27,3,0,30,45,5,0,50,55,6,0,61,55,6,0,61
67309,227,"ȘCOALA PREOT PANAIT GEORGESCU",DOBRA,DB,1460,19,1,0,20,51,5,0,56,124,9,0,133,208,13,0,221,241,13,0,254
67318,228,"ȘCOALA ÎNVĂȚĂTOR IULIAN RUSU",MĂRCEŞTI,DB,1544,14,6,0,20,40,7,0,47,54,10,0,64,119,13,0,132,135,13,0,148
65422,229,"ȘCOALA GIMNAZIALĂ NR.3 DOICEȘTI",DOICEŞTI,DB,1547,17,0,0,17,39,0,0,39,48,0,0,48,66,0,0,66,67,0,0,67
65422,230,"ȘCOALA GIMNAZIALĂ NR.1 DOICEȘTI",DOICEŞTI,DB,1522,35,0,0,35,61,0,0,61,83,0,0,83,88,3,0,91,92,3,0,95
65422,231,"GRĂDINIȚA CU PROGRAM NORMAL NR. 3 DOICEȘTI",DOICEŞTI,DB,858,7,4,0,11,13,4,0,17,23,4,0,27,43,4,1,48,46,9,1,56
67336,232,"ȘCOALA DRAGODANA",DRAGODANA,DB,1327,10,4,0,14,33,10,5,48,39,11,5,55,73,20,5,98,83,22,5,110
67354,233,"ȘCOALA BURDUCA",BURDUCA,DB,1026,25,5,0,30,72,12,0,84,109,19,0,128,160,23,0,183,173,23,0,196
67381,234,CĂMINCULTURALPICIORDEMUNTE,"PICIOR DE MUNTE",DB,1396,9,2,0,11,36,2,0,38,65,2,2,69,76,4,2,82,81,4,2,87
67381,235,"ȘCOALA NR.2 PICIOR DE MUNTE - BOBOCI","PICIOR DE MUNTE",DB,1080,14,0,0,14,35,2,0,37,53,2,0,55,66,2,11,79,74,2,11,87
67381,236,"ȘCOALA NR.2 PICIOR DE MUNTE - BOBOCI","PICIOR DE MUNTE",DB,713,11,0,0,11,20,3,0,23,29,3,0,32,40,8,8,56,45,10,8,63
67416,237,"ŞCOALA GIMNAZIALĂ DRAGOMIREŞTI",DRAGOMIREŞTI,DB,1752,8,2,0,10,41,2,0,43,65,5,0,70,88,7,0,95,100,8,0,108
67425,238,"ŞCOALAGIMNAZIALĂ DECINDENI –DRAGOMIREŞTI",DECINDENI,DB,1036,11,0,0,11,17,0,0,17,35,0,0,35,49,1,0,50,57,1,0,58
67425,239,"ŞCOALA GIMNAZIALĂ DECINDENI-DRAGOMIREŞTI",DECINDENI,DB,993,6,0,0,6,17,0,0,17,27,0,0,27,44,0,0,44,45,0,0,45
67452,240,"ŞCOALA GIMNAZIALĂ RȊNCĂCIOV-DRAGOMIREŞTI",RÎNCĂCIOV,DB,846,2,0,0,2,6,0,0,6,17,0,0,17,29,1,0,30,32,1,0,33
67452,241,"ŞCOALA GIMNAZIALĂ RȊNCĂCIOV-DRAGOMIREŞTI",RÎNCĂCIOV,DB,771,6,3,0,9,14,3,0,17,22,6,0,28,30,6,0,36,31,7,0,38
67461,242,"ŞCOALA GIMNAZIALĂ UNGURENI-DRAGOMIREŞTI",UNGURENI,DB,1073,3,3,0,6,9,3,0,12,19,3,0,22,57,4,0,61,61,4,0,65
67443,243,"CĂMINUL CULTURAL MOGOŞEŞTI",MOGOŞEŞTI,DB,482,7,1,0,8,15,2,0,17,33,3,0,36,72,6,0,78,84,12,0,96
67434,244,"GRĂDINIŢA GEANGOEŞTI-DRAGOMIREŞTI",GEANGOEŞTI,DB,274,8,3,0,11,14,3,0,17,19,3,0,22,26,3,0,29,29,3,0,32
67489,245,"ŞCOALA GENERALĂFINTA","FINTA MARE",DB,1042,0,3,0,3,9,3,0,12,19,4,0,23,25,6,0,31,25,6,0,31
67498,246,ŞCOALABECHINEŞTI,BECHINEŞTI,DB,622,6,0,0,6,25,3,0,28,48,3,0,51,52,7,0,59,54,7,0,61
67513,247,"CĂMIN CULTURAL GHEBOAIA",GHEBOAIA,DB,930,13,2,0,15,27,2,0,29,44,4,0,48,73,5,0,78,88,5,0,93
67513,248,"CĂMIN CULTURAL GHEBOAIA",GHEBOAIA,DB,798,7,2,0,9,14,2,0,16,35,4,0,39,57,7,0,64,62,7,0,69
67531,249,"ȘCOALA ""BUICĂ IONESCU""",GLODENI,DB,1666,17,0,0,17,43,4,0,47,50,4,0,54,85,9,1,95,98,9,1,108
67531,250,"ȘCOALA ""BUICĂ IONESCU""",GLODENI,DB,1151,9,0,0,9,14,1,0,15,17,1,0,18,35,1,0,36,40,1,0,41
67559,251,"GRĂDINȚA LĂCULEȚE",LĂCULEŢE,DB,702,8,0,0,8,16,2,0,18,25,3,0,28,31,3,0,34,35,3,0,38
65716,252,"ŞCOALA GIMNAZIALĂ GURA FOII","GURA FOII",DB,1238,28,7,0,35,64,15,0,79,89,16,0,105,124,24,0,148,154,29,0,183
65716,253,"GRĂDINIŢA BUMBUIA","GURA FOII",DB,364,4,0,0,4,14,9,0,23,22,10,0,32,43,13,0,56,54,13,0,67
65716,254,"SALA DE FESTIVITĂŢI FĂGETU","GURA FOII",DB,301,14,2,0,16,28,4,0,32,40,14,0,54,59,15,1,75,72,21,1,94
67602,255,"ȘCOALACU CLASELE. I-VIII GURA OCNIȚEI","GURA OCNIŢEI",DB,1393,12,0,0,12,20,8,0,28,30,9,0,39,42,9,0,51,48,9,0,57
67602,256,"ȘCOALA CU CLASELE. I-VIII GURA OCNIȚEI","GURA OCNIŢEI",DB,1523,23,2,0,25,49,11,0,60,66,13,0,79,96,15,0,111,98,15,1,114
67611,257,"ȘCOALA CUCLASELE. I-VIII ADÂNCA",ADÎNCA,DB,1548,9,1,0,10,23,2,0,25,41,3,0,44,75,6,0,81,82,7,0,89
67639,258,"ȘCOALACU CLASELE. I-VIII SĂCUENI",SĂCUENI,DB,1524,20,2,0,22,44,4,0,48,76,5,0,81,105,5,0,110,122,6,0,128
67657,259,"ȘCOALA GIMNAZIALӐ GURA ȘUȚII","GURA ŞUŢII",DB,894,18,2,0,20,28,4,0,32,59,7,0,66,94,14,23,131,108,17,23,148
67657,260,"ȘCOALA GIMNAZIALӐ GURA ȘUȚII","GURA ŞUŢII",DB,889,14,0,0,14,39,2,0,41,68,4,0,72,111,4,21,136,119,5,21,145
67657,261,"GRӐDINIȚA CU PROGRAM NORMAL GURA ȘUȚII,CORPUL B","GURA ŞUŢII",DB,1004,17,1,0,18,38,2,25,65,61,3,25,89,129,8,25,162,169,8,25,202
67666,262,"ȘCOALA GIMNAZIALӐ SPERIEȚENI",SPERIEŢENI,DB,1487,42,2,0,44,84,7,0,91,114,13,0,127,157,14,0,171,199,19,0,218
67684,263,"GRĂDINIŢA CU PROGRAM NORMAL HULUBEŞTI",HULUBEŞTI,DB,690,3,1,0,4,16,1,0,17,20,3,0,23,27,11,0,38,28,11,0,39
67719,264,"GRĂDINIŢA CU PROGRAM NORMAL MĂGURA",MĂGURA,DB,544,4,4,0,8,16,8,0,24,27,9,0,36,47,13,0,60,52,13,0,65
67693,265,"ŞCOALA GIMNAZIALĂ BUTOIU DE JOS","BUTOIU DE JOS",DB,782,6,0,0,6,13,1,0,14,28,4,0,32,60,7,0,67,62,7,0,69
67700,266,"GRĂDINIŢA CU PROGRAM NORMAL BUTOIU DE SUS","BUTOIU DE SUS",DB,643,17,1,0,18,28,2,0,30,45,9,0,54,62,10,0,72,67,10,0,77
67746,267,"ȘCOALA GIMNAZIALĂ NR. 1 GHIRDOVENI",GHIRDOVENI,DB,1513,14,2,0,16,38,4,0,42,62,8,0,70,89,10,0,99,102,12,0,114
67746,268,"ȘCOALAGIMNAZIALĂ NR. 2 GHIRDOVENI",GHIRDOVENI,DB,1224,15,0,0,15,42,2,0,44,43,4,0,47,50,4,0,54,52,4,0,56
67755,269,"CLUB PENITENCIAR I.L.CARAGIALE","I. L. CARAGIALE",DB,669,11,0,0,11,20,1,0,21,22,3,196,221,35,6,196,237,38,6,196,240
67755,270,"CĂMINUL CULTURAL I.L.CARAGIALE","I. L. CARAGIALE",DB,1444,12,3,0,15,17,4,0,21,22,4,41,67,46,4,166,216,48,4,190,242
67764,271,"ȘCOALA PRIMARĂ MIJA",MIJA,DB,646,11,0,0,11,20,1,0,21,28,2,0,30,33,3,0,36,34,3,0,37
65878,272,"ȘCOALA GIMNAZIALĂ IEDERA DE JOS","IEDERA DE JOS",DB,1202,11,2,0,13,19,6,0,25,32,9,0,41,43,10,0,53,47,10,0,57
65887,273,"GRĂDINIȚA CU PROGRAM NORMAL COLIBAȘI",COLIBAŞI,DB,440,4,5,0,9,19,8,0,27,26,10,0,36,29,10,0,39,29,10,0,39
65896,274,"GRĂDINIȚA CU PROGRAM NORMAL CRICOVU DULCE","CRICOVU DULCE",DB,331,9,4,0,13,12,4,0,16,15,4,0,19,19,4,0,23,20,4,0,24
65903,275,"ȘCOALA CU CLASELE I-IV IEDERA DE SUS","IEDERA DE SUS",DB,1158,8,0,0,8,21,2,0,23,31,3,0,34,45,3,0,48,49,3,0,52
67782,276,"ŞCOALA LUCIENI",LUCIENI,DB,978,6,2,0,8,18,3,0,21,23,3,0,26,32,6,0,38,42,7,0,49
67782,277,"ŞCOALA LUCIENI",LUCIENI,DB,1077,7,0,0,7,18,0,0,18,29,0,0,29,48,0,0,48,65,0,0,65
67791,278,"ŞCOALA OLTENI",OLTENI,DB,459,16,2,0,18,30,4,0,34,50,9,0,59,66,11,0,77,69,12,0,81
67899,279,"ȘCOALA GIMNAZIALĂ TELEȘTI",TELEŞTI,DB,1391,7,0,0,7,14,2,0,16,20,2,0,22,29,2,0,31,30,5,0,35
67862,280,"ȘCOALA PRIMARĂ POTOCELU",POTOCELU,DB,941,6,0,0,6,21,0,0,21,27,0,0,27,39,0,0,39,47,0,0,47
67871,281,"ȘCOALA GIMNAZIALA SCHEIU DE JOS","SCHEIU DE JOS",DB,856,1,0,0,1,4,0,0,4,9,0,0,9,12,0,0,12,14,0,0,14
67880,282,"ȘCOALA PRIMARĂ SCHEIU DE SUS","SCHEIU DE SUS",DB,795,2,1,0,3,6,3,0,9,12,3,0,15,16,3,0,19,16,4,0,20
67915,283,"ŞCOALA GIMNAZIALĂ NR. 2 LUNGULEŢU",LUNGULEŢU,DB,872,7,1,0,8,26,2,0,28,36,2,0,38,53,3,0,56,58,3,0,61
67915,284,"ŞCOALA GIMNAZIALĂ NR. 2 LUNGULEŢU",LUNGULEŢU,DB,1024,4,3,0,7,23,5,0,28,35,5,0,40,57,6,0,63,63,6,0,69
67915,285,"ŞCOALA GIMNAZIALĂ NR. 1 LUNGULEŢU",LUNGULEŢU,DB,1421,7,0,0,7,34,0,0,34,68,4,0,72,114,9,0,123,129,10,0,139
67933,286,"ŞCOALA GIMNAZIALĂ SERDANU",SERDANU,DB,1034,8,6,0,14,20,12,0,32,40,16,0,56,62,16,0,78,70,17,0,87
67951,287,"ȘCOALA GIMNAZIALĂ MALU CU FLORI, NR. 139BIS","MALU CU FLORI",DB,1173,5,1,0,6,9,2,0,11,15,3,0,18,20,5,10,35,40,6,10,56
67951,288,"ȘCOALA GENERALĂ CU CLASELE I-IV MICLOȘANII MICI","MALU CU FLORI",DB,743,4,2,0,6,8,3,0,11,12,7,7,26,28,12,7,47,40,17,7,64
68011,289,"ȘCOALA GIMNAZIALĂ MĂNEȘTI",MĂNEŞTI,DB,1097,11,4,0,15,21,8,0,29,35,12,0,47,55,16,0,71,55,16,0,71
68039,290,"ŞCOALA GIMNAZIALĂ DRĂGĂEŞTI-UNGURENI","DRĂGĂEŞTI UNGURENI",DB,1080,6,3,0,9,15,4,0,19,20,7,0,27,32,11,0,43,41,11,0,52
68020,291,"ŞCOALA GIMNAZIALĂ DRĂGĂEŞTI-PĂMÂNTENI","DRĂGĂEŞTI PĂMÎNTENI",DB,1793,8,2,0,10,23,2,0,25,45,7,0,52,136,11,0,147,188,12,0,200
68075,292,"ŞCOALA GENERALĂ MĂTĂSARU",MĂTĂSARU,DB,858,14,0,0,14,26,1,0,27,30,1,0,31,57,7,0,64,65,7,0,72
68084,293,"ŞCOALA PRIMARĂ ODAIA TURCULUI","ODAIA TURCULUI",DB,896,8,0,0,8,15,0,0,15,22,0,0,22,39,1,0,40,46,1,0,47
68057,294,"GRĂDINIŢA TEŢCOIU",TEŢCOIU,DB,1102,10,3,0,13,17,4,0,21,34,4,0,38,47,5,0,52,62,6,0,68
68093,295,"ŞCOALA GENERALĂ POROINICA",POROINICA,DB,639,4,1,0,5,19,4,0,23,41,7,0,48,54,8,0,62,57,8,0,65
68100,296,"ŞCOALA PRIMARĂ PUŢU CU SALCIE","PUŢU CU SALCIE",DB,777,2,1,0,3,11,1,0,12,22,1,0,23,47,1,0,48,51,1,0,52
68137,297,ȘCOALAGENERALĂMOGOȘANI,MOGOŞANI,DB,1381,7,5,0,12,18,5,0,23,33,5,0,38,52,6,0,58,56,8,0,64
68155,298,ȘCOALACOJOCARU,COJOCARU,DB,654,14,2,0,16,26,8,0,34,40,9,0,49,69,13,0,82,73,14,0,87
68164,299,ȘCOALAMERII,MERII,DB,788,11,1,0,12,21,4,0,25,40,5,0,45,64,5,0,69,64,7,0,71
68173,300,ȘCOALAZĂVOIU,ZĂVOIU,DB,741,3,3,0,6,5,4,0,9,12,4,0,16,19,4,0,23,25,5,0,30
68226,301,"SCOALA VECHE-GRADINITA",LUNCA,DB,1001,12,4,0,16,17,4,0,21,20,4,0,24,26,6,0,32,32,6,0,38
68191,302,"SCOALA ""ION CIORANESCU""",MOROENI,DB,1229,11,0,0,11,33,3,0,36,43,14,0,57,49,15,0,64,63,15,0,78
68244,303,"PANAIT PETRE",PUCHENI,DB,484,10,4,0,14,15,10,0,25,38,10,0,48,39,11,0,50,42,16,0,58
68217,304,"SCOALA GLOD",GLOD,DB,1351,8,2,0,10,23,6,30,59,62,11,30,103,89,11,30,130,106,11,30,147
68235,305,"SCOALA MUSCEL",MUŞCEL,DB,62,0,0,0,0,2,5,0,7,2,5,0,7,2,5,0,7,2,5,0,7
68262,306,"GRĂDINIȚA MORTENI CENTRU",MORTENI,DB,1180,23,2,0,25,41,9,0,50,63,10,0,73,121,11,0,132,130,11,0,141
68271,307,"GRĂDINIȚA MORTENI CENTRU",NEAJLOVU,DB,1131,15,6,0,21,31,7,0,38,54,9,0,63,93,10,0,103,103,10,0,113
65654,308,"CĂMIN CULTURAL MOŢĂIENI",MOŢĂIENI,DB,1394,9,0,0,9,28,3,0,31,43,6,0,49,57,7,2,66,61,7,2,70
65663,309,"ŞCOALA CUCUTENI",CUCUTENI,DB,375,7,3,0,10,13,5,0,18,18,6,0,24,20,7,0,27,20,7,0,27
104396,310,"ȘCOALA CU CLASELE I - VIII NICULEȘTI",NICULEŞTI,DB,1018,20,7,0,27,26,7,0,33,61,11,0,72,105,18,0,123,122,20,0,142
104396,311,"ȘCOALA CU CLASELE I - VIII NICULEȘTI",NICULEŞTI,DB,832,7,0,0,7,25,5,0,30,44,5,0,49,105,13,0,118,123,14,0,137
104412,312,"ȘCOALA CU CLASELE I-IV MOVILA",MOVILA,DB,485,8,3,0,11,15,7,0,22,27,19,0,46,49,24,0,73,55,27,0,82
104403,313,"ȘCOALA CU CLASELE I-VIII CIOCĂNARI",CIOCĂNARI,DB,987,3,2,0,5,12,5,0,17,20,10,0,30,50,13,0,63,63,15,0,78
68299,314,"ȘCOALA GIMNAZIALĂ "" NUCET """,NUCET,DB,959,58,4,0,62,115,16,0,131,127,18,0,145,154,22,0,176,173,22,0,195
68299,315,"ȘCOALA GIMNAZIALĂ""NUCET""",NUCET,DB,888,35,1,0,36,75,3,0,78,107,5,0,112,152,9,0,161,168,11,0,179
68306,316,"ȘCOALA GIMNAZIALĂ "" CAZACI """,CAZACI,DB,1192,26,5,0,31,62,11,0,73,93,17,0,110,127,23,0,150,146,24,0,170
68315,317,"ȘCOALA PRIMARĂ "" ILFOVENI """,ILFOVENI,DB,452,9,2,0,11,32,2,0,34,48,4,0,52,67,5,0,72,80,8,0,88
68333,318,"GRĂDINIȚA CU PROGRAM NORMAL NR 1 OCNIȚA",OCNIŢA,DB,1215,13,4,0,17,28,5,0,33,46,6,0,52,54,6,0,60,56,6,0,62
68333,319,"ȘCOALAGIMNAZIALĂ OCNIȚA",OCNIŢA,DB,1375,17,1,0,18,28,1,0,29,37,1,0,38,43,1,0,44,47,3,0,50
68333,320,"GRADINIȚA CU PROGRAM NORMAL NR 2FUNDU OCNEI",OCNIŢA,DB,993,6,3,0,9,16,3,0,19,32,5,0,37,50,5,0,55,52,5,0,57
68351,321,"ȘCOALA GIMNAZIALĂ ODOBEȘTI",ODOBEŞTI,DB,1269,19,4,0,23,46,19,0,65,67,29,0,96,88,39,0,127,95,41,0,136
68360,322,"GRĂDINIȚA BRÂNCOVEANU",BRÎNCOVEANU,DB,535,14,2,0,16,51,8,0,59,90,12,0,102,115,13,0,128,118,15,0,133
68388,323,"ȘCOALA PRIMARĂMIULEȘTI",MIULEŞTI,DB,423,2,3,0,5,9,5,0,14,36,9,0,45,61,9,0,70,62,10,0,72
68379,324,"GRĂDINIȚA CU PROGRAM NORMAL CROVU",CROVU,DB,1082,9,1,0,10,40,3,0,43,78,8,0,86,102,12,0,114,121,15,0,136
68397,325,"ȘCOALA PRIMARĂZIDURILE",ZIDURILE,DB,661,10,2,0,12,31,6,0,37,56,9,0,65,63,10,0,73,69,10,0,79
69296,326,"GRĂDINIȚA PERȘINARI",PERŞINARI,DB,1147,13,5,0,18,21,5,0,26,32,6,0,38,47,11,12,70,51,13,12,76
69296,327,"GRĂDINIȚA PERȘINARI",PERŞINARI,DB,1175,18,1,0,19,28,2,0,30,45,2,0,47,98,7,22,127,102,8,22,132
65823,328,"CĂMIN CULTURAL","PUNTEA DE GRECI",DB,591,5,1,0,6,25,10,0,35,36,14,0,50,40,14,0,54,40,16,0,56
65761,329,"ȘCOALA GIMNAZIALĂ PETREŞTI",PETREŞTI,DB,1162,5,5,0,10,14,7,0,21,28,11,0,39,36,15,0,51,36,15,0,51
65798,330,"ȘCOALA GIMNAZIALĂ GRECI",GRECI,DB,1271,25,2,0,27,44,6,0,50,65,8,0,73,86,9,0,95,96,9,0,105
65805,331,"GRADINITA IONESTI",IONEŞTI,DB,1515,11,2,0,13,31,5,0,36,77,9,0,86,97,9,0,106,104,9,0,113
65814,332,"GRADINITA POTLOGENI DEAL",POTLOGENI-DEAL,DB,145,4,0,0,4,4,6,0,10,9,6,0,15,12,7,0,19,12,7,0,19
66287,333,"CAMINUL CULTURAL PIETRARI",PIETRARI,DB,1450,11,4,0,15,30,14,0,44,64,18,0,82,102,19,0,121,118,19,0,137
66321,334,"SCOALA VALEA DC138",VALEA,DB,534,6,2,0,8,11,4,0,15,16,7,0,23,28,9,0,37,36,12,0,48
68413,335,"GRĂDINIŢA PIETROŞIŢA,NR.327 B",PIETROŞIŢA,DB,913,12,2,0,14,29,2,0,31,49,2,0,51,75,5,0,80,83,5,0,88
68413,336,"GRĂDINIŢA PIETROŞIŢA,NR 327 B",PIETROŞIŢA,DB,926,5,0,0,5,9,2,0,11,26,3,0,29,32,16,0,48,32,18,0,50
68422,337,"CAMINUL CULTURAL DEALU FRUMOS ,NR.309","DEALU FRUMOS",DB,856,11,2,0,13,11,6,0,17,19,6,0,25,30,6,0,36,37,7,0,44
68440,338,"ȘCOALA NR.1 POIANA, SAT POIANA",POIANA,DB,1271,11,0,0,11,31,1,0,32,56,2,0,58,89,6,0,95,96,7,0,103
68440,339,"ȘCOALANR.1 POIANA",POIANA,DB,678,11,2,0,13,21,3,0,24,27,3,0,30,45,5,0,50,49,5,0,54
68440,340,"ȘCOALA NR.2 POIANA",POIANA,DB,903,8,2,0,10,16,5,0,21,27,5,0,32,49,12,0,61,58,13,0,71
68477,341,"ŞCOALA POTLOGI",POTLOGI,DB,1293,29,3,0,32,55,11,0,66,80,14,0,94,107,15,0,122,115,17,0,132
68477,342,"ŞCOALA POTLOGI",POTLOGI,DB,1169,25,7,0,32,46,8,0,54,72,12,0,84,100,16,0,116,105,17,0,122
68486,343,"ŞCOALA PITARU",PITARU,DB,694,12,2,0,14,24,9,0,33,36,14,0,50,51,18,0,69,58,19,0,77
68510,344,"ŞCOALA VLĂSCENI",VLĂSCENI,DB,573,15,5,0,20,32,9,0,41,34,17,0,51,56,28,0,84,65,28,0,93
68501,345,"ŞCOALA ROMÂNEŞTI",ROMÂNEŞTI,DB,1336,14,5,0,19,48,9,0,57,83,14,0,97,124,16,0,140,137,16,0,153
68501,346,"ŞCOALA ROMÂNEŞTI",ROMÂNEŞTI,DB,1611,11,0,0,11,31,1,0,32,52,1,0,53,96,2,0,98,115,4,0,119
68538,347,"CĂMIN CULTURAL",PRODULEŞTI,DB,1502,19,4,0,23,35,7,0,42,50,8,0,58,98,17,0,115,121,19,0,140
68547,348,"ȘCOALA PRIMARĂBROȘTENI",BROŞTENI,DB,532,3,2,0,5,11,4,0,15,21,5,0,26,25,5,0,30,27,5,0,32
68556,349,"ȘCOALA PRIMARĂCOSTEȘTII DIN DEAL","COSTEŞTII DIN DEAL",DB,759,21,1,0,22,51,7,0,58,78,12,0,90,116,20,0,136,124,22,0,146
68574,350,"CĂMIN CULTURAL",PUCHENI,DB,1307,4,1,0,5,21,1,0,22,27,1,0,28,31,1,0,32,34,1,0,35
68609,351,"SCOALA VALEA LARGA","VALEA LARGĂ",DB,218,1,1,0,2,3,3,0,6,3,3,0,6,3,4,0,7,3,4,0,7
67808,352,"ȘCOALA GIMNAZIALĂ RACIU",RACIU,DB,1241,7,1,0,8,13,1,0,14,32,5,0,37,71,6,0,77,84,9,0,93
67826,353,"ȘCOALA GIMNAZIALĂ ȘUȚA SEACĂ - RACIU","ŞUŢA SEACĂ",DB,722,15,1,0,16,22,2,0,24,37,3,0,40,41,6,0,47,55,6,0,61
67817,354,"ȘCOALA PRIMARĂ SILIȘTEA - RACIU",SILIŞTEA,DB,752,20,2,0,22,44,3,0,47,52,4,0,56,75,4,0,79,81,4,0,85
69376,355,"ŞCOALA PRIMARĂDRĂGHINEASCA",RĂSCĂEŢI,DB,812,7,0,0,7,17,0,0,17,26,0,0,26,41,4,12,57,51,4,12,67
69376,356,"ŞCOALA GIMNAZIALĂ RĂSCĂEŢI",RĂSCĂEŢI,DB,1008,12,4,0,16,24,4,0,28,41,6,0,47,54,7,16,77,63,10,16,89
65440,357,"BIBLIOTECA COMUNALĂ",RĂZVAD,DB,1451,17,1,0,18,38,3,0,41,68,3,0,71,97,4,0,101,103,4,0,107
65440,358,"ȘCOALA GIMNAZIALĂ RĂZVAD",RĂZVAD,DB,1081,22,5,0,27,59,11,0,70,67,13,0,80,84,15,0,99,92,18,0,110
65440,359,"CENTRUL EDUCATIV PENTRU COPII SĂRACI RĂZVAD",RĂZVAD,DB,1129,23,2,0,25,43,10,0,53,57,10,0,67,76,11,0,87,88,14,0,102
65468,360,"ȘCOALA GIMNAZIALĂ VALEA VOIEVOZILOR","VALEA VOIEVOZILOR",DB,1439,17,1,0,18,32,3,0,35,50,4,0,54,64,4,0,68,70,6,0,76
65468,361,"ȘCOALA GIMNAZIALĂ VALEA VOIEVOZILOR","VALEA VOIEVOZILOR",DB,1213,11,1,0,12,30,6,0,36,39,10,0,49,64,11,0,75,76,11,0,87
65459,362,"ȘCOALA GIMNAZIALĂ GORGOTA",GORGOTA,DB,1081,11,0,0,11,20,0,0,20,23,2,0,25,44,5,0,49,51,6,0,57
66296,363,"CĂMINUL CULTURAL RÂU ALB","RÂU ALB DE JOS",DB,1205,10,1,0,11,25,11,0,36,41,15,0,56,75,24,0,99,107,32,0,139
68725,364,"GRÃDINIŢA CU PROGRAM NORMAL RUNCU",RUNCU,DB,1179,7,4,0,11,23,4,0,27,33,8,0,41,43,8,27,78,45,8,27,80
68725,365,"ŞCOALA GIMNAZIALÃ “CONSTANTIN SECÃREANU” RUNCU",RUNCU,DB,1066,3,0,0,3,8,0,0,8,15,4,0,19,18,8,26,52,18,8,26,52
68734,366,"GRÃDINIŢA CU PROGRAM NORMAL BÃDENI",BĂDENI,DB,823,10,1,0,11,31,8,0,39,58,8,0,66,58,11,0,69,58,11,0,69
68743,367,"GRÃDINIŢA CU PROGRAM NORMAL BREBU",BREBU,DB,540,2,0,0,2,10,2,0,12,11,8,8,27,14,9,8,31,15,9,8,32
68798,368,"ȘCOALA GENERALĂ BĂNEȘTI",BĂNEŞTI,DB,348,7,2,0,9,20,8,0,28,23,10,0,33,41,12,0,53,41,15,0,56
68869,369,"ȘCOALA GENERALĂ PODU-RIZII","PODU RIZII",DB,587,19,6,0,25,44,12,0,56,71,17,0,88,116,22,1,139,127,24,1,152
68832,370,"ȘCOALA GENERALĂ MIRCEA-VODĂSALA 1","MIRCEA VODĂ",DB,925,19,0,0,19,37,8,0,45,48,13,0,61,68,14,0,82,76,14,0,90
68823,371,"ȘCOALA GENERALĂ GHINEȘTISALA1",GHINEŞTI,DB,1004,8,0,0,8,28,2,0,30,64,8,0,72,138,15,0,153,143,20,0,163
68814,372,"ȘCOALA GENERALĂ CUZA-VODĂ","CUZA VODĂ",DB,310,8,3,0,11,22,4,0,26,29,6,0,35,37,11,0,48,37,11,0,48
105151,373,"ȘCOALA GIMNAZIALĂ SLOBOZIA MOARĂ","SLOBOZIA MOARĂ",DB,855,22,1,0,23,44,8,0,52,52,12,10,74,80,15,10,105,96,16,10,122
105151,374,"ȘCOALA GIMNAZIALĂ SLOBOZIA MOARĂ","SLOBOZIA MOARĂ",DB,834,11,2,0,13,25,9,13,47,48,17,13,78,76,18,14,108,103,18,14,135
68896,375,"ȘCOALA GIMNAZIALĂ ȘELARU",ŞELARU,DB,722,2,4,0,6,34,16,0,50,44,22,0,66,58,28,0,86,63,30,0,93
68903,376,"GRĂDINIȚA CU PROGRAM NORMAL FIERBINȚI",FIERBINŢI,DB,1235,4,0,0,4,7,1,0,8,19,1,0,20,37,2,0,39,47,3,0,50
68912,377,"GRĂDINIȚA CU PROGRAM NORMAL",GLOGOVEANU,DB,593,5,2,0,7,36,12,0,48,62,20,0,82,76,23,0,99,77,24,0,101
65495,378,"ȘCOALA GIMNAZIALĂ ”TEIUL DOAMNEI” - CORP B",TEIŞ,DB,865,4,0,0,4,38,3,0,41,55,3,0,58,86,3,0,89,89,3,0,92
65495,379,"CĂMIN CULTURAL TEIŞ",TEIŞ,DB,1266,34,1,0,35,70,1,0,71,125,3,0,128,154,4,0,158,161,6,0,167
65486,380,"ȘCOALA GIMNAZIALĂ ”PROFESOR ILIE POPESCU”",ŞOTÎNGA,DB,1527,37,2,0,39,71,2,0,73,96,4,0,100,117,5,0,122,123,5,0,128
65486,381,"CĂMIN CULTURAL ŞOTÂNGA",ŞOTÎNGA,DB,1165,30,4,0,34,72,7,0,79,100,8,0,108,159,11,0,170,163,11,0,174
65486,382,"ȘCOALA GIMNAZIALĂ NR. 2",ŞOTÎNGA,DB,1108,25,0,0,25,57,2,0,59,104,3,0,107,152,5,0,157,159,6,0,165
105543,383,"ŞCOALA GIMNAZIALĂ TĂRTĂŞEŞTI",TĂRTĂŞEŞTI,DB,862,10,4,0,14,29,14,0,43,59,39,0,98,79,44,0,123,83,44,0,127
105552,384,"ŞCOALA GIMNAZIALĂ BÂLDANA - TĂRTĂŞEŞTI,",BÎLDANA,DB,1451,15,2,0,17,26,11,0,37,40,16,0,56,50,20,0,70,81,23,0,104
105561,385,"SCOALA GIMNAZIALĂ GULIA- TĂRTĂŞEŞTI,",GULIA,DB,948,14,4,0,18,27,10,0,37,45,17,0,62,77,23,0,100,88,24,0,112
105543,386,"LICEUL TEHNOLOGIC TĂRTĂŞEŞTI,",TĂRTĂŞEŞTI,DB,942,15,5,0,20,27,10,0,37,34,11,0,45,53,18,0,71,68,21,0,89
68930,387,"SALA DE FESTIVITĂŢI A PRIMĂRIEI TĂTĂRANI",TĂTĂRANI,DB,886,15,4,0,19,21,5,0,26,30,7,0,37,54,9,0,63,55,9,0,64
68958,388,"GRĂDINIŢA DE COPII GHEBOIENI",GHEBOIENI,DB,1274,7,0,0,7,21,1,0,22,35,5,0,40,64,8,0,72,66,8,0,74
68949,389,"CĂMIN CULTURAL SAT CĂPRIORU",CĂPRIORU,DB,1376,17,2,0,19,33,3,0,36,72,8,0,80,97,14,0,111,119,16,0,135
68967,390,"CĂMIN CULTURAL",PRIBOIU,DB,756,2,1,0,3,23,1,0,24,25,4,0,29,33,7,0,40,35,7,0,42
68985,391,"ŞCOALA GIMNAZIALĂ ULIEŞTI",ULIEŞTI,DB,1066,6,0,0,6,21,3,0,24,36,6,0,42,44,7,0,51,48,8,0,56
68994,392,"ŞCOALA CROITORI",CROITORI,DB,695,3,0,0,3,9,0,0,9,17,2,0,19,26,5,0,31,26,5,0,31
69018,393,"ŞCOALA GIMNAZIALĂ JUGURENI",JUGURENI,DB,1263,8,0,0,8,19,2,0,21,41,10,0,51,62,12,0,74,72,14,0,86
69009,394,"ŞCOALA PRIMARĂ HANU LUI PALĂ","HANU LUI PALĂ",DB,263,0,0,0,0,1,2,0,3,3,4,0,7,9,6,0,15,9,6,0,15
65510,395,"SCOALA GIMNAZIALA ULMI",ULMI,DB,1098,11,5,0,16,33,11,0,44,45,11,0,56,73,20,0,93,77,20,0,97
65547,396,"GRADINITA DUMBRAVA",DUMBRAVA,DB,942,7,0,0,7,27,8,0,35,40,9,0,49,56,13,1,70,61,13,1,75
65583,397,"SCOALA GIMNAZIALA ION CONSTANTINESCUVIISOARA",VIIŞOARA,DB,1133,16,1,0,17,45,2,0,47,72,10,0,82,111,11,0,122,118,11,0,129
65556,398,"GRADINITA MATRACA",MATRACA,DB,589,3,0,0,3,25,2,0,27,41,5,0,46,57,7,0,64,60,7,0,67
69072,399,"ŞCOALA GIMNAZIALĂ VALEA LUNGĂ CRICOV","VALEA LUNGĂ-CRICOV",DB,1032,15,1,0,16,35,5,0,40,44,7,0,51,52,10,0,62,56,10,0,66
69161,400,"ŞCOALA PRIMARĂ VALEA MARE","VALEA MARE",DB,442,6,0,0,6,11,0,0,11,14,0,0,14,25,2,0,27,25,2,0,27
69152,401,"ŞCOALA PRIMARĂ VALEA LUNGĂ OGREA","VALEA LUNGĂ OGREA",DB,1105,12,1,0,13,23,5,0,28,35,8,0,43,47,9,0,56,50,9,0,59
69143,402,"ŞCOALA GIMNAZIALĂ ION HARALMBIE VALEA LUNGĂ GORGOTA","VALEA LUNGĂ GORGOTA",DB,1052,2,3,0,5,2,3,0,5,17,6,0,23,26,9,0,35,34,9,0,43
69125,403,"GRADINIŢA CU PROGRAM NORMAL ŞTUBEIE TISA","ŞTUBEIE TISA",DB,352,1,0,0,1,2,0,0,2,6,1,0,7,6,3,0,9,9,3,0,12
69189,404,"ŞCOALA GIMNAZIALĂ VALEA MARE","VALEA MARE",DB,1225,16,6,0,22,41,13,0,54,50,15,0,65,66,20,0,86,74,20,0,94
69241,405,"GRĂDINIŢA CU PROGRAM NORMAL VALEA CASELOR","VALEA CASELOR",DB,605,6,0,0,6,16,1,0,17,31,1,0,32,35,2,0,37,45,2,0,47
69269,406,"ȘCOALA GIMNAZIALĂ ""IANCU VĂCĂRESCU"" - VĂCĂREȘTI",VĂCĂREŞTI,DB,1457,12,2,0,14,19,3,0,22,42,4,0,46,56,5,0,61,59,6,0,65
69269,407,"ȘCOALA GIMNAZIALĂ ""IANCU VĂCĂRESCU"" - VĂCĂREȘTI",VĂCĂREŞTI,DB,1122,7,3,0,10,14,6,0,20,23,6,0,29,40,6,0,46,44,6,0,50
69287,408,"ȘCOALA GIMNAZIALĂ BUNGETU",BUNGETU,DB,1132,9,0,0,9,34,3,0,37,60,5,0,65,79,6,0,85,84,6,0,90
69278,409,"GRĂDINIȚA CU PROGRAM NORMAL BRĂTEȘTII DE JOS","BRĂTEŞTII DE JOS",DB,561,11,0,0,11,31,2,0,33,50,2,0,52,84,4,0,88,89,4,0,93
69312,410,"SCOALA GENERALA VALENI DIMBOVITA, PARTER SALA A DOUA",VĂLENI-DÎMBOVIŢA,DB,945,4,0,0,4,7,0,0,7,8,0,0,8,10,4,0,14,16,4,0,20
69312,411,"SCOALA GENERALA VALENI DIMBOVITA, PARTER SALA PATRU",VĂLENI-DÎMBOVIŢA,DB,979,4,0,0,4,15,4,0,19,16,5,0,21,19,7,0,26,24,8,0,32
69321,412,"SCOALA NOUA GENERALA MESTEACAN",MESTEACĂN,DB,233,2,1,0,3,3,1,0,4,4,1,0,5,4,1,0,5,5,1,0,6
69349,413,"CĂMIN CULTURAL",VIŞINA,DB,1365,20,3,0,23,46,9,0,55,74,9,0,83,123,11,0,134,137,12,0,149
69349,414,"GRĂDINIŢA NR. 1 VISINA",VIŞINA,DB,956,8,4,0,12,22,7,0,29,31,9,0,40,58,12,0,70,70,14,0,84
69358,415,"GRĂDINIŢA BROŞTENI",BROŞTENI,DB,929,12,7,0,19,25,10,0,35,32,11,0,43,58,12,0,70,76,15,0,91
69401,416,"ȘCOALA GIMNAZIALĂ VIȘINEȘTI",VIŞINEŞTI,DB,790,8,1,0,9,31,6,0,37,49,7,0,56,63,11,0,74,79,16,0,95
69438,417,"ȘCOALA URSEIU",URSEIU,DB,548,11,1,0,12,15,5,0,20,24,5,0,29,31,5,0,36,33,5,0,38
69429,418,"CĂMIN CULTURAL SULTANU",SULTANU,DB,252,6,0,0,6,10,0,0,10,12,0,0,12,16,1,0,17,22,2,0,24
69508,419,CĂMINULCULTURAL,ŞUVIŢA,DB,1522,14,4,0,18,28,11,0,39,35,15,0,50,41,15,0,56,41,15,0,56
67283,420,"ȘCOALA GIMNAZIALĂ ""STAN ȘTEFAN""",VLĂDENI,DB,1302,13,1,0,14,20,4,0,24,36,6,0,42,43,7,0,50,47,7,0,54
67283,421,"CĂMIN CULTURAL",VLĂDENI,DB,1003,11,1,0,12,17,1,0,18,29,1,0,30,33,1,0,34,33,1,0,34
69544,422,"CĂMINUL CULTURAL","GEMENEA BRĂTULEŞTI",DB,978,6,5,0,11,7,5,0,12,8,5,0,13,12,5,0,17,15,5,0,20
69599,423,"GRĂDINIŢA DE COPII",ONCEŞTI,DB,728,4,0,0,4,12,0,0,12,19,6,0,25,20,9,0,29,31,12,0,43
69535,424,"ŞCOALA CU CLASELE I-VIII",VOINEŞTI,DB,1343,23,4,0,27,27,4,0,31,46,8,0,54,59,12,0,71,64,15,0,79
69606,425,"ŞCOALA CU CLASELE I-VIII",SUDULENI,DB,1317,6,0,0,6,12,6,0,18,20,7,0,27,20,9,0,29,20,9,0,29
69571,426,"GRĂDINIŢA MANGA",MANGA,DB,666,3,0,0,3,10,4,0,14,12,9,0,21,21,11,0,32,26,11,0,37
69624,427,"GRĂDINIŢA DE COPII „ALBĂ CA ZĂPADA”",VULCANA-BĂI,DB,1298,9,1,0,10,46,5,0,51,63,11,0,74,73,15,0,88,82,19,0,101
69642,428,"GRĂDINIŢA DE COPII „PARADISUL COPIILOR”","VULCANA DE SUS",DB,1193,6,0,0,6,16,1,0,17,32,5,0,37,40,5,0,45,44,5,0,49
66063,429,"CĂMINUL CULTURAL ""IZVOR DE APĂ VIE""",VULCANA-PANDELE,DB,1287,12,0,0,12,29,0,0,29,41,0,0,41,58,2,0,60,63,2,0,65
66063,430,"ȘCOALA GIMNAZIALĂ VULCANA-PANDELE",VULCANA-PANDELE,DB,1233,7,2,0,9,19,2,0,21,29,6,0,35,34,8,0,42,39,8,0,47
66027,431,"ȘCOALA GIMNAZIALĂ GURA VULCANEI","GURA VULCANEI",DB,906,9,7,0,16,17,7,0,24,20,7,0,27,24,8,0,32,26,8,0,34
66027,432,"ȘCOALA GIMNAZIALĂ GURA VULCANEI","GURA VULCANEI",DB,807,6,1,0,7,16,1,0,17,19,1,0,20,21,1,0,22,22,1,0,23
69919,1,"COLEGIUL NAŢIONAL “ELENA CUZA”",CRAIOVA,DJ,1245,13,2,0,15,66,6,0,72,85,7,0,92,102,8,0,110,110,8,0,118
69919,2,"CASA DE CULTURA A STUDENŢILOR",CRAIOVA,DJ,1540,13,1,0,14,48,3,0,51,75,5,0,80,91,5,0,96,98,6,0,104
69919,3,"PRIMARIA CRAIOVA- DIRECŢIA DE ASISTENŢĂ ŞI PROTECŢIE SOCIALĂ",CRAIOVA,DJ,1346,14,0,0,14,31,2,0,33,48,3,0,51,81,4,0,85,95,7,0,102
69919,4,"LICEUL CU PROGRAM SPORTIV ""PETRACHE TRIŞCU""",CRAIOVA,DJ,1731,12,3,0,15,50,4,0,54,63,4,0,67,83,4,0,87,100,4,0,104
69919,5,"LICEUL TEORETIC ""TRAIAN VUIA""",CRAIOVA,DJ,1216,11,3,0,14,35,4,0,39,45,5,0,50,56,6,0,62,61,6,0,67
69919,6,"LICEUL TEORETIC ""TRAIAN VUIA""",CRAIOVA,DJ,1051,4,3,0,7,25,3,0,28,43,5,0,48,51,7,0,58,59,8,0,67
69919,7,"LICEUL CU PROGRAM SPORTIV ”PETRACHE TRIȘCU”",CRAIOVA,DJ,1747,12,0,0,12,59,7,0,66,85,7,0,92,107,7,0,114,111,7,0,118
69919,8,"UNIVERSITATEA DIN CRAIOVA",CRAIOVA,DJ,1750,5,5,0,10,33,13,0,46,60,17,0,77,90,20,0,110,94,21,0,115
69919,9,"UNIVERSITATEA DIN CRAIOVA",CRAIOVA,DJ,988,7,3,0,10,29,5,0,34,54,10,0,64,71,11,0,82,84,11,0,95
69919,10,"UNIVERSITATEA DIN CRAIOVA",CRAIOVA,DJ,1026,9,0,0,9,50,4,0,54,69,4,0,73,88,6,0,94,95,8,0,103
69919,11,"ŞCOALA GIMNAZIALĂ NR.22 ""MIRCEA ELIADE""",CRAIOVA,DJ,1220,10,0,0,10,40,0,0,40,59,0,0,59,84,6,0,90,93,8,0,101
69919,12,"ŞCOALA GIMNAZIALĂ ""MIRCEA ELIADE""",CRAIOVA,DJ,1525,19,0,0,19,54,0,0,54,86,4,0,90,102,4,0,106,113,4,0,117
69919,13,"GRADINIŢA CU PROGRAM PRELUNGIT ""DUMBRAVA MINUNATA"" ( FOSTĂ NR.37)",CRAIOVA,DJ,1841,17,1,0,18,60,4,0,64,82,8,0,90,105,12,0,117,125,12,0,137
69919,14,"GRADINIŢA CU PROGRAM PRELUNGIT""DUMBRAVA MINUNATA""(FOSTĂ NR.37)",CRAIOVA,DJ,1764,19,4,0,23,33,5,0,38,47,5,31,83,54,7,31,92,61,7,31,99
69919,15,"ŞCOALA GIMNAZIALĂ ""MIHAI EMINESCU""(FOSTA NR.37",CRAIOVA,DJ,1256,7,4,0,11,21,7,0,28,30,7,0,37,46,7,0,53,48,8,0,56
69919,16,"ŞCOALA GIMNAZIALĂ ""MIHAI EMINESCU""(FOSTA NR.37)",CRAIOVA,DJ,1402,3,0,0,3,20,1,0,21,38,1,0,39,53,4,0,57,53,4,0,57
69919,17,"ŞCOALA GIMNAZIALĂ ""MIHAI EMINESCU""(FOSTA NR. 37)",CRAIOVA,DJ,1267,4,1,0,5,17,1,0,18,21,1,0,22,28,1,0,29,33,1,0,34
69919,18,"GRADINIŢA CU PROGRAM NORMAL ”PRICHINDEL”(FOSTA NR. 55) – STRUCTURĂ A ŞCOLII GIMNAZIALE ""MIHAI EMINESCU"" (FOSTA NR.37))",CRAIOVA,DJ,1010,10,0,0,10,36,1,0,37,44,4,0,48,57,8,0,65,65,8,0,73
69919,19,"GRADINIŢA CU PROGRAM NORMAL ”PRICHINDEL”(FOSTA NR. 55) – STRUCTURĂ A ŞCOLII GIMNAZIALE ""MIHAI EMINESCU"" (FOSTA NR.37)",CRAIOVA,DJ,1333,7,0,0,7,22,2,0,24,27,3,0,30,47,3,0,50,49,4,0,53
69919,20,"LICEUL TEORETIC ""HENRI COANDĂ”",CRAIOVA,DJ,1633,12,4,0,16,29,4,0,33,34,4,0,38,47,5,0,52,55,6,0,61
69919,21,"LICEUL TEORETIC ""HENRI COANDĂ”",CRAIOVA,DJ,1437,20,1,0,21,37,1,0,38,63,1,0,64,81,1,0,82,93,4,0,97
69919,22,"LICEUL TEORETIC ""HENRI COANDĂ”",CRAIOVA,DJ,1513,10,0,0,10,33,1,0,34,44,5,0,49,62,5,0,67,70,6,0,76
69919,23,"LICEUL TEHNOLOGIC UCECOM „SPIRU HARET”",CRAIOVA,DJ,1746,15,0,0,15,53,1,0,54,73,3,0,76,83,6,0,89,87,6,0,93
69919,24,"COLEGIUL „ŞTEFAN ODOBLEJA”",CRAIOVA,DJ,1836,9,4,0,13,39,5,0,44,61,7,1,69,82,8,1,91,86,8,1,95
69919,25,"COLEGIUL „ŞTEFAN ODOBLEJA”",CRAIOVA,DJ,1786,10,0,0,10,27,0,0,27,34,0,0,34,51,0,0,51,55,0,0,55
69919,26,"GRADINIŢA DE COPII CU PROGRAM PRELUNGIT""ELENA FARAGO""(FOSTA NR.41)",CRAIOVA,DJ,934,7,0,0,7,20,0,0,20,30,0,0,30,34,0,0,34,39,0,0,39
69919,27,"GRADINIŢA DE COPII CU PROGRAM PRELUNGIT""ELENA FARAGO""(FOSTA NR. 41)",CRAIOVA,DJ,1336,12,3,0,15,38,3,0,41,46,4,0,50,70,7,0,77,72,7,0,79
69919,28,"ŞCOALA GIMNAZIALĂ „NICOLAE ROMANESCU”",CRAIOVA,DJ,1556,12,0,0,12,33,2,1,36,58,4,1,63,87,8,1,96,98,8,1,107
69919,29,"GRADINIŢA CU PROGRAM PRELUNGIT""ION CREANGA"" (FOSTA NR. 42)",CRAIOVA,DJ,1340,10,4,0,14,42,4,0,46,59,4,0,63,70,5,0,75,83,6,0,89
69919,30,"ŞCOALA GIMNAZIALĂ ""NICOLAEROMANESCU"" (FOSTA NR. 29)",CRAIOVA,DJ,1515,11,2,0,13,42,4,0,46,59,6,0,65,76,7,0,83,78,7,0,85
69919,31,"ŞCOALA GIMNAZIALĂ ""NICOLAEROMANESCU"" (FOSTA NR. 29)",CRAIOVA,DJ,1306,13,3,0,16,39,4,0,43,58,5,0,63,76,5,0,81,81,5,0,86
69919,32,"ŞCOALA GIMNAZIALĂ ""NICOLAEROMANESCU"" (FOSTA NR. 29)",CRAIOVA,DJ,1271,7,0,0,7,16,0,0,16,26,0,0,26,47,0,0,47,48,0,0,48
69919,33,"UNIVERSITATEA DE MEDICINĂ ŞI FARMACIE, (SEDIUL VECHI)",CRAIOVA,DJ,1050,8,2,0,10,16,5,0,21,19,6,0,25,33,8,0,41,39,8,0,47
69919,34,"UNIVERSITATEA DE MEDICINĂ ŞI FARMACIE, (SEDIUL VECHI)",CRAIOVA,DJ,1169,10,0,0,10,24,0,0,24,39,0,0,39,53,0,0,53,60,1,0,61
69919,35,"LICEUL TEHNOLOGIC DE TRANSPORTURI AUTO",CRAIOVA,DJ,1830,6,1,0,7,37,3,0,40,51,3,0,54,55,3,0,58,72,4,0,76
69919,36,"LICEUL TEHNOLOGIC DE TRANSPORTURI AUTO",CRAIOVA,DJ,1772,2,0,0,2,17,0,0,17,27,2,0,29,32,2,0,34,39,2,0,41
69919,37,"LICEUL TEHNOLOGIC DE TRANSPORTURI AUTO",CRAIOVA,DJ,1601,12,0,0,12,34,2,0,36,49,3,0,52,56,3,0,59,63,3,0,66
69919,38,"LICEUL TEHNOLOGIC DE TRANSPORTURI AUTO",CRAIOVA,DJ,1726,10,0,0,10,17,2,0,19,31,2,0,33,42,3,0,45,44,3,0,47
69919,39,"LICEUL TEHNOLOGIC DE TRANSPORTURI AUTO, (FOSTA ȘCOALĂ CU CLASELE I-VIII NR.25 FĂCĂI)",CRAIOVA,DJ,1179,8,0,0,8,13,1,0,14,19,1,0,20,30,4,366,400,30,4,366,400
69919,40,"ŞCOALA PRIMARĂ NR.27 POPOVENI – STRUCTURĂ A SCOLII GIMNAZIALE ”GHEORGHE BIBESCU”, (FOSTA NR. 36)",CRAIOVA,DJ,881,3,0,0,3,7,0,0,7,18,2,0,20,26,3,0,29,26,3,0,29
69919,41,"ȘCOALA GIMNAZIALA ”GHEORGHE BIBESCU” (FOSTA NR. 36)",CRAIOVA,DJ,1380,14,2,0,16,51,2,0,53,72,4,0,76,82,5,0,87,84,5,0,89
69919,42,"ȘCOALA GIMNAZIALA ”GHEORGHE BIBESCU” (FOSTA NR. 36)",CRAIOVA,DJ,1670,10,3,0,13,33,3,0,36,52,7,0,59,61,8,0,69,64,12,0,76
69919,43,"ȘCOALA GIMNAZIALA ”GHEORGHE BIBESCU” (FOSTA NR. 36)",CRAIOVA,DJ,1722,10,1,0,11,43,3,0,46,66,4,0,70,79,6,0,85,85,6,0,91
69919,44,"ȘCOALA GIMNAZIALA ”GHEORGHE BIBESCU” (FOSTA NR. 36)",CRAIOVA,DJ,1553,4,0,0,4,21,0,0,21,31,0,0,31,40,0,0,40,51,0,0,51
69919,45,"COLEGIUL NAȚIONAL ECONOMIC ”GHEORGHE CHIȚU”",CRAIOVA,DJ,1468,13,0,0,13,24,0,0,24,44,0,0,44,56,6,0,62,62,6,0,68
69919,46,"COLEGIUL NAȚIONAL ECONOMIC ”GHEORGHE CHIȚU”",CRAIOVA,DJ,1401,3,0,0,3,26,1,0,27,39,1,0,40,48,1,0,49,50,1,0,51
69919,47,"COLEGIUL NAŢIONAL ECONOMIC ""GHEORGHE CHIŢU""",CRAIOVA,DJ,1648,18,2,0,20,41,3,0,44,57,3,0,60,71,3,0,74,83,3,0,86
69919,48,"UNIVERSITATEA DE MEDICINA SI FARMACIE, (SEDIUL NOU)",CRAIOVA,DJ,1573,12,0,0,12,43,8,0,51,61,11,52,124,74,12,52,138,86,13,63,162
69919,49,"ŞCOALA GIMNAZIALĂ ""SFÂNTUL DUMITRU"" (FOSTA NR. 18)",CRAIOVA,DJ,1158,14,1,0,15,42,1,0,43,60,2,0,62,84,4,0,88,99,4,0,103
69919,50,"LICEUL DE ARTE ”MARIN SORESCU”",CRAIOVA,DJ,1469,17,1,0,18,60,1,0,61,80,2,0,82,98,2,104,204,109,2,104,215
69919,51,"LICEUL DE ARTE ""MARIN SORESCU""",CRAIOVA,DJ,1382,9,1,0,10,36,2,0,38,55,7,0,62,79,12,0,91,86,12,0,98
69919,52,"COLEGIUL NATIONAL ""FRAŢII BUZEŞTI""",CRAIOVA,DJ,1944,14,3,0,17,58,7,0,65,81,9,0,90,99,10,15,124,116,10,15,141
69919,53,"COLEGIUL NATIONAL ""FRAŢII BUZEŞTI""",CRAIOVA,DJ,1854,9,3,0,12,47,5,0,52,75,5,0,80,90,7,0,97,107,8,0,115
69919,54,"ŞCOALA GIMNAZIALĂ”LASCĂR CATARGIU” (FOSTA NR. 19)",CRAIOVA,DJ,1973,6,0,0,6,13,4,0,17,29,6,0,35,63,7,0,70,79,9,0,88
69919,55,"ŞCOALA GIMNAZIALĂ”LASCĂR CATARGIU” (FOSTA NR. 19)",CRAIOVA,DJ,1765,7,2,0,9,19,4,0,23,37,6,0,43,58,7,0,65,69,8,0,77
69919,56,"ŞCOALA GIMNAZIALĂ”LASCĂR CATARGIU” (FOSTA NR. 19)",CRAIOVA,DJ,1793,15,0,0,15,46,1,0,47,57,1,0,58,69,2,0,71,82,2,0,84
69919,57,"ŞCOALA GIMNAZIALĂ”LASCĂR CATARGIU” (FOSTA NR. 19)",CRAIOVA,DJ,1749,18,1,0,19,44,1,0,45,57,1,0,58,75,1,0,76,89,1,0,90
69919,58,"ŞCOALA GIMNAZIALA NR. 26 MOFLENI – STRUCTURĂ A ŞCOLII GIMNAZIALE ”ANTON PAN” (FOSTA NR.13 BUCOVĂŢ)",CRAIOVA,DJ,1319,3,0,0,3,9,0,0,9,11,0,0,11,18,1,1,20,25,1,1,27
69919,59,"S.C. PENTRU LUCRARI DE DRUMURI ŞI PODURI DOLJ S.A",CRAIOVA,DJ,1877,4,19,0,23,25,54,0,79,39,68,0,107,76,82,0,158,82,87,0,169
69919,60,"ŞCOALA GIMNAZIALĂ ”ANTON PAN” (FOSTA NR.13 BUCOVĂŢ)",CRAIOVA,DJ,1976,10,1,0,11,21,1,0,22,35,1,0,36,61,3,0,64,62,3,0,65
69919,61,"COLEGIUL NAŢIONAL ""CAROL I""",CRAIOVA,DJ,957,6,3,0,9,24,9,0,33,42,11,0,53,57,11,0,68,67,12,0,79
69919,62,"COLEGIUL NAȚIONAL ”CAROL I”",CRAIOVA,DJ,1303,2,0,0,2,19,0,0,19,28,0,1,29,42,0,1,43,44,0,1,45
69919,63,"FACULTATEA DE AGRONOMIE",CRAIOVA,DJ,1931,18,2,0,20,35,3,0,38,58,3,0,61,71,3,0,74,74,9,0,83
69919,64,"FACULTATEA DE AGRONOMIE",CRAIOVA,DJ,1821,13,0,0,13,73,3,0,76,92,5,0,97,114,5,0,119,128,9,0,137
69919,65,"GRADINIŢA CU PROGRAM PRELUNGIT”PARADISUL COPIILOR” (FOSTA NR. 24)",CRAIOVA,DJ,1178,17,2,0,19,33,4,0,37,40,4,0,44,49,4,0,53,53,4,0,57
69919,66,"GRADINIŢA CU PROGRAM PRELUNGIT”PARADISUL COPIILOR”, (FOSTA NR. 24)",CRAIOVA,DJ,998,8,1,0,9,26,2,0,28,43,2,0,45,65,5,0,70,68,8,0,76
69919,67,"COLEGIUL TEHNIC DE INDUSTRIE ALIMENTARĂ",CRAIOVA,DJ,1890,4,1,0,5,28,2,0,30,41,17,0,58,65,24,0,89,67,27,0,94
69919,68,"COLEGIUL TEHNIC DE INDUSTRIE ALIMENTARĂ",CRAIOVA,DJ,1770,17,1,0,18,26,1,0,27,40,2,0,42,54,2,0,56,62,3,0,65
69919,69,"COLEGIUL TEHNIC DE INDUSTRIE ALIMENTARĂ",CRAIOVA,DJ,1986,8,1,0,9,40,2,0,42,53,2,0,55,67,2,0,69,72,4,0,76
69919,70,"ŞCOALA GIMNAZIALĂ”ION CREANGĂ” (FOSTA NR.16)",CRAIOVA,DJ,1687,8,1,0,9,21,1,0,22,33,1,0,34,43,1,0,44,44,1,0,45
69919,71,"ŞCOALA GIMNAZIALĂ”ION CREANGĂ” (FOSTA NR.16)",CRAIOVA,DJ,1570,9,3,0,12,14,3,0,17,21,3,0,24,31,8,0,39,33,10,0,43
69919,72,"ŞCOALA GIMNAZIALĂ”ION CREANGĂ” (FOSTA NR.16)",CRAIOVA,DJ,1796,5,0,0,5,12,0,0,12,24,0,0,24,37,0,0,37,40,0,0,40
69919,73,"GRĂDINITA CU PROGRAM NORMAL ”CASA CU PITICI” (FOSTA NR. 15) – STRUCTURĂ A ŞCOLII GIMNAZIALE “ION CREANGA” (FOSTĂ NR.16)",CRAIOVA,DJ,1718,7,4,0,11,19,5,0,24,34,5,0,39,54,5,0,59,56,5,0,61
69919,74,"RAT S.R.L.",CRAIOVA,DJ,1630,6,4,0,10,26,5,0,31,38,5,0,43,50,6,0,56,57,6,0,63
69919,75,"ȘCOALA GIMNAZIALĂ ”ELENA FARAGO” (FOSTA SCOALA GIMNAZIALA NR.34)",CRAIOVA,DJ,1504,4,4,0,8,28,4,0,32,37,5,0,42,49,5,0,54,59,5,0,64
69919,76,"ȘCOALA GIMNAZIALĂ ”ELENA FARAGO” (FOSTA SCOALA GIMNAZIALA NR.34)",CRAIOVA,DJ,1554,6,2,0,8,25,4,0,29,35,6,0,41,49,6,0,55,51,6,0,57
69919,77,"ȘCOALA GIMNAZIALĂ ”ELENA FARAGO” (FOSTA SCOALA GIMNAZIALA NR.34)",CRAIOVA,DJ,1549,6,0,0,6,23,1,0,24,37,1,0,38,49,3,0,52,58,3,0,61
69919,78,"ȘCOALA GIMNAZIALĂ ”ELENA FARAGO” (FOSTA SCOALA GIMNAZIALA NR.34)",CRAIOVA,DJ,1783,5,2,0,7,28,3,0,31,46,3,0,49,61,7,0,68,74,8,0,82
69919,79,"ȘCOALA GIMNAZIALĂ ”ELENA FARAGO” (FOSTA SCOALA GIMNAZIALA NR.33)",CRAIOVA,DJ,1783,4,5,0,9,17,5,0,22,37,5,0,42,63,6,0,69,68,7,0,75
69919,80,"ȘCOALA GIMNAZIALĂ ”ELENA FARAGO” (FOSTA SCOALA GIMNAZIALA NR.33)",CRAIOVA,DJ,1756,14,0,0,14,49,4,0,53,69,6,0,75,95,6,0,101,98,6,0,104
69919,81,"ȘCOALA GIMNAZIALĂ ”ELENA FARAGO” (FOSTA SCOALA GIMNAZIALA NR.33)",CRAIOVA,DJ,1675,10,1,0,11,28,1,0,29,40,1,0,41,50,3,0,53,54,3,0,57
69919,82,"GRADINIŢA CU PROGRAM PRELUNGIT ”PITICOT” (FOSTA NR.45)",CRAIOVA,DJ,1670,12,3,0,15,45,5,0,50,61,7,0,68,74,7,0,81,90,8,0,98
69919,83,"GRADINIŢA CU PROGRAM PRELUNGIT ”PITICOT” (FOSTA NR.45)",CRAIOVA,DJ,1203,8,2,0,10,31,2,0,33,36,2,0,38,46,3,0,49,47,3,0,50
69919,84,"GRADINIŢA CU PROGRAM PRELUNGIT ”PITICOT” (FOSTA NR.45)",CRAIOVA,DJ,1088,10,0,0,10,25,0,0,25,39,0,0,39,43,0,0,43,48,0,0,48
69919,85,"GRADINIŢA CU PROGRAM PRELUNGIT ”FLOAREA SOARELUI” (FOSTA NR.51)",CRAIOVA,DJ,1267,16,6,0,22,46,6,0,52,60,6,0,66,78,6,0,84,84,6,0,90
69919,86,"GRADINIŢA CU PROGRAM PRELUNGIT ”FLOAREA SOARELUI” (FOSTA NR.51)",CRAIOVA,DJ,1358,6,5,0,11,15,6,0,21,23,12,0,35,39,12,0,51,43,18,0,61
69919,87,"GRADINIŢA CU PROGRAM PRELUNGIT ”FLOAREA SOARELUI” (FOSTA NR.51)",CRAIOVA,DJ,1324,7,5,0,12,26,5,0,31,36,7,0,43,44,7,0,51,54,7,0,61
69919,88,"ŞCOALA GIMNAZIALĂ""ALEXANDRU MACEDONSKI"" (FOSTA NR.32)",CRAIOVA,DJ,1656,12,2,0,14,30,3,0,33,42,5,0,47,66,6,0,72,69,6,0,75
69919,89,"ŞCOALA GIMNAZIALĂ""ALEXANDRU MACEDONSKI"" (FOSTA NR.32)",CRAIOVA,DJ,1699,8,3,0,11,35,3,0,38,48,3,0,51,70,3,0,73,81,3,0,84
69919,90,"ŞCOALA GIMNAZIALĂ""ALEXANDRU MACEDONSKI"" (FOSTA NR.32)",CRAIOVA,DJ,1859,14,11,0,25,34,14,0,48,44,17,0,61,61,20,0,81,62,20,0,82
69919,91,"ŞCOALA GIMNAZIALĂ""ALEXANDRU MACEDONSKI"" (FOSTA NR.32)",CRAIOVA,DJ,1723,13,9,0,22,50,14,0,64,72,14,0,86,85,14,0,99,88,15,0,103
69919,92,"GRĂDINIŢA CU PROGRAM PRELUNGIT ”FLOARE ALBASTRA” (FOSTA NR.40)",CRAIOVA,DJ,1326,10,4,0,14,30,4,0,34,36,5,0,41,51,5,0,56,56,5,0,61
69919,93,"GRĂDINIŢA CU PROGRAM PRELUNGIT ”FLOARE ALBASTRA” (FOSTA NR.40)",CRAIOVA,DJ,1567,22,0,0,22,54,1,0,55,75,1,0,76,85,1,0,86,93,1,0,94
69919,94,"ŞCOALA GIMNAZIALĂ""MIHAI VITEAZU"" (FOSTA NR.30)",CRAIOVA,DJ,1401,6,2,0,8,27,2,0,29,44,3,0,47,63,5,0,68,69,5,0,74
69919,95,"ŞCOALA GIMNAZIALĂ""MIHAI VITEAZU"" (FOSTA NR.30)",CRAIOVA,DJ,1595,8,2,0,10,25,4,0,29,43,4,1,48,53,4,1,58,53,4,1,58
69919,96,"ŞCOALA GIMNAZIALĂ""MIHAI VITEAZU"" (FOSTA NR.30)",CRAIOVA,DJ,1526,13,1,0,14,39,1,0,40,50,1,0,51,74,2,0,76,74,2,0,76
69919,97,"ŞCOALA GIMNAZIALĂ""MIHAI VITEAZU"" (FOSTA NR.30)",CRAIOVA,DJ,1386,8,0,0,8,20,0,0,20,41,0,0,41,50,1,0,51,51,1,0,52
69919,98,"ŞCOALA GIMNAZIALĂ""MIHAI VITEAZU"" (FOSTA NR.30)",CRAIOVA,DJ,1436,6,2,0,8,18,2,0,20,27,2,0,29,42,2,0,44,46,2,0,48
69919,99,"LICEUL TEHNOLOGIC""GEORGE BIBESCU""",CRAIOVA,DJ,1288,11,2,0,13,31,3,0,34,39,9,0,48,46,12,0,58,48,12,0,60
69919,100,"LICEUL TEHNOLOGIC""GEORGE BIBESCU""",CRAIOVA,DJ,1178,1,4,0,5,11,7,0,18,23,15,0,38,33,39,0,72,38,52,0,90
69919,101,"GRADINIŢA CU PROGRAM PRELUNGIT ”PHOENIX” (FOSTA NR.52)",CRAIOVA,DJ,1225,4,4,0,8,26,6,0,32,36,6,0,42,50,7,0,57,53,7,0,60
69919,102,"GRADINITA CU PROGRAM PRELUNGIT ”PHOENIX” (FOSTA NR. 52)",CRAIOVA,DJ,1183,7,2,1,10,25,4,1,30,33,6,1,40,44,9,1,54,49,10,1,60
69919,103,"COLEGIUL TEHNIC “COSTIN D. NENITESCU”",CRAIOVA,DJ,1818,7,0,0,7,34,1,0,35,57,4,0,61,77,4,0,81,80,4,0,84
69919,104,"COLEGIUL TEHNIC “COSTIN D. NENIŢESCU”",CRAIOVA,DJ,1808,6,5,0,11,13,6,0,19,25,9,0,34,43,9,0,52,50,11,0,61
69919,105,"COLEGIUL TEHNIC “COSTIN D. NENIŢESCU”",CRAIOVA,DJ,1528,9,3,0,12,34,4,0,38,57,4,0,61,76,4,0,80,86,4,0,90
69919,106,"COLEGIUL TEHNIC “COSTIN D. NENIŢESCU”",CRAIOVA,DJ,1575,3,1,0,4,32,6,0,38,48,6,0,54,63,7,0,70,66,8,0,74
69919,107,"COLEGIUL TEHNIC “COSTIN D. NENIŢESCU”",CRAIOVA,DJ,1698,13,0,0,13,35,2,0,37,53,2,0,55,58,3,0,61,65,3,0,68
69919,108,"ŞCOALA GIMNAZIALĂ""DECEBAL"" (FOSTA NR. 12)",CRAIOVA,DJ,1479,15,1,0,16,35,2,0,37,57,3,0,60,65,3,0,68,68,5,0,73
69919,109,"ŞCOALA GIMNAZIALĂ""DECEBAL"" (FOSTA NR. 12)",CRAIOVA,DJ,1415,9,1,0,10,34,2,0,36,55,2,0,57,64,2,0,66,69,3,0,72
69919,110,"ŞCOALA GIMNAZIALĂ""DECEBAL"" (FOSTA NR. 12)",CRAIOVA,DJ,1496,15,5,0,20,35,6,0,41,55,7,0,62,72,11,0,83,79,12,0,91
69919,111,"COLEGIUL TEHNIC ENERGETIC",CRAIOVA,DJ,1566,8,0,0,8,31,1,0,32,52,1,0,53,76,1,0,77,84,1,0,85
69919,112,"COLEGIUL TEHNIC ENERGETIC",CRAIOVA,DJ,1471,6,0,0,6,15,9,28,52,27,10,28,65,46,15,28,89,47,15,28,90
69919,113,"COLEGIUL TEHNIC ENERGETIC",CRAIOVA,DJ,1328,7,0,0,7,21,3,0,24,35,5,0,40,41,5,0,46,52,5,0,57
69919,114,"COLEGIUL NAŢIONAL PEDAGOGIC ""ŞTEFAN VELOVAN""",CRAIOVA,DJ,1876,5,0,0,5,18,2,0,20,44,4,0,48,61,4,0,65,67,4,0,71
69919,115,"COLEGIUL NAŢIONAL PEDAGOGIC ""ŞTEFAN VELOVAN""",CRAIOVA,DJ,1738,8,0,0,8,45,0,0,45,67,4,0,71,82,4,0,86,90,4,0,94
69919,116,"GRĂDINIŢA CU PROGRAM PRELUNGIT ”CASUTA CU POVESTI” (FOSTA NR.43)",CRAIOVA,DJ,1652,10,2,0,12,42,4,0,46,56,5,0,61,70,6,0,76,72,6,0,78
69919,117,"GRADINITA CU PROGRAM PRELUNGIT ”CASUTA CU POVESTI” (FOSTA NR. 43)",CRAIOVA,DJ,1529,16,0,0,16,53,3,0,56,77,5,0,82,104,13,0,117,109,23,0,132
69919,118,"GRĂDINIŢA CU PROGRAM PRELUNGIT ”VOINICEII” (FOSTA NR.32)",CRAIOVA,DJ,1502,8,0,0,8,48,3,0,51,61,5,0,66,72,6,0,78,80,6,0,86
69919,119,"GRĂDINIŢA CU PROGRAM PRELUNGIT ”VOINICEII” (FOSTA NR.32)",CRAIOVA,DJ,1317,12,0,0,12,37,0,0,37,50,0,0,50,73,3,0,76,75,3,0,78
69919,120,"ŞCOALA GIMNAZIALĂ""SFÂNTU GHEORGHE"" (FOSTA NR.24)",CRAIOVA,DJ,1752,15,2,0,17,56,4,0,60,75,4,0,79,95,5,0,100,110,7,0,117
69919,121,"ŞCOALA GIMNAZIALĂ""SFÂNTU GHEORGHE"" (FOSTA NR.24)",CRAIOVA,DJ,1646,16,1,0,17,35,3,0,38,53,3,0,56,80,5,0,85,84,8,0,92
69919,122,"ŞCOALA GIMNAZIALĂ""SFÂNTU GHEORGHE"" (FOSTA NR.24)",CRAIOVA,DJ,1603,10,0,0,10,35,0,0,35,46,0,0,46,63,0,0,63,70,0,0,70
69919,123,"LICEUL TEHNOLOGIC TRANSPORTURI CĂI FERATE",CRAIOVA,DJ,928,7,1,0,8,28,4,0,32,43,4,0,47,57,5,0,62,64,5,0,69
69919,124,"LICEUL TEHNOLOGIC TRANSPORTURI CĂI FERATE",CRAIOVA,DJ,1022,6,5,0,11,24,5,0,29,37,5,29,71,41,6,29,76,44,7,29,80
69919,125,"COLEGIUL NAȚIONAL ”NICOLAE TITULESCU”",CRAIOVA,DJ,1703,15,0,0,15,50,1,0,51,68,3,0,71,90,4,0,94,100,4,0,104
69919,126,"ŞCOALA GIMNAZIALĂ""TRAIAN"" (FOSTA NR. 2)",CRAIOVA,DJ,969,15,1,0,16,45,1,0,46,68,1,0,69,89,1,0,90,99,1,0,100
69919,127,"ŞCOALA GIMNAZIALĂ""TRAIAN"" (FOSTA NR.2)",CRAIOVA,DJ,1222,7,3,0,10,31,4,0,35,48,7,0,55,70,9,0,79,74,9,0,83
69919,128,"GRĂDINIŢA CU PROGRAM PRELUNGIT ”TUDOR VLADIMIRESCU” (FOSTA NR.21)",CRAIOVA,DJ,1736,23,3,0,26,65,8,0,73,93,9,0,102,105,9,0,114,123,10,0,133
69919,129,"ŞCOALA GIMNAZIALĂ„SF. GHEORGHE” (FOSTA SCOALA CU CLASELE I - VIII NR.23)",CRAIOVA,DJ,1758,13,5,0,18,66,13,0,79,78,14,0,92,94,14,0,108,106,14,0,120
69919,130,"ŞCOALA GIMNAZIALĂ„SF. GHEORGHE” (FOSTA SCOALA CU CLASELE I - VIII NR.23)",CRAIOVA,DJ,1737,11,0,0,11,49,0,0,49,62,0,0,62,88,0,0,88,93,0,0,93
69919,131,"ŞCOALA GIMNAZIALĂ„SF. GHEORGHE” (FOSTA SCOALA CU CLASELE I - VIII NR.23)",CRAIOVA,DJ,1678,10,5,0,15,49,6,0,55,70,6,0,76,77,7,0,84,78,9,0,87
69919,132,"DIRECȚIADE SĂNĂTATE PUBLICĂ DOLJ",CRAIOVA,DJ,1250,16,0,0,16,38,0,0,38,56,0,0,56,69,0,0,69,75,0,0,75
69919,133,"DIRECȚIADE SĂNĂTATE PUBLICĂ DOLJ",CRAIOVA,DJ,1725,17,0,0,17,60,0,0,60,75,2,0,77,97,2,0,99,99,2,0,101
69919,134,"ŞCOALA GIMNAZIALĂ""ION ŢUCULESCU"" (FOSTA NR. 14)",CRAIOVA,DJ,1900,11,2,0,13,34,4,117,155,44,4,117,165,48,8,117,173,52,9,117,178
69919,135,"ŞCOALA GIMNAZIALĂ""ION ŢUCULESCU"" (FOSTA NR. 14)",CRAIOVA,DJ,1939,15,2,0,17,34,2,0,36,49,3,0,52,53,3,0,56,60,3,0,63
69919,136,"GRĂDINIȚA CU PROGRAM NORMAL” ÎNGERAȘII” (FOSTĂ NR.5)",CRAIOVA,DJ,1668,6,0,0,6,11,0,0,11,24,0,0,24,28,0,0,28,38,0,0,38
69919,137,"GRADINITA CU PROGRAM NORMAL NR.35 – STRUCTURĂ A SCOLII GIMNAZIALE ”ION ŢUCULESCU” (FOSTĂ NR.14)",CRAIOVA,DJ,1009,4,2,0,6,13,8,1,22,22,8,1,31,25,8,1,34,31,8,1,40
69919,138,"GRĂDINIŢA CU PROGRAM NORMAL NR.16-STRUCTURĂ A ŞCOLII GIMNAZIALE ”ION ŢUCULESCU” (FOSTA NR.14)",CRAIOVA,DJ,1466,9,1,0,10,34,1,0,35,49,1,0,50,60,1,0,61,62,1,0,63
69919,139,"GRĂDINIȚA CU PROGRAM NORMAL”ÎNGERAȘII” ( FOSTA NR. 5)",CRAIOVA,DJ,1711,6,0,0,6,19,0,0,19,32,0,0,32,49,0,0,49,52,0,0,52
69919,140,"SUCURSALA REGIONALĂ CF CRAIOVA",CRAIOVA,DJ,1269,11,4,0,15,49,4,0,53,63,4,0,67,76,12,0,88,85,14,0,99
69919,141,"SUCURSALA REGIONALĂ CF CRAIOVA",CRAIOVA,DJ,1580,10,0,0,10,57,9,0,66,71,12,0,83,93,16,0,109,103,18,0,121
69919,142,"GRĂDINIŢA CU PROGRAM PRELUNGIT""SF. LUCIA"" (FOSTA NR.50)",CRAIOVA,DJ,975,4,0,0,4,16,1,0,17,22,2,0,24,30,2,0,32,34,4,0,38
69919,143,"GRĂDINIŢA CU PROGRAM PRELUNGIT""SF. LUCIA"" (FOSTA NR.50)",CRAIOVA,DJ,954,10,3,0,13,15,3,0,18,24,3,0,27,35,4,0,39,41,4,0,45
69919,144,"GRĂDINIŢA CU PROGRAM PRELUNGIT ”PETRACHE POENARU” (FOSTA SCOALA CU CLASELE IVIII NR.9 PETRACHE POENARU)",CRAIOVA,DJ,1636,16,0,0,16,54,1,310,365,65,1,310,376,87,1,310,398,104,1,310,415
69919,145,"GRĂDINIŢA CU PROGRAM PRELUNGIT ”PETRACHE POENARU” (FOSTA SCOALA CU CLASELE IVIII NR.9 PETRACHE POENARU)",CRAIOVA,DJ,1194,14,0,0,14,41,2,284,327,62,4,284,350,77,6,284,367,81,6,284,371
69919,146,"ŞCOALA GIMNAZIALĂ""GHEORGHE ŢIŢEICA"" (FOSTA NR. 21)",CRAIOVA,DJ,1504,9,0,0,9,45,0,0,45,73,3,0,76,96,3,0,99,109,3,0,112
69919,147,"ŞCOALA GIMNAZIALĂ""GHEORGHE ŢIŢEICA"" (FOSTA NR. 21)",CRAIOVA,DJ,1473,22,3,0,25,65,4,0,69,87,4,0,91,112,5,0,117,117,8,0,125
69919,148,"GRĂDINIŢA CU PROGRAM PRELUNGIT ""PINOCHIO""",CRAIOVA,DJ,1151,10,0,0,10,36,1,0,37,56,3,0,59,75,3,0,78,75,3,0,78
69919,149,"PRIMĂRIA MUNICIPIULUI CRAIOVA, (FOSTA ŞCOALA CU CLASELE I-VIIINR.35„I.D. SÎRBU”)”",CRAIOVA,DJ,1122,11,4,0,15,40,7,0,47,50,10,0,60,64,10,0,74,69,10,0,79
69919,150,"PRIMĂRIA MUNICIPIULUI CRAIOVA, (FOSTA ŞCOALA CU CLASELE I-VIIINR.35„I.D. SÎRBU”)",CRAIOVA,DJ,1064,4,1,0,5,19,1,0,20,28,3,0,31,41,3,0,44,43,5,0,48
69919,151,"PRIMĂRIA MUNICIPIULUI CRAIOVA, (FOSTA ŞCOALA CU CLASELE I-VIIINR.35„I.D. SÎRBU”)",CRAIOVA,DJ,1255,19,4,0,23,38,5,0,43,55,5,0,60,79,5,0,84,88,5,0,93
69919,152,"LICEUL""MATEI BASARAB""",CRAIOVA,DJ,986,8,2,0,10,22,2,0,24,35,4,0,39,55,7,0,62,58,7,0,65
69919,153,"LICEUL""MATEI BASARAB""",CRAIOVA,DJ,917,12,5,0,17,29,5,0,34,32,5,0,37,48,5,0,53,49,5,0,54
69919,154,"LICEUL TEORETIC ""TUDOR ARGHEZI""",CRAIOVA,DJ,1310,10,4,0,14,34,12,0,46,60,21,0,81,78,22,0,100,83,23,0,106
69919,155,"LICEUL TEORETIC ""TUDOR ARGHEZI""",CRAIOVA,DJ,1375,10,0,0,10,34,5,0,39,51,8,0,59,71,8,0,79,78,8,0,86
69919,156,"LICEUL TEORETIC ""TUDOR ARGHEZI""",CRAIOVA,DJ,1409,12,2,0,14,35,3,0,38,46,5,0,51,58,7,0,65,65,7,0,72
69919,157,"ŞCOALA GIMNAZIALĂ""NICOLAE BĂLCESCU"" (FOSTA NR.39)",CRAIOVA,DJ,1460,9,1,0,10,49,1,0,50,67,1,0,68,80,2,0,82,88,3,0,91
69919,158,"ŞCOALA GIMNAZIALĂ""NICOLAE BĂLCESCU"" (FOSTA NR.39)",CRAIOVA,DJ,1317,13,4,0,17,38,4,0,42,42,18,0,60,63,38,0,101,69,39,0,108
69919,159,"ŞCOALA GIMNAZIALĂ""NICOLAE BĂLCESCU"" (FOSTA NR.39)",CRAIOVA,DJ,1499,11,1,0,12,27,4,0,31,51,5,0,56,69,6,0,75,75,6,0,81
69919,160,"ŞCOALA GIMNAZIALĂ""NICOLAE BĂLCESCU"" (FOSTA NR.39)",CRAIOVA,DJ,1498,11,3,0,14,34,4,0,38,46,12,0,58,63,13,0,76,67,14,0,81
69919,161,"GRĂDINIŢA CU PROGRAM NORMAL NR.14 ”LUCEAFĂRUL” – STRUCTURĂ A ŞCOLII GIMNAZIALE ""NICOLAE BĂLCESCU"" (FOSTA NR.39)",CRAIOVA,DJ,1507,18,0,0,18,54,4,0,58,78,7,0,85,102,7,0,109,107,9,0,116
69919,162,"FACULTATEA DE MECANICĂ",CRAIOVA,DJ,1093,15,12,0,27,45,15,0,60,68,22,0,90,87,23,0,110,88,24,0,112
69919,163,"LICEUL TEHNOLOGIC AUTO",CRAIOVA,DJ,1689,6,1,0,7,25,1,0,26,39,2,0,41,53,6,0,59,57,9,0,66
69919,164,"LICEUL TEHNOLOGIC AUTO",CRAIOVA,DJ,1395,3,2,0,5,15,3,0,18,24,6,0,30,37,6,0,43,44,6,0,50
69919,165,"PUNCTUL TERMIC NR.1 LĂPUȘ (LÂNGĂ BL.23 - BLD. DECEBAL NR.66B)",CRAIOVA,DJ,1225,7,0,0,7,22,5,0,27,31,5,0,36,41,6,0,47,43,6,0,49
69919,166,"PUNCTUL TERMIC NR.2 LĂPUȘ (LÂNGĂ BL. 59 - BLD. DECEBAL NR.55B)",CRAIOVA,DJ,1447,8,0,0,8,24,1,0,25,32,1,0,33,42,1,0,43,47,1,0,48
69919,167,"PRIMĂRIA MUNICIPIULUI CRAIOVA DIRECŢIA DE ASISTENŢĂ ŞI PROTECŢIE SOCIALĂ",CRAIOVA,DJ,1485,14,0,0,14,40,1,0,41,55,8,0,63,68,8,0,76,72,8,0,80
69919,168,"PRIMĂRIA MUNICIPIULUI CRAIOVA-DIRECŢIA DE ASISTENŢĂ ŞI PROTECŢIE SOCIALĂ",CRAIOVA,DJ,1371,21,1,0,22,31,9,0,40,47,13,0,60,66,14,0,80,73,19,0,92
69919,169,"ŞCOALA GIMNAZIALĂ NR.38- STRUCTURĂ A ŞCOLII GIMNAZIALE “ION CREANGA” (FOSTĂ NR.16)",CRAIOVA,DJ,1537,6,0,0,6,22,0,0,22,34,0,0,34,49,0,0,49,53,3,0,56
69919,170,"ŞCOALA GIMNAZIALĂ NR.38- STRUCTURĂ A ŞCOLII GIMNAZIALE “ION CREANGA” (FOSTĂ NR.16)",CRAIOVA,DJ,1633,3,0,0,3,9,0,0,9,18,2,0,20,31,2,0,33,37,2,0,39
69919,171,"ŞCOALA GIMNAZIALĂ NR.38- STRUCTURĂ A ŞCOLII GIMNAZIALE “ION CREANGA” (FOSTĂ NR.16)",CRAIOVA,DJ,1507,3,2,0,5,12,2,0,14,31,2,0,33,40,5,0,45,43,6,0,49
69919,172,"GRĂDINIŢA CU PROGRAM NORMAL ROVINE 2 – STRUCTURĂ A ŞCOLII GIMNAZIALE “ION CREANGA” (FOSTĂ NR.16)",CRAIOVA,DJ,573,3,0,0,3,8,1,0,9,14,1,0,15,14,1,0,15,14,1,0,15
69919,173,"ŞCOALA PRIMARĂ IZVORUL RECE – STRUCTURĂ A ŞCOLII GIMNAZIALE “DECEBAL” (FOSTĂ NR.12)",CRAIOVA,DJ,642,3,0,0,3,7,1,0,8,9,1,0,10,15,2,0,17,15,3,0,18
70325,174,"ŞCOALA GIMNAZIALĂ NR. 1",BĂILEŞTI,DJ,1420,4,5,0,9,15,6,0,21,18,6,0,24,30,7,0,37,34,7,0,41
70325,175,"GRĂDINIŢA DE COPII NR. 3",BĂILEŞTI,DJ,1119,2,0,0,2,11,1,0,12,20,1,0,21,22,1,0,23,23,1,0,24
70325,176,"ŞCOALA GIMNAZIALĂ NR. 3",BĂILEŞTI,DJ,543,6,0,0,6,8,4,0,12,14,5,0,19,17,5,0,22,18,5,0,23
70325,177,"ŞCOALA GIMNAZIALĂ NR. 3",BĂILEŞTI,DJ,902,1,2,0,3,4,3,0,7,5,4,0,9,14,5,0,19,16,5,0,21
70325,178,"ŞCOALA GIMNAZIALĂ NR. 5",BĂILEŞTI,DJ,1007,10,0,0,10,16,0,0,16,23,0,0,23,29,4,0,33,30,6,0,36
70325,179,"GRĂDINIŢA DE COPII NR. 7",BĂILEŞTI,DJ,742,2,0,0,2,7,0,0,7,10,0,0,10,20,0,0,20,22,0,0,22
70325,180,"LICEUL MIHAI VITEAZUL",BĂILEŞTI,DJ,1026,1,1,0,2,9,1,0,10,13,2,0,15,26,2,0,28,26,3,0,29
70325,181,"GRĂDINIŢA DE COPII NR. 5",BĂILEŞTI,DJ,663,5,6,0,11,14,7,0,21,18,10,0,28,23,10,0,33,26,10,0,36
70325,182,"ŞCOALA GIMNAZIALĂ NR. 4",BĂILEŞTI,DJ,1478,11,1,0,12,16,4,0,20,23,5,0,28,30,5,0,35,34,5,0,39
70325,183,"ŞCOALA GIMNAZIALĂ NR. 4",BĂILEŞTI,DJ,1009,4,0,0,4,12,0,0,12,14,0,0,14,16,1,0,17,20,1,0,21
70325,184,"GRĂDINIŢA DE COPII NR. 8",BĂILEŞTI,DJ,1366,4,0,0,4,17,2,0,19,22,2,0,24,29,2,0,31,33,2,0,35
70325,185,"LICEUL TEHNOLOGIC ŞTEFAN ANGHEL",BĂILEŞTI,DJ,634,2,2,0,4,5,3,0,8,6,5,0,11,13,5,0,18,18,5,0,23
70325,186,"GRĂDINIŢA DE COPII NR. 2",BĂILEŞTI,DJ,1017,8,2,0,10,15,2,0,17,21,5,0,26,29,5,0,34,33,5,0,38
70325,187,"AGROZIND S.A.",BĂILEŞTI,DJ,811,2,0,0,2,14,4,0,18,21,4,0,25,41,7,0,48,47,7,0,54
70325,188,"ŞCOALA GIMNAZIALĂ NR. 6",BĂILEŞTI,DJ,1360,9,0,0,9,23,1,0,24,28,2,0,30,43,2,0,45,48,3,0,51
70334,189,"ŞCOALA GIMNAZIALĂ BALASAN",BALASAN,DJ,490,2,0,0,2,2,0,0,2,2,0,0,2,4,0,0,4,4,0,0,4
70398,190,"CAMINUL CULTURAL GOLENTI(DIN CADRUL CASEI DE CULTURA CALAFAT )",GOLENŢI,DJ,416,5,1,0,6,23,3,0,26,50,4,0,54,68,8,0,76,76,8,0,84
70370,191,"CAMINUL CULTURAL BASARABI (DIN CADRUL CASEI DE CULTURA CALAFAT )",BASARABI,DJ,883,12,4,0,16,33,5,0,38,39,6,0,45,66,10,0,76,79,10,0,89
70389,192,"CAMINUL CULTURAL CIUPERCENII VECHII ( DIN CADRUL CASEI DE CULTURA CALAFAT )","CIUPERCENII VECHI",DJ,1824,9,3,0,12,35,3,0,38,39,3,0,42,55,3,0,58,63,3,0,66
70361,193,"SC. GENERALA NR. 1 CALAFAT",CALAFAT,DJ,1576,30,3,0,33,58,8,0,66,67,11,45,123,83,12,45,140,101,14,45,160
70361,194,"LICEUL TEORETIC INDEPENDENTA",CALAFAT,DJ,1807,18,8,0,26,41,10,0,51,55,15,0,70,101,17,0,118,102,18,0,120
70361,195,"CLUBUL COPIILOR",CALAFAT,DJ,1465,13,0,0,13,33,3,0,36,38,7,0,45,62,7,0,69,67,9,0,76
70361,196,"SC. GENERALA NR. 2 CALAFAT",CALAFAT,DJ,1819,22,1,0,23,65,5,0,70,74,6,0,80,97,7,0,104,101,7,0,108
70361,197,"SC.GENERALA NR. 2 CALAFAT",CALAFAT,DJ,1693,13,0,5,18,34,0,5,39,45,7,0,52,59,7,0,66,65,9,0,74
70361,198,"GRADINITA NR. 4 ( DIN CADRUL SC.GENERALE NR.1 CALAFAT )",CALAFAT,DJ,1751,13,4,0,17,35,5,0,40,51,8,0,59,59,11,0,70,71,15,0,86
70361,199,"CLUBUL PENSIONARILOR",CALAFAT,DJ,1797,13,4,0,17,33,7,0,40,45,9,0,54,61,9,0,70,66,9,0,75
70888,200,"LICEUL TEORETIC BECHET",BECHET,DJ,1353,25,3,0,28,65,7,0,72,82,10,0,92,106,10,0,116,113,10,0,123
70888,201,"SCOALA PRIMARA BECHET VALE",BECHET,DJ,659,12,0,0,12,43,2,0,45,45,2,0,47,56,3,0,59,61,3,0,64
70888,202,"BIBLIOTECA ORASENEASCA BECHET",BECHET,DJ,1257,19,5,0,24,38,7,0,45,47,9,20,76,65,11,20,96,74,12,20,106
72016,203,"STRUCTURA SCOLII GIMNAZIALE NR. 1 DABULENI",DĂBULENI,DJ,1692,3,0,0,3,9,1,0,10,10,4,0,14,35,5,0,40,42,5,0,47
72016,204,"CLUBUL COPIILOR DABULENI",DĂBULENI,DJ,1544,8,0,0,8,13,1,0,14,29,1,0,30,40,1,0,41,43,1,0,44
72016,205,"SCOALA GIMNAZIALA CU CLASELE I-VIII NR.1 DABULENI, NORD",DĂBULENI,DJ,1549,4,1,0,5,7,2,0,9,12,3,0,15,24,6,0,30,32,10,0,42
72016,206,"SCOALA GIMNAZIALA CU CLASELE I-VIII NR.1 DABULENI, SUD",DĂBULENI,DJ,1710,5,0,0,5,14,0,0,14,28,0,0,28,45,0,0,45,50,0,0,50
72016,207,"LICEUL TEORETIC CONSTANTIN BRANCOVEANU",DĂBULENI,DJ,1169,5,2,0,7,9,4,0,13,14,4,0,18,30,5,0,35,32,5,0,37
72016,208,"LICEUL TEORETIC CONSTANTIN BRANCOVEANU (FOSTA SCOALA NR. 3, INTRARE ELEVI)",DĂBULENI,DJ,1316,8,2,0,10,17,2,0,19,23,2,0,25,55,2,0,57,62,2,0,64
72016,209,"LICEUL TEORETIC CONSTANTIN BRANCOVEANU (FOSTA SCOALA NR. 3, INTRARE PROFESORI)",DĂBULENI,DJ,1270,8,0,0,8,16,0,0,16,24,1,0,25,34,1,0,35,34,1,0,35
70423,210,"CASA DE CULTURĂ",FILIAŞI,DJ,1500,10,3,0,13,51,9,0,60,79,10,0,89,88,13,0,101,103,14,0,117
70423,211,"GRĂDINIŢA NR. 1 FILIAŞI",FILIAŞI,DJ,1825,15,0,0,15,44,0,0,44,63,0,0,63,80,0,0,80,93,5,0,98
70423,212,"GRĂDINIŢA NR. 2 FILIAŞI",FILIAŞI,DJ,1742,14,7,0,21,50,11,0,61,68,11,0,79,105,12,0,117,109,12,0,121
70423,213,"GRĂDINIŢA NR. 3 FILIAŞI",FILIAŞI,DJ,1325,10,4,0,14,28,13,0,41,45,25,0,70,63,25,0,88,74,31,0,105
70423,214,"LICEUL TEHNOLOGIC DIMITRIE FILIŞANU",FILIAŞI,DJ,1540,25,4,0,29,52,4,0,56,67,7,0,74,113,12,0,125,138,14,0,152
70423,215,"PRIMĂRIA ORAŞULUI FILIAŞI",FILIAŞI,DJ,1748,19,0,0,19,61,2,0,63,91,3,0,94,111,11,0,122,124,16,0,140
70423,216,"ŞCOALA GIMNAZIALĂ FILIAŞI",FILIAŞI,DJ,1330,13,4,0,17,33,6,0,39,56,6,0,62,63,7,0,70,70,7,0,77
70441,217,"ŞCOALA BÎLTA",BÎLTA,DJ,917,8,5,0,13,46,9,0,55,77,14,0,91,121,20,0,141,154,21,0,175
70469,218,"SCOALA GIMNAZIALĂ FRATOŞTIŢA - CORP 1",FRATOŞTIŢA,DJ,1318,12,1,0,13,48,2,0,50,72,3,0,75,99,3,0,102,118,3,0,121
70469,219,"ŞCOALA GIMNAZIALĂ FRATOŞTITA - CORP 2",FRATOŞTIŢA,DJ,794,3,6,0,9,29,6,0,35,33,6,0,39,43,6,0,49,53,7,0,60
70478,220,"ŞCOALA RĂCARII DE SUS","RĂCARII DE SUS",DJ,963,4,2,0,6,24,2,0,26,47,3,0,50,67,3,0,70,72,3,0,75
70511,221,"LICEUL TEHNOLOGIC HORIA VINTILĂ",SEGARCEA,DJ,1654,18,8,0,26,23,13,0,36,31,13,0,44,42,16,0,58,49,17,0,66
70511,222,"SCOALA CU CLASELE I-VIII",SEGARCEA,DJ,1485,5,5,0,10,26,5,0,31,33,7,0,40,44,9,0,53,46,10,0,56
70511,223,"BIBLIOTECA ORĂŞENEASCĂ MIRCEA RĂDINA",SEGARCEA,DJ,1576,14,3,0,17,33,4,0,37,45,5,0,50,56,5,0,61,65,7,0,72
70511,224,"CLUBUL COPIILOR",SEGARCEA,DJ,1672,16,6,0,22,42,6,0,48,57,8,0,65,77,9,0,86,83,10,0,93
70539,225,"CONSILIUL LOCAL AFUMATI",AFUMAŢI,DJ,918,6,2,0,8,9,2,0,11,18,3,0,21,19,4,0,23,20,4,0,24
70548,226,"CAMINUL CULTURAL BOURENI",BOURENI,DJ,856,4,0,0,4,15,2,0,17,21,3,0,24,31,4,0,35,44,6,0,50
70557,227,"CAMINUL CULTURAL COVEI",COVEI,DJ,403,4,2,0,6,9,3,0,12,13,3,0,16,16,3,0,19,18,3,0,21
70575,228,"ŞCOALA GIMNAZIALĂ ""ION GHE. PLEŞA""",ALMĂJ,DJ,1099,4,0,0,4,28,4,0,32,49,9,0,58,64,18,0,82,80,24,0,104
70628,229,"ŞCOALA PRIMARĂ ŞITOAIA",ŞITOAIA,DJ,509,10,3,0,13,17,5,0,22,19,7,0,26,40,9,0,49,52,10,0,62
70646,230,"GRĂDINIȚA CU PROGRAM NORMAL AMĂRĂȘTII DE JOS","AMĂRĂŞTII DE JOS",DJ,1173,3,0,0,3,7,7,0,14,13,8,0,21,30,12,0,42,39,12,0,51
70646,231,"GRADINITA TOSCA","AMĂRĂŞTII DE JOS",DJ,1034,7,2,0,9,13,3,0,16,26,3,0,29,61,7,0,68,61,9,0,70
70664,232,"GRĂDINIŢA PRAPOR",PRAPOR,DJ,1117,9,2,0,11,23,3,0,26,32,3,0,35,56,12,0,68,75,12,0,87
70655,233,GRADINITAOCOLNA,OCOLNA,DJ,948,1,0,0,1,26,6,0,32,46,6,0,52,117,6,0,123,125,6,0,131
70682,234,"CĂMINUL CULTURAL","AMĂRĂŞTII DE SUS",DJ,1327,40,5,0,45,68,11,0,79,109,13,0,122,169,21,0,190,202,25,0,227
70735,235,"CĂMINUL CULTURAL","APELE VII",DJ,1710,14,1,0,15,21,5,0,26,35,11,0,46,73,23,0,96,89,30,0,119
70753,236,"ȘCOALA PROFESIONALĂ C-TIN ARGETOAIANU",ARGETOAIA,DJ,1087,3,1,0,4,18,2,0,20,33,2,0,35,51,2,0,53,55,2,0,57
70753,237,"ȘCOALA PROFESIONALĂ C-TIN ARGETOAIANU",ARGETOAIA,DJ,679,3,0,0,3,6,2,0,8,7,3,0,10,10,7,0,17,13,7,0,20
70842,238,"ȘCOALA. GIMNAZIALĂ SALCIA",SALCIA,DJ,960,4,0,0,4,11,1,0,12,22,3,0,25,31,4,0,35,31,4,0,35
70824,239,"ȘCOALA. PRIMARĂ PIRIA",PIRIA,DJ,295,2,0,0,2,3,0,0,3,6,0,0,6,12,0,0,12,13,0,0,13
70799,240,"ȘCOALA. PRIMARĂ LEORDOASA",LEORDOASA,DJ,385,2,6,0,8,3,6,0,9,3,6,0,9,4,6,0,10,7,6,0,13
70815,241,"GRĂDINIȚA CU PROGRAM NORMAL NOVACU",NOVAC,DJ,217,0,3,0,3,3,4,0,7,7,5,0,12,8,7,0,15,10,7,0,17
70904,242,"ȘCOALA GIMNAZIALĂ BISTREȚ",BISTREŢ,DJ,1039,49,1,0,50,136,9,0,145,178,18,0,196,200,23,0,223,214,23,0,237
70904,243,"ȘCOALA GIMNAZIALĂ BISTREȚ",BISTREŢ,DJ,802,14,1,0,15,148,25,0,173,234,27,0,261,260,27,0,287,267,27,0,294
70913,244,"ȘCOALA PRIMARĂ BISTRETU NOU","BISTREŢU NOU",DJ,631,9,6,0,15,40,9,0,49,61,13,0,74,117,21,0,138,124,24,0,148
70931,245,"ȘCOALA PRIMARĂ PLOSCA",PLOSCA,DJ,737,23,3,0,26,132,15,0,147,169,22,0,191,223,31,0,254,241,32,0,273
70959,246,"CAMINUL CULTURAL",BÎRCA,DJ,1656,11,5,0,16,35,15,0,50,43,17,0,60,57,20,0,77,60,20,0,80
70959,247,"GRADINITA DE COPII",BÎRCA,DJ,1478,5,0,0,5,12,2,0,14,28,3,0,31,51,3,0,54,60,3,0,63
70977,248,"CĂMINUL CULTURAL",BOTOŞEŞTI-PAIA,DJ,578,174,9,0,183,263,37,0,300,313,60,0,373,415,69,0,484,415,69,0,484
70995,249,"CĂMINUL CULTURAL BRABOVA",BRABOVA,DJ,450,21,8,0,29,52,43,0,95,80,60,0,140,99,69,0,168,112,81,0,193
71037,250,"CĂMINUL CULTURAL URDINIȚA",URDINIŢA,DJ,236,7,3,0,10,22,12,0,34,43,14,0,57,61,21,0,82,71,22,0,93
71028,251,"CĂMINUL CULTURAL RĂCHITA DE JOS","RĂCHITA DE JOS",DJ,229,10,2,0,12,34,6,0,40,50,13,0,63,85,19,0,104,104,23,0,127
71019,252,"ȘCOALA CU CLASELE I-IV MOSNA",MOSNA,DJ,132,4,0,0,4,8,0,0,8,19,0,0,19,42,5,0,47,45,5,0,50
71135,253,"SALA DE SEDINȚE A CONSILIULUI LOCAL BRALOȘTIȚA",BRALOŞTIŢA,DJ,621,10,2,0,12,26,4,0,30,35,5,0,40,55,10,0,65,59,11,0,70
71171,254,"SCOALA DIN SATUL SFIRCEA",SFÎRCEA,DJ,815,7,0,0,7,15,4,0,19,20,5,0,25,24,5,0,29,32,6,0,38
71180,255,"ŞCOALA DIN SATUL VALEA FÎNTÎNILOR","VALEA FÎNTÎNILOR",DJ,522,4,0,0,4,10,0,0,10,17,0,0,17,30,1,0,31,32,1,0,33
71144,256,"ŞCOALA DIN SATUL CIOCANE",CIOCANELE,DJ,630,4,1,0,5,15,4,0,19,40,15,0,55,54,17,0,71,54,19,0,73
71162,257,"ŞCOALA DIN SATUL SCHITU",SCHITU,DJ,391,0,0,0,0,5,0,0,5,10,0,0,10,17,0,0,17,23,1,0,24
71215,258,"ȘCOALA PRIMARĂ BĂDOȘI",BĂDOŞI,DJ,729,4,2,0,6,8,3,0,11,11,3,0,14,15,3,0,18,18,3,0,21
71233,259,"ȘCOALA PRIMARĂ PRUNET",PRUNET,DJ,471,5,0,0,5,7,0,0,7,9,0,0,9,14,3,0,17,14,3,0,17
71206,260,"ȘCOALA GIMNAZIALĂ BRATOVOEȘTI",BRATOVOEŞTI,DJ,1116,4,2,0,6,10,2,0,12,13,2,0,15,40,2,0,42,44,2,0,46
71224,261,"ȘCOALA PRIMARĂ GEOROCU MARE","GEOROCU MARE",DJ,397,2,0,0,2,8,0,0,8,9,1,0,10,18,3,0,21,20,3,0,23
71064,262,"GRĂDINIȚA ,,PROF. GHEORGHE LUȚĂ” BRĂDEȘTI",BRĂDEŞTI,DJ,1573,4,3,0,7,33,17,0,50,61,21,0,82,76,25,0,101,83,25,0,108
71073,263,"SCOALAGENERALABRADESTI BATRINI","BRĂDEŞTII BĂTRÎNI",DJ,327,0,4,0,4,5,5,0,10,8,6,0,14,15,7,0,22,16,8,0,24
71117,264,"SCOALAGENERALA TATOMIRESTI",TATOMIREŞTI,DJ,824,7,2,0,9,14,2,0,16,18,4,0,22,33,4,0,37,37,5,0,42
71118,265,"SCOALAGENERALA RACARII DEJOS",RĂCARI,DJ,964,6,0,0,6,25,3,0,28,41,3,0,44,51,3,0,54,67,5,0,72
71091,266,"SCOALA GENERALAPISCANI",PISCANI,DJ,80,1,4,0,5,1,4,0,5,2,4,0,6,3,4,0,7,5,4,0,9
71279,267,"ŞCOALA BREASTA",BREASTA,DJ,1183,6,0,0,6,15,0,0,15,37,5,0,42,55,6,0,61,56,6,0,62
71279,268,"ŞCOALA BREASTA",BREASTA,DJ,927,7,0,0,7,12,0,0,12,22,4,0,26,33,6,0,39,35,6,0,41
71331,269,"ŞCOALA VALEA LUNGULUI","VALEA LUNGULUI",DJ,541,4,3,0,7,17,6,0,23,31,6,0,37,51,27,0,78,61,35,0,96
71313,270,"ŞCOALA OBEDIN",OBEDIN,DJ,597,10,0,0,10,26,0,0,26,41,1,0,42,47,3,0,50,49,4,0,53
69973,271,"SCOALA GENERALA CU CLASELE L-VLLL BUCOVAT",BUCOVĂŢ,DJ,1634,24,8,0,32,74,21,0,95,100,30,0,130,133,48,0,181,157,73,0,230
70003,272,"SCOALA GENERALA CU CLASELE L-LV LEAMNA DE JOS","LEAMNA DE JOS",DJ,282,6,1,0,7,14,3,0,17,21,5,0,26,28,12,0,40,34,13,0,47
70012,273,"SCOALA GENERALA CU CLASELE L-LV LEAMNA DE SUS","LEAMNA DE SUS",DJ,321,6,11,0,17,28,17,0,45,30,19,0,49,46,24,0,70,59,26,0,85
70030,274,"SCOALA GENERALA CU CLASELE L-VLLL SARBATOAREA",SĂRBĂTOAREA,DJ,612,2,3,0,5,13,7,0,20,37,15,0,52,57,26,0,83,71,29,0,100
70021,275,"SCOALA GENERALA CU CLASELE L-VLLL PALILULA",PALILULA,DJ,635,9,2,0,11,18,13,0,31,40,19,0,59,54,23,0,77,62,23,0,85
71368,276,"CĂMINUL CULTURAL",BULZEŞTI,DJ,646,3,3,0,6,14,12,0,26,17,16,0,33,28,20,0,48,33,22,0,55
71420,277,"PUNCT INFORMARE, PRIMĂRIA BULZEŞTI",SĂLIŞTE,DJ,525,4,8,0,12,35,21,0,56,51,25,0,76,63,30,0,93,71,35,0,106
71466,278,"ȘCOALA CU CLS.I-VIII CALOPĂR",CALOPĂR,DJ,1083,5,1,0,6,12,1,0,13,39,3,0,42,53,9,0,62,67,13,0,80
71475,279,"ȘCOALA CU CLS I-VIII BELCINU",BELCINU,DJ,425,7,4,0,11,15,9,0,24,35,15,0,50,40,17,0,57,51,21,0,72
71493,280,"ȘCOALA CU CLS I-IV PANAGHIA",PANAGHIA,DJ,571,1,2,0,3,9,7,0,16,19,8,0,27,24,8,0,32,37,9,0,46
71509,281,"CĂMIN CULTURAL SĂLCUȚA",SĂLCUŢA,DJ,878,10,3,0,13,28,4,0,32,48,14,0,62,76,20,0,96,86,20,0,106
71527,282,"CĂMINUL CULTURAL",CARAULA,DJ,960,75,13,0,88,128,24,0,152,185,29,0,214,268,49,0,317,319,57,27,403
71527,283,"CENTRUL SOCIAL CARAULA",CARAULA,DJ,977,18,8,0,26,76,11,0,87,131,15,0,146,166,17,0,183,182,18,0,200
71545,284,"CĂMINUL CULTURAL CARPEN",CARPEN,DJ,772,7,3,0,10,34,7,0,41,35,7,0,42,72,14,0,86,74,18,0,92
71554,285,"CĂMINUL CULTURAL CLEANOV",CLEANOV,DJ,1089,21,6,0,27,54,13,0,67,111,18,0,129,168,18,0,186,191,18,0,209
71581,286,"CAMINUL CULTURAL",CASTRANOVA,DJ,1486,8,2,0,10,20,5,0,25,28,5,0,33,63,12,0,75,84,12,0,96
71590,287,"ŞCOALA PUŢURI",PUŢURI,DJ,1083,9,1,0,10,22,1,0,23,31,4,0,35,37,7,0,44,46,7,0,53
73488,288,"SCOALA GIMNAZIALA CATANE",CATANE,DJ,1403,8,2,0,10,45,7,0,52,72,7,0,79,103,7,0,110,110,9,0,119
71616,289,"CĂMINUL CULTURAL",CĂLĂRAŞI,DJ,1493,8,8,0,16,28,15,0,43,45,17,0,62,58,17,0,75,69,17,0,86
71616,290,"ŞCOALAGIMNAZIALĂNR. 1 CĂLĂRAŞI",CĂLĂRAŞI,DJ,1782,15,1,0,16,28,2,0,30,69,8,0,77,92,12,0,104,95,15,0,110
71625,291,"ŞCOALA GIMNAZIALĂ SĂRATA",SĂRATA,DJ,1674,15,1,0,16,41,4,0,45,70,4,0,74,81,4,0,85,87,6,0,93
71901,292,"CENTRUL CULTURAL",CÂRCEA,DJ,1492,18,3,0,21,61,11,0,72,121,27,40,188,161,39,40,240,191,43,40,274
71901,293,"LICEUL TEHNOLOGIC ""CONSTANTIN IANCULESCU""",CÂRCEA,DJ,725,5,6,0,11,13,10,5,28,23,12,5,40,29,14,5,48,29,14,5,48
72668,294,"SCOALA CU CLS. I-VIII CÂRNA",CÂRNA,DJ,1104,23,6,0,29,83,13,0,96,106,16,0,122,189,22,0,211,201,22,0,223
71643,295,"SCOALA NOUA CELARU",CELARU,DJ,1469,6,4,0,10,11,4,0,15,19,8,0,27,29,8,0,37,38,8,0,46
71661,296,"CAMIN CULTURAL MAROTINU DE JOS","MAROTINU DE JOS",DJ,455,3,1,0,4,7,3,0,10,17,8,0,25,21,8,0,29,24,8,0,32
71652,297,"CAMIN CULTURAL GHIZDAVESTI",GHIZDĂVEŞTI,DJ,1215,5,3,0,8,35,8,0,43,57,9,0,66,76,11,0,87,80,13,0,93
71670,298,"CAMIN CULTURAL MAROTINU DE SUS","MAROTINU DE SUS",DJ,452,2,0,0,2,6,0,0,6,7,0,0,7,9,1,0,10,9,1,0,10
71705,299,"CAMINUL CULTURAL CERAT",CERĂT,DJ,1951,19,4,0,23,104,14,0,118,193,17,0,210,280,20,0,300,301,20,0,321
71705,300,"SCOALA GIMNAZIALA CERĂT - LOCALUL NR. 3",CERĂT,DJ,1192,6,3,0,9,21,3,0,24,42,4,0,46,61,6,0,67,70,6,0,76
71732,301,"CĂMINUL CULTURAL",CERNĂTEŞTI,DJ,387,4,2,0,6,11,7,0,18,15,7,0,22,30,12,7,49,32,12,7,51
71778,302,GRĂDINIŢĂ,ŢIU,DJ,381,3,0,0,3,10,2,0,12,21,5,0,26,27,5,3,35,28,6,3,37
71741,303,"ŞCOALA GENERALĂ",CORNIŢA,DJ,243,4,2,0,6,7,3,0,10,14,4,0,18,16,5,0,21,23,9,0,32
71769,304,"ŞCOALA GENERALĂ","RASNICU OGHIAN",DJ,424,10,1,0,11,22,1,0,23,34,3,0,37,34,3,0,37,39,3,0,42
71796,305,"SCOALA CU CLS. I-IV CETATE",CETATE,DJ,1645,39,1,0,40,125,4,0,129,298,9,32,339,450,15,32,497,487,16,32,535
71796,306,"CĂMINUL CULTURAL CETATE",CETATE,DJ,1457,30,0,0,30,67,5,0,72,111,9,0,120,143,11,87,241,179,13,87,279
71796,307,"SCOALA CU CLS. I-VIII F-B",CETATE,DJ,758,24,1,0,25,79,1,0,80,102,1,0,103,120,2,0,122,124,2,0,126
71803,308,"SCOALA CU CLS. I-IV MORENI",MORENI,DJ,436,6,2,0,8,12,5,0,17,23,7,0,30,57,7,0,64,66,9,0,75
71821,309,"ȘCOALA CU CLASELE I-VIII CIOROIAȘI",CIOROIAŞI,DJ,841,1,0,0,1,5,3,0,8,11,4,0,15,18,7,0,25,18,7,0,25
71849,310,"ȘCOALA CU CLASELE I-IV CIOROIU NOU","CIOROIU NOU",DJ,408,5,0,0,5,5,3,0,8,6,3,0,9,12,5,0,17,18,6,0,24
71867,311,"ȘCOALA GIMNAZIALĂ ,,NICOLAE CARAȘ ”","CIUPERCENII NOI",DJ,1530,11,8,0,19,35,8,0,43,48,8,0,56,111,14,0,125,187,16,0,203
71867,312,"SCOALA GENERALA CIUPERCENII NOI","CIUPERCENII NOI",DJ,1852,17,1,0,18,42,1,0,43,52,3,0,55,152,6,0,158,276,15,0,291
71876,313,"SCOALA GENERALA SMÎRDAN",SMÎRDAN,DJ,1036,4,2,0,6,25,2,0,27,37,2,0,39,70,5,0,75,83,6,0,89
71894,314,"CAMIN CULTURAL",COŞOVENI,DJ,880,3,0,0,3,13,5,0,18,22,11,0,33,22,14,0,36,26,15,0,41
71894,315,"GRADINITA NR. 1",COŞOVENI,DJ,1067,4,0,0,4,14,2,0,16,22,2,0,24,26,4,0,30,26,6,0,32
71894,316,"GRADINITA NR. 2",COŞOVENI,DJ,683,3,1,0,4,9,2,0,11,11,3,0,14,22,5,0,27,24,5,0,29
71929,317,"SCOALA GIMNAZIALA COTOFENII DIN DOS","COŢOFENII DIN DOS",DJ,846,6,4,0,10,26,6,0,32,36,10,0,46,52,11,0,63,52,12,0,64
71947,318,"GRADINITA CU POGRAM NORMAL POTMELTU",POTMELŢU,DJ,423,3,1,0,4,6,1,0,7,7,6,0,13,16,7,0,23,17,7,0,24
71938,319,"SCOALA GIMNAZIALA MIHAITA",MIHĂIŢA,DJ,631,14,6,0,20,23,14,0,37,39,16,0,55,60,17,0,77,67,22,0,89
70600,320,"ŞCOALA CU CLASELE I-VIII COȚOFENII DIN FAŢĂ","COŢOFENII DIN FAŢĂ",DJ,1313,14,1,0,15,77,1,0,78,92,1,0,93,117,4,0,121,135,11,0,146
70584,321,"ȘCOALA CU CLASELE I-IV",BEHARCA,DJ,254,2,0,0,2,9,3,0,12,11,3,0,14,31,5,0,36,41,5,0,46
71965,322,"ȘCOALA PROFESIONALĂ DANEŢI",DANEŢI,DJ,1668,7,3,0,10,26,7,0,33,64,11,0,75,124,24,0,148,138,26,0,164
71965,323,"ŞCOALA PROFESIONALĂ DANEŢI",DANEŢI,DJ,1405,4,0,0,4,14,1,0,15,43,4,0,47,78,8,0,86,94,9,0,103
71983,324,"ŞCOALA GENERALĂ CU CLASELE I-VIII BRANIŞTE",BRANIŞTE,DJ,510,1,0,0,1,9,1,0,10,19,2,0,21,36,8,0,44,50,8,0,58
71992,325,"ŞCOALA GENERALĂ CU CLASELE I-IV LOCUSTENI",LOCUSTENI,DJ,475,2,3,0,5,9,6,0,15,15,6,0,21,27,9,0,36,30,11,0,41
71974,326,"ŞCOALA GENERALĂ CU CLASELE I-VIII BRABEŢI",BRABEŢI,DJ,848,1,0,0,1,10,4,0,14,29,18,0,47,81,29,0,110,94,33,0,127
72043,327,"ŞCOALA GIMNAZIALĂ DESA",DESA,DJ,1193,2,0,0,2,9,0,0,9,21,0,0,21,37,0,0,37,45,0,0,45
72043,328,"ŞCOALA GIMNAZIALĂ DESA",DESA,DJ,1367,5,0,0,5,11,1,0,12,19,1,0,20,29,1,0,30,50,3,0,53
72043,329,"ŞCOALA GIMNAZIALĂ DESA",DESA,DJ,1347,8,0,0,8,16,0,0,16,25,0,0,25,34,0,0,34,48,0,0,48
72061,330,"CLUB CAMIN CULTURAL DIOSTI",DIOŞTI,DJ,993,13,1,0,14,38,4,0,42,60,11,0,71,79,12,0,91,92,14,0,106
72089,331,"SCOALA GENERALA CU CLASELE I-IV RADOMIR",RADOMIR,DJ,893,3,3,0,6,11,4,0,15,19,4,0,23,28,6,0,34,33,6,0,39
72070,332,"SCOALA GENERALA CU CLASELE I-VIII CIOCANESTI",CIOCĂNEŞTI,DJ,594,4,2,0,6,5,3,0,8,10,3,0,13,12,3,0,15,12,4,0,16
72105,333,"ȘCOALA DOBREȘTI",DOBREŞTI,DJ,332,4,1,0,5,5,1,0,6,10,1,0,11,14,3,0,17,18,5,0,23
72132,334,"ȘCOALA MURTA",MURTA,DJ,694,6,1,0,7,15,2,0,17,32,2,0,34,47,2,0,49,58,2,0,60
72141,335,"ȘCOALA TOCENI",TOCENI,DJ,521,13,2,0,15,14,2,0,16,20,2,0,22,26,5,0,31,26,5,0,31
72114,336,"ȘCOALA CĂCIULĂTEȘTI",CĂCIULĂTEŞTI,DJ,412,3,2,0,5,6,2,0,8,7,4,0,11,7,4,0,11,7,4,0,11
70691,337,"CĂMINUL CULTURAL",DOBROTEŞTI,DJ,1377,13,2,0,15,33,8,0,41,46,13,0,59,62,17,0,79,78,26,0,104
72212,338,"SCOALA CU CLS. I - IV VIIŞOARA",VIIŞOARA,DJ,430,4,0,0,4,12,1,0,13,24,3,0,27,57,8,0,65,61,13,0,74
72169,339,"SCOALA VECHE DRĂGOTEŞTI",DRĂGOTEŞTI,DJ,369,15,0,0,15,25,3,0,28,60,7,0,67,80,12,0,92,91,12,0,103
72178,340,"SCOALA CU CLS. I - IV BENEŞTI",BENEŞTI,DJ,349,6,0,0,6,15,1,0,16,40,4,0,44,70,5,7,82,82,7,5,94
72203,341,"TARG SAPTAMANAL-CLADIREA PRODUSE LACTATE",POPÎNZĂLEŞTI,DJ,488,2,4,0,6,18,7,0,25,35,10,19,64,51,13,19,83,52,13,19,84
72196,342,"SCOALA CU CLS. I - IV BUZDUC",BUZDUC,DJ,123,1,1,0,2,5,4,0,9,13,5,0,18,29,12,9,50,34,12,9,55
72230,343,"CAMINUL CULTURAL DRANIC",DRĂNIC,DJ,818,3,0,0,3,9,1,0,10,10,1,0,11,13,1,0,14,13,1,0,14
72267,344,"SCOALA PRIMARA PADEA",PADEA,DJ,615,4,1,0,5,8,2,0,10,14,3,0,17,18,4,0,22,20,4,0,24
72249,345,"SCOALA CU CLASELE I-IV BOOVENI",BOOVENI,DJ,284,1,0,0,1,1,0,0,1,5,0,0,5,8,0,0,8,8,0,0,8
72258,346,"SCOALA CU CLASELE I-IV FOISOR",FOIŞOR,DJ,218,3,2,0,5,4,3,0,7,6,3,0,9,12,4,0,16,12,4,0,16
72285,347,"CAMINUL CULTURAL FARCAS",FĂRCAŞ,DJ,1011,1,0,0,1,9,2,0,11,13,9,0,22,59,15,0,74,65,16,0,81
72310,348,"SCOALA GENERALA GOLUMBU",GOLUMBU,DJ,664,4,3,0,7,8,4,0,12,16,5,0,21,39,7,0,46,44,9,0,53
72392,349,"ȘCOALA GIMNAZIALĂ CORP 3","GALICEA MARE",DJ,1203,1,3,0,4,5,4,0,9,5,4,0,9,18,7,0,25,20,7,0,27
72392,350,"ȘCOALA GIMNAZIALĂ -CORP 4","GALICEA MARE",DJ,914,2,0,0,2,11,0,0,11,12,0,0,12,20,1,0,21,21,2,0,23
72392,351,"ȘCOALA GIMNAZIALĂ - CORP 4","GALICEA MARE",DJ,1226,1,0,0,1,9,0,0,9,11,0,0,11,17,2,0,19,18,4,0,22
72524,352,"CAMINUL CULTURAL",GALICIUICA,DJ,1161,20,8,0,28,41,10,0,51,60,14,0,74,101,16,0,117,121,21,0,142
72418,353,"ŞCOALA GIMNAZIALĂ GHERCEŞTI",GHERCEŞTI,DJ,845,3,4,0,7,15,9,0,24,34,9,0,43,43,19,0,62,54,19,0,73
72427,354,"ŞCOALA GENERALĂ GÂRLEŞTI",GÎRLEŞTI,DJ,378,3,0,0,3,5,1,0,6,14,5,0,19,40,6,0,46,50,8,0,58
72445,355,"CLĂDIREA CONSILIULUI LOCAL UNGURENI",UNGURENI,DJ,254,4,1,0,5,17,8,0,25,24,22,0,46,33,25,0,58,43,25,0,68
73683,356,"CĂMINUL CULTURAL",GHIDICI,DJ,1850,84,12,0,96,202,18,0,220,269,35,78,382,401,62,78,541,453,78,78,609
73086,357,"CAMIN CULTURAL",GHINDENI,DJ,1544,19,4,0,23,35,6,0,41,50,10,0,60,70,12,0,82,107,23,0,130
72472,358,"CĂMINUL CULTURAL GIGHERA",GIGHERA,DJ,967,15,0,0,15,34,4,0,38,43,7,0,50,52,9,0,61,58,9,0,67
72481,359,"CĂMINUL CULTURAL NEDEIA",NEDEIA,DJ,696,5,1,0,6,11,7,0,18,23,10,0,33,35,13,0,48,38,14,0,52
72490,360,"CĂMINUL CULTURAL ZĂVAL",ZĂVAL,DJ,621,8,1,0,9,30,5,0,35,43,6,0,49,84,11,0,95,89,14,0,103
72515,361,"CAMIN CULTURAL",GIUBEGA,DJ,903,1,2,0,3,18,7,0,25,29,8,0,37,44,8,0,52,52,9,0,61
72515,362,"PRIMARIA VECHE",GIUBEGA,DJ,850,2,5,0,7,12,7,0,19,19,12,0,31,36,17,0,53,42,17,0,59
72542,363,"SCOALA GIMNAZIALA GIURGITA",GIURGIŢA,DJ,978,7,6,0,13,17,8,0,25,26,8,0,34,41,17,0,58,54,19,0,73
72542,364,"GRADINITA PORTARESTI",GIURGIŢA,DJ,958,4,6,0,10,11,7,0,18,20,15,0,35,30,15,0,45,49,17,0,66
72551,365,"GRADINITA CURMATURA",CURMĂTURA,DJ,421,3,3,0,6,4,4,0,8,6,4,0,10,8,6,0,14,9,6,0,15
72588,366,"CĂMINUL CULTURAL GÎNGIOVA",GÎNGIOVA,DJ,1159,3,3,0,6,8,5,0,13,11,5,0,16,26,5,0,31,28,5,0,33
72597,367,"CĂMINUL CULTURAL COMOŞTENI",COMOŞTENI,DJ,845,3,2,0,5,13,3,0,16,18,4,0,22,25,5,0,30,27,5,0,32
72613,368,"CĂMINUL CULTURAL GOGOŞU",GOGOŞU,DJ,184,2,0,0,2,9,2,0,11,11,3,0,14,14,16,0,30,22,20,0,42
72622,369,"ŞCOALA CU CLASELE I-IV",GOGOŞIŢA,DJ,154,0,0,0,0,5,1,0,6,6,3,0,9,11,3,0,14,11,3,0,14
72631,370,"ŞCOALA CU CLASELE I-IV",ŞTEFĂNEL,DJ,152,3,0,0,3,5,5,0,10,8,5,0,13,10,5,0,15,11,5,0,16
72659,371,"GRĂDINIȚA NR.1",GOICEA,DJ,1202,105,26,0,131,186,55,0,241,222,69,0,291,269,76,40,385,278,77,40,395
72659,372,"GRĂDINIȚA NR.2",GOICEA,DJ,900,12,1,0,13,43,6,0,49,70,11,0,81,104,11,19,134,112,11,19,142
72686,373,"CAMIN CULTURAL GOIESTI SALA",GOIEŞTI,DJ,1150,4,2,0,6,16,7,0,23,30,8,0,38,40,12,0,52,48,14,0,62
72739,374,"SCOALA CLS I-IV MOGOSESTI SALA",MOGOŞEŞTI,DJ,483,3,3,0,6,5,7,0,12,10,7,0,17,17,10,0,27,18,10,0,28
72720,375,"SCOALA CU CLS I-IV MALAESTI SALA",MĂLĂEŞTI,DJ,480,6,4,0,10,10,4,0,14,14,6,0,20,27,7,0,34,28,9,0,37
72784,376,"SCOALA CU CLS I-VIII TANDARA SALA",ŢANDĂRA,DJ,432,0,1,0,1,4,1,0,5,14,2,0,16,33,11,0,44,37,12,0,49
72837,377,"ȘCOALA BĂRBOI",BĂRBOI,DJ,309,10,0,0,10,18,1,0,19,37,10,10,57,53,14,10,77,57,14,10,81
72828,378,"ȘCOALA GRECEȘTI",GRECEŞTI,DJ,232,6,5,0,11,13,8,0,21,22,9,5,36,36,15,5,56,42,17,5,64
72846,379,"ȘCOALA BUSU",BUSU,DJ,541,9,1,0,10,31,9,0,40,47,10,11,68,64,10,11,85,73,13,11,97
72873,380,"ȘCOALA GROPANELE",GROPANELE,DJ,240,4,2,0,6,5,2,0,7,9,2,0,11,17,5,0,22,18,5,0,23
70101,381,"ŞCOALA GIMNAZIALĂ ELIZA OPRAN",IŞALNIŢA,DJ,1675,8,4,0,12,48,17,0,65,58,18,48,124,116,20,48,184,121,21,48,190
70101,382,"ŞCOALA GIMNAZIALĂ ELIZA OPRAN",IŞALNIŢA,DJ,1759,8,9,0,17,33,23,0,56,57,31,0,88,98,47,11,156,117,53,11,181
72891,383,"GRADINITA IZVOARE",IZVOARE,DJ,967,11,5,0,16,20,9,0,29,41,18,0,59,77,26,0,103,95,35,0,130
72908,384,"SCOALA CLASELE I-IV",CORLATE,DJ,269,10,6,0,16,30,6,14,50,60,16,14,90,86,25,14,125,116,35,14,165
73889,385,"SCOALA GIMNAZIALA N. GH. POPESCU",ÎNTORSURA,DJ,1220,18,4,0,22,49,17,0,66,65,22,0,87,91,26,0,117,94,26,0,120
72935,386,"GRADINA DE VARA LEU",LEU,DJ,1436,11,2,0,13,28,5,0,33,34,7,0,41,60,14,0,74,68,14,0,82
72935,387,"GRADINA DE VARA LEU",LEU,DJ,1543,15,1,0,16,18,8,0,26,46,19,0,65,66,28,0,94,74,28,0,102
72944,388,GRADINITAZĂNOAGA,ZĂNOAGA,DJ,954,5,2,0,7,12,6,0,18,15,7,0,22,25,9,0,34,25,11,0,36
72962,389,"SCOALA GIMNAZIALA CLASELE I-VIIIPETRE MANARCESCU",LIPOVU,DJ,1298,5,4,0,9,5,4,0,9,9,4,0,13,9,5,0,14,9,5,0,14
72962,390,"LOCAL PRIMĂRIE",LIPOVU,DJ,876,1,1,0,2,2,1,0,3,11,2,0,13,13,3,0,16,14,3,0,17
72971,391,"SCOALA PRIMARA CLSELE I-VIII","LIPOVU DE SUS",DJ,164,0,3,0,3,0,4,0,4,2,5,0,7,4,6,0,10,4,6,0,10
73040,392,"SCOALA CU CLASELE I-VIII MAGLAVIT",MAGLAVIT,DJ,1821,11,0,0,11,33,3,0,36,38,6,0,44,55,6,0,61,57,7,0,64
73040,393,"SCOALA CLASELE I-IV MAGLAVIT",MAGLAVIT,DJ,1040,5,1,0,6,20,5,0,25,22,12,0,34,35,15,0,50,38,15,0,53
73041,394,"ȘCOALA GENERALĂ HUNIA",HUNIA,DJ,1086,5,1,0,6,9,2,0,11,11,5,0,16,20,12,0,32,20,12,0,32
73077,395,"LICEUL TEHNOLOGIC ""ING. IONETE AURELIAN""","MALU MARE",DJ,949,5,5,0,10,12,5,0,17,14,12,0,26,30,13,0,43,36,13,0,49
73095,396,"ŞCOALA PRIMARĂ PREAJBA",PREAJBA,DJ,2020,6,0,0,6,13,5,0,18,23,5,0,28,32,9,0,41,33,9,0,42
73077,397,"ȘCOALA GIMNAZIALĂ MALU MARE","MALU MARE",DJ,1224,5,3,0,8,20,6,0,26,24,6,0,30,36,10,0,46,36,11,0,47
72999,398,"PRIMĂRIA MĂCEŞU DE JOS","MĂCEŞU DE JOS",DJ,805,22,2,0,24,41,17,0,58,57,20,0,77,72,34,0,106,74,36,0,110
73004,399,"ŞCOALA SĂPATA",SĂPATA,DJ,266,4,0,0,4,7,5,0,12,14,17,0,31,22,26,0,48,22,31,0,53
73022,400,CAMINULCULTURAL,"MĂCEŞU DE SUS",DJ,1037,21,8,0,29,40,10,0,50,75,16,0,91,97,19,0,116,97,21,0,118
73111,401,"CĂMINUL CULTURAL MELINEŞTI",MELINEŞTI,DJ,945,3,1,0,4,28,4,3,35,40,7,20,67,47,12,20,79,52,12,20,84
73166,402,"ŞCOALAGENERALĂ NEGOIEŞTI",NEGOIEŞTI,DJ,1172,8,0,0,8,22,3,0,25,45,7,0,52,54,12,0,66,59,14,0,73
73120,403,"SEDIUL FOSTEI ŞCOLI GENERALE BODAIESTI",BODĂIEŞTI,DJ,606,8,1,0,9,12,1,0,13,18,1,0,19,22,3,0,25,24,5,0,29
73139,404,"ŞCOALA GENERALĂ BODĂIEŞTII DE SUS","BODĂIEŞTII DE SUS",DJ,243,2,3,0,5,2,4,0,6,3,4,0,7,5,5,0,10,5,5,0,10
73219,405,"ŞCOALA GENERALĂ SPINENI",SPINENI,DJ,257,1,1,0,2,6,5,0,11,17,8,0,25,34,10,0,44,54,14,0,68
73255,406,"ŞCOALA GENERALĂ MISCHII",MISCHII,DJ,500,6,4,0,10,17,13,0,30,32,28,0,60,53,47,0,100,68,56,0,124
73282,407,"ŞCOALA GENERALĂ MLECĂNEŞTI",MLECĂNEŞTI,DJ,442,4,4,0,8,9,12,0,21,26,12,0,38,48,19,0,67,55,22,0,77
73308,408,"ŞCOALA GENERALĂ URECHEŞTI",URECHEŞTI,DJ,404,0,3,0,3,11,7,0,18,20,9,0,29,26,12,0,38,36,17,0,53
73264,409,"ŞCOALA GENERALĂ CĂLINEŞTI",CĂLINEŞTI,DJ,108,2,4,0,6,3,5,0,8,12,16,0,28,17,16,0,33,17,17,0,34
73326,410,"ȘCOALA GENERALĂ NR. 2 MÎRȘANI",MÎRŞANI,DJ,1462,8,1,0,9,24,4,0,28,54,4,0,58,82,6,0,88,97,7,0,104
73326,411,"ȘCOALA GENERALĂ NR. 1 MÎRȘANI",MÎRŞANI,DJ,1107,0,2,0,2,32,4,0,36,56,8,0,64,80,9,0,89,89,9,0,98
73326,412,"ȘCOALA GENERALĂ NR. 3 MÎRȘANI",MÎRŞANI,DJ,1220,17,1,0,18,28,1,0,29,45,3,0,48,83,6,0,89,93,6,0,99
73362,413,"ŞCOALA MOŢĂŢEI GARĂ","MOŢĂŢEI GARĂ",DJ,693,3,0,0,3,5,0,0,5,11,0,0,11,22,1,0,23,37,3,0,40
73344,414,"GRĂDINIŢA NR. 2 MOŢĂŢEI",MOŢĂŢEI,DJ,1774,14,0,0,14,27,1,0,28,34,1,0,35,60,1,0,61,68,1,0,69
73344,415,"ŞCOALA NR. 1 MOŢĂŢEI",MOŢĂŢEI,DJ,1136,5,2,0,7,18,2,0,20,25,2,0,27,35,3,0,38,42,7,0,49
73344,416,"GRĂDINIŢA NR. 3 MOŢĂŢEI",MOŢĂŢEI,DJ,1600,7,1,0,8,14,2,0,16,35,4,0,39,65,5,0,70,84,6,0,90
73353,417,"GRĂDINIŢA NR. 2 DOBRIDOR",DOBRIDOR,DJ,642,8,3,0,11,13,6,0,19,16,6,0,22,24,8,0,32,25,8,0,33
73424,418,"ŞCOALA CU CLASELE I-VIII MURGAŞI",MURGAŞI,DJ,863,27,15,0,42,51,18,0,69,71,28,0,99,115,41,0,156,133,44,0,177
73380,419,"GRĂDINIŢA BALOTA DE JOS","BALOTA DE JOS",DJ,716,27,1,0,28,100,16,0,116,150,18,0,168,214,31,0,245,237,35,0,272
73451,420,"ŞCOALA CU CLASELE I-IV VELEŞTI",VELESTI,DJ,379,5,4,0,9,33,14,0,47,53,23,0,76,65,24,0,89,67,26,0,93
73479,421,"SCOALA GIMNAZIALA NEGOI",NEGOI,DJ,931,22,2,0,24,38,2,0,40,60,3,0,63,81,8,20,109,87,9,20,116
73479,422,"SCOALA GIMNAZIALA NEGOI",NEGOI,DJ,794,0,2,0,2,8,4,0,12,17,4,0,21,39,5,0,44,42,10,0,52
73512,423,"ŞCOALA GENERALĂ ORODEL",ORODEL,DJ,944,22,7,0,29,45,10,0,55,65,12,0,77,86,13,0,99,98,13,0,111
73549,424,"ŞCOALA GENERALĂCORNU",CORNU,DJ,431,8,5,0,13,24,9,0,33,29,12,0,41,33,14,0,47,35,14,0,49
73558,425,"ŞCOALA GENERALĂTEIU",TEIU,DJ,184,3,2,0,5,3,3,0,6,7,3,0,10,30,4,0,34,39,5,0,44
73530,426,"ŞCOALA GENERALĂ CĂLUGĂREI",CĂLUGĂREI,DJ,517,6,4,0,10,32,4,0,36,41,6,0,47,71,11,0,82,84,11,0,95
73576,427,"CĂMINUL CULTURAL OSTROVENI",OSTROVENI,DJ,1106,12,1,0,13,15,1,0,16,34,7,0,41,80,10,0,90,86,10,0,96
73576,428,"GRĂDINIŢA DE COPII ORĂŞANI",OSTROVENI,DJ,1128,11,2,0,13,24,6,0,30,55,8,0,63,89,15,0,104,96,15,0,111
73576,429,"GRĂDINIŢA DE COPII GRINDENI",OSTROVENI,DJ,564,4,2,0,6,16,4,0,20,23,9,0,32,53,17,0,70,59,22,0,81
73585,430,"ŞCOALA GIMNAZIALĂ LIŞTEAVA",LIŞTEAVA,DJ,1228,12,0,0,12,28,5,0,33,67,12,0,79,73,12,0,85,87,13,0,100
73601,431,"ŞCOALA PRIMARĂ(LOCAL VECHI)",PERIŞOR,DJ,1156,3,0,0,3,11,3,0,14,20,9,0,29,26,11,0,37,27,12,0,39
73610,432,"ŞCOALA PRIMARĂ CL. I-IV",MĂRĂCINELE,DJ,217,1,0,0,1,3,1,0,4,3,1,0,4,5,5,0,10,5,5,0,10
73638,433,"ŞCOALA GIMNAZIALĂPIELEŞTI",PIELEŞTI,DJ,1250,5,2,0,7,12,7,0,19,18,50,0,68,27,85,0,112,30,114,0,144
73638,434,"SEDIUL FOSTEI ŞCOLI GENERALE NR 2 PIELEŞTI",PIELEŞTI,DJ,1326,3,0,0,3,13,2,0,15,19,2,0,21,20,5,0,25,20,5,0,25
73647,435,"ŞCOALA GIMNAZIALĂ PIELEŞTI",CÎMPENI,DJ,626,5,3,0,8,10,4,0,14,16,4,0,20,20,4,0,24,21,4,0,25
73674,436,"CAMINUL CULTURAL PISCU VECHI","PISCU VECHI",DJ,952,25,7,0,32,112,11,0,123,151,11,0,162,192,17,0,209,275,17,0,292
73692,437,"SCOALA PISCULET",PISCULEŢ,DJ,246,6,3,0,9,20,4,0,24,61,5,0,66,80,6,0,86,87,6,0,93
73674,438,"SCOALA GIMNAZIALA PISCU VECHI","PISCU VECHI",DJ,980,60,0,0,60,121,1,0,122,161,9,0,170,242,13,0,255,289,15,0,304
73718,439,"LICEUL TEHNOLOGIC C.N. PLOPSOR",PLENIŢA,DJ,1042,13,2,0,15,26,7,0,33,45,7,8,60,56,8,8,72,65,8,8,81
73718,440,"SCOALA CU CALSELE I-VIII LOCAL B POIANA",PLENIŢA,DJ,955,11,0,0,11,40,1,0,41,62,1,0,63,82,1,0,83,88,2,0,90
73718,441,"GRADINITA ""ALBA CA ZAPADA""",PLENIŢA,DJ,1069,11,1,0,12,24,2,0,26,40,4,0,44,71,7,40,118,82,8,40,130
73727,442,"SCOALA CU CLASELEI-IV DIN SATUL CASTRELE TRAIANE","CASTRELE TRAIANE",DJ,654,8,0,0,8,14,0,0,14,24,0,0,24,43,4,0,47,43,4,0,47
73834,443,"SCOALA GIMNAZIALA PLEŞOI",PLEŞOI,DJ,1027,18,2,0,20,33,3,0,36,54,14,0,68,113,22,0,135,150,32,0,182
70147,444,"ŞCOALA GENERALĂ BRANIŞTE",BRANIŞTE,DJ,678,4,2,0,6,17,5,0,22,42,10,0,52,74,17,0,91,74,17,0,91
70138,445,"ŞCOALA GENERALĂ BALTA VERDE","BALTA VERDE",DJ,425,1,0,0,1,10,7,0,17,17,7,0,24,28,9,0,37,33,10,0,43
70129,446,"PRIMĂRIA PODARI",PODARI,DJ,1390,17,2,0,19,31,2,0,33,40,5,0,45,55,8,4,67,58,8,4,70
70129,447,"ŞCOALA GENERALĂ PODARI",PODARI,DJ,1942,5,0,0,5,16,0,0,16,24,0,0,24,34,0,0,34,37,0,0,37
70165,448,"ŞCOALA GENERALĂ LIVEZI",LIVEZI,DJ,753,6,2,0,8,10,3,0,13,15,4,0,19,19,8,0,27,26,8,0,34
70156,449,"ŞCOALA GENERALĂ GURA VĂII","GURA VĂII",DJ,372,9,4,0,13,11,10,0,21,18,10,0,28,24,13,0,37,28,13,0,41
73745,450,"ŞCOALA PRIMARĂ I-IV SÎRBI","POIANA MARE",DJ,1494,10,0,0,10,25,2,0,27,47,7,0,54,79,7,0,86,86,7,0,93
73745,451,"ŞCOALA GENERALĂ DRAGU","POIANA MARE",DJ,1583,14,4,0,18,41,5,0,46,57,5,0,62,78,7,0,85,83,7,0,90
73745,452,"ŞCOALA GENERALĂ 3 CENTRU","POIANA MARE",DJ,1389,10,3,0,13,20,5,0,25,21,8,0,29,30,9,0,39,63,10,138,211
73745,453,"LICEUL GEORGEST. MARINCU","POIANA MARE",DJ,1267,3,0,0,3,17,2,0,19,27,2,0,29,59,2,0,61,70,4,0,74
73745,454,"ŞCOALA GENERALĂ TRAISTARU","POIANA MARE",DJ,1673,7,0,0,7,38,6,0,44,43,8,0,51,63,10,1,74,74,10,1,85
73763,455,"ŞCOALA GENERALĂ TUNARII VECHI","TUNARII VECHI",DJ,1084,1,0,0,1,16,1,0,17,18,1,0,19,37,5,0,42,37,5,0,42
73754,456,"ŞCOALA GENERALĂ TUNARII NOI","TUNARII NOI",DJ,415,1,2,0,3,5,4,0,9,6,5,0,11,14,8,0,22,17,10,0,27
73781,457,"ŞC.GIMNAZIALĂ PREDEŞTI",PREDEŞTI,DJ,1669,8,18,0,26,23,34,0,57,62,37,0,99,103,48,0,151,111,52,0,163
73861,458,"ŞCOALA GIMNAZIALA RADOVAN",RADOVAN,DJ,814,3,2,0,5,10,3,0,13,19,4,0,23,59,6,0,65,63,9,0,72
73870,459,"CAMIN CULTURAL FÂNTÂNELE",FÎNTÎNELE,DJ,77,0,1,0,1,1,4,0,5,2,5,0,7,3,6,0,9,3,6,0,9
73898,460,"CAMIN CULTURAL TÂRNAVA",TÎRNAVA,DJ,149,1,2,0,3,4,4,0,8,9,6,0,15,18,8,0,26,18,8,0,26
73914,461,"CAMINUL CULTURAL",RAST,DJ,1678,8,2,0,10,36,10,0,46,67,13,0,80,93,18,0,111,122,22,0,144
73914,462,"SEDIUL NOU PRIMARIE",RAST,DJ,1186,7,0,0,7,13,2,0,15,40,3,0,43,60,6,0,66,66,6,0,72
73932,463,"CĂMIN CULTURAL","ROBĂNEŞTII DE JOS",DJ,505,2,3,0,5,13,4,0,17,22,9,0,31,32,10,0,42,37,14,0,51
73950,464,"ŞCOALA GOLFIN",GOLFIN,DJ,503,3,0,0,3,17,2,0,19,21,2,0,23,33,9,0,42,34,12,0,46
73969,465,"ŞCOALA LĂCRIŢA MARE","LĂCRIŢA MARE",DJ,476,6,1,0,7,13,2,0,15,20,5,0,25,32,7,0,39,40,8,0,48
73987,466,"ŞCOALA ROBĂNEŞTII DE SUS","ROBĂNEŞTII DE SUS",DJ,509,5,0,0,5,13,3,0,16,25,3,0,28,44,7,0,51,48,8,0,56
71242,467,"SCOALA GIMNAZIALA ROJISTE",ROJIŞTE,DJ,1456,18,1,0,19,61,8,0,69,175,45,0,220,310,70,0,380,353,74,0,427
71251,468,"ŞCOALA CUCLS.I-IV",TÂMBUREŞTI,DJ,525,12,2,0,14,30,2,0,32,57,4,0,61,94,11,0,105,99,12,0,111
74000,469,"SCOALA GIMNAZIALA STRUCTURA RAIETI",SADOVA,DJ,533,3,6,0,9,9,8,0,17,23,9,0,32,38,10,0,48,39,11,0,50
74000,470,"SCOALA GIMNAZIALA STRUCTURA RAIETI",SADOVA,DJ,1336,2,3,0,5,13,4,0,17,59,5,0,64,86,6,0,92,140,6,0,146
74000,471,"SCOALA GIMNAZIALA SADOVA LOCAL VALE",SADOVA,DJ,1214,7,2,0,9,7,2,0,9,16,2,0,18,29,2,0,31,29,3,0,32
74000,472,"SCOALA GIMNAZIALA SADOVA, LOCAL DEAL",SADOVA,DJ,1234,3,2,0,5,24,6,0,30,55,9,29,93,91,10,29,130,111,10,29,150
74000,473,"ŞCOALA GIMNAZIALĂ STRUCTURA DAMIAN",SADOVA,DJ,1374,5,2,0,7,13,3,0,16,18,4,0,22,71,6,0,77,73,6,0,79
74019,474,"ŞCOALA GIMNAZIALĂ SADOVA, STRUCTURA PISCU – SADOVEI LOCAL VECHI","PISCU SADOVEI",DJ,958,13,3,0,16,22,3,0,25,30,3,0,33,47,3,0,50,95,3,0,98
74037,475,"ŞCOALA VECHE SĂLCUŢA",SĂLCUŢA,DJ,877,2,1,0,3,3,3,0,6,7,3,0,10,57,5,0,62,57,5,0,62
74064,476,"ŞCOALA VECHE TENCĂNĂU",TENCĂNĂU,DJ,674,4,0,0,4,11,0,0,11,16,0,0,16,18,0,0,18,19,0,0,19
74082,477,"ŞCOALA GENERALĂ SCAEŞTI",SCĂEŞTI,DJ,894,13,1,0,14,33,1,0,34,52,12,0,64,80,18,0,98,86,21,0,107
74091,478,"ŞCOALA GENERALĂ VALEA LUI PĂTRU","VALEA LUI PĂTRU",DJ,758,5,1,0,6,22,5,0,27,30,7,0,37,45,10,0,55,50,12,0,62
74117,479,"ŞCOALA GIMNAZIALĂ CU CLASELE I-VIII DIN SEACA DE CÎMP","SEACA DE CÎMP",DJ,780,16,2,0,18,34,2,0,36,41,3,0,44,56,5,0,61,65,5,0,70
74126,480,"GRĂDINIȚA SEACA DE CÎMP, SATPISCU NOU","PISCU NOU",DJ,742,19,4,0,23,35,8,0,43,49,9,0,58,75,10,0,85,85,16,0,101
74144,481,"ŞCOALA SEACA DE PĂDURE","SEACA DE PĂDURE",DJ,322,18,8,0,26,40,9,0,49,65,25,0,90,95,31,0,126,103,32,0,135
74162,482,"ŞCOALA VELENI",VELENI,DJ,315,2,3,0,5,14,4,0,18,28,4,0,32,47,7,0,54,50,7,0,57
74153,483,"ŞCOALA RĂCHITA DE SUS","RĂCHITA DE SUS",DJ,141,1,4,0,5,7,4,0,11,15,5,0,20,26,6,0,32,27,7,0,34
74180,484,"ȘCOALA GEN.CLASELE I-IV SECU",SECU,DJ,648,2,3,0,5,5,5,0,10,21,7,0,28,38,11,0,49,46,16,0,62
74206,485,"ŞCOALA GENERALĂ CU CLS. I-IV SMADOVICIOARA","SMADOVICIOARA DE SECU",DJ,167,3,0,0,3,7,2,0,9,11,2,0,13,14,2,0,16,18,2,0,20
74233,486,"CĂMINUL CULTURAL","SILIŞTEA CRUCII",DJ,1241,9,1,0,10,17,3,0,20,22,4,0,26,34,4,0,38,37,4,0,41
74251,487,"SCOALA CU CLASELE I-IV SOPOT",SOPOT,DJ,393,7,9,0,16,16,18,0,34,32,28,0,60,57,35,0,92,68,37,0,105
74279,488,"SCOALA CU CLASELE I-VIII BELOŢ",BELOŢ,DJ,255,5,12,0,17,13,30,0,43,32,32,0,64,39,36,0,75,40,36,0,76
74313,489,"SCOALA SÎRSCA",SÎRSCA,DJ,141,3,4,0,7,7,7,0,14,9,11,0,20,12,13,0,25,12,13,0,25
74260,490,"SCOALA CU CLASELE I-IV BAŞCOV",BAŞCOV,DJ,293,2,4,0,6,6,7,0,13,10,7,0,17,19,11,0,30,29,13,0,42
74304,491,"SCOALA CU CLASELE I-IV PIETROAIA",PIETROAIA,DJ,344,0,0,0,0,7,1,0,8,9,1,0,10,11,2,0,13,12,2,0,14
70192,492,"GRADINITA ALBESTI",ALBEŞTI,DJ,843,7,1,0,8,21,5,0,26,27,7,0,34,40,9,0,49,43,9,0,52
70227,493,"SCOALA DUDOVICESTI",DUDOVICEŞTI,DJ,741,3,0,0,3,7,3,0,10,10,3,0,13,17,6,0,23,19,8,0,27
70245,494,"CAMIN CULTURAL FLORESTI",FLOREŞTI,DJ,594,0,2,0,2,4,4,0,8,8,5,0,13,16,8,0,24,18,8,0,26
70254,495,"SCOALA IZVOR",IZVOR,DJ,564,2,0,0,2,6,0,0,6,9,3,0,12,10,5,0,15,12,5,0,17
70272,496,"GRADINITA LESILE",LEŞILE,DJ,751,2,0,0,2,17,5,0,22,21,6,0,27,21,6,0,27,24,8,0,32
70281,497,"SCOALA MILESTI",MILEŞTI,DJ,684,0,2,0,2,1,3,0,4,11,5,0,16,21,7,0,28,21,9,0,30
72374,498,"SCOALA GIMNAZIALA TĂLPAȘ",TĂLPAŞ,DJ,1001,7,0,0,7,29,8,0,37,34,11,0,45,59,16,0,75,63,16,0,79
74331,499,"ŞCOALA GIMNAZIALĂ TEASC",TEASC,DJ,1358,1,0,0,1,5,0,0,5,9,2,0,11,21,2,0,23,26,4,0,30
74340,500,"ŞCOALA GIMNAZIALĂ SECUI",SECUI,DJ,1187,5,2,0,7,22,6,0,28,24,6,0,30,43,12,0,55,46,14,0,60
74368,501,"ŞCOALA GENERALĂ TERPEZIŢA",TERPEZIŢA,DJ,710,20,10,0,30,32,15,0,47,51,19,0,70,74,29,0,103,83,30,0,113
74386,502,"ŞCOALA CU CLASELE I-IV CĂCIULATU",CĂCIULATU,DJ,279,13,2,0,15,19,6,0,25,35,14,0,49,47,15,0,62,60,21,0,81
74402,503,"ŞCOALA CU CLASELE I-IV LAZU",LAZU,DJ,272,272,1,0,273,4,4,0,8,28,9,0,37,41,15,0,56,44,18,0,62
74420,504,"SCOALA GIMNAZIALA TESLUI",TESLUI,DJ,471,5,1,0,6,35,3,0,38,59,13,0,72,74,19,0,93,78,20,0,98
74466,505,"ȘCOALA GENERALĂ CLASELE V-VIII PREAJBA DE PĂDURE","PREAJBA DE PĂDURE",DJ,662,19,3,0,22,97,12,0,109,115,23,0,138,148,27,0,175,159,29,0,188
74475,506,"ȘCOALA CLASELE I-IV ȚĂRȚĂL",ŢĂRŢĂL,DJ,274,4,0,0,4,19,6,0,25,41,10,0,51,53,11,0,64,63,12,0,75
74484,507,"SCOALA VIISOARA MOSNENI",URIENI,DJ,430,7,2,0,9,9,6,0,15,34,9,0,43,78,10,0,88,81,10,0,91
74518,508,"ȘCOALA GIMNAZIALĂ ȚUGLUI",ŢUGLUI,DJ,1317,16,0,0,16,47,0,0,47,68,1,0,69,92,4,0,96,101,4,0,105
74518,509,"GRĂDINIȚA NR 2 ȚUGLUI",ŢUGLUI,DJ,883,12,1,0,13,40,4,0,44,60,5,0,65,66,5,0,71,71,6,0,77
74527,510,"DISPENSAR UMAN",JIUL,DJ,217,4,5,0,9,9,9,0,18,13,9,0,22,22,13,0,35,24,13,0,37
74545,511,"SCOALA DIN VALE NR.1",UNIREA,DJ,1652,8,18,0,26,20,30,0,50,28,40,0,68,60,59,0,119,82,62,0,144
74545,512,"SCOALA NR.2",UNIREA,DJ,1419,12,4,0,16,27,5,0,32,40,20,0,60,59,21,0,80,70,22,0,92
74563,513,"SCOALA CU CLS. I-VIII BARBU IONESCU URZICUTA",URZICUŢA,DJ,1870,7,4,0,11,21,10,0,31,39,14,0,53,67,14,0,81,70,15,0,85
74572,514,"CORP ADMINISTRATIV - PRIMARIE","URZICA MARE",DJ,391,4,2,0,6,6,4,0,10,8,8,0,16,15,11,0,26,19,13,0,32
74590,515,"SCOALA CU CLASELE I-VIII","VALEA STANCIULUI",DJ,1184,10,0,0,10,22,7,0,29,41,9,0,50,51,16,0,67,51,17,0,68
74607,516,"SCOALA CU CLASELE I-VIII","HOREZU POENARI",DJ,1351,1,0,0,1,4,0,0,4,27,2,0,29,60,4,0,64,72,4,0,76
74590,517,"GRADINITA TUGURESTI","VALEA STANCIULUI",DJ,536,7,2,0,9,17,4,0,21,34,9,0,43,42,10,0,52,43,10,0,53
74590,518,"CAMINUL CULTURAL BIRZA","VALEA STANCIULUI",DJ,679,10,1,0,11,24,5,0,29,41,6,0,47,53,7,0,60,54,11,0,65
74607,519,"SCOALA CU CLASELE I-IV","HOREZU POENARI",DJ,580,2,0,0,2,10,0,0,10,52,8,0,60,68,11,0,79,68,11,0,79
74625,520,"ŞCOALA CU CLASELE I-VIII VELA",VELA,DJ,346,4,0,0,4,8,2,0,10,22,10,0,32,61,25,0,86,76,29,0,105
74634,521,"ŞCOALA CU CLASELE I-IV BUCOVICIOR",BUCOVICIOR,DJ,323,1,0,0,1,6,1,0,7,9,1,0,10,18,2,0,20,19,2,0,21
74698,522,"ŞCOALA CU CLASELE I-IV STIUBEI",ŞTIUBEI,DJ,82,1,2,0,3,6,2,0,8,7,2,0,9,19,8,0,27,22,9,0,31
74661,523,"ŞCOALA CU CLASELE I-VIII GUBAUCEA",GUBAUCEA,DJ,502,6,2,0,8,13,4,0,17,20,4,0,24,42,6,10,58,44,7,10,61
74689,524,"ŞCOALA CU CLASELE I-IV SUHARU",SUHARU,DJ,218,3,2,0,5,4,3,0,7,16,6,0,22,28,9,6,43,41,12,6,59
74714,525,"ŞCOALA GIMNAZIALĂ",VERBIŢA,DJ,654,7,1,0,8,12,1,0,13,15,1,0,16,28,6,0,34,37,8,0,45
74723,526,"GRĂDINIŢA CU PROGRAM NORMAL",VERBICIOARA,DJ,387,8,3,0,11,16,5,0,21,24,7,0,31,45,9,0,54,56,9,0,65
74741,527,"ŞCOALA GIMNAZIALĂ VÎRTOP",VÎRTOP,DJ,1339,72,4,0,76,100,10,0,110,148,16,0,164,179,20,0,199,205,20,0,225
74830,528,"ŞCOALA CU CLASELE I-IV VÎRVOR",VÎRVOR,DJ,524,5,0,0,5,10,2,0,12,17,5,0,22,38,12,0,50,38,13,0,51
74769,529,"ŞCOALA CU CLASELE I-VIII VÎRVORU DE JOS","VÎRVORU DE JOS",DJ,967,14,36,0,50,22,42,0,64,32,43,0,75,42,44,0,86,46,45,0,91
74787,530,"SCOALA CU CLASELE I-IV CIUTURA",CIUTURA,DJ,594,9,1,0,10,17,7,0,24,31,13,0,44,37,22,0,59,37,22,0,59
77821,1,"UNIVERSITATEA „CONSTANTIN BRÂNCUȘI”","TÎRGU JIU",GJ,1398,19,0,0,19,45,4,0,49,51,7,0,58,68,8,0,76,72,9,0,81
77821,2,"COLEGIUL NAȚIONAL TUDOR VLADIMIRESCU","TÎRGU JIU",GJ,1144,19,3,0,22,49,3,0,52,60,6,0,66,72,6,0,78,75,6,0,81
77821,3,"COLEGIUL NAȚIONAL TUDOR VLADIMIRESCU","TÎRGU JIU",GJ,1154,3,2,0,5,24,2,0,26,38,2,0,40,49,3,0,52,58,6,0,64
77821,4,"ŞCOALA GIMNAZIALĂ CONSTANTIN SĂVOIU","TÎRGU JIU",GJ,1443,9,2,0,11,41,2,0,43,43,2,0,45,49,2,0,51,54,2,0,56
77821,5,"ŞCOALA GIMNAZIALĂ CONSTANTIN SĂVOIU","TÎRGU JIU",GJ,1197,8,3,0,11,24,3,0,27,35,3,0,38,45,3,0,48,49,3,0,52
77821,6,"COLEGIUL TEHNIC NR.2","TÎRGU JIU",GJ,1674,8,2,0,10,38,4,0,42,52,4,0,56,59,5,0,64,62,6,0,68
77885,7,"ȘCOALA PRIMARĂ DIN LOCALITATEA COMPONENTĂ ROMANEȘTI",ROMANEŞTI,GJ,736,4,3,0,7,9,3,0,12,10,3,0,13,19,3,0,22,19,3,0,22
77821,8,"ŞCOALA GIMNAZIALĂ ALEXANDRU ŞTEFULESCU","TÎRGU JIU",GJ,1215,9,1,0,10,40,1,0,41,69,3,0,72,88,10,0,98,97,12,0,109
77821,9,"UNIVERSITATEA CONSTANTIN BRÂNCUŞI","TÎRGU JIU",GJ,1759,6,0,0,6,23,0,0,23,40,0,0,40,61,2,0,63,64,2,0,66
77849,10,"ŞCOALA PRIMARĂ DIN LOCALITATEA COMPONENTĂ DRĂGOENI",DRĂGOENI,GJ,1482,12,2,0,14,20,2,0,22,40,4,0,44,42,4,0,46,46,5,0,51
77821,11,"COLEGIUL NAȚIONAL SPIRU HARET","TÎRGU JIU",GJ,1145,7,1,0,8,27,3,0,30,37,4,0,41,45,5,0,50,52,5,0,57
77821,12,"COLEGIUL NAŢIONAL SPIRU HARET","TÎRGU JIU",GJ,1082,10,1,0,11,18,3,0,21,27,5,0,32,34,6,0,40,43,7,0,50
77821,13,"COLEGIUL NAŢIONAL SPIRU HARET","TÎRGU JIU",GJ,1621,12,0,0,12,45,1,0,46,62,1,0,63,77,1,0,78,86,1,0,87
77821,14,"COLEGIUL NAŢIONAL SPIRU HARET","TÎRGU JIU",GJ,1504,7,1,0,8,22,1,0,23,27,1,0,28,35,1,0,36,37,1,0,38
77821,15,"COLEGIUL NAŢIONAL SPIRU HARET","TÎRGU JIU",GJ,1198,9,0,0,9,21,0,0,21,34,0,0,34,45,0,0,45,46,0,0,46
77821,16,"PALATUL COPIILOR","TÎRGU JIU",GJ,1101,11,4,0,15,38,4,0,42,53,4,0,57,63,6,0,69,71,7,0,78
77821,17,"LICEUL TEOLOGIC","TÎRGU JIU",GJ,1594,8,3,0,11,39,4,0,43,53,7,0,60,70,8,8,86,72,8,8,88
77821,18,"LICEUL TEOLOGIC","TÎRGU JIU",GJ,1498,11,1,0,12,39,1,0,40,44,1,0,45,59,1,0,60,63,1,0,64
77821,19,"LICEUL TEOLOGIC","TÎRGU JIU",GJ,1488,13,3,0,16,34,3,0,37,44,3,0,47,57,4,0,61,60,4,0,64
77821,20,"ŞCOALA GIMNAZIALĂ GHEORGHE TĂTĂRĂSCU","TÎRGU JIU",GJ,1610,8,0,0,8,25,0,0,25,44,0,0,44,54,1,0,55,55,1,0,56
77821,21,"ŞCOALA GIMNAZIALĂ GHEORGHE TĂTĂRĂSCU","TÎRGU JIU",GJ,1660,9,2,0,11,36,3,0,39,67,3,0,70,78,4,0,82,86,4,0,90
77821,22,"ŞCOALA GIMNAZIALĂ POMPILIU MARCEA","TÎRGU JIU",GJ,1722,10,1,0,11,35,2,0,37,46,7,0,53,56,7,0,63,65,7,0,72
77821,23,"ŞCOALA GIMNAZIALĂ POMPILIU MARCEA","TÎRGU JIU",GJ,1759,15,1,0,16,40,2,0,42,60,2,0,62,80,4,0,84,89,5,0,94
77821,24,"ŞCOALA GIMNAZIALĂ CONSTANTIN BRÂNCUŞI","TÎRGU JIU",GJ,1658,9,0,0,9,32,0,0,32,49,0,0,49,66,0,0,66,70,0,0,70
77821,25,"ŞCOALA GIMNAZIALĂ CONSTANTIN BRÂNCUŞI","TÎRGU JIU",GJ,1658,12,3,0,15,30,3,0,33,45,3,0,48,57,7,0,64,64,7,0,71
77821,26,"ŞCOALA GIMNAZIALĂ CONSTANTIN BRÂNCUŞI","TÎRGU JIU",GJ,1610,8,2,0,10,21,2,0,23,41,2,0,43,55,2,0,57,59,2,0,61
77821,27,"ŞCOALA GIMNAZIALĂ CONSTANTIN BRÂNCUŞI","TÎRGU JIU",GJ,1515,4,0,0,4,28,0,0,28,35,1,0,36,43,2,0,45,46,4,0,50
77821,28,"COLEGIUL NAȚIONAL ECATERINA TEODOROIU","TÎRGU JIU",GJ,1441,10,1,0,11,34,1,0,35,59,3,0,62,67,4,0,71,77,4,0,81
77821,29,"COLEGIUL NAŢIONAL ECATERINA TEODOROIU","TÎRGU JIU",GJ,1569,11,0,0,11,29,0,0,29,43,0,0,43,55,0,0,55,62,1,0,63
77821,30,"COLEGIUL NAŢIONAL ECATERINA TEODOROIU","TÎRGU JIU",GJ,1555,7,2,0,9,25,2,0,27,49,3,0,52,60,6,0,66,63,7,0,70
77821,31,"LICEUL CU PROGRAM SPORTIV","TÎRGU JIU",GJ,1163,15,3,0,18,27,3,0,30,40,3,0,43,51,6,0,57,58,6,0,64
77821,32,"LICEUL CU PROGRAM SPORTIV","TÎRGU JIU",GJ,978,15,1,0,16,21,1,0,22,26,3,0,29,35,4,0,39,42,4,0,46
77821,33,"COLEGIUL ECONOMIC VIRGIL MADGEARU","TÎRGU JIU",GJ,1975,17,0,0,17,53,0,0,53,67,0,0,67,86,0,0,86,96,0,0,96
77821,34,"COLEGIUL ECONOMIC VIRGIL MADGEARU","TÎRGU JIU",GJ,1769,15,0,0,15,42,2,0,44,61,8,0,69,80,11,0,91,84,11,0,95
77821,35,"LICEULDE ARTE CONSTANTIN BRĂILOIU","TÎRGU JIU",GJ,1178,11,4,0,15,35,6,0,41,57,10,0,67,73,11,0,84,81,11,0,92
77821,36,"LICEUL DE ARTECONSTANTIN BRĂILOIU","TÎRGU JIU",GJ,1716,20,1,0,21,42,2,0,44,57,2,0,59,80,2,0,82,88,2,0,90
77821,37,"LICEUL DE ARTE CONSTANTIN BRĂILOIU","TÎRGU JIU",GJ,1393,5,0,0,5,16,1,0,17,21,1,0,22,26,1,0,27,31,1,0,32
77821,38,"LICEUL DE ARTE CONSTANTIN BRĂILOIU","TÎRGU JIU",GJ,982,2,4,0,6,28,4,0,32,34,4,0,38,45,4,0,49,51,4,0,55
77821,39,"CASA DE CULTURĂ A SINDICATELOR","TÎRGU JIU",GJ,1169,8,2,0,10,14,4,0,18,15,5,3,23,45,5,3,53,52,5,3,60
77821,40,"ŞCOALA GIMNAZIALĂ SFÂNTU NICOLAE","TÎRGU JIU",GJ,1759,27,3,0,30,69,6,0,75,80,7,241,328,112,7,241,360,119,7,241,367
77821,41,"ŞCOALA GIMNAZIALĂ SFÂNTU NICOLAE","TÎRGU JIU",GJ,775,7,0,0,7,25,0,0,25,35,1,0,36,43,1,0,44,46,1,0,47
77821,42,"ŞCOALA GIMNAZIALĂ SFÂNTU NICOLAE","TÎRGU JIU",GJ,1300,9,1,0,10,35,3,0,38,49,3,0,52,59,3,0,62,66,3,0,69
77821,43,"ŞCOALA GENERALĂ ECATERINA TEODOROIU","TÎRGU JIU",GJ,1535,15,1,0,16,40,2,0,42,53,6,0,59,65,7,0,72,69,8,0,77
77821,44,"COLEGIUL TEHNIC ION MINCU","TÎRGU JIU",GJ,1769,11,2,0,13,29,2,0,31,52,3,0,55,62,3,0,65,69,3,0,72
77821,45,"COLEGIUL TEHNIC ION MINCU","TÎRGU JIU",GJ,847,3,0,0,3,12,0,0,12,17,5,0,22,22,5,0,27,22,5,0,27
77821,46,"COLEGIUL TEHNIC GENERAL GHEORGHE MAGHERU","TÎRGU JIU",GJ,1714,12,5,0,17,24,7,0,31,36,8,0,44,41,8,0,49,45,8,0,53
77821,47,"COLEGIUL TEHNIC GENERAL GHEORGHE MAGHERU","TÎRGU JIU",GJ,1842,2,3,0,5,7,3,0,10,17,3,0,20,25,3,0,28,30,3,0,33
77821,48,"ŞCOALA GIMNAZIALĂ NR.7","TÎRGU JIU",GJ,1724,14,12,0,26,35,15,0,50,46,22,0,68,54,22,0,76,58,22,0,80
77821,49,"ŞCOALA GIMNAZIALĂ NR.7","TÎRGU JIU",GJ,1639,6,0,0,6,19,1,0,20,26,1,0,27,44,6,0,50,46,7,0,53
77821,50,"ŞCOALA GIMNAZIALĂ VOIEVOD LITOVOI","TÎRGU JIU",GJ,1944,12,3,0,15,37,3,0,40,54,4,0,58,67,4,0,71,78,5,0,83
77821,51,"ŞCOALA GIMNAZIALĂ VOIEVOD LITOVOI","TÎRGU JIU",GJ,1880,9,0,0,9,28,2,0,30,35,2,0,37,66,8,0,74,89,8,0,97
77821,52,"ŞCOALA GIMNAZIALĂ VOIEVOD LITOVOI","TÎRGU JIU",GJ,1839,3,0,0,3,12,3,0,15,16,3,0,19,27,3,0,30,44,4,0,48
77830,53,"ŞCOALA GIMNAZIALĂ NR.9",BÎRSEŞTI,GJ,1512,6,0,0,6,19,0,0,19,33,0,0,33,51,1,0,52,61,1,0,62
77858,54,"IMOBIL NR.42",IEZURENI,GJ,745,10,1,0,11,13,1,0,14,20,1,0,21,24,2,0,26,28,2,0,30
77901,55,"ŞCOALA PRIMARĂ ŞI GRĂDINIŢA DE COPII URSAŢI",URSAŢI,GJ,596,0,2,0,2,2,4,0,6,7,4,0,11,9,4,0,13,11,4,0,15
77821,56,"COLEGIUL TEHNIC HENRI COANDĂ","TÎRGU JIU",GJ,827,5,0,0,5,15,0,0,15,26,0,0,26,28,0,0,28,33,0,0,33
78150,57,"ŞCOALA GIMNAZIALĂ NR.2 MOTRU",MOTRU,GJ,1494,25,0,0,25,49,3,0,52,76,4,0,80,101,4,0,105,107,4,0,111
78150,58,"COLEGIUL TEHNIC MOTRU",MOTRU,GJ,1039,6,1,0,7,20,1,0,21,32,2,0,34,42,2,0,44,47,2,0,49
78150,59,"CASA DE CULTURĂMOTRU",MOTRU,GJ,1766,12,1,0,13,32,2,0,34,41,4,0,45,58,4,0,62,57,6,0,63
78150,60,"COLEGIUL NAŢIONAL GEORGE COŞBUC MOTRU",MOTRU,GJ,1526,11,0,0,11,38,2,0,40,53,2,0,55,64,4,0,68,68,5,0,73
78150,61,"ŞCOALA GIMNAZIALĂ NR.1 MOTRU",MOTRU,GJ,1637,9,0,0,9,28,2,0,30,51,5,0,56,58,9,0,67,60,10,0,70
78150,62,"GRĂDINIŢA ""VILE"" MOTRU",MOTRU,GJ,1171,7,1,0,8,22,4,1,27,28,4,1,33,42,6,1,49,47,9,1,57
78150,63,"GRĂDINIŢA CATOLICĂ MOTRU",MOTRU,GJ,1748,11,0,0,11,37,0,0,37,53,0,0,53,68,4,0,72,75,9,0,84
78150,64,"GRĂDINIŢA CREŞĂ NR.1 MOTRU",MOTRU,GJ,1824,19,2,0,21,66,2,0,68,86,2,0,88,95,2,0,97,104,2,0,106
78150,65,"SEDIULIMPOZITE ŞI TAXE LOCALEMOTRU",MOTRU,GJ,1745,10,4,0,14,30,7,0,37,47,12,0,59,65,21,0,86,70,21,0,91
78150,66,"CASA MULTICULTURALĂ MOTRU",MOTRU,GJ,1701,9,0,0,9,34,0,0,34,49,1,0,50,60,1,0,61,67,1,0,68
78196,67,"ŞCOALA LEURDA",LEURDA,GJ,665,4,3,0,7,12,3,0,15,15,4,0,19,20,4,0,24,20,4,0,24
78178,68,"ŞCOALA HORĂŞTI",HORĂŞTI,GJ,419,4,2,0,6,6,2,0,8,10,2,0,12,11,2,0,13,11,2,0,13
78203,69,"ŞCOALA PRIMARĂ PLOŞTINA",PLOŞTINA,GJ,1086,6,0,0,6,12,0,0,12,20,0,0,20,34,4,0,38,38,5,0,43
78221,70,"ŞCOALA PRIMARĂ ROŞIUŢA",ROŞIUŢA,GJ,495,8,2,0,10,9,2,0,11,14,2,0,16,20,2,0,22,23,2,0,25
78230,71,"ŞCOALA RÂPA",RÎPA,GJ,284,3,0,0,3,4,2,0,6,4,2,0,6,13,3,0,16,13,3,0,16
79317,72,"SALA DE SPORT A ORAȘULUI",BUMBEŞTI-JIU,GJ,1090,7,4,0,11,19,4,0,23,21,4,0,25,27,4,0,31,29,11,0,40
79317,73,"GRĂDINIȚA BUMBEȘTI-JIU",BUMBEŞTI-JIU,GJ,1143,15,5,0,20,26,5,0,31,47,12,0,59,61,16,0,77,63,16,0,79
79317,74,"ȘCOALA GIMNAZIALĂ NR.1 BUMBEȘTI-JIU",BUMBEŞTI-JIU,GJ,1561,15,0,0,15,35,1,0,36,41,3,0,44,66,6,0,72,68,6,0,74
79317,75,"ȘCOALA GIMNAZIALĂ NR.1 BUMBEȘTI-JIU",BUMBEŞTI-JIU,GJ,973,11,4,0,15,27,4,0,31,38,4,0,42,54,4,0,58,55,7,0,62
79317,76,"COLEGIUL MIHAI VITEAZUL BUMBEȘTI-JIU",BUMBEŞTI-JIU,GJ,985,3,0,0,3,4,0,0,4,5,0,0,5,16,0,0,16,18,0,0,18
79317,77,"ȘCOALA PRIMARĂ BUMBEȘTI-JIU",BUMBEŞTI-JIU,GJ,911,1,0,0,1,8,0,0,8,15,3,0,18,17,4,0,21,20,6,0,26
79353,78,"ȘCOALA PRIMARĂ TETILA",TETILA,GJ,1112,3,1,0,4,9,1,0,10,9,2,0,11,18,3,0,21,21,4,0,25
79326,79,"ȘCOALA GIMNAZIALĂ CURTIȘOARA",CURTIŞOARA,GJ,595,0,0,0,0,1,0,0,1,6,0,0,6,10,0,0,10,13,0,0,13
78267,80,"ŞCOALA GIMNAZIALĂNOVACI",NOVACI,GJ,1670,2,3,0,5,10,7,0,17,16,9,0,25,19,12,0,31,39,13,0,52
78267,81,"CLUBUL ELEVILOR",NOVACI,GJ,1121,3,0,0,3,9,0,0,9,13,0,0,13,18,0,0,18,18,0,0,18
78294,82,"ŞCOALA GIMNAZIALĂ POCIOVALIŞTEA",POCIOVALIŞTEA,GJ,1459,4,0,0,4,15,1,0,16,17,5,0,22,24,10,0,34,26,10,0,36
78276,83,"GRĂDINIŢA BERCEŞTI",BERCEŞTI,GJ,554,3,0,0,3,10,4,0,14,15,4,0,19,22,4,0,26,23,4,0,27
79059,84,"ŞCOALA GIMNAZIALĂ NR. 1 ROVINARI",ROVINARI,GJ,1407,5,0,0,5,15,2,0,17,28,2,0,30,34,2,0,36,36,2,0,38
79059,85,"ŞCOALA GIMNAZIALĂ NR. 1 ROVINARI",ROVINARI,GJ,1361,4,5,0,9,10,7,0,17,22,10,0,32,27,10,0,37,29,10,0,39
79059,86,"ŞCOALA GIMNAZIALĂ NR. 3 ROVINARI",ROVINARI,GJ,1257,3,2,0,5,17,2,0,19,26,2,0,28,30,5,0,35,33,5,0,38
79059,87,"ŞCOALA GIMNAZIALĂ NR. 3 ROVINARI",ROVINARI,GJ,1246,5,0,0,5,20,0,0,20,27,0,0,27,32,0,0,32,33,0,0,33
79059,88,"COLEGIUL ""GHEORGHE TĂTĂRESCU"" ROVINARI",ROVINARI,GJ,1262,4,2,0,6,19,2,0,21,26,2,0,28,35,2,0,37,38,3,0,41
79059,89,"COLEGIUL ""GHEORGHE TĂTĂRESCU"" ROVINARI",ROVINARI,GJ,1156,9,2,0,11,19,2,0,21,27,4,0,31,34,4,0,38,35,7,0,42
79059,90,"GRĂDINIŢA NR. 3 ROVINARI",ROVINARI,GJ,1302,4,0,0,4,12,0,0,12,34,0,0,34,42,0,0,42,50,0,0,50
79059,91,"GRĂDINIȚA NR. 3 ROVINARI",ROVINARI,GJ,1304,2,0,0,2,11,0,0,11,28,1,0,29,38,2,0,40,42,2,0,44
82902,92,"GRĂDINIȚA CARTIER VÎRȚ",VÎRT,GJ,564,3,4,0,7,5,7,0,12,11,8,0,19,12,8,0,20,12,8,0,20
82449,93,"GRADINITA CU PROGRAM NORMAL TISMANA",TISMANA,GJ,903,1,0,0,1,5,2,0,7,18,4,0,22,24,4,0,28,29,10,0,39
82449,94,"GRADINITA CU PROGRAM NORMAL TISMANA",TISMANA,GJ,895,2,2,0,4,4,4,0,8,39,13,0,52,42,15,0,57,44,17,0,61
82458,95,"SCOALA GENERALA CELEI",CELEI,GJ,757,8,1,0,9,8,2,0,10,10,2,0,12,11,4,0,15,13,4,0,17
82528,96,"SCOALA GENERALA TOPESTI",TOPEŞTI,GJ,862,4,2,0,6,10,2,0,12,13,3,0,16,16,3,0,19,20,3,0,23
82494,97,"SCOALA GENERALA POCRUIA",POCRUIA,GJ,877,8,0,0,8,17,0,0,17,20,3,0,23,27,3,0,30,28,3,0,31
82519,98,"SCOALA GENERALA SOHODOL",SOHODOL,GJ,752,3,2,0,5,4,2,0,6,7,2,0,9,9,2,0,11,10,3,0,13
82467,99,"SCOALA GENERALA COSTENI",COSTENI,GJ,907,3,1,0,4,10,4,0,14,18,4,0,22,30,6,0,36,32,6,0,38
78338,100,"ŞCOALA GIMNAZIALĂ GEORGE USCĂTESCU","TÎRGU CĂRBUNEŞTI",GJ,1364,5,2,0,7,18,10,0,28,26,12,0,38,39,14,0,53,46,14,0,60
78338,101,"ȘCOALA GIMNAZIALĂGEORGE USCĂTESCU","TÎRGU CĂRBUNEŞTI",GJ,1365,9,2,0,11,18,3,0,21,28,3,0,31,37,4,0,41,45,4,0,49
78338,102,"COLEGIU NAŢIONAL TUDOR ARGHEZI","TÎRGU CĂRBUNEŞTI",GJ,1452,9,1,0,10,36,6,0,42,45,6,0,51,60,7,0,67,70,9,45,124
78374,103,"ŞCOALA GIMNAZIALĂ CREŢEŞTI",CREŢEŞTI,GJ,744,5,2,0,7,9,2,0,11,12,2,0,14,15,3,0,18,16,3,0,19
78418,104,"ŞCOALA GIMNAZIALĂ POJOGENI",POJOGENI,GJ,593,3,0,0,3,3,0,0,3,5,0,0,5,11,0,0,11,13,0,0,13
78436,105,"ŞCOALA PRIMARĂ ŞTEFĂNEŞTI",ŞTEFĂNEŞTI,GJ,438,1,0,0,1,5,4,0,9,12,4,0,16,19,5,0,24,21,5,0,26
78356,106,"CĂMIN CULTURAL",CĂRBUNEŞTI-SAT,GJ,558,5,2,0,7,12,2,0,14,15,2,0,17,21,2,0,23,26,5,0,31
78418,107,"ŞCOALA PRIMARĂ POJOGENI CERĂT",POJOGENI,GJ,257,1,0,0,1,2,3,0,5,9,7,0,16,24,8,0,32,24,8,0,32
78365,108,"ŞCOALA PRIMARĂ COJANI",COJANI,GJ,327,0,0,0,0,1,0,0,1,7,0,0,7,8,1,0,9,8,1,0,9
82626,109,"CASA DE CULTURĂ TURCENI",TURCENI,GJ,926,8,0,0,8,23,0,0,23,27,0,0,27,27,2,0,29,31,3,0,34
82626,110,"CASA DE CULTURĂ TURCENI",TURCENI,GJ,1949,10,3,0,13,33,4,19,56,43,6,19,68,58,6,19,83,63,6,19,88
82626,111,"POLIȚIA LOCALĂ TURCENI",TURCENI,GJ,614,3,0,0,3,8,0,0,8,9,0,0,9,12,0,0,12,13,0,0,13
82626,112,"ȘCOALA GENERALĂ STOLOJANI",TURCENI,GJ,571,0,0,0,0,3,0,0,3,11,1,0,12,16,1,0,17,16,1,0,17
82653,113,"ȘCOALA GENERALĂ MURGEȘTI",MURGEŞTI,GJ,629,7,0,0,7,7,1,0,8,11,1,0,12,18,1,0,19,19,1,0,20
82635,114,"ȘCOALA GENERALĂ GÂRBOVU",GÂRBOVU,GJ,747,3,2,0,5,5,2,0,7,7,2,0,9,15,3,0,18,17,3,0,20
82662,115,"ȘCOALA GENERALĂ STRÂMBA JIU","STRÂMBA JIU",GJ,1262,4,1,0,5,29,2,0,31,39,2,0,41,54,5,1,60,59,7,1,67
78463,116,"GRĂDINIȚA NR. 2 TUNȘI",ŢICLENI,GJ,820,11,0,0,11,15,0,0,15,15,0,0,15,28,0,0,28,33,0,0,33
78463,117,"ȘCOALA GIMNAZIALĂ NR. 1 ȚICLENI",ŢICLENI,GJ,1066,4,1,0,5,15,3,0,18,26,4,0,30,62,4,0,66,62,4,0,66
78463,118,"ȘCOALA GIMNAZIALĂ NR. 1 ȚICLENI",ŢICLENI,GJ,924,6,0,0,6,12,0,0,12,21,0,0,21,30,0,0,30,30,0,0,30
78463,119,"GRĂDINIȚA NR. 3 RĂȘINA",ŢICLENI,GJ,1152,9,0,0,9,15,0,0,15,17,1,0,18,20,1,0,21,21,5,0,26
78481,120,"ȘCOALA GIMNAZIALĂ ALBENI",ALBENI,GJ,1066,4,1,0,5,17,1,0,18,28,2,0,30,40,2,0,42,47,2,0,49
78481,121,"ȘCOALA PRIMARÂ ALBENI",ALBENI,GJ,717,6,4,0,10,11,4,0,15,22,4,0,26,41,4,0,45,46,4,0,50
78506,122,"ȘCOALA PRIMARÂ BOLBOCEȘTI",BOLBOCEŞTI,GJ,436,4,1,0,5,9,1,0,10,14,1,0,15,16,1,0,17,16,1,0,17
78533,123,"ȘCOALA PRIMARÂ PRUNEȘTI",PRUNEŞTI,GJ,120,0,0,0,0,1,0,0,1,1,0,0,1,2,0,0,2,4,0,0,4
78551,124,"ŞCOALAGENERALĂ ""ION LOTREANU "" ALIMPEŞTI, SAT. ALIMPEŞTI,",ALIMPEŞTI,GJ,845,5,1,0,6,12,2,0,14,14,2,0,16,20,2,0,22,20,2,0,22
78551,125,"ŞCOALAGENERALĂSÎRBEŞTI , SAT.SÎRBEŞTI",ALIMPEŞTI,GJ,652,5,2,0,7,9,7,0,16,11,8,0,19,14,11,0,25,15,12,0,27
78613,126,"ŞCOALA GIMNAZIALĂ ANINOASA",ANINOASA,GJ,1115,0,1,0,1,13,3,0,16,19,3,0,22,22,3,0,25,22,3,0,25
78640,127,"ŞCOALA GIMNAZIALĂ GROȘEREA",GROŞEREA,GJ,467,1,2,0,3,3,2,0,5,9,4,0,13,13,5,0,18,13,5,0,18
78631,128,"ŞCOALA PRIMARĂ COSTEȘTI",COSTEŞTI,GJ,808,0,0,0,0,3,4,0,7,10,6,0,16,10,7,0,17,11,7,0,18
78659,129,"ŞCOALA PRIMARĂ NR.2 STERPOAIA",STERPOAIA,GJ,701,4,1,0,5,4,2,0,6,8,4,0,12,9,4,0,13,9,5,0,14
78677,130,"ŞCOALA GIMNAZIALĂ ARCANI",ARCANI,GJ,1120,7,4,0,11,25,14,0,39,36,16,0,52,46,19,0,65,47,20,0,67
78720,131,"ŞCOALA GENERALĂ BAIA DE FIER","BAIA DE FIER",GJ,1387,1,0,0,1,11,2,0,13,21,2,0,23,28,3,0,31,29,3,0,32
78720,132,"ŞCOALA GENERALĂBAIA DE FIER","BAIA DE FIER",GJ,1457,10,1,0,11,19,2,0,21,23,4,0,27,39,5,0,44,42,6,0,48
78739,133,"ŞCOALA GENERALĂ CERNĂDIA",CERNĂDIA,GJ,679,9,1,0,10,23,3,0,26,39,6,0,45,43,7,0,50,44,7,0,51
78766,134,"ȘCOALA PRIMARĂ BĂLANEȘTI",BĂLĂNEŞTI,GJ,655,7,0,0,7,12,4,0,16,16,13,0,29,21,18,0,39,22,20,0,42
78757,135,PRIMĂRIE,"VOITEŞTII DE VALE",GJ,522,3,2,0,5,4,9,0,13,8,11,0,19,17,19,0,36,22,19,0,41
78793,136,"ȘCOALA PRIMARĂ GLODENI",GLODENI,GJ,654,5,0,0,5,23,4,0,27,29,4,0,33,41,12,0,53,51,12,0,63
77947,137,"ŞCOALA PRIMARĂ CORNEŞTI",CORNEŞTI,GJ,692,4,0,0,4,8,0,0,8,15,0,0,15,15,0,0,15,18,5,0,23
77965,138,"ŞCOALA PRIMARĂ RASOVA",RASOVA,GJ,417,7,0,0,7,13,1,0,14,16,5,0,21,19,5,0,24,19,5,0,24
77974,139,"ŞCOALA PRIMARĂ STOLOJANI",STOLOJANI,GJ,568,6,3,0,9,9,3,0,12,17,3,0,20,23,7,0,30,24,8,0,32
77983,140,"ŞCOALA PRIMARĂ TĂLPĂŞEŞTI",TĂLPĂŞEŞTI,GJ,474,2,0,0,2,4,3,0,7,6,4,0,10,11,6,0,17,12,6,0,18
77992,141,"ŞCOALA PRIMARĂ TĂMĂŞEŞTI",TĂMĂŞEŞTI,GJ,546,4,3,0,7,6,4,0,10,10,4,0,14,16,5,0,21,19,5,0,24
77929,142,"CĂMIN CULTURAL BĂLEŞTI",BĂLEŞTI,GJ,1724,13,1,0,14,26,1,0,27,37,5,0,42,39,6,0,45,47,6,0,53
77938,143,"ŞCOALA GIMNAZIALĂ ""ANTONIE MOGOŞ""",CEAURU,GJ,1953,6,2,0,8,31,6,0,37,45,6,0,51,51,6,0,57,54,6,0,60
78837,144,"ŞCOALA GIMNAZIALĂ BĂRBĂTEŞTI",BĂRBĂTEŞTI,GJ,723,6,2,0,8,16,2,0,18,24,3,0,27,30,3,0,33,39,3,0,42
78855,145,"ŞCOALA PRIMARĂ PETREŞTI",PETREŞTI,GJ,665,1,0,0,1,8,2,0,10,15,4,0,19,23,9,0,32,28,9,0,37
78882,146,"CĂMIN CULTURAL BENGEŞTI",BENGEŞTI,GJ,961,3,0,0,3,6,1,0,7,12,1,0,13,14,1,0,15,14,1,0,15
78882,147,"CĂMIN CULTURAL BENGEŞTI",BENGEŞTI,GJ,285,0,0,0,0,3,0,0,3,3,0,0,3,4,0,0,4,6,0,0,6
78891,148,"CĂMIN CULTURAL BĂLCEŞTI",BĂLCEŞTI,GJ,615,4,2,0,6,9,5,0,14,14,8,0,22,23,13,0,36,24,13,0,37
78917,149,"CĂMIN CULTURAL CIOCADIA",CIOCADIA,GJ,795,5,7,0,12,12,7,0,19,16,7,0,23,24,7,0,31,24,7,0,31
78935,150,"ŞCOALA PRIMARĂBERLEŞTI",BERLEŞTI,GJ,699,2,0,0,2,3,0,0,3,12,3,0,15,14,6,0,20,14,6,0,20
78971,151,"CĂMINUL CULTURAL PÎRÎU VIU","PÎRÎU VIU",GJ,996,1,0,0,1,2,0,0,2,6,1,0,7,9,3,0,12,11,3,0,14
79013,152,"ȘCOALA PRIMARĂ DINKĂ SKELERU",BÎLTENI,GJ,1668,16,1,0,17,45,5,0,50,60,5,0,65,73,6,0,79,74,6,0,80
79040,153,"ŞCOALA PRIMARĂ NR.2 PEŞTEANA-JIU","PEŞTEANA JIU",GJ,1765,32,1,0,33,64,3,0,67,85,4,0,89,85,4,0,89,106,6,0,112
79031,154,"ŞCOALA GENERALĂ MOI",MOI,GJ,843,8,1,0,9,18,1,0,19,23,6,0,29,37,8,0,45,42,8,0,50
79022,155,"ŞCOALA PRIMARĂ COCORENI",COCORENI,GJ,1081,1,0,0,1,7,0,0,7,13,2,0,15,17,2,0,19,21,3,0,24
79068,156,"ȘCOALA PRIMARĂ VLĂDULENI",VLĂDULENI,GJ,878,5,4,0,9,16,7,0,23,43,7,0,50,51,9,0,60,58,9,0,67
79086,157,"ŞCOALA PRIMARĂ BOLBOŞI",BOLBOŞI,GJ,912,11,0,0,11,14,1,0,15,24,1,0,25,33,1,0,34,36,1,0,37
79095,158,"ŞCOALA PRIMARĂ BĂLĂCEŞTI",BĂLĂCEŞTI,GJ,541,2,0,0,2,5,0,0,5,11,1,0,12,15,2,0,17,17,2,0,19
79148,159,"ŞCOALA GENERALĂ VALEA",VALEA,GJ,1130,1,0,0,1,4,0,0,4,9,3,0,12,10,3,0,13,12,3,0,15
79166,160,"ŞCOALA GENERALĂ CU CLASELE I-IV BORĂSCU",BORĂSCU,GJ,942,12,2,0,14,14,2,0,16,14,2,0,16,24,2,0,26,32,2,0,34
79200,161,"ŞCOALA GENERALĂ CU CLASELE I-IV MENŢII DIN DOS","MENŢII DIN DOS",GJ,585,2,1,0,3,3,2,0,5,5,2,0,7,12,4,0,16,12,4,0,16
79219,162,"ŞCOALA GIMNAZIALÂ MILUTA",MILUTA,GJ,508,2,5,0,7,4,6,0,10,6,6,0,12,17,6,0,23,18,6,0,24
79184,163,"ŞCOALA GENERALĂ CALAPĂRU",CALAPĂRU,GJ,655,19,0,0,19,26,1,0,27,48,1,0,49,69,1,0,70,77,4,0,81
79273,164,"ȘCOALA GIMNAZIALĂ CAPU-DEALULUI","CAPU DEALULUI",GJ,660,4,4,0,8,30,8,0,38,40,10,0,50,40,11,0,51,41,11,0,52
79246,165,"ȘCOALA PRIMARĂ BRĂNEȘTI",BRĂNEŞTI,GJ,573,5,0,0,5,6,1,0,7,8,1,0,9,8,2,0,10,10,2,0,12
79291,166,"ȘCOALAPRIMARĂ GILORTU",PÎRÎU,GJ,485,1,0,0,1,2,1,0,3,3,1,0,4,5,1,0,6,5,1,0,6
79255,167,"ȘCOALAPRIMARĂ BĂDEȘTI",BĂDEŞTI,GJ,175,2,0,0,2,3,0,0,3,5,0,0,5,5,0,0,5,5,0,0,5
79371,168,"CĂMINUL CULTURAL BUMBEŞTI-PIŢIC",BUMBEŞTI-PIŢIC,GJ,1041,5,0,0,5,7,1,0,8,10,1,0,11,13,4,0,17,15,6,0,21
79380,169,"GRĂDINIŢA CÂRLIGEI",CÎRLIGEI,GJ,177,0,0,0,0,1,0,0,1,1,0,0,1,2,0,0,2,2,0,0,2
79399,170,"ŞCOALA GENERALĂ POIENARI",POIENARI,GJ,585,1,0,0,1,10,3,0,13,10,3,0,13,12,3,0,15,12,3,0,15
79415,171,"LICEUL TEHNOLOGIC BUSTUCHIN",BUSTUCHIN,GJ,915,4,4,0,8,9,4,0,13,16,4,0,20,18,6,0,24,24,6,0,30
79460,172,"ŞCOALA GENERALĂ POIANA-SECIURI","POIANA SECIURI",GJ,735,0,0,0,0,0,0,0,0,5,0,0,5,15,0,0,15,20,2,0,22
79488,173,"ŞCOALA PRIMARĂ VALEA POJARULUI","VALEA POJARULUI",GJ,336,4,1,0,5,4,1,0,5,7,1,0,8,7,1,0,8,11,1,0,12
79451,174,"ŞCOALA PRIMARĂ POIENIŢA",POIENIŢA,GJ,308,4,4,0,8,12,5,0,17,17,5,0,22,21,5,0,26,24,6,0,30
79479,175,"ŞCOALA PRIMARĂ POJARU",POJARU,GJ,402,3,6,0,9,3,6,0,9,6,7,0,13,7,10,0,17,13,10,0,23
79503,176,"ŞCOALA GENERALĂ CĂPRENI",CĂPRENI,GJ,803,7,2,0,9,8,2,0,10,11,2,0,13,16,2,0,18,18,2,0,20
79576,177,"ŞCOALA PRIMARĂ CĂPRENI DE SUS","SATU NOU",GJ,538,2,3,0,5,7,4,0,11,10,4,0,14,10,4,0,14,10,4,0,14
79530,178,"ŞCOALA PRIMARĂ BULBUCENI",BULBUCENI,GJ,375,1,0,0,1,3,4,0,7,17,6,0,23,20,6,0,26,22,6,0,28
79647,179,"GRĂDINIȚA VALEA PERILOR","VALEA PERILOR",GJ,580,5,2,0,7,10,2,0,12,16,2,0,18,25,5,0,30,29,9,0,38
79638,180,"ȘCOALA GIMNAZIALA""MAZILU VIPIE GHEORGHE""","VALEA MÎNĂSTIRII",GJ,364,0,0,0,0,7,0,0,7,8,0,0,8,11,0,0,11,11,0,0,11
79610,181,"CĂMINUL CULTURAL LUPOAIA",LUPOAIA,GJ,770,4,0,0,4,11,6,0,17,15,6,0,21,17,7,0,24,17,7,0,24
79601,182,"ȘCOALA PRIMARĂ DEALU VIILOR","DEALU VIILOR",GJ,494,1,0,0,1,3,0,0,3,7,2,0,9,7,2,0,9,9,2,0,11
79665,183,"ŞCOALA GENERALĂ CIUPERCENI",CIUPERCENI,GJ,420,4,3,0,7,8,4,0,12,12,5,0,17,13,7,0,20,15,7,0,22
79709,184,"ŞCOALA PRIMARĂ STRÎMBA VULCAN","STRÎMBA VULCAN",GJ,291,2,3,0,5,8,3,0,11,8,3,0,11,8,3,0,11,8,3,0,11
79718,185,"ŞCOALA PRIMARĂ VÎRTOPU",VÎRTOPU,GJ,321,5,0,0,5,5,2,0,7,7,2,0,9,8,2,0,10,8,4,0,12
79683,186,"ŞCOALA PRIMARĂ PEŞTEANA VULCAN","PEŞTEANA VULCAN",GJ,257,3,0,0,3,5,0,0,5,5,1,0,6,11,8,0,19,14,9,0,23
79745,187,"CĂMINUL CULTURAL CÎLNIC",CÎLNIC,GJ,659,4,2,0,6,10,2,0,12,14,6,0,20,20,8,0,28,22,9,0,31
79754,188,"ŞCOALA PRIMARĂ CÎLNICU DE SUS","CÎLNICU DE SUS",GJ,652,3,1,0,4,16,3,0,19,21,4,0,25,27,4,0,31,27,4,0,31
79781,189,"ŞCOALA PRIMARĂ HODOREASCA",HODOREASCA,GJ,330,2,0,0,2,9,3,0,12,13,3,0,16,22,5,0,27,22,5,0,27
79807,190,"ŞCOALA PRIMARĂ PINOASA",PINOASA,GJ,196,1,0,0,1,15,3,0,18,19,3,0,22,20,5,0,25,20,5,0,25
79889,191,"CĂMINUL CULTURAL CĂRPINIŞ",CĂRPINIŞ,GJ,1594,9,2,0,11,21,6,0,27,40,8,0,48,69,10,0,79,77,10,0,87
79905,192,"ŞCOALA PRIMARĂ DRĂGOIEŞTI",DRĂGOIEŞTI,GJ,1040,8,2,0,10,12,4,0,16,23,14,0,37,26,21,0,47,28,29,0,57
79914,193,"CĂMINUL CULTURAL DUMBRĂVENI",DUMBRĂVENI,GJ,733,8,1,0,9,18,3,0,21,21,3,0,24,30,5,0,35,34,5,0,39
79861,194,"CĂMINUL CULTURAL ANINIŞ","ANINIŞU DIN VALE",GJ,777,3,0,0,3,9,2,0,11,11,2,0,13,23,4,0,27,24,4,0,28
79941,195,"ȘCOALA PRIMARĂ CRUȘEȚ",CRUŞET,GJ,1345,3,1,0,4,7,4,0,11,10,5,0,15,13,6,0,19,19,6,0,25
79978,196,"CĂMINUL CULTURAL MĂIAG",MĂIAG,GJ,626,7,2,0,9,10,5,0,15,10,7,0,17,10,8,0,18,11,8,0,19
80016,197,"CĂMINUL CULTURAL SLĂVUȚA",SLĂVUŢA,GJ,507,0,0,0,0,6,4,0,10,7,6,0,13,13,6,0,19,13,6,0,19
80052,198,"ŞCOALA GIMNAZIALĂ DĂNCIULEŞTI",DĂNCIULEŞTI,GJ,655,5,1,0,6,6,1,0,7,8,3,0,11,17,4,0,21,20,6,0,26
80105,199,"ŞCOALA GIMNAZIALĂ ,,CORNELIUS RADU"" RĂDINEŞTI",RĂDINEŞTI,GJ,503,0,0,0,0,6,0,0,6,7,0,0,7,7,1,0,8,8,2,0,10
80089,200,"ȘCOALA GIMNAZIALĂ OBÂRȘIA",OBÎRŞIA,GJ,469,2,1,0,3,5,1,0,6,7,1,0,8,9,4,0,13,11,5,0,16
80169,201,"ŞCOALA PRIMARĂ BRĂTUIA",BRĂTUIA,GJ,751,9,4,0,13,14,6,0,20,17,8,0,25,23,8,0,31,26,8,0,34
80132,202,"ŞCOALA PRIMARĂ DĂNEȘTI",DĂNEŞTI,GJ,1137,1,0,0,1,7,0,0,7,12,0,0,12,23,1,0,24,24,1,0,25
80230,203,"ŞCOALAPRIMARĂ VĂCAREA",VĂCAREA,GJ,718,7,3,0,10,14,5,0,19,17,5,0,22,28,8,0,36,28,9,0,37
80196,204,"ŞCOALA PRIMARĂ ȘASA",ŞASA,GJ,576,3,4,0,7,8,6,0,14,8,12,0,20,11,12,0,23,16,13,0,29
80258,205,"CĂMINUL CULTURAL DRĂGOTEȘTI",DRĂGOTEŞTI,GJ,990,6,2,0,8,7,2,0,9,8,2,0,10,12,2,0,14,15,2,0,17
80267,206,"ȘCOALA GENERALĂ COROBĂI",COROBĂI,GJ,1124,2,2,0,4,8,4,0,12,15,5,0,20,19,6,0,25,26,6,0,32
78025,207,"ȘCOALA GENERALĂ DRĂGUȚEȘTI",DRĂGUŢEŞTI,GJ,894,2,4,0,6,20,7,0,27,22,9,0,31,23,9,0,32,28,9,0,37
78052,208,"CĂMIN CULTURAL",IAŞI-GORJ,GJ,835,4,1,0,5,9,1,0,10,12,1,0,13,18,1,0,19,19,1,0,20
78070,209,"ȘCOALA GENERALĂ URECHEȘTI",URECHEŞTI,GJ,747,3,2,0,5,21,2,0,23,25,3,0,28,30,3,0,33,34,3,0,37
78061,210,"ȘCOALA PRIMARĂ TÎLVEȘTI",TÎLVEŞTI,GJ,534,8,0,0,8,16,0,0,16,25,1,0,26,32,3,0,35,38,3,0,41
78034,211,"ȘCOALA GENERALĂ CÎRBEȘTI",CÎRBEŞTI,GJ,1233,4,0,0,4,14,0,0,14,23,0,0,23,32,0,0,32,32,0,0,32
80294,212,"ŞCOALA PRIMARĂ FĂRCĂŞEŞTI",FĂRCĂŞEŞTI,GJ,583,2,1,0,3,3,2,0,5,3,2,0,5,13,6,0,19,18,7,0,25
80338,213,"LICEU ROŞIA JIU","ROŞIA JIU",GJ,656,8,2,0,10,11,2,0,13,16,2,0,18,17,2,0,19,17,2,0,19
80310,214,"GRĂDINIȚA PEȘTEANA DE JOS","PEŞTEANA DE JOS",GJ,679,2,0,0,2,5,3,0,8,12,3,0,15,24,5,0,29,27,5,0,32
80347,215,"ŞCOALA PRIMARĂ TIMIŞENI",TIMIŞENI,GJ,115,1,0,0,1,1,0,0,1,2,5,0,7,3,5,0,8,3,5,0,8
80356,216,"ȘCOALA GENERALĂ VICTOR POPESCU","VALEA CU APĂ",GJ,650,5,0,0,5,8,1,0,9,11,1,0,12,15,1,0,16,17,2,0,19
80374,217,"PRIMARIA GLOGOVA",IORMĂNEŞTI,GJ,518,6,1,0,7,11,2,0,13,18,2,0,20,28,7,0,35,33,11,0,44
80409,218,"ŞCOALA PRIMARĂ ÎNVĂŢĂTOR NICOLAE CARANDA",GLOGOVA,GJ,598,14,2,0,16,21,3,0,24,24,3,0,27,27,3,0,30,33,4,0,37
80418,219,"ŞCOALA PRIMARĂ OLTEANU",OLTEANU,GJ,450,2,4,0,6,5,4,0,9,6,4,0,10,18,8,0,26,18,8,0,26
80436,220,"PRIMĂRIA GODINEŞTI",GODINEŞTI,GJ,861,4,2,0,6,14,4,0,18,22,6,0,28,36,7,0,43,40,13,0,53
80463,221,"ŞCOALA CÎLCEŞTI",CÎLCEŞTI,GJ,260,3,3,0,6,3,3,0,6,8,7,0,15,12,9,0,21,15,10,0,25
80472,222,"ŞCOALA PRIMARĂ PÎRÎU DE PRIPOR","PÎRÎU DE PRIPOR",GJ,327,1,4,0,5,7,4,0,11,14,4,0,18,21,4,0,25,23,4,0,27
80481,223,"ȘCOALA PÎRÎU DE VALE","PÎRÎU DE VALE",GJ,167,3,3,0,6,10,3,0,13,14,3,0,17,22,6,0,28,24,8,0,32
80515,224,"ŞCOALA GENERALĂHUREZANI",HUREZANI,GJ,1148,5,1,0,6,12,7,0,19,15,9,0,24,24,12,0,36,24,13,0,37
80542,225,"ŞCOALA PRIMARĂ PLOPU",PLOPU,GJ,146,0,2,0,2,1,2,0,3,4,2,0,6,9,3,0,12,10,4,0,14
80579,226,"ȘCOALA GIMNAZIALĂIONEȘTI",IONEŞTI,GJ,966,5,1,0,6,13,2,0,15,13,3,0,16,20,4,0,24,22,4,0,26
80597,227,"ȘCOALA PRIMARĂ ILIEȘTI",ILIEŞTI,GJ,438,8,4,0,12,12,5,0,17,15,5,0,20,25,5,0,30,26,5,0,31
80604,228,"ȘCOALA PRIMARĂ PICU",PICU,GJ,530,10,1,0,11,14,4,0,18,20,4,0,24,25,5,0,30,27,5,0,32
80659,229,"ŞCOALA PRIMARĂ VIDIN",VIDIN,GJ,227,0,0,0,0,1,0,0,1,4,0,0,4,7,0,0,7,10,0,0,10
80640,230,"ŞCOALA PRIMARĂ PÎRÎU-BOIA","PÎRÎU BOIA",GJ,286,3,0,0,3,4,0,0,4,8,0,0,8,18,4,0,22,21,4,0,25
80622,231,"CĂMIN CULTURAL JUPÎNEŞTI",JUPÎNEŞTI,GJ,559,3,2,0,5,3,2,0,5,6,2,0,8,10,2,0,12,14,2,0,16
80668,232,"SCOALA PRIMARĂ VIERŞANI",VIERŞANI,GJ,663,1,0,0,1,7,0,0,7,11,2,0,13,14,2,0,16,15,2,0,17
80686,233,"ȘCOALA GENERALA ,,ION GRIGOROIU,, LELEȘTI",LELEŞTI,GJ,1031,13,5,0,18,18,7,0,25,29,13,0,42,42,15,0,57,46,15,0,61
80695,234,"ȘCOALA PRIMARĂ FRĂTEȘTI",FRĂTEŞTI,GJ,271,3,1,0,4,4,4,0,8,11,5,0,16,14,5,0,19,16,7,0,23
80702,235,"ȘCOALA PRIMARĂ RASOVIȚA",RASOVIŢA,GJ,183,2,5,0,7,4,5,0,9,4,6,0,10,7,7,0,14,8,7,0,15
80720,236,"ŞCOALA PRIMARĂLICURICI",LICURICI,GJ,624,3,1,0,4,8,4,0,12,17,6,0,23,22,10,0,32,26,10,0,36
80748,237,"ŞCOALA GIMNAZIALĂ NEGRENI",NEGRENI,GJ,566,6,5,0,11,6,7,0,13,10,8,0,18,12,8,0,20,15,10,0,25
80757,238,"ŞCOALA GIMNAZIALĂNR. 1 TOTEA",TOTEA,GJ,619,0,0,0,0,0,0,0,0,0,0,0,0,2,2,0,4,12,4,0,16
80793,239,"CĂMIN CULTURAL FRUNZA",FRUNZA,GJ,590,1,0,0,1,3,2,0,5,5,4,0,9,12,4,0,16,14,4,0,18
80775,240,"CĂMIN CULTURAL TÎRGU LOGREȘTI","TÎRGU LOGREŞTI",GJ,570,2,1,0,3,10,3,0,13,15,4,0,19,18,6,0,24,22,6,0,28
80800,241,"ȘCOALA PRIMARĂ MOȘTENI","LOGREŞTI MOŞTENI",GJ,464,1,0,0,1,4,0,0,4,6,0,0,6,9,1,0,10,9,1,0,10
80819,242,"ȘCOALA PRIMARĂ MĂRU",MĂRU,GJ,291,1,3,0,4,1,3,0,4,3,3,0,6,11,5,0,16,11,5,0,16
80837,243,"ȘCOALA PRIMARĂ SEACA",SEACA,GJ,247,4,3,0,7,5,4,0,9,5,4,0,9,5,4,0,9,6,4,0,10
80855,244,"GRĂDINIŢA MĂTĂSARI",MĂTĂSARI,GJ,977,4,0,0,4,13,0,0,13,16,0,0,16,19,0,0,19,32,0,0,32
80855,245,"GRĂDINIŢA MĂTĂSARI",MĂTĂSARI,GJ,1508,6,0,0,6,21,0,0,21,32,0,0,32,40,2,0,42,43,2,0,45
80855,246,"ŞCOALA NR.2 MĂTĂSARI",MĂTĂSARI,GJ,571,2,0,0,2,7,4,0,11,7,4,0,11,7,4,0,11,13,6,0,19
80864,247,"ŞCOALA PRIMARĂ BRĂDET",BRĂDET,GJ,539,3,2,0,5,3,2,0,5,4,2,0,6,6,2,0,8,6,3,0,9
80891,248,"ŞCOALA PRIMARĂ RUNCUREL",RUNCUREL,GJ,237,5,1,0,6,7,1,0,8,10,1,0,11,12,1,0,13,13,1,0,14
80882,249,"ŞCOALA PRIMARĂ CROICI",CROICI,GJ,292,6,1,0,7,6,3,0,9,8,4,0,12,11,4,0,15,15,4,0,19
80917,250,"CĂMINUL CULTURAL",MUŞETEŞTI,GJ,743,7,1,0,8,10,3,0,13,13,5,0,18,13,5,0,18,14,5,0,19
80962,251,"ŞCOLA PRIMARĂ STĂNCEŞTI",STĂNCEŞTI,GJ,465,0,0,0,0,3,3,0,6,7,3,0,10,12,3,0,15,13,4,0,17
80953,252,"ŞCOLA PRIMARĂ GRUI",GRUI,GJ,453,11,2,0,13,13,2,0,15,15,3,0,18,15,4,0,19,15,4,0,19
80999,253,"ȘCOALA GIMNAZIALĂNR.1 NEGOMIR",NEGOMIR,GJ,1107,4,0,0,4,20,1,0,21,22,3,0,25,28,3,0,31,34,3,0,37
81004,254,"ȘCOALA PRIMARĂARTANU",ARTANU,GJ,951,4,0,0,4,5,2,0,7,21,3,0,24,37,3,0,40,37,6,0,43
81022,255,"ȘCOALA GIMNAZIALĂ RACI",CONDEIEŞTI,GJ,813,7,0,0,7,8,0,0,8,22,2,0,24,26,9,0,35,36,11,0,47
81102,256,"CĂMIN CULTURAL CĂLUGĂRENI",CĂLUGĂRENI,GJ,915,4,3,0,7,13,3,0,16,16,3,0,19,26,3,0,29,28,6,0,34
81166,257,"ȘCOALA GIMNAZIALĂ PADEȘ",PADEŞ,GJ,1302,1,0,0,1,1,1,0,2,3,1,0,4,6,1,0,7,28,11,0,39
81148,258,"ȘCOALA GIMNAZIALĂ MOTRU-SEC","MOTRU SEC",GJ,1715,2,4,0,6,12,6,0,18,20,9,0,29,25,9,0,34,44,11,0,55
81120,259,"ȘCOALA GENERALĂ CERNA SAT",CERNA-SAT,GJ,51,0,0,0,0,0,0,0,0,2,0,0,2,3,0,0,3,4,0,0,4
81193,260,"GRUP ȘCOLAR INDUSTRIAL MINIER CONSTANTIN BRÂNCUȘI",PEŞTIŞANI,GJ,1354,3,1,0,4,8,5,0,13,15,7,0,22,22,9,0,31,23,11,0,34
81193,261,"ȘCOALA GIMNAZIALĂ PEȘTIȘANI",PEŞTIŞANI,GJ,1295,3,4,0,7,13,12,0,25,22,14,0,36,30,18,0,48,35,18,0,53
81219,262,"ȘCOALA PRIMARĂ BRĂDICENI",BRĂDICENI,GJ,523,10,2,0,12,10,5,0,15,11,7,0,18,19,10,0,29,19,11,0,30
81273,263,"ȘCOALA GIMNAZIALĂ'' NICOLAE TOMOVICI PLOPȘOR'' PLOPȘORU",PLOPŞORU,GJ,1928,13,0,0,13,26,0,0,26,35,0,0,35,37,3,12,52,41,3,12,56
81353,264,"ȘCOALAGIMNAZIALĂ PISCURI",PISCURI,GJ,1018,7,1,0,8,18,1,0,19,27,1,0,28,38,1,0,39,38,3,0,41
81371,265,"ȘCOALA PRIMARĂVĂLENI",VĂLENI,GJ,1493,12,3,0,15,34,3,0,37,47,3,0,50,70,4,0,74,76,4,0,80
81372,266,ȘCOALAGENERALĂCEPLEA,IZVOARELE,GJ,841,4,3,0,7,13,3,0,16,14,3,14,31,17,3,14,34,22,3,14,39
81399,267,"ŞCOALA GIMNAZIALĂ NR.1 POLOVRAGI",POLOVRAGI,GJ,979,7,0,0,7,30,0,0,30,32,0,0,32,36,0,0,36,40,0,0,40
81399,268,"ȘCOALA GIMNAZIALĂ NR.1 POLOVRAGI",POLOVRAGI,GJ,891,6,1,0,7,23,8,0,31,24,14,0,38,29,19,0,48,32,19,0,51
81406,269,"ŞCOALA PRIMARĂ RACOVIȚA",RACOVIŢA,GJ,375,2,1,0,3,6,4,0,10,16,8,0,24,20,14,0,34,22,14,0,36
81424,270,"ŞCOALAGIMNAZIALĂ PRIGORIA",PRIGORIA,GJ,357,1,3,0,4,3,3,0,6,5,9,0,14,7,10,0,17,7,10,0,17
81451,271,"ȘCOALA CU CLASELE I-IV CĂLUGAREASA",CĂLUGĂREASA,GJ,484,5,1,0,6,6,2,0,8,9,2,0,11,10,3,0,13,13,4,0,17
81479,272,"ȘCOALA CU CLASELE I-IVNEGOEȘTI",NEGOIEŞTI,GJ,252,3,0,0,3,4,0,0,4,4,0,0,4,4,0,0,4,4,0,0,4
81460,273,"ȘCOALA CU CLASELE I-IVDOBRANA",DOBRANA,GJ,323,3,1,0,4,6,2,0,8,6,2,0,8,6,2,0,8,8,2,0,10
81433,274,"ȘCOALA CU CLASELE I-IV BUCȘANA",BUCŞANA,GJ,661,1,0,0,1,4,0,0,4,7,0,0,7,8,0,0,8,8,0,0,8
81488,275,"ȘCOALA CU CLASELE I-IVZORLEȘTI",ZORLEŞTI,GJ,353,3,0,0,3,4,0,0,4,6,0,0,6,7,1,0,8,8,1,0,9
81503,276,"CĂMINUL CULTURAL „IZVORUL”","ROŞIA DE AMARADIA",GJ,1129,1,0,0,1,5,0,0,5,7,2,0,9,11,2,0,13,12,2,0,14
81549,277,"ŞCOALA PRIMARĂ SECIURILE",SECIURILE,GJ,587,2,0,0,2,2,0,0,2,3,0,0,3,5,0,0,5,5,0,0,5
81530,278,"ŞCOALA PRIMARĂ RUGET",RUGET,GJ,488,0,0,0,0,3,0,0,3,6,1,0,7,10,1,0,11,10,1,0,11
81567,279,"GRĂDINIȚA ȘITOAIA",ŞITOAIA,GJ,268,0,0,0,0,0,0,0,0,1,2,0,3,1,3,0,4,1,3,0,4
81647,280,"ŞCOALA PRIMARĂ VALEA-MARE","VALEA MARE",GJ,674,6,1,0,7,8,1,0,9,10,3,0,13,13,4,0,17,32,6,0,38
81594,281,"CĂMINUL CULTURAL BÎLTA",BÎLTA,GJ,1398,10,3,0,13,17,5,0,22,20,5,0,25,47,8,0,55,57,9,0,66
81585,282,"ŞCOALA GENERALĂ RUNCU",RUNCU,GJ,1171,9,1,0,10,12,6,0,18,27,6,0,33,32,8,0,40,33,8,0,41
81610,283,"CĂMINUL CULTURAL DOBRIŢA",DOBRIŢA,GJ,794,9,0,0,9,44,12,10,66,44,13,10,67,44,14,10,68,51,16,10,77
81638,284,"CENTRUL DE ÎNGRIJIRE ŞI ASISTENŢĂ SUSENI",SUSENI,GJ,241,0,0,0,0,4,16,9,29,7,17,9,33,17,20,9,46,18,20,9,47
81665,285,"ŞCOALA GENERALĂ CU CLASELE V-VIII SAMARINEŞTI",SAMARINEŞTI,GJ,1123,12,3,0,15,26,6,0,32,37,10,0,47,52,16,0,68,66,19,0,85
81709,286,"ŞCOALA PRIMARĂ LARGA",LARGA,GJ,346,1,2,0,3,6,2,0,8,7,5,0,12,20,9,0,29,22,9,0,31
81763,287,"ȘCOALA GENERALĂ SĂCELU",SĂCELU,GJ,778,4,0,0,4,15,1,0,16,19,1,0,20,22,7,0,29,23,7,0,30
81763,288,"ȘCOALA GENERALĂ SĂCELU",SĂCELU,GJ,469,4,2,0,6,4,2,0,6,4,4,0,8,6,6,0,12,6,6,0,12
81825,289,"ȘCOALA GIMNAZIALĂ SĂULEȘTI",SĂULEŞTI,GJ,1231,12,0,0,12,18,2,0,20,28,4,0,32,48,9,0,57,49,12,0,61
81834,290,"ȘCOALA PRIMARĂ BIBEȘTI",BIBEŞTI,GJ,622,7,3,0,10,12,5,0,17,17,5,0,22,28,6,0,34,32,6,0,38
81996,291,"FOSTA ŞCOALA PRIMARĂ SÎMBOTIN",SÎMBOTIN,GJ,472,5,0,0,5,11,0,0,11,16,0,0,16,22,0,0,22,22,0,0,22
82010,292,"ȘCOALA PRIMARĂCU CLASELE I - IV GORNĂCEL",GORNĂCEL,GJ,483,2,0,0,2,3,0,0,3,3,0,0,3,4,3,0,7,6,5,0,11
82038,293,"FOSTA ŞCOALĂ GENERALĂ CU CLASELE I - VIII SCHELA",SCHELA,GJ,513,3,0,0,3,3,3,0,6,9,3,0,12,25,7,0,32,28,7,0,35
81898,294,"ŞCOALA GENERALĂ BUDIENI",BUDIENI,GJ,602,4,0,0,4,12,1,0,13,16,5,0,21,29,6,0,35,38,6,0,44
81978,295,"ŞCOALA PRIMARĂ PIŞTEŞTII DIN DEAL","PIŞTEŞTII DIN DEAL",GJ,874,3,4,0,7,7,4,0,11,20,5,0,25,63,6,0,69,63,7,0,70
81932,296,"ŞCOALA PRIMARĂCOPĂCIOASA",COPĂCIOASA,GJ,702,14,3,0,17,17,5,0,22,20,7,2,29,29,8,2,39,32,8,2,42
81870,297,"CĂMINUL CULTURAL SCOARŢA",SCOARŢA,GJ,727,6,2,0,8,20,8,0,28,20,12,0,32,21,12,0,33,23,13,0,36
81889,298,"LOCALUL FOSTEI PRIMĂRII BOBU",BOBU,GJ,969,3,4,0,7,8,8,0,16,18,10,0,28,20,15,0,35,23,15,0,38
82056,299,"ȘCOALA PRIMARĂ SLIVILEȘTICU CLASELE I-IV",SLIVILEŞTI,GJ,859,7,2,0,9,12,2,0,14,20,4,0,24,28,5,0,33,36,6,0,42
82092,300,"ȘCOALA PRIMARĂ STRÎMTUCU CLASELE I-IV",STRÎMTU,GJ,417,0,1,0,1,2,1,0,3,13,4,0,17,21,5,0,26,28,9,0,37
82074,301,"SALA DE SPORT",MICULEŞTI,GJ,776,0,0,0,0,1,0,0,1,2,0,0,2,4,0,0,4,6,0,0,6
82109,302,"ȘCOALA PRIMARĂ SURACU CLASELE I-IV",SURA,GJ,603,6,2,0,8,7,2,0,9,9,2,0,11,14,3,0,17,19,3,0,22
82145,303,"PRIMĂRIA STĂNEŞTI",STĂNEŞTI,GJ,1134,5,2,0,7,10,3,0,13,13,3,0,16,18,3,0,21,19,3,0,22
82181,304,"ŞCOALA GENERALĂ CURPEN",CURPEN,GJ,755,1,0,0,1,2,1,0,3,2,1,0,3,6,7,0,13,7,7,0,14
82252,305,"CENTRUL CULTURAL ""GH.ZAMFIR""",STEJARI,GJ,840,1,0,0,1,8,0,0,8,11,0,0,11,12,0,0,12,17,6,0,23
82298,306,"CĂMINUL CULTURAL PISCOIU",PISCOIU,GJ,702,4,2,0,6,5,2,0,7,5,3,0,8,8,3,0,11,12,3,0,15
82261,307,"ŞCOALA PRIMARĂ BALOŞANI",BALOŞANI,GJ,419,2,1,0,3,7,2,0,9,7,2,0,9,8,2,0,10,10,2,0,12
82323,308,"CĂMINUL CULTURAL STOINA",STOINA,GJ,1218,8,2,0,10,22,13,0,35,30,22,0,52,45,24,0,69,46,26,0,72
82350,309,"ŞCOALA CU CLASELE I-IV PĂIŞANI",PĂIŞANI,GJ,666,5,0,0,5,9,1,0,10,12,1,0,13,16,1,0,17,17,1,0,18
82403,310,"CLĂDIREA DE LÂNGĂ SEDIUL PRIMĂRIEI COMUNEI TELEŞTI - SALA DE ŞEDINŢE A CONSILIULUI LOCAL TELEŞTI",TELEŞTI,GJ,494,3,1,0,4,5,3,0,8,14,7,0,21,17,7,0,24,18,7,0,25
82403,311,"ŞCOALA PRIMARĂ TELEŞTI",TELEŞTI,GJ,553,2,0,0,2,7,0,0,7,9,2,0,11,11,5,0,16,25,9,0,34
82412,312,"ŞCOALA PRIMARĂNR.1 BUDUHALA",BUDUHALA,GJ,672,2,2,0,4,8,3,0,11,11,4,0,15,16,4,0,20,18,4,0,22
82421,313,"ŞCOALA PRIMARĂ ŞOMĂNEŞTI",ŞOMĂNEŞTI,GJ,571,4,0,0,4,8,0,0,8,16,2,0,18,24,3,0,27,27,3,0,30
82564,314,"ŞCOALA PRIMARĂ TURBUREA",TURBUREA,GJ,440,5,4,0,9,10,6,0,16,20,8,9,37,31,10,9,50,37,10,9,56
82564,315,"ŞCOALA GENERALĂ TURBUREA",TURBUREA,GJ,731,7,1,0,8,11,2,0,13,15,3,0,18,26,5,0,31,30,6,0,36
82608,316,"SPAȚIUL PUBLICȘIPOTU",ŞIPOTU,GJ,726,0,0,0,0,7,2,0,9,15,3,22,40,47,5,22,74,56,8,22,86
82582,317,"ŞCOALA GENERALĂPOIANA",POIANA,GJ,1193,9,1,0,10,15,2,0,17,29,2,0,31,53,10,18,81,56,10,18,84
82573,318,"ŞCOALAPRIMARĂ COCOROVA",COCOROVA,GJ,407,3,0,0,3,6,1,0,7,9,1,0,10,18,3,4,25,22,3,4,29
78098,319,"ȘCOALA GIMNAZIALĂ GRIGORE GEAMĂNU",TURCINEŞTI,GJ,1337,7,1,0,8,12,1,0,13,16,1,0,17,26,3,0,29,30,3,0,33
78123,320,"ȘCOALA PRIMARĂ RUGI",RUGI,GJ,497,3,2,0,5,4,2,0,6,4,2,0,6,5,2,0,7,8,3,0,11
82699,321,"ŞCOALA COORDONATOARE ŢÎNŢĂRENI",ŢÎNŢĂRENI,GJ,1871,12,0,0,12,33,0,0,33,53,0,0,53,81,0,0,81,84,0,0,84
82724,322,"ȘCOALA PRIMARĂ FLOREȘTI NR. 2",FLOREŞTI,GJ,998,9,2,0,11,21,6,0,27,41,9,0,50,67,11,0,78,89,11,0,100
82724,323,"ȘCOALA GENERALĂ FLOREȘTI NR. 1",FLOREŞTI,GJ,1328,14,0,0,14,29,0,0,29,44,0,0,44,60,3,0,63,69,3,0,72
82715,324,"ŞCOALA PRIMARĂ CHICIORA",CHICIORA,GJ,249,1,5,0,6,1,5,0,6,5,5,0,10,6,6,0,12,10,6,0,16
82751,325,"ŞCOALA GIMNAZIALĂ FÎNTÎNELE",FÎNTÎNELE,GJ,788,1,0,0,1,4,0,0,4,11,0,0,11,18,0,0,18,24,0,0,24
82742,326,"ŞCOALA GIMNAZIALĂ NR. 1 URDARI",URDARI,GJ,1345,9,4,0,13,15,4,0,19,24,4,0,28,28,5,0,33,28,5,0,33
82760,327,"GRĂDINIŢA HOTĂROASA",HOTĂROASA,GJ,459,1,0,0,1,2,0,0,2,4,0,0,4,5,0,0,5,5,0,0,5
82788,328,"ŞCOALA GENERALĂ NR.1 VÂGIULEŞTI",VĂGIULEŞTI,GJ,1097,6,0,0,6,6,0,0,6,10,5,0,15,12,7,0,19,17,7,0,24
82804,329,"CĂMINUL CULTURAL COVRIGI",COVRIGI,GJ,1006,5,0,0,5,9,1,0,10,15,2,0,17,27,2,0,29,27,2,0,29
82840,330,"ȘCOALA GIMNAZIALĂ NR 1 CORP B",ANDREEŞTI,GJ,870,6,2,0,8,7,4,0,11,10,5,0,15,14,6,0,20,14,6,0,20
82877,331,"ŞCOALA PRIMARĂNR 1VLADIMIR",VLADIMIR,GJ,901,0,0,0,0,5,3,0,8,5,3,0,8,6,4,0,10,6,6,0,12
82859,332,"ŞCOALA PRIMARĂNR. 2 FRASIN",FRASIN,GJ,561,2,3,0,5,2,3,0,5,5,5,0,10,8,7,0,15,8,7,0,15
75105,1,"ȘCOALA GIMNAZIALĂ NR. 26 (ŞCOALA GENERALĂ ”ION CREANGĂ"" - ȘCOALA GENERALĂ NR. 26)",GALAŢI,GL,1265,12,0,0,12,46,2,0,48,65,3,0,68,98,3,0,101,105,4,0,109
75105,2,"ȘCOALA GIMNAZIALĂ NR. 26 (ŞCOALA GENERALĂ ”ION CREANGĂ"" - ȘCOALA GENERALĂ NR. 26)",GALAŢI,GL,1173,14,1,0,15,61,5,0,66,85,6,0,91,106,6,0,112,113,6,0,119
75105,3,"ȘCOALA GIMNAZIALĂ NR. 28 (ŞCOALA GENERALĂ ”MIHAI EMINESCU” - ȘCOALA GENERALĂ NR. 28)",GALAŢI,GL,1235,15,3,0,18,49,7,0,56,68,9,0,77,78,11,0,89,83,11,0,94
75105,4,"ȘCOALA GIMNAZIALĂ NR. 28 (ŞCOALA GENERALĂ ”MIHAI EMINESCU” - ȘCOALA GENERALĂ NR. 28)",GALAŢI,GL,1098,11,4,0,15,44,5,0,49,58,6,0,64,78,9,0,87,87,10,0,97
75105,5,"ȘCOALA GIMNAZIALĂ NR. 28 (ŞCOALA GENERALĂ ”MIHAI EMINESCU” - ȘCOALA GENERALĂ NR. 28)",GALAŢI,GL,1314,20,0,0,20,77,0,0,77,97,0,0,97,117,1,0,118,126,1,0,127
75105,6,"ȘCOALA GIMNAZIALĂ NR. 28 (ŞCOALA GENERALĂ ”MIHAI EMINESCU” - ȘCOALA GENERALĂ NR. 28)",GALAŢI,GL,1336,19,0,0,19,68,0,0,68,91,0,0,91,124,0,0,124,138,0,0,138
75105,7,"ȘCOALA GIMNAZIALĂ NR. 28 (ŞCOALA GENERALĂ ”MIHAI EMINESCU” - ȘCOALA GENERALĂ NR. 28)",GALAŢI,GL,948,10,3,0,13,28,3,0,31,46,5,0,51,60,5,0,65,60,5,0,65
75105,8,"S.C. “APA-CANAL” S.A.",GALAŢI,GL,1707,31,0,0,31,79,1,0,80,106,2,0,108,143,2,0,145,157,2,0,159
75105,9,"S.C. “APA-CANAL” S.A.",GALAŢI,GL,1608,28,0,0,28,59,0,0,59,90,0,0,90,128,1,0,129,136,1,0,137
75105,10,"S.C. “APA-CANAL” S.A.",GALAŢI,GL,1364,14,0,0,14,53,0,0,53,71,0,0,71,90,0,0,90,94,1,0,95
75105,11,"ȘCOALA GIMNAZIALĂ ”CONSTANTIN GHEORGHE MARINESCU” (SCOALA GENERALĂ NR.2)",GALAŢI,GL,1495,10,0,0,10,36,1,0,37,49,1,0,50,66,2,0,68,73,2,0,75
75105,12,"ȘCOALA GIMNAZIALĂ ”CONSTANTIN GHEORGHE MARINESCU” (SCOALA GENERALĂ NR.2)",GALAŢI,GL,1635,28,1,0,29,79,4,0,83,91,9,0,100,120,11,0,131,127,11,0,138
75105,13,"LICEUL TEORETIC ”EMIL RACOVIȚĂ” (LICEUL ”EMIL RACOVIŢĂ” - ȘCOALA GENERALĂ NR. 6)",GALAŢI,GL,1697,15,1,0,16,47,2,0,49,64,3,0,67,84,6,0,90,86,6,0,92
75105,14,"LICEUL TEORETIC ”EMIL RACOVIȚĂ” (LICEUL ”EMIL RACOVIŢĂ” - ȘCOALA GENERALĂ NR. 6)",GALAŢI,GL,1334,15,0,0,15,43,0,0,43,58,0,0,58,81,1,0,82,84,1,0,85
75105,15,"LICEUL TEORETIC ”EMIL RACOVIȚĂ” (LICEUL ”EMIL RACOVIŢĂ” - ȘCOALA GENERALĂ NR. 6)",GALAŢI,GL,1155,10,0,0,10,27,0,0,27,52,0,0,52,65,0,0,65,70,0,0,70
75105,16,"COLEGIUL NATIONAL “MIHAIL KOGĂLNICEANU”",GALAŢI,GL,1138,5,6,0,11,28,6,0,34,41,7,0,48,56,7,0,63,62,7,0,69
75105,17,"COLEGIUL NATIONAL “MIHAIL KOGĂLNICEANU”",GALAŢI,GL,1205,17,4,0,21,37,4,0,41,52,4,0,56,70,4,0,74,72,4,0,76
75105,18,"CASA DE CULTURA A SINDICATELOR",GALAŢI,GL,1118,19,3,0,22,42,7,0,49,63,8,0,71,81,8,0,89,89,9,0,98
75105,19,"CASA DE CULTURA A SINDICATELOR",GALAŢI,GL,1557,8,0,0,8,34,0,0,34,56,0,0,56,75,0,0,75,78,0,0,78
75105,20,"ȘCOALA GIMNAZIALĂ ”ELENA CUZA” (ȘCOALA NR.15)",GALAŢI,GL,1351,9,0,0,9,19,0,0,19,28,0,0,28,47,0,0,47,55,0,0,55
75105,21,"ȘCOALA GIMNAZIALĂ ”ELENA CUZA” (ȘCOALA NR.15)",GALAŢI,GL,1675,9,1,0,10,37,1,0,38,51,1,0,52,72,1,0,73,79,1,0,80
75105,22,"GRĂDINIȚA CU PROGRAM NORMAL ”IOAN NENIȚESCU” (GRĂDINIȚA NR. 15)",GALAŢI,GL,1439,20,3,0,23,49,3,0,52,64,4,0,68,85,4,0,89,88,4,0,92
75105,23,"GRĂDINIȚA CU PROGRAM NORMAL ”IOAN NENIȚESCU” (GRĂDINIȚA NR. 15)",GALAŢI,GL,1390,21,0,0,21,45,1,0,46,62,1,0,63,78,3,0,81,88,4,0,92
75105,24,"COLEGIUL NAȚIONAL ""VASILE ALECSANDRI""",GALAŢI,GL,993,12,0,0,12,28,5,0,33,40,6,0,46,63,8,0,71,73,8,0,81
75105,25,"COLEGIUL NAȚIONAL ""VASILE ALECSANDRI""",GALAŢI,GL,1405,14,4,0,18,44,4,0,48,63,4,0,67,79,5,0,84,84,5,0,89
75105,26,"COLEGIUL NAȚIONAL ""VASILE ALECSANDRI""",GALAŢI,GL,1333,9,0,0,9,26,0,0,26,34,0,0,34,55,1,0,56,59,3,0,62
75105,27,"ȘCOALA GIMNAZIALĂ NR. 16 (ȘCOALA GENERALĂ ”NICOLAE BĂLCESCU” - ȘCOALA GENERALĂ NR. 16)",GALAŢI,GL,1426,20,0,0,20,52,1,0,53,64,1,0,65,84,2,0,86,91,3,0,94
75105,28,"ȘCOALA GIMNAZIALĂ NR. 16 (ȘCOALA GENERALĂ ”NICOLAE BĂLCESCU” - ȘCOALA GENERALĂ NR. 16)",GALAŢI,GL,1201,16,0,0,16,36,0,0,36,44,0,0,44,51,6,0,57,57,6,0,63
75105,29,"ȘCOALA GIMNAZIALĂ NR. 16 (ȘCOALA GENERALĂ ”NICOLAE BĂLCESCU” - ȘCOALA GENERALĂ NR. 16)",GALAŢI,GL,1309,9,2,0,11,38,3,0,41,48,4,0,52,66,4,0,70,72,4,0,76
75105,30,"ȘCOALA GIMNAZIALĂ NR. 16 (ȘCOALA GENERALĂ ”NICOLAE BĂLCESCU” - ȘCOALA GENERALĂ NR. 16)",GALAŢI,GL,1320,18,0,0,18,42,0,0,42,56,0,0,56,63,0,0,63,72,0,0,72
75105,31,"ȘCOALA GIMNAZIALĂ NR. 25 (ȘCOALA GENERALĂ ”PETRU RAREȘ” - ȘCOALA GENERALĂ NR. 25)",GALAŢI,GL,1528,16,2,0,18,35,5,0,40,46,8,0,54,58,9,1,68,64,10,1,75
75105,32,"ȘCOALA GIMNAZIALĂ NR. 25 (ȘCOALA GENERALĂ ”PETRU RAREȘ” - ȘCOALA GENERALĂ NR. 25)",GALAŢI,GL,1529,9,0,0,9,37,0,0,37,59,8,0,67,69,10,0,79,79,12,0,91
75105,33,"ȘCOALA GIMNAZIALĂ NR. 25 (ȘCOALA GENERALĂ ”PETRU RAREȘ” - ȘCOALA GENERALĂ NR. 25)",GALAŢI,GL,1341,12,0,0,12,47,1,0,48,59,8,0,67,73,8,0,81,83,9,0,92
75105,34,"UNIVERSITATEA ”DUNĂREA DE JOS” GALAȚI (UNIVERSITATEA GALAŢI)",GALAŢI,GL,1564,17,0,0,17,50,3,0,53,66,9,19,94,81,10,19,110,82,12,19,113
75105,35,"ȘCOALA GIMNAZIALĂ ”LUDOVIC COSMA” (ȘCOALA GENERALĂ NR. 19)",GALAŢI,GL,1346,8,1,0,9,20,1,0,21,35,1,2,38,45,1,2,48,49,1,2,52
75105,36,"ȘCOALA GIMNAZIALĂ ”LUDOVIC COSMA” (ȘCOALA GENERALĂ NR. 19)",GALAŢI,GL,1552,5,0,0,5,27,1,0,28,44,1,0,45,58,1,0,59,65,1,0,66
75105,37,"COLEGIUL TEHNIC ""RADU NEGRU""",GALAŢI,GL,1684,3,0,0,3,14,0,0,14,26,1,198,225,43,1,198,242,45,1,198,244
75105,38,"COLEGIUL DE INDUSTRIE ALIMENTARĂ ”ELENA DOAMNA” (GRUP ȘCOLAR ”ELENA DOAMNA”)",GALAŢI,GL,1957,11,1,0,12,37,10,0,47,52,17,0,69,68,20,0,88,71,20,0,91
75105,39,"COLEGIUL DE INDUSTRIE ALIMENTARĂ ”ELENA DOAMNA” (GRUP ȘCOLAR ”ELENA DOAMNA”)",GALAŢI,GL,1687,16,5,0,21,41,5,0,46,56,5,0,61,74,5,45,124,76,5,45,126
75105,40,"COLEGIUL TEHNIC ”RADU NEGRU” (GRUP ȘCOLAR ”RADU NEGRU”)",GALAŢI,GL,1922,14,3,0,17,27,4,199,230,38,7,199,244,63,8,199,270,65,8,199,272
75105,41,"ȘCOALA GIMNAZIALĂ NR. 20 (ȘCOALA GENERALĂ NR. 20 ”TRAIAN”)",GALAŢI,GL,1988,12,0,0,12,41,0,0,41,56,0,0,56,76,0,0,76,76,0,0,76
75105,42,"ȘCOALA GIMNAZIALĂ NR. 20 (ȘCOALA GENERALĂ NR. 20 ”TRAIAN”)",GALAŢI,GL,1953,0,2,0,2,0,3,0,3,0,6,0,6,0,6,0,6,0,6,0,6
75105,43,"ȘCOALA GIMNAZIALĂ NR. 20 (ȘCOALA GENERALĂ NR. 20 ”TRAIAN”)",GALAŢI,GL,1851,7,0,0,7,26,0,17,43,45,0,17,62,61,0,17,78,65,0,17,82
75105,44,"ȘCOALA GIMNAZIALĂ NR. 24 (ȘCOALA GENERALĂ NR. 24)",GALAŢI,GL,1599,25,1,0,26,69,3,0,72,98,5,0,103,124,6,0,130,128,7,0,135
75105,45,"LICEUL TEHNOLOGIC DE MARINĂ (GRUP ȘCOLAR INDUSTRIAL DE MARINĂ - LICEUL DE MARINĂ)",GALAŢI,GL,1427,6,1,0,7,18,3,0,21,25,4,0,29,32,4,0,36,36,4,0,40
75105,46,"LICEUL TEHNOLOGIC DE MARINĂ (GRUP ȘCOLAR INDUSTRIAL DE MARINĂ - LICEUL DE MARINĂ)",GALAŢI,GL,1468,10,5,0,15,36,8,0,44,43,9,0,52,57,9,0,66,59,9,0,68
75105,47,"LICEUL TEHNOLOGIC DE MARINĂ (GRUP ȘCOLAR INDUSTRIAL DE MARINĂ - LICEUL DE MARINĂ)",GALAŢI,GL,1344,15,0,0,15,40,0,0,40,63,2,0,65,80,3,0,83,86,4,0,90
75105,48,"COLEGIUL NAȚIONAL ”ALEXANDRU IOAN CUZA” (GRĂDINIȚA NR. 59 - FOSTA ȘCOALĂGENERALĂNR. 8)",GALAŢI,GL,1325,15,0,0,15,36,1,0,37,56,1,0,57,71,1,0,72,80,1,0,81
75105,49,"COLEGIUL NAȚIONAL ”ALEXANDRU IOAN CUZA” (GRĂDINIȚA NR. 59 - FOSTA ȘCOALĂGENERALĂNR. 8)",GALAŢI,GL,1469,11,2,0,13,41,2,0,43,59,2,0,61,91,2,0,93,99,2,0,101
75105,50,"COLEGIUL NAȚIONAL ”ALEXANDRU IOAN CUZA” (GRĂDINIȚA NR. 59 - FOSTA ȘCOALĂGENERALĂNR. 8)",GALAŢI,GL,1442,12,0,0,12,44,0,0,44,52,0,0,52,71,0,0,71,76,0,0,76
75105,51,"COLEGIUL NAȚIONAL ”ALEXANDRU IOAN CUZA” (GRĂDINIȚA NR. 59 - FOSTA ȘCOALĂGENERALĂNR. 8)",GALAŢI,GL,1731,12,0,0,12,32,0,0,32,50,0,0,50,64,0,0,64,66,4,0,70
75105,52,"LICEUL CU PROGRAM SPORTIV (LICEUL CU PROGRAM DE EDUCAȚIE FIZICĂ - LICEUL INDUSTRIAL NR.12)",GALAŢI,GL,1738,11,0,0,11,28,2,0,30,53,2,0,55,69,3,0,72,73,3,0,76
75105,53,"LICEUL CU PROGRAM SPORTIV (LICEUL CU PROGRAM DE EDUCAȚIE FIZICĂ - LICEUL INDUSTRIAL NR.12)",GALAŢI,GL,2188,11,0,0,11,32,0,0,32,43,0,0,43,56,0,0,56,65,0,0,65
75105,54,"LICEUL CU PROGRAM SPORTIV (LICEUL CU PROGRAM DE EDUCAȚIE FIZICĂ - LICEUL INDUSTRIAL NR.12)",GALAŢI,GL,1594,8,3,0,11,40,3,0,43,63,3,0,66,79,4,0,83,83,4,0,87
75105,55,"LICEUL CU PROGRAM SPORTIV (LICEUL CU PROGRAM DE EDUCAȚIE FIZICĂ - LICEUL INDUSTRIAL NR.12)",GALAŢI,GL,1561,15,0,0,15,54,0,0,54,63,0,0,63,84,0,0,84,94,0,0,94
75105,56,"ȘCOALA GIMNAZIALĂ NR. 17 (ȘCOALA GENERALĂ ”NICHITA STĂNESCU” - ȘCOALA GENERALĂ NR. 17)",GALAŢI,GL,1354,19,0,0,19,45,0,0,45,58,5,0,63,71,6,0,77,74,6,0,80
75105,57,"ȘCOALA GIMNAZIALĂ NR. 17 (ȘCOALA GENERALĂ ”NICHITA STĂNESCU” - ȘCOALA GENERALĂ NR. 17)",GALAŢI,GL,1472,11,5,0,16,52,6,0,58,70,6,0,76,84,7,0,91,96,7,0,103
75105,58,"ȘCOALA GIMNAZIALĂ NR. 17 (ȘCOALA GENERALĂ ”NICHITA STĂNESCU” - ȘCOALA GENERALĂ NR. 17)",GALAŢI,GL,1279,9,2,0,11,52,4,0,56,54,5,0,59,71,5,0,76,74,5,0,79
75105,59,"COLEGIUL ECONOMIC ”VIRGIL MADGEARU” (GRUP ȘCOLAR ECONOMIC ADMINISTRATIV ”VIRGIL MADGEARU”)",GALAŢI,GL,1318,28,7,0,35,65,11,0,76,79,13,0,92,90,14,0,104,101,14,0,115
75105,60,"ȘCOALA GIMNAZIALĂ NR. 29 (ȘCOALA GENERALĂ ”SFÂNTA ANA” - ȘCOALA GENERALĂ NR. 29)",GALAŢI,GL,1340,6,0,0,6,47,0,0,47,72,0,1,73,88,6,1,95,90,7,1,98
75105,61,"ȘCOALA GIMNAZIALĂ NR. 29 (ȘCOALA GENERALĂ ”SFÂNTA ANA” - ȘCOALA GENERALĂ NR. 29)",GALAŢI,GL,1310,17,0,0,17,38,0,0,38,54,8,0,62,82,8,0,90,86,8,0,94
75105,62,"ȘCOALA GIMNAZIALĂ NR. 29 (ȘCOALA GENERALĂ ”SFÂNTA ANA” - ȘCOALA GENERALĂ NR. 29)",GALAŢI,GL,1390,16,8,0,24,40,8,0,48,52,8,0,60,78,8,0,86,84,8,0,92
75105,63,"ȘCOALA GIMNAZIALĂ NR. 29 (ȘCOALA GENERALĂ ”SFÂNTA ANA” - ȘCOALA GENERALĂ NR. 29)",GALAŢI,GL,1489,21,0,0,21,46,0,0,46,63,7,0,70,89,7,0,96,89,7,0,96
75105,64,"ȘCOALA GIMNAZIALĂ NR. 22 (ȘCOALA GENERALĂ ”DIMITRIE CANTEMIR” - ȘCOALA GENERALĂ NR. 22)",GALAŢI,GL,1512,9,0,0,9,35,0,0,35,50,1,0,51,64,1,0,65,69,3,0,72
75105,65,"ȘCOALA GIMNAZIALĂ NR. 22 (ȘCOALA GENERALĂ ”DIMITRIE CANTEMIR” - ȘCOALA GENERALĂ NR. 22)",GALAŢI,GL,1518,29,2,0,31,74,2,0,76,87,3,0,90,115,3,0,118,120,3,0,123
75105,66,"ȘCOALA GIMNAZIALĂ NR. 22 (ȘCOALA GENERALĂ ”DIMITRIE CANTEMIR” - ȘCOALA GENERALĂ NR. 22)",GALAŢI,GL,1572,17,3,0,20,61,3,0,64,87,3,0,90,104,6,0,110,110,6,0,116
75105,67,"GRĂDINIȚA CU PROGRAM PRELUNGIT ”PRICHINDEL” (GRĂDINIȚA ”PRICHINDEL” - GRĂDINIȚA NR. 62)",GALAŢI,GL,1542,20,2,0,22,65,8,0,73,79,8,0,87,90,8,0,98,100,9,0,109
75105,68,"GRĂDINIȚA CU PROGRAM PRELUNGIT ”PRICHINDEL” (GRĂDINIȚA ”PRICHINDEL” - GRĂDINIȚA NR. 62)",GALAŢI,GL,1520,20,1,0,21,43,4,0,47,65,6,0,71,82,6,0,88,87,8,0,95
75105,69,"GRĂDINIȚA CU PROGRAM PRELUNGIT ”PRICHINDEL” (GRĂDINIȚA ”PRICHINDEL” - GRĂDINIȚA NR. 62)",GALAŢI,GL,1439,18,0,0,18,47,0,0,47,68,0,0,68,85,0,0,85,89,0,0,89
75105,70,"GARA CFR BARBOȘI",GALAŢI,GL,486,11,6,0,17,21,6,0,27,26,6,0,32,35,6,0,41,38,7,0,45
75105,71,"ȘCOALA GIMNAZIALĂ ”DAN BARBILIAN” (ȘCOALA GENERALĂ ”DAN BARBILIAN”- ȘCOALA GENERALĂ NR. 43)",GALAŢI,GL,1658,22,1,0,23,38,4,0,42,61,5,0,66,90,11,0,101,102,15,0,117
75105,72,"ȘCOALA GIMNAZIALĂ ”DAN BARBILIAN” (ȘCOALA GENERALĂ ”DAN BARBILIAN”- ȘCOALA GENERALĂ NR. 43)",GALAŢI,GL,1506,17,5,0,22,61,6,0,67,78,6,0,84,90,6,0,96,99,7,0,106
75105,73,"ȘCOALA GIMNAZIALĂ ”DAN BARBILIAN” (ȘCOALA GENERALĂ ”DAN BARBILIAN”- ȘCOALA GENERALĂ NR. 43)",GALAŢI,GL,1462,12,0,0,12,34,0,1,35,50,1,0,51,75,1,0,76,81,1,0,82
75105,74,"ȘCOALA GIMNAZIALĂ ”DAN BARBILIAN” (ȘCOALA GENERALĂ ”DAN BARBILIAN”- ȘCOALA GENERALĂ NR. 43)",GALAŢI,GL,1540,11,3,0,14,34,4,0,38,47,4,0,51,64,4,0,68,69,5,0,74
75105,75,"ȘCOALA GIMNAZIALĂ ”DAN BARBILIAN” (ȘCOALA GENERALĂ ”DAN BARBILIAN”- ȘCOALA GENERALĂ NR. 43)",GALAŢI,GL,1563,24,7,0,31,45,7,0,52,62,7,0,69,76,7,0,83,82,7,0,89
75105,76,"ȘCOALA GIMNAZIALĂ ”DAN BARBILIAN” (ȘCOALA GENERALĂ ”DAN BARBILIAN”- ȘCOALA GENERALĂ NR. 43)",GALAŢI,GL,1508,13,0,0,13,43,0,0,43,54,1,0,55,69,1,0,70,76,1,0,77
75105,77,"ȘCOALA GIMNAZIALĂ ”DAN BARBILIAN” (ȘCOALA GENERALĂ ”DAN BARBILIAN”- ȘCOALA GENERALĂ NR. 43)",GALAŢI,GL,1581,10,0,0,10,36,0,0,36,41,0,0,41,56,0,0,56,58,0,0,58
75105,78,"ȘCOALA GIMNAZIALĂ NR. 3 (ȘCOALA GENERALĂ NR. 3)",GALAŢI,GL,1566,12,0,0,12,51,0,0,51,66,4,0,70,72,4,0,76,87,4,0,91
75105,79,"ȘCOALA GIMNAZIALĂ NR. 3 (ȘCOALA GENERALĂ NR. 3)",GALAŢI,GL,1601,4,4,0,8,26,6,0,32,40,6,0,46,73,7,0,80,80,7,0,87
75105,80,"ȘCOALA GIMNAZIALĂ NR. 3 (ȘCOALA GENERALĂ NR. 3)",GALAŢI,GL,1551,11,1,0,12,30,1,0,31,50,1,0,51,69,1,1,71,72,2,1,75
75105,81,"ȘCOALA GIMNAZIALĂ NR. 3 (ȘCOALA GENERALĂ NR. 3)",GALAŢI,GL,1707,14,0,0,14,51,4,0,55,71,4,0,75,103,4,0,107,114,5,0,119
75105,82,"ȘCOALA GIMNAZIALĂ NR. 3 (ȘCOALA GENERALĂ NR. 3)",GALAŢI,GL,1423,11,3,0,14,30,5,0,35,48,9,0,57,61,9,0,70,71,10,0,81
75105,83,"ȘCOALA GIMNAZIALĂ ”IULIA HAȘDEU” (ȘCOALA GENERALĂ ”IULIA HAȘDEU” - ȘCOALA GENERALĂ NR. 40)",GALAŢI,GL,1478,10,4,0,14,50,4,0,54,69,4,0,73,90,4,0,94,96,4,0,100
75105,84,"ȘCOALA GIMNAZIALĂ ”IULIA HAȘDEU” (ȘCOALA GENERALĂ ”IULIA HAȘDEU” - ȘCOALA GENERALĂ NR. 40)",GALAŢI,GL,1379,14,0,0,14,29,1,0,30,44,1,0,45,62,1,0,63,65,1,0,66
75105,85,"ȘCOALA GIMNAZIALĂ ”IULIA HAȘDEU” (ȘCOALA GENERALĂ ”IULIA HAȘDEU” - ȘCOALA GENERALĂ NR. 40)",GALAŢI,GL,1436,16,2,0,18,50,2,0,52,65,2,0,67,96,2,0,98,99,3,0,102
75105,86,"ȘCOALA GIMNAZIALĂ ”IULIA HAȘDEU” (ȘCOALA GENERALĂ ”IULIA HAȘDEU” - ȘCOALA GENERALĂ NR. 40)",GALAŢI,GL,1428,19,0,0,19,43,1,0,44,56,3,0,59,82,4,0,86,86,8,0,94
75105,87,"ȘCOALA GIMNAZIALĂ ”IULIA HAȘDEU” (ȘCOALA GENERALĂ ”IULIA HAȘDEU” - ȘCOALA GENERALĂ NR. 40)",GALAŢI,GL,1585,9,6,0,15,33,6,0,39,55,6,0,61,77,7,0,84,93,7,0,100
75105,88,"ȘCOALA GIMNAZIALĂ ”IULIA HAȘDEU” (ȘCOALA GENERALĂ ”IULIA HAȘDEU” - ȘCOALA GENERALĂ NR. 40)",GALAŢI,GL,1293,12,6,0,18,28,7,0,35,44,7,0,51,65,7,0,72,70,7,0,77
75105,89,"ȘCOALA GIMNAZIALĂ NR. 9 (ȘCOALA GIMNAZIALĂ NR. 9 ""CALISTRAT HOGAȘ"")",GALAŢI,GL,1484,14,0,0,14,39,7,0,46,55,7,0,62,77,8,0,85,92,8,0,100
75105,90,"ȘCOALA GIMNAZIALĂ NR. 9 (ȘCOALA GIMNAZIALĂ NR. 9 ""CALISTRAT HOGAȘ"")",GALAŢI,GL,1295,16,0,0,16,47,1,0,48,65,1,0,66,80,2,0,82,90,2,0,92
75105,91,"ȘCOALA GIMNAZIALĂ NR. 9 (ȘCOALA GIMNAZIALĂ NR. 9 ""CALISTRAT HOGAȘ"")",GALAŢI,GL,1376,16,0,0,16,40,0,0,40,55,0,0,55,65,0,0,65,75,0,0,75
75105,92,"GRĂDINIȚA CU PROGRAM NORMAL NR. 59 (FOSTA ȘCOALĂ GIMNAZIALĂ ”NICOLAE MANTU”)",GALAŢI,GL,1617,8,0,0,8,30,3,0,33,47,5,0,52,81,5,0,86,85,5,0,90
75105,93,"GRĂDINIȚA CU PROGRAM NORMAL NR. 59 (FOSTA ȘCOALĂ GIMNAZIALĂ ”NICOLAE MANTU”)",GALAŢI,GL,1471,6,0,0,6,24,7,0,31,38,11,0,49,70,11,0,81,77,11,0,88
75105,94,"ȘCOALA GIMNAZIALĂ NR. 5 (ȘCOALA GENERALĂ ”CUZA VODĂ” - ȘCOALA GENERALĂ NR. 5)",GALAŢI,GL,1563,12,3,0,15,34,4,0,38,48,9,0,57,66,12,0,78,67,12,0,79
75105,95,"ȘCOALA GIMNAZIALĂ NR. 5 (ȘCOALA GENERALĂ ”CUZA VODĂ” - ȘCOALA GENERALĂ NR. 5)",GALAŢI,GL,1322,11,0,0,11,33,1,0,34,44,5,0,49,54,6,1,61,59,6,1,66
75105,96,"ȘCOALA GIMNAZIALĂ NR. 5 (ȘCOALA GENERALĂ ”CUZA VODĂ” - ȘCOALA GENERALĂ NR. 5)",GALAŢI,GL,1600,9,0,0,9,27,0,0,27,41,2,0,43,56,2,1,59,62,3,1,66
75105,97,"ȘCOALA GIMNAZIALĂ NR. 5 (ȘCOALA GENERALĂ ”CUZA VODĂ” - ȘCOALA GENERALĂ NR. 5)",GALAŢI,GL,1410,12,0,0,12,51,2,0,53,77,2,0,79,95,2,0,97,98,2,0,100
75105,98,"LICEUL TEORETIC ""DUNAREA""",GALAŢI,GL,1333,16,2,0,18,39,3,0,42,49,3,0,52,67,4,0,71,75,4,0,79
75105,99,"LICEUL TEORETIC ""DUNAREA""",GALAŢI,GL,1289,9,0,0,9,24,1,0,25,45,1,0,46,62,4,0,66,66,4,0,70
75105,100,"LICEUL TEORETIC ""DUNAREA""",GALAŢI,GL,1415,11,5,0,16,24,5,0,29,35,5,0,40,53,7,0,60,67,8,0,75
75105,101,"ȘCOALA GIMNAZIALĂ ”MIHAIL SADOVEANU” (ȘCOALA GENERALĂ ”MIHAIL SADOVEANU” - ȘCOALA GENERALĂ NR. 11)",GALAŢI,GL,1534,11,1,0,12,40,2,0,42,62,2,0,64,82,4,0,86,82,4,0,86
75105,102,"ȘCOALA GIMNAZIALĂ ”MIHAIL SADOVEANU” (ȘCOALA GENERALĂ ”MIHAIL SADOVEANU” - ȘCOALA GENERALĂ NR. 11)",GALAŢI,GL,1522,18,0,0,18,58,2,0,60,75,3,0,78,86,3,0,89,92,4,0,96
75105,103,"ȘCOALA GIMNAZIALĂ ”MIHAIL SADOVEANU” (ȘCOALA GENERALĂ ”MIHAIL SADOVEANU” - ȘCOALA GENERALĂ NR. 11)",GALAŢI,GL,1176,8,3,0,11,35,5,0,40,51,6,0,57,62,6,0,68,67,6,0,73
75105,104,"ȘCOALA GIMNAZIALĂ ”MIHAIL SADOVEANU” (ȘCOALA GENERALĂ ”MIHAIL SADOVEANU” - ȘCOALA GENERALĂ NR. 11)",GALAŢI,GL,1442,12,0,0,12,44,0,0,44,59,2,0,61,76,3,0,79,82,3,0,85
75105,105,"ȘCOALA GIMNAZIALĂ ”MIHAIL SADOVEANU” (ȘCOALA GENERALĂ ”MIHAIL SADOVEANU” - ȘCOALA GENERALĂ NR. 11)",GALAŢI,GL,1420,13,2,0,15,40,2,0,42,56,2,0,58,79,2,0,81,87,2,0,89
75105,106,"ȘCOALA GIMNAZIALĂ ”MIHAIL SADOVEANU” (ȘCOALA GENERALĂ ”MIHAIL SADOVEANU” - ȘCOALA GENERALĂ NR. 11)",GALAŢI,GL,1394,18,5,0,23,55,5,0,60,77,5,0,82,91,7,0,98,100,8,0,108
75105,107,"ȘCOALA GIMNAZIALĂ NR. 10 (ȘCOALA GENERALĂ ”PETRE ȚUȚEA” - ȘCOALA GENERALĂ NR. 10)",GALAŢI,GL,1415,22,0,0,22,41,1,0,42,56,1,0,57,75,2,0,77,77,2,0,79
75105,108,"ȘCOALA GIMNAZIALĂ NR. 10 (ȘCOALA GENERALĂ ”PETRE ȚUȚEA” - ȘCOALA GENERALĂ NR. 10)",GALAŢI,GL,1451,7,0,0,7,28,1,0,29,44,1,0,45,74,2,0,76,76,5,0,81
75105,109,"ȘCOALA GIMNAZIALĂ NR. 10 (ȘCOALA GENERALĂ ”PETRE ȚUȚEA” - ȘCOALA GENERALĂ NR. 10)",GALAŢI,GL,1375,15,1,0,16,37,2,0,39,55,2,0,57,64,4,0,68,69,4,0,73
75105,110,"ȘCOALA GIMNAZIALĂ NR. 10 (ȘCOALA GENERALĂ ”PETRE ȚUȚEA” - ȘCOALA GENERALĂ NR. 10)",GALAŢI,GL,1468,9,0,0,9,36,0,0,36,52,0,0,52,79,0,0,79,82,0,0,82
75105,111,"ȘCOALA GIMNAZIALĂ NR. 10 (ȘCOALA GENERALĂ ”PETRE ȚUȚEA” - ȘCOALA GENERALĂ NR. 10)",GALAŢI,GL,1512,21,3,0,24,41,3,0,44,64,4,0,68,87,4,1,92,99,4,1,104
75105,112,"COLEGIUL TEHNIC ”TRAIAN VUIA” (GRUP ŞCOLAR TRANSPORTURI AUTO)",GALAŢI,GL,1324,7,0,0,7,28,0,0,28,42,0,0,42,60,0,0,60,72,0,0,72
75105,113,"COLEGIUL TEHNIC ”TRAIAN VUIA” (GRUP ŞCOLAR TRANSPORTURI AUTO)",GALAŢI,GL,1406,8,1,0,9,27,1,0,28,43,1,0,44,58,4,0,62,67,6,0,73
75105,114,"COLEGIUL TEHNIC ”TRAIAN VUIA” (GRUP ŞCOLAR TRANSPORTURI AUTO)",GALAŢI,GL,1338,9,0,0,9,35,0,0,35,52,0,0,52,67,0,0,67,79,0,0,79
75105,115,"ȘCOALA GIMNAZIALĂ ”SFINȚII ÎMPĂRAȚI” (ȘCOALA GENERALĂ ”SFINȚII ÎMPĂRAȚI”- ȘCOALA GENERALĂ NR. 42)",GALAŢI,GL,1383,14,0,0,14,47,2,0,49,63,4,0,67,88,4,0,92,96,4,0,100
75105,116,"ȘCOALA GIMNAZIALĂ ”SFINȚII ÎMPĂRAȚI” (ȘCOALA GENERALĂ ”SFINȚII ÎMPĂRAȚI”- ȘCOALA GENERALĂ NR. 42)",GALAŢI,GL,1623,7,5,0,12,53,5,0,58,72,7,0,79,87,7,0,94,93,7,0,100
75105,117,"ȘCOALA GIMNAZIALĂ ”SFINȚII ÎMPĂRAȚI” (ȘCOALA GENERALĂ ”SFINȚII ÎMPĂRAȚI”- ȘCOALA GENERALĂ NR. 42)",GALAŢI,GL,1406,18,0,0,18,40,0,0,40,62,1,0,63,92,1,0,93,102,1,0,103
75105,118,"ȘCOALA GIMNAZIALĂ ”SFÂNTUL GRIGORE TEOLOGUL” (ȘCOALA GENERALĂ ”SFÂNTUL GRIGORE TEOLOGUL” - ȘCOALA GENERALĂ NR. 41)",GALAŢI,GL,1564,17,0,0,17,52,4,0,56,71,6,0,77,94,6,0,100,105,6,0,111
75105,119,"ȘCOALA GIMNAZIALĂ ”SFÂNTUL GRIGORE TEOLOGUL” (ȘCOALA GENERALĂ ”SFÂNTUL GRIGORE TEOLOGUL” - ȘCOALA GENERALĂ NR. 41)",GALAŢI,GL,1508,13,0,0,13,50,2,0,52,67,3,0,70,91,3,0,94,101,3,0,104
75105,120,"ȘCOALA GIMNAZIALĂ ”SFÂNTUL GRIGORE TEOLOGUL” (ȘCOALA GENERALĂ ”SFÂNTUL GRIGORE TEOLOGUL” - ȘCOALA GENERALĂ NR. 41)",GALAŢI,GL,1531,9,5,0,14,40,5,0,45,61,5,0,66,84,5,0,89,85,5,0,90
75105,121,"ȘCOALA GIMNAZIALĂ ”SFÂNTUL GRIGORE TEOLOGUL” (ȘCOALA GENERALĂ ”SFÂNTUL GRIGORE TEOLOGUL” - ȘCOALA GENERALĂ NR. 41)",GALAŢI,GL,1553,16,4,0,20,48,4,0,52,60,4,0,64,86,4,0,90,91,4,0,95
75105,122,"LICEUL TEHNOLOGIC ”ANGHEL SALIGNY” (GRUP ȘCOLAR INDUSTRIAL ”ANGHEL SALIGNY” - LICEUL INDUSTRIAL NR.9)",GALAŢI,GL,1872,11,1,0,12,46,3,0,49,68,3,0,71,95,4,0,99,109,4,0,113
75105,123,"LICEUL TEHNOLOGIC ”ANGHEL SALIGNY” (GRUP ȘCOLAR INDUSTRIAL ”ANGHEL SALIGNY” - LICEUL INDUSTRIAL NR.9)",GALAŢI,GL,2389,6,1,0,7,15,8,0,23,23,8,0,31,36,9,0,45,36,9,0,45
75105,124,"LICEUL TEHNOLOGIC ”ANGHEL SALIGNY” (GRUP ȘCOLAR INDUSTRIAL ”ANGHEL SALIGNY” - LICEUL INDUSTRIAL NR.9)",GALAŢI,GL,1773,10,4,0,14,23,4,0,27,39,4,0,43,79,4,0,83,87,4,0,91
75105,125,"LICEUL TEHNOLOGIC ”ANGHEL SALIGNY” (GRUP ȘCOLAR INDUSTRIAL ”ANGHEL SALIGNY” - LICEUL INDUSTRIAL NR.9)",GALAŢI,GL,1845,6,2,0,8,26,2,0,28,29,2,0,31,46,2,0,48,50,2,0,52
75105,126,"LICEUL TEORETIC ”SFÂNTA MARIA” (GRUP ȘCOLAR INDUSTRIAL ”SFÂNTA MARIA” - LICEUL INDUSTRIAL NR.10)",GALAŢI,GL,1240,12,2,0,14,44,4,0,48,61,5,0,66,76,5,0,81,81,6,0,87
75105,127,"LICEUL TEORETIC ”SFÂNTA MARIA” (GRUP ȘCOLAR INDUSTRIAL ”SFÂNTA MARIA” - LICEUL INDUSTRIAL NR.10)",GALAŢI,GL,1529,19,4,0,23,49,5,0,54,68,5,0,73,92,5,0,97,97,5,0,102
75105,128,"ȘCOALA GIMNAZIALĂ ”ȘTEFAN CEL MARE” (ȘCOALA GENERALĂ ”ȘTEFAN CEL MARE” - ȘCOALA GENERALĂ NR. 13)",GALAŢI,GL,1464,15,5,0,20,37,5,0,42,63,5,0,68,82,5,0,87,90,5,0,95
75105,129,"ȘCOALA GIMNAZIALĂ ”ȘTEFAN CEL MARE” (ȘCOALA GENERALĂ ”ȘTEFAN CEL MARE” - ȘCOALA GENERALĂ NR. 13)",GALAŢI,GL,1593,18,4,0,22,55,6,0,61,83,6,0,89,111,7,0,118,112,9,0,121
75105,130,"COLEGIUL NAȚIONAL ”COSTACHE NEGRI” (LICEUL PEDAGOGIC “COSTACHE NEGRI”)",GALAŢI,GL,1575,17,1,0,18,54,2,19,75,70,8,19,97,87,9,19,115,89,9,19,117
75105,131,"COLEGIUL NAȚIONAL ”COSTACHE NEGRI” (LICEUL PEDAGOGIC “COSTACHE NEGRI”)",GALAŢI,GL,1509,22,0,0,22,65,1,0,66,93,3,0,96,114,6,0,120,118,6,0,124
75105,132,"COLEGIUL NAȚIONAL ”COSTACHE NEGRI” (LICEUL PEDAGOGIC “COSTACHE NEGRI”)",GALAŢI,GL,1489,8,0,0,8,42,0,0,42,68,6,0,74,87,8,0,95,94,8,0,102
75105,133,"ȘCOALA GIMNAZIALĂ ”GRIGORE MOISIL” (ȘCOALA GENERALĂ ”GRIGORE MOISIL” - ȘCOALA GENERALĂ NR. 38)",GALAŢI,GL,1716,9,2,0,11,38,3,0,41,51,4,0,55,74,4,0,78,85,5,0,90
75105,134,"ȘCOALA GIMNAZIALĂ ”GRIGORE MOISIL” (ȘCOALA GENERALĂ ”GRIGORE MOISIL” - ȘCOALA GENERALĂ NR. 38)",GALAŢI,GL,1402,15,5,0,20,39,5,0,44,64,5,0,69,87,5,0,92,95,5,0,100
75105,135,"ȘCOALA GIMNAZIALĂ ”GRIGORE MOISIL” (ȘCOALA GENERALĂ ”GRIGORE MOISIL” - ȘCOALA GENERALĂ NR. 38)",GALAŢI,GL,1451,16,1,0,17,33,1,0,34,37,1,0,38,56,1,0,57,65,3,0,68
75105,136,"ȘCOALA GIMNAZIALĂ ”GRIGORE MOISIL” (ȘCOALA GENERALĂ ”GRIGORE MOISIL” - ȘCOALA GENERALĂ NR. 38)",GALAŢI,GL,1730,15,4,0,19,35,5,0,40,55,5,0,60,78,5,0,83,82,5,0,87
75105,137,"ȘCOALA GIMNAZIALĂ ”GHEORGHE MUNTEANU” (ȘCOALA GENERALĂ ”GHEORGHE MUNTEANU” - ȘCOALA GENERALĂ NR. 31)",GALAŢI,GL,1514,21,1,0,22,45,1,0,46,63,1,0,64,85,1,0,86,88,1,0,89
75105,138,"ȘCOALA GIMNAZIALĂ ”GHEORGHE MUNTEANU” (ȘCOALA GENERALĂ ”GHEORGHE MUNTEANU” - ȘCOALA GENERALĂ NR. 31)",GALAŢI,GL,1540,7,7,0,14,27,7,0,34,37,7,0,44,57,8,0,65,62,8,0,70
75105,139,"ȘCOALA GIMNAZIALĂ ”GHEORGHE MUNTEANU” (ȘCOALA GENERALĂ ”GHEORGHE MUNTEANU” - ȘCOALA GENERALĂ NR. 31)",GALAŢI,GL,1474,17,6,0,23,42,6,0,48,48,6,0,54,63,6,0,69,70,6,0,76
75105,140,"GRĂDINIȚA CU PROGRAM NORMAL NR. 29, ARONDATĂ GRĂDINIȚEI CU PROGRAM PRELUNGIT ”CAMIL RESSU” (GRĂDINIȚA FILEȘTI - GRĂDINIȚA NR.29)",GALAŢI,GL,474,1,0,0,1,7,0,0,7,7,0,0,7,15,0,1,16,16,0,1,17
75105,141,"COLEGIUL TEHNIC ”PAUL DIMO” (LICEUL ENERGETIC NR.4)",GALAŢI,GL,1446,6,3,0,9,22,3,0,25,31,4,0,35,44,8,0,52,51,8,0,59
75105,142,"COLEGIUL TEHNIC ”PAUL DIMO” (LICEUL ENERGETIC NR.4)",GALAŢI,GL,1480,11,6,0,17,29,6,0,35,48,6,0,54,65,6,0,71,72,6,0,78
75105,143,"COLEGIUL TEHNIC ”PAUL DIMO” (LICEUL ENERGETIC NR.4)",GALAŢI,GL,1526,15,2,0,17,36,2,0,38,55,2,0,57,71,2,0,73,77,2,0,79
75105,144,"COLEGIUL TEHNIC ”PAUL DIMO” (LICEUL ENERGETIC NR.4)",GALAŢI,GL,1140,5,5,0,10,22,5,0,27,36,6,0,42,53,6,0,59,59,7,0,66
75105,145,"ȘCOALA GIMNAZIALĂ NR. 33 (ȘCOALA GENERALĂ ”SFÂNTUL DUMITRU” - ȘCOALA GENERALĂ NR.33)",GALAŢI,GL,1440,10,0,0,10,36,5,0,41,56,8,0,64,64,9,0,73,78,10,0,88
75105,146,"ȘCOALA GIMNAZIALĂ NR. 33 (ȘCOALA GENERALĂ ”SFÂNTUL DUMITRU” - ȘCOALA GENERALĂ NR.33)",GALAŢI,GL,1805,11,0,0,11,26,0,0,26,46,0,0,46,74,0,0,74,76,0,0,76
75105,147,"ȘCOALA GIMNAZIALĂ NR. 33 (ȘCOALA GENERALĂ ”SFÂNTUL DUMITRU” - ȘCOALA GENERALĂ NR.33)",GALAŢI,GL,1425,8,0,0,8,28,0,0,28,40,1,0,41,53,1,0,54,56,1,0,57
75105,148,"ȘCOALA GIMNAZIALĂ NR. 33 (ȘCOALA GENERALĂ ”SFÂNTUL DUMITRU” - ȘCOALA GENERALĂ NR.33)",GALAŢI,GL,1405,14,6,0,20,37,8,0,45,50,8,0,58,74,8,0,82,78,9,0,87
75105,149,"ȘCOALA GIMNAZIALĂ ”MIHAI VITEAZUL” (ȘCOALA GENERALĂ ”MIHAI VITEAZUL” - ȘCOALA GENERALĂ NR. 34)",GALAŢI,GL,1602,8,0,0,8,29,2,0,31,53,4,0,57,75,7,0,82,76,7,0,83
75105,150,"ȘCOALA GIMNAZIALĂ ”MIHAI VITEAZUL” (ȘCOALA GENERALĂ ”MIHAI VITEAZUL” - ȘCOALA GENERALĂ NR. 34)",GALAŢI,GL,1405,9,0,0,9,34,0,0,34,44,0,0,44,65,0,0,65,68,0,0,68
75105,151,"GRĂDINIȚA CU PROGRAM PRELUNGIT NR. 47, ARONDATĂ GRĂDINIȚEI CU PROGRAM NORMAL ”ION CREANGĂ” (GRĂDINIȚA NR.47)",GALAŢI,GL,1767,14,2,0,16,34,2,0,36,49,4,0,53,72,7,0,79,75,7,0,82
75105,152,"GRĂDINIȚA CU PROGRAM PRELUNGIT NR. 47, ARONDATĂ GRĂDINIȚEI CU PROGRAM NORMAL ”ION CREANGĂ” (GRĂDINIȚA NR.47)",GALAŢI,GL,1682,12,0,0,12,29,1,0,30,40,6,0,46,63,6,0,69,63,6,0,69
75105,153,"GRĂDINIȚA CU PROGRAM PRELUNGIT NR. 47, ARONDATĂ GRĂDINIȚEI CU PROGRAM NORMAL ”ION CREANGĂ” (GRĂDINIȚA NR.47)",GALAŢI,GL,1542,6,0,0,6,22,0,0,22,34,0,0,34,44,0,0,44,49,0,0,49
75105,154,"GRĂDINIȚA CU PROGRAM PRELUNGIT NR. 47, ARONDATĂ GRĂDINIȚEI CU PROGRAM NORMAL ”ION CREANGĂ” (GRĂDINIȚA NR.47)",GALAŢI,GL,1887,8,0,0,8,16,0,0,16,23,0,0,23,29,0,0,29,31,0,0,31
75105,155,"COLEGIUL TEHNIC ”AUREL VLAICU” (GRUP ȘCOLAR METALURGIC - LICEUL INDUSTRIAL NR. 3 )",GALAŢI,GL,1299,8,4,0,12,20,4,0,24,25,6,0,31,46,6,0,52,47,6,0,53
75105,156,"COLEGIUL TEHNIC ”AUREL VLAICU” (GRUP ȘCOLAR METALURGIC - LICEUL INDUSTRIAL NR. 3 )",GALAŢI,GL,1732,19,3,0,22,33,3,0,36,46,3,0,49,61,4,0,65,71,4,0,75
75105,157,"COLEGIUL TEHNIC ”AUREL VLAICU” (GRUP ȘCOLAR METALURGIC - LICEUL INDUSTRIAL NR. 3 )",GALAŢI,GL,1561,20,0,0,20,51,0,0,51,62,4,0,66,86,4,0,90,103,4,0,107
75105,158,"COLEGIUL TEHNIC ”AUREL VLAICU” (GRUP ȘCOLAR METALURGIC - LICEUL INDUSTRIAL NR. 3 )",GALAŢI,GL,1470,4,0,0,4,24,4,0,28,43,5,0,48,62,5,0,67,62,5,0,67
75105,159,"LICEUL TEORETIC ”MIRCEA ELIADE” (GRUP ȘCOLAR INDUSTRIAL ”GHEORGHE ASACHI” - LICEUL INDUSTRIAL NR. 8)",GALAŢI,GL,1914,7,0,0,7,13,1,0,14,14,2,0,16,24,2,0,26,28,7,0,35
75105,160,"LICEUL TEORETIC ”MIRCEA ELIADE” (GRUP ȘCOLAR INDUSTRIAL ”GHEORGHE ASACHI” - LICEUL INDUSTRIAL NR. 8)",GALAŢI,GL,1315,5,0,0,5,26,2,0,28,37,3,0,40,45,3,0,48,49,3,0,52
75105,161,"LICEUL TEORETIC ”MIRCEA ELIADE” (GRUP ȘCOLAR INDUSTRIAL ”GHEORGHE ASACHI” - LICEUL INDUSTRIAL NR. 8)",GALAŢI,GL,1716,11,5,0,16,25,5,0,30,35,6,0,41,43,6,0,49,44,7,0,51
75105,162,"LICEUL TEHNOLOGIC CĂI FERATE (GRUP ȘCOLAR INDUSTRIAL TRANSPORTURI CF - LICEUL CFR)",GALAŢI,GL,1570,10,0,0,10,27,0,0,27,37,0,0,37,64,1,0,65,68,2,0,70
75105,163,"LICEUL TEHNOLOGIC CĂI FERATE (GRUP ȘCOLAR INDUSTRIAL TRANSPORTURI CF - LICEUL CFR)",GALAŢI,GL,1541,8,0,0,8,24,0,0,24,33,0,0,33,45,0,0,45,51,0,0,51
75105,164,"LICEUL TEHNOLOGIC CĂI FERATE (GRUP ȘCOLAR INDUSTRIAL TRANSPORTURI CF - LICEUL CFR)",GALAŢI,GL,1586,10,0,0,10,35,0,0,35,43,0,0,43,57,0,0,57,62,1,0,63
75105,165,"ȘCOALA GIMNAZIALĂ ”MIRON COSTIN” (ȘCOALA GENERALĂ ”MIRON COSTIN” - ȘCOALA GENERALĂ NR.12)",GALAŢI,GL,1503,17,0,0,17,56,2,0,58,61,9,0,70,83,9,0,92,93,9,0,102
75105,166,"ȘCOALA GIMNAZIALĂ ”MIRON COSTIN” (ȘCOALA GENERALĂ ”MIRON COSTIN” - ȘCOALA GENERALĂ NR.12)",GALAŢI,GL,1543,7,2,0,9,30,4,0,34,46,9,0,55,57,12,0,69,65,13,0,78
75105,167,"ȘCOALA GIMNAZIALĂ ”MIRON COSTIN” (ȘCOALA GENERALĂ ”MIRON COSTIN” - ȘCOALA GENERALĂ NR.12)",GALAŢI,GL,1612,16,5,0,21,35,5,0,40,47,7,0,54,56,8,0,64,62,8,0,70
75105,168,"ȘCOALA GIMNAZIALĂ ”MIRON COSTIN” (ȘCOALA GENERALĂ ”MIRON COSTIN” - ȘCOALA GENERALĂ NR.12)",GALAŢI,GL,1562,11,0,0,11,32,0,0,32,53,0,0,53,68,0,0,68,77,1,0,78
75105,169,"ȘCOALA GIMNAZIALĂ ”MIRON COSTIN” (ȘCOALA GENERALĂ ”MIRON COSTIN” - ȘCOALA GENERALĂ NR.12)",GALAŢI,GL,1514,11,0,0,11,51,0,0,51,66,0,0,66,85,2,0,87,89,2,0,91
75105,170,"ȘCOALA GIMNAZIALĂ ”MIRON COSTIN” (ȘCOALA GENERALĂ ”MIRON COSTIN” - ȘCOALA GENERALĂ NR.12)",GALAŢI,GL,1553,10,0,0,10,45,0,0,45,60,0,0,60,88,0,0,88,95,0,0,95
75105,171,"ȘCOALA GIMNAZIALĂ ”MIRON COSTIN” (ȘCOALA GENERALĂ ”MIRON COSTIN” - ȘCOALA GENERALĂ NR.12)",GALAŢI,GL,1409,8,2,0,10,29,3,0,32,36,3,0,39,53,3,0,56,53,3,0,56
75105,172,"ȘCOALA GIMNAZIALĂ ”MIRON COSTIN” (ȘCOALA GENERALĂ ”MIRON COSTIN” - ȘCOALA GENERALĂ NR.12)",GALAŢI,GL,1518,11,0,0,11,40,2,0,42,56,3,0,59,78,4,0,82,83,4,0,87
75105,173,"ȘCOALA GIMNAZIALĂ ”MIRON COSTIN” (ȘCOALA GENERALĂ ”MIRON COSTIN” - ȘCOALA GENERALĂ NR.12)",GALAŢI,GL,1496,6,6,0,12,31,6,0,37,45,11,0,56,69,11,0,80,73,11,0,84
75105,174,"ȘCOALA GIMNAZIALĂ ”MIRON COSTIN” (ȘCOALA GENERALĂ ”MIRON COSTIN” - ȘCOALA GENERALĂ NR.12)",GALAŢI,GL,1381,5,2,0,7,33,2,0,35,48,2,0,50,67,2,0,69,75,2,0,77
75105,175,"GRĂDINIȚA CU PROGRAM NORMAL NR. 20, ARONDATĂ ȘCOLII GIMNAZIALE ”MIRON COSTIN” (GRĂDINIȚA NR. 20 - ANEXA ȘCOLII NR. 12)",GALAŢI,GL,1536,6,2,0,8,29,2,0,31,40,2,0,42,64,3,0,67,72,3,0,75
75105,176,"GRĂDINIȚA CU PROGRAM NORMAL NR. 20, ARONDATĂ ȘCOLII GIMNAZIALE ”MIRON COSTIN” (GRĂDINIȚA NR. 20 - ANEXA ȘCOLII NR. 12)",GALAŢI,GL,1449,14,2,0,16,35,2,0,37,51,3,0,54,66,3,0,69,66,3,0,69
75212,177,"ŞCOALA NR.1",TECUCI,GL,1326,2,0,0,2,8,2,0,10,26,3,0,29,34,6,0,40,39,6,0,45
75212,178,"ŞCOALA NR.1",TECUCI,GL,1314,6,3,0,9,10,3,0,13,21,3,0,24,24,3,0,27,29,3,0,32
75212,179,"ŞCOALA NR.1",TECUCI,GL,1497,9,2,0,11,17,2,0,19,23,2,0,25,29,2,0,31,33,2,0,35
75212,180,"ŞCOALA NR.10",TECUCI,GL,936,16,0,0,16,41,0,0,41,58,5,0,63,72,5,0,77,76,5,0,81
75212,181,"ŞCOALA NR.10",TECUCI,GL,746,10,0,0,10,18,0,0,18,37,0,0,37,50,0,0,50,51,0,0,51
75212,182,"ŞCOALA NR.2",TECUCI,GL,1000,9,2,0,11,24,2,0,26,32,2,0,34,41,3,0,44,44,5,0,49
75212,183,"ŞCOALA NR.2",TECUCI,GL,1430,14,1,0,15,28,1,0,29,37,2,0,39,41,3,0,44,44,3,0,47
75212,184,"BIROU OBOR",TECUCI,GL,1662,8,0,0,8,14,1,0,15,26,1,0,27,31,1,0,32,31,1,0,32
75212,185,"ŞCOALA NR.4",TECUCI,GL,1019,11,4,0,15,23,7,0,30,36,9,0,45,51,9,0,60,60,9,0,69
75212,186,"ŞCOALA NR.4",TECUCI,GL,755,16,5,0,21,28,6,0,34,33,7,0,40,46,7,0,53,48,7,0,55
75212,187,"LICEUL SPIRU HARET",TECUCI,GL,1219,8,0,0,8,19,3,0,22,23,3,0,26,32,3,0,35,35,3,0,38
75212,188,"LICEUL SPIRU HARET",TECUCI,GL,712,3,1,0,4,13,2,0,15,29,8,0,37,34,8,0,42,34,10,0,44
75212,189,"COLEGIUL AGRICOL",TECUCI,GL,1045,9,1,0,10,22,2,0,24,33,2,0,35,49,5,0,54,49,5,0,54
75212,190,"COLEGIUL AGRICOL",TECUCI,GL,1312,12,4,0,16,48,4,0,52,54,4,0,58,67,5,0,72,71,6,0,77
75212,191,"GRĂDINIŢA NR.17",TECUCI,GL,1144,5,0,0,5,13,3,0,16,25,3,0,28,42,3,0,45,50,4,0,54
75212,192,"GRĂDINIŢA NR.17",TECUCI,GL,914,8,1,0,9,19,2,0,21,25,2,0,27,40,2,0,42,42,3,0,45
75212,193,"ŞCOALA NR.11",TECUCI,GL,863,8,1,0,9,20,2,0,22,27,2,0,29,40,3,0,43,48,3,0,51
75212,194,"ŞCOALA NR.11",TECUCI,GL,1190,9,2,0,11,32,3,0,35,41,3,0,44,54,4,0,58,60,6,0,66
75212,195,"ŞCOALA NR.11",TECUCI,GL,1158,8,0,0,8,20,0,0,20,26,0,0,26,31,0,0,31,39,0,0,39
75212,196,"ŞCOALA NR.8",TECUCI,GL,1303,6,5,0,11,28,7,0,35,44,7,0,51,51,7,0,58,62,9,0,71
75212,197,"ŞCOALA NR.6",TECUCI,GL,1439,16,2,0,18,25,2,0,27,35,2,0,37,46,2,0,48,52,2,0,54
75212,198,"ŞCOALA NR.6",TECUCI,GL,1136,6,1,0,7,26,3,0,29,43,3,0,46,45,3,0,48,46,3,0,49
75212,199,"ŞCOALA NR.7",TECUCI,GL,1138,4,6,0,10,12,6,0,18,16,6,0,22,22,6,0,28,25,6,0,31
75212,200,"ŞCOALA NR.7",TECUCI,GL,1035,2,1,0,3,12,1,0,13,19,5,0,24,25,5,0,30,27,5,0,32
75212,201,"GRĂDINIŢADIN CARTIERUL N BALCESCU",TECUCI,GL,997,5,0,0,5,10,0,0,10,15,0,0,15,22,2,0,24,22,4,0,26
75212,202,"GRĂDINIŢA 18",TECUCI,GL,1209,25,4,0,29,47,5,0,52,60,6,0,66,83,8,0,91,85,8,0,93
75212,203,"GRĂDINIŢA NR.2",TECUCI,GL,1074,14,0,0,14,32,0,0,32,46,0,1,47,57,1,1,59,62,1,1,64
75212,204,"GRĂDINIŢA NR.2",TECUCI,GL,1281,21,0,0,21,47,1,0,48,59,2,0,61,73,3,0,76,77,3,0,80
75212,205,"LICEUL CALISTRAT HOGAŞ",TECUCI,GL,877,12,6,0,18,19,7,0,26,22,7,0,29,27,8,0,35,27,11,0,38
75212,206,"LICEUL CALISTRAT HOGAŞ",TECUCI,GL,905,8,0,0,8,22,1,0,23,32,1,0,33,40,1,0,41,44,1,0,45
75212,207,"GRĂDINIŢA NR.1",TECUCI,GL,914,2,0,0,2,22,3,0,25,29,3,0,32,44,3,0,47,45,3,0,48
75212,208,"CAMINUL NR. 15",TECUCI,GL,810,12,2,0,14,28,2,0,30,34,2,0,36,46,2,0,48,48,2,0,50
75212,209,"ŞCOALA NR.9",TECUCI,GL,974,8,1,0,9,21,1,0,22,35,2,0,37,47,2,0,49,51,2,0,53
75347,210,"CASA DE CULTURA „ION CREANGĂ"" BERESTI",BEREŞTI,GL,1296,13,1,0,14,22,1,0,23,29,1,0,30,41,2,0,43,42,2,0,44
75347,211,"LICEUL TEHNOLOGIC „PAUL BUJOR"" BERESTI",BEREŞTI,GL,1392,10,0,0,10,15,2,0,17,20,2,0,22,24,2,0,26,27,2,0,29
75481,212,"GRADINIŢA NR.2 CĂSUŢA PITICILOR","TÎRGU BUJOR",GL,736,7,0,0,7,10,1,0,11,12,1,0,13,16,1,0,17,17,1,0,18
75481,213,"GRADINIŢA NR.2 CĂSUŢA PITICILOR","TÎRGU BUJOR",GL,809,5,8,0,13,9,9,0,18,18,9,0,27,24,9,0,33,24,9,0,33
75481,214,"ŞCOALA GIMNAZIALĂ ,,GRIGORE HAGIU,,","TÎRGU BUJOR",GL,1362,7,4,0,11,18,5,0,23,23,8,0,31,32,8,0,40,35,9,0,44
75481,215,"LICEUL TEHNOLOGIC ,,EREMIA GRIGORESCU,,","TÎRGU BUJOR",GL,1082,7,0,0,7,25,1,0,26,36,3,0,39,42,4,0,46,48,4,0,52
75490,216,"SCOALA GENERALĂ MOSCU",MOSCU,GL,1035,11,2,0,13,30,2,0,32,30,3,0,33,30,5,2,37,35,6,2,43
75506,217,"SCOALA GENERALĂ UMBRĂREŞTI",UMBRĂREŞTI,GL,915,5,2,0,7,8,2,0,10,11,3,0,14,12,3,0,15,15,3,0,18
75524,218,"ŞCOALA NR. 2 BARCEA",BARCEA,GL,775,9,1,0,10,20,3,0,23,28,3,0,31,37,3,0,40,45,3,0,48
75524,219,"ŞCOALA NR. 2 BARCEA",BARCEA,GL,932,1,1,0,2,5,2,0,7,9,2,0,11,14,6,0,20,15,6,0,21
75524,220,"ŞCOALA NR. 3 BARCEA",BARCEA,GL,1014,6,0,0,6,11,2,0,13,15,2,0,17,23,3,0,26,24,3,0,27
75524,221,"ŞCOALA NR. 1 BARCEA",BARCEA,GL,1097,4,0,0,4,8,0,0,8,14,1,0,15,20,2,0,22,21,2,0,23
75533,222,"ŞCOALA NR. 4 PODOLENI",PODOLENI,GL,1245,0,0,0,0,10,0,0,10,15,0,0,15,22,0,0,22,22,0,0,22
75551,223,"CĂMINUL CULTURAL BĂLĂBĂNEŞTI",BĂLĂBĂNEŞTI,GL,625,3,0,0,3,6,3,0,9,22,9,0,31,31,9,0,40,31,10,0,41
75560,224,"CAMIN CULTURAL BURSUCANI",BURSUCANI,GL,495,2,1,0,3,3,2,0,5,8,2,0,10,10,2,0,12,11,3,0,14
75588,225,"SCOALA GENERALĂ LUNGEŞTI",LUNGEŞTI,GL,476,4,3,0,7,14,5,0,19,19,5,0,24,24,5,0,29,27,5,0,32
75622,226,"CĂMINUL CULTURAL BĂLĂŞEŞTI",BĂLĂŞEŞTI,GL,933,6,1,0,7,13,1,0,14,16,1,0,17,22,2,0,24,23,5,0,28
75640,227,"GRADINITA CIUREŞTII NOI","CIUREŞTII NOI",GL,420,4,0,0,4,7,2,0,9,10,2,0,12,14,7,0,21,14,7,0,21
75631,228,"SCOALA GENERALĂ CIUREŞTI",CIUREŞTI,GL,267,1,0,0,1,3,0,0,3,4,0,0,4,6,0,0,6,7,0,0,7
75659,229,"SCOALA GENERALĂ PUPEZENI",PUPEZENI,GL,151,1,0,0,1,2,0,0,2,4,4,0,8,6,4,0,10,6,4,0,10
75677,230,"“ȘCOALA GIMNAZIALĂ NR. 1 BĂLENI”",BĂLENI,GL,950,7,6,0,13,10,8,0,18,15,8,0,23,25,8,0,33,25,8,0,33
75677,231,"“ȘCOALA GIMNAZIALĂ NR. 1 BĂLENI”",BĂLENI,GL,1004,7,2,0,9,20,4,0,24,23,4,0,27,28,6,0,34,28,6,0,34
75702,232,"SCOALA PRIMARA ,,ION VODA CEL VITEAZ ROSCANI",ROŞCANI,GL,495,2,0,0,2,5,0,0,5,9,2,0,11,12,2,0,14,12,2,0,14
75695,233,"CĂMIN CULTURAL",BĂNEASA,GL,1217,10,1,0,11,19,3,0,22,28,4,0,32,55,7,0,62,69,7,0,76
75365,234,"ŞCOALA GIMNAZIALĂ NR. 1 SAT BEREŞTI - MERIA",BEREŞTI-MERIA,GL,435,7,3,0,10,8,3,0,11,8,3,0,11,9,6,0,15,11,6,0,17
75445,235,"ŞCOALAGIMNAZIALĂ NR. 1 SAT SLIVNA",SLIVNA,GL,565,1,4,0,5,1,4,0,5,1,4,0,5,6,4,0,10,8,4,0,12
75427,236,"CĂMIN CULTURAL",PURICANI,GL,223,6,0,0,6,12,3,0,15,16,4,0,20,18,4,0,22,20,6,0,26
75374,237,"ŞCOALA PRIMARĂ ANDRONACHI GOGA NR. 1 SAT ALDEŞTI",ALDEŞTI,GL,365,6,0,0,6,7,1,0,8,9,2,0,11,15,2,0,17,16,2,0,18
75409,238,"GRĂDINIŢA CU PROGRAM NORMAL NR. 1 SAT PLEŞA",PLEŞA,GL,534,3,1,0,4,6,5,0,11,12,5,0,17,14,6,0,20,14,6,0,20
75383,239,"SALA DE SPORT BALINTEȘTI",BALINTEŞTI,GL,801,2,1,0,3,6,2,0,8,8,2,0,10,22,8,0,30,22,8,0,30
75720,240,"ȘCOALA GIMNAZIALĂ UNIREA BRANIȘTEA",BRANIŞTEA,GL,1244,11,0,0,11,21,0,0,21,23,0,0,23,38,2,0,40,38,2,0,40
75720,241,"ȘCOALA GIMNAZIALĂ UNIREA BRANIȘTEA",BRANIŞTEA,GL,1024,8,0,0,8,12,1,0,13,18,1,0,19,24,1,0,25,25,1,0,26
75757,242,"SCOALA GENERALA VASILE ALECSANDRI","VASILE ALECSANDRI",GL,893,6,1,0,7,8,4,0,12,17,6,0,23,30,8,0,38,30,9,0,39
75748,243,"SCOALA GENERALĂ TRAIAN",TRAIAN,GL,465,5,0,0,5,7,0,0,7,8,0,0,8,11,2,0,13,12,5,0,17
75775,244,"SCOALA GIMNAZIALA NR.1 BRĂHĂŞEŞTI",BRĂHĂŞEŞTI,GL,1261,15,2,0,17,29,4,0,33,45,9,0,54,54,11,0,65,60,13,0,73
75775,245,"SCOALA GIMNAZIALA NR.1 BRĂHĂŞEŞTI",BRĂHĂŞEŞTI,GL,1035,3,2,0,5,12,7,0,19,24,7,0,31,31,7,0,38,32,7,0,39
75800,246,"SCOALA GIMNAZIALA TOFLEA",TOFLEA,GL,1501,9,0,0,9,27,3,0,30,44,3,0,47,53,4,0,57,55,4,0,59
75800,247,"SCOALA GIMNAZIALA TOFLEA",TOFLEA,GL,1121,9,2,0,11,19,4,0,23,22,4,0,26,31,8,0,39,34,8,0,42
75800,248,"SCOALA GIMNAZIALA TOFLEA",TOFLEA,GL,1421,6,0,0,6,32,1,0,33,55,1,0,56,66,3,0,69,69,3,0,72
75828,249,"SCOALA NATALIA NEGRU",BUCIUMENI,GL,939,5,1,0,6,17,6,0,23,30,7,2,39,32,8,2,42,38,10,2,50
75837,250,"SCOALA SMARANDA BRAESCU",HĂNŢEŞTI,GL,392,4,3,0,7,7,5,0,12,11,6,0,17,13,6,0,19,13,8,0,21
75855,251,"SCOALA CU CLASE I-IV",VIZUREŞTI,GL,325,2,3,0,5,4,4,0,8,5,5,0,10,8,7,0,15,9,7,0,16
75846,252,"SCOALA CU CLASE I-IV","TECUCELU SEC",GL,363,4,0,0,4,5,0,0,5,6,0,0,6,11,3,0,14,12,3,0,15
75873,253,"SCOALA PRIMARA NR.3",CAVADINEŞTI,GL,186,0,5,0,5,0,6,0,6,3,6,0,9,5,6,0,11,5,6,0,11
75873,254,"SCOALA GIMNAZIALĂ NR.2",CAVADINEŞTI,GL,882,7,0,0,7,14,4,0,18,19,4,0,23,30,4,0,34,39,8,0,47
75891,255,"SCOALA GIMNAZIALA GĂNEŞTI",GĂNEŞTI,GL,733,4,5,0,9,9,5,0,14,12,5,0,17,13,6,0,19,13,6,0,19
75908,256,"SCOALA GENERALĂ VĂDENI",VĂDENI,GL,373,3,1,0,4,11,4,0,15,13,4,0,17,17,4,0,21,18,5,0,23
75882,257,"SCOALA GENERALĂ COMĂNEŞTI",COMĂNEŞTI,GL,182,3,0,0,3,3,0,0,3,5,4,0,9,6,4,0,10,9,4,0,13
75926,258,"SCOALA GIMNAZIALA GEORGE IVASCU",CERŢEŞTI,GL,699,5,5,0,10,8,5,0,13,14,7,0,21,14,7,0,21,18,7,0,25
75935,259,"SCOALA GIMNAZIALA",CÎRLOMĂNEŞTI,GL,624,2,0,0,2,11,2,0,13,12,3,0,15,16,4,0,20,16,5,0,21
75944,260,"SCOALA PRIMARA",COTOROAIA,GL,581,2,0,0,2,5,0,0,5,7,2,0,9,8,2,0,10,11,5,0,16
76013,261,"SCOALA NOUA - SAT CORNI",CORNI,GL,702,0,2,0,2,8,5,0,13,10,5,0,15,12,5,0,17,12,5,0,17
76022,262,"SCOALA GENERALA MĂCIŞENI",MĂCIŞENI,GL,661,0,0,0,0,2,0,0,2,4,1,0,5,9,4,0,13,10,7,0,17
76031,263,"SCOALA GENERALA URLEŞTI",URLEŞTI,GL,387,7,4,0,11,12,5,0,17,15,7,0,22,22,7,0,29,26,7,0,33
75962,264,"ŞCOALA NR.2 COROD",COROD,GL,1226,9,1,0,10,12,5,0,17,20,7,0,27,25,11,0,36,25,11,0,36
75962,265,"CĂMIN CULTURAL COROD",COROD,GL,1253,8,1,0,9,19,5,0,24,27,8,0,35,32,9,0,41,34,9,0,43
75962,266,"ŞCOALA NR.3 COROD",COROD,GL,1523,1,0,0,1,16,0,0,16,22,1,0,23,28,2,0,30,29,4,0,33
75971,267,"ŞCOALA BLÎNZI",BLÎNZI,GL,975,4,0,0,4,4,0,0,4,8,0,0,8,8,0,0,8,9,0,0,9
75980,268,"ŞCOALA BRĂTULEŞTI",BRĂTULEŞTI,GL,492,3,0,0,3,5,0,0,5,13,0,0,13,16,0,0,16,16,0,0,16
75999,269,"ŞCOALA CĂRĂPCEŞTI",CĂRĂPCEŞTI,GL,644,4,4,0,8,7,5,0,12,11,9,0,20,11,9,0,20,13,10,0,23
76059,270,"ŞCOALA GIMNAZIALĂ ,,GENERAL DUMITRU DĂMĂCEANU""",COSMEŞTI,GL,1265,11,0,0,11,18,3,0,21,25,3,0,28,27,5,0,32,30,8,0,38
76077,271,"ŞCOALA CU CLASELE I-VIII COSMEŞTII-VALE",COSMEŞTII-VALE,GL,959,8,0,0,8,18,0,0,18,25,0,0,25,30,0,0,30,31,0,0,31
76068,272,"ŞCOALA CU CLASELE I-IV BĂLTĂREŢI",BĂLTĂREŢI,GL,742,4,2,0,6,15,2,0,17,16,2,0,18,18,2,0,20,19,2,0,21
76095,273,"CAMIN CULTURAL DIN SAT FURCENII VECHI","FURCENII VECHI",GL,1281,6,4,0,10,10,5,0,15,13,5,0,18,18,6,0,24,19,6,0,25
76086,274,"SCOALA CU CLASELE I-VIII FURCENII NOI","FURCENII NOI",GL,1291,11,1,0,12,15,1,0,16,20,1,0,21,26,2,0,28,31,5,0,36
76120,275,"CAMINUL CULTURAL COSTACHE NEGRI","COSTACHE NEGRI",GL,1167,14,1,0,15,33,1,0,34,39,1,0,40,46,2,0,48,52,2,0,54
76120,276,"CAMINUL CULTURAL COSTACHE NEGRI","COSTACHE NEGRI",GL,1022,3,2,0,5,15,5,0,20,19,7,0,26,31,8,0,39,33,9,0,42
76148,277,"CĂMINUL CULTURAL CUCA",CUCA,GL,943,4,1,0,5,15,8,0,23,25,10,0,35,33,12,0,45,33,12,0,45
76148,278,"ŞCOALA GENERALĂ CUCA",CUCA,GL,891,9,2,0,11,17,2,0,19,19,2,0,21,23,2,0,25,25,2,0,27
76166,279,"ȘCOALA GIMNAZIALĂ PROF. EMIL PANAITESCU",CUDALBI,GL,1749,8,2,0,10,19,2,0,21,33,2,0,35,49,2,0,51,52,3,0,55
76166,280,"ŞCOALA GIMNAZIALA PROF. EMIL PANAITESCU",CUDALBI,GL,1516,5,5,0,10,12,5,0,17,17,5,0,22,23,5,0,28,24,5,0,29
76166,281,"ŞCOALA GIMNAZIALA PROF. EMIL PANAITESCU",CUDALBI,GL,1317,5,1,0,6,14,1,0,15,16,1,0,17,19,2,0,21,20,2,0,22
76166,282,"LICEUL TEHNOLOGIC NR.1",CUDALBI,GL,1659,1,0,0,1,5,0,0,5,14,1,0,15,23,1,0,24,23,1,0,24
77206,283,"ŞCOALA GIMNAZIALA ELENA DOAMNA,","CUZA VODĂ",GL,1219,8,0,0,8,21,0,0,21,26,0,0,26,37,0,0,37,37,0,0,37
77206,284,"ŞCOALA GIMNAZIALA ELENA DOAMNA,","CUZA VODĂ",GL,1083,2,2,0,4,13,2,0,15,18,2,0,20,20,2,0,22,21,2,0,23
75230,285,"SCOALA DIN SATUL DRĂGĂNEŞTI",DRĂGĂNEŞTI,GL,1861,3,0,0,3,16,2,0,18,23,2,0,25,31,4,0,35,33,11,0,44
75230,286,"CAMINUL CULTURAL DIN SATUL DRĂGĂNEŞTI",DRĂGĂNEŞTI,GL,1851,4,0,0,4,12,3,0,15,14,3,0,17,25,4,0,29,29,5,0,34
75249,287,"SCOALA DIN MALUL ALB","MALU ALB",GL,1746,5,0,0,5,9,0,0,9,15,0,0,15,21,0,0,21,28,0,0,28
76184,288,"ŞCOALA DRĂGUŞENI",DRĂGUŞENI,GL,1493,5,0,0,5,9,0,0,9,15,0,0,15,25,2,0,27,27,2,0,29
76219,289,"SCOALA FUNDEANU",FUNDEANU,GL,752,0,0,0,0,5,0,0,5,8,0,0,8,14,0,0,14,14,0,0,14
76237,290,"SCOALA NICOPOLE",NICOPOLE,GL,454,2,4,0,6,4,4,0,8,6,4,0,10,10,4,0,14,10,5,0,15
76200,291,"SCOALA CĂUIEŞTI",CĂUIEŞTI,GL,467,0,0,0,0,2,1,0,3,7,4,0,11,10,6,0,16,11,6,0,17
76246,292,"SCOALA ŞTIETEŞTI",ŞTIEŢEŞTI,GL,254,10,2,0,12,11,2,0,13,15,2,0,17,16,2,0,18,18,2,0,20
76193,293,"SCOALA ADAM",ADAM,GL,595,4,0,0,4,9,1,0,10,9,3,0,12,17,5,0,22,17,5,0,22
76228,294,"SCOALA GHINGHEŞTI",GHINGHEŞTI,GL,225,0,0,0,0,1,0,0,1,4,0,0,4,11,0,0,11,12,0,0,12
76264,295,"CAMINUL CULTURAL FIRTANESTI",FÎRŢĂNEŞTI,GL,1392,8,0,0,8,15,0,0,15,22,4,0,26,25,6,0,31,27,6,0,33
76264,296,"CAMINUL CULTURAL FIRTANESTI",FÎRŢĂNEŞTI,GL,1455,6,0,0,6,10,4,0,14,21,4,0,25,29,6,0,35,30,6,0,36
76273,297,"CĂMINUL CULTURAL VIILE",VIILE,GL,1287,8,3,0,11,16,3,0,19,19,3,0,22,38,4,0,42,38,4,0,42
76291,298,"GRADINITA CU PROGRAM NORMAL NR. 1 FOLTESTI - SALA NR.1",FOLTEŞTI,GL,905,2,0,0,2,6,4,0,10,9,4,0,13,15,5,0,20,18,5,0,23
76291,299,"GRADINITA CU PROGRAM NORMAL NR.1 FOLTESTI - SALA NR.2",FOLTEŞTI,GL,915,2,1,0,3,10,3,0,13,11,4,0,15,17,6,0,23,18,6,0,24
76308,300,"SCOALA GIMNAZIALA NR.1 STOICANI",STOICANI,GL,862,9,1,0,10,13,8,0,21,21,10,0,31,36,11,0,47,38,11,0,49
76326,301,"ŞCOALA GENERALA NR.1 FRUMUŞIŢA (ŞCOALADIN CENTRU)",FRUMUŞIŢA,GL,1819,16,0,0,16,24,3,0,27,37,3,0,40,50,3,0,53,53,3,0,56
76326,302,"SCOALA GENERALĂ NR.2 PETRU RAREŞ",FRUMUŞIŢA,GL,859,9,0,0,9,16,0,0,16,20,0,0,20,23,2,0,25,27,8,0,35
76335,303,"SCOALA GENERALA IJDILENI",IJDILENI,GL,753,3,0,0,3,6,0,0,6,8,4,0,12,9,4,0,13,12,5,0,17
76344,304,"SCOALA GENERALA TĂMĂOANI",TĂMĂOANI,GL,966,5,2,0,7,16,4,0,20,23,4,0,27,28,5,0,33,29,5,0,34
76371,305,"ŞCOALA GENERALA FUNDENI",FUNDENI,GL,681,1,0,0,1,3,0,0,3,7,0,0,7,13,0,0,13,13,0,0,13
76399,306,"SCOALA ELEMENTARA LUNGOCI",LUNGOCI,GL,426,0,0,0,0,4,5,0,9,6,6,0,12,6,16,0,22,6,16,0,22
76380,307,"ŞCOALA GENERALA HANU CONACHI","HANU CONACHI",GL,1234,1,0,0,1,6,0,0,6,9,0,0,9,19,0,0,19,20,0,0,20
76380,308,"ŞCOALA GENERALA HANU CONACHI","HANU CONACHI",GL,866,1,0,0,1,4,0,0,4,12,0,0,12,16,1,0,17,20,3,0,23
76415,309,"ŞCOALA GIMNAZIALĂ NR.1 GHIDIGENI",GHIDIGENI,GL,1665,4,0,0,4,9,1,0,10,10,1,0,11,21,5,0,26,21,5,0,26
76433,310,ȘCOALAGEFU,GEFU,GL,830,0,0,0,0,1,0,0,1,3,0,0,3,3,0,0,3,5,0,0,5
76442,311,"ȘCOALA GÂRBOVĂȚ",GÎRBOVĂŢ,GL,213,1,0,0,1,5,3,0,8,9,5,0,14,10,6,0,16,10,6,0,16
76479,312,ȘCOALATĂLPIGI,TĂLPIGI,GL,1658,4,0,0,4,8,0,0,8,12,1,0,13,17,1,0,18,17,1,0,18
76460,313,ȘCOALASLOBOZIA,"SLOBOZIA CORNI",GL,639,2,3,0,5,3,4,0,7,6,4,0,10,10,7,0,17,13,8,0,21
76503,314,"ŞCOALA GIMNAZIALA NR.1 GOHOR",GOHOR,GL,1345,10,1,0,11,14,1,0,15,25,4,0,29,33,4,0,37,35,4,0,39
76521,315,"ŞCOALA CU CLASELE I-IV IREASCA",IREASCA,GL,223,1,1,0,2,5,3,0,8,8,4,0,12,18,5,0,23,20,5,0,25
76530,316,"ŞCOALA CU CLASELE I-IV NĂRTEŞTI",NĂRTEŞTI,GL,670,6,0,0,6,11,2,0,13,19,2,0,21,24,2,0,26,25,2,0,27
76512,317,"ŞCOALA GIMNAZIALA - SAT GARA BERHECI","GARA BERHECI",GL,547,1,0,0,1,6,1,0,7,7,1,0,8,7,1,0,8,9,1,0,10
76567,318,"SCOALA NOUA GRIVITA",GRIVIŢA,GL,1518,9,2,0,11,13,2,0,15,13,4,0,17,17,4,0,21,32,6,0,38
76567,319,"ŞCOALA VECHE GRIVIŢA",GRIVIŢA,GL,999,4,4,0,8,10,4,0,14,21,4,0,25,30,5,0,35,36,5,0,41
76576,320,"SCOALA PRIMARA, SAT CĂLMĂŢUI",CĂLMĂŢUI,GL,573,5,0,0,5,11,2,0,13,18,2,0,20,35,3,0,38,43,6,0,49
76594,321,"SCOALA GIMNAZIALA NR. 1",INDEPENDENŢA,GL,1370,7,0,0,7,16,2,0,18,17,4,0,21,24,4,0,28,28,7,0,35
76594,322,"SCOALA GIMNAZIALA NR. 2",INDEPENDENŢA,GL,1638,5,0,0,5,20,0,0,20,30,6,0,36,51,9,0,60,57,9,0,66
76594,323,"CLADIREA GRADINITA NR.1",INDEPENDENŢA,GL,931,4,1,0,5,10,2,0,12,12,3,0,15,16,3,0,19,19,3,0,22
76610,324,"ŞCOALA NR.2 IVEŞTI",IVEŞTI,GL,754,0,0,0,0,0,2,0,2,6,2,0,8,19,2,0,21,24,2,0,26
76610,325,"ŞCOALA GIMNAZIALĂ ""VICTOR ION POPA "" IVEŞTI (ŞCOALA GIMNAZIALA NR.3 IVEŞTI)",IVEŞTI,GL,1509,13,1,0,14,48,7,0,55,88,7,0,95,163,11,0,174,187,12,0,199
76610,326,"LICEUL TEHNOLOGIC “HORTENSIA PAPADAT – BENGESCU”",IVEŞTI,GL,1022,9,3,0,12,16,3,0,19,17,4,0,21,22,5,0,27,30,6,0,36
76610,327,"LICEUL TEHNOLOGIC “HORTENSIA PAPADAT – BENGESCU”",IVEŞTI,GL,1022,3,5,0,8,20,8,0,28,25,13,0,38,34,16,0,50,38,16,0,54
76629,328,"ŞCOALA GIMNAZIALA “NEGOIŢĂ DĂNĂILĂ”",BUCEŞTI,GL,1924,7,3,0,10,15,4,0,19,22,7,0,29,42,10,0,52,45,10,0,55
76629,329,"ŞCOALA GIMNAZIALA “GEN.EREMIA GRIGORESCU”",BUCEŞTI,GL,1773,5,5,0,10,15,5,0,20,25,7,0,32,44,12,0,56,51,12,0,63
76647,330,"CĂMINUL CULTURAL JORĂȘTI",JORĂŞTI,GL,916,8,2,0,10,20,5,0,25,30,5,0,35,43,6,0,49,46,6,0,52
76656,331,"SALĂ ÎNTRUNIRI LUNCA",LUNCA,GL,177,5,4,0,9,8,4,0,12,9,4,0,13,10,4,0,14,10,4,0,14
76665,332,"CĂMINUL CULTURAL ZĂRNEȘTI",ZĂRNEŞTI,GL,289,8,3,0,11,13,3,0,16,19,3,0,22,31,3,0,34,33,3,0,36
76683,333,"ŞCOALA GIMNAZIALĂ NR. 1",LIEŞTI,GL,1701,8,2,0,10,12,2,0,14,20,3,0,23,32,4,0,36,35,4,0,39
76683,334,"ŞCOALA GIMNAZIALĂ NR. 2",LIEŞTI,GL,1517,11,2,0,13,16,5,0,21,19,5,0,24,29,9,0,38,31,9,0,40
76683,335,"ŞCOALA GIMNAZIALĂ NR. 2",LIEŞTI,GL,1375,6,0,0,6,12,0,0,12,20,1,0,21,37,2,0,39,50,2,0,52
76683,336,"ŞCOALA GIMNAZIALĂ NR. 3",LIEŞTI,GL,1435,5,5,0,10,15,5,0,20,24,6,0,30,29,7,0,36,30,8,0,38
76683,337,"GRADINITA NR. 3",LIEŞTI,GL,1402,3,5,0,8,11,6,0,17,12,7,0,19,20,7,0,27,25,7,0,32
76683,338,"ŞCOALA GIMNAZIALĂ""SFÂNTUL NICOLAE""",LIEŞTI,GL,1500,6,3,0,9,14,4,0,18,14,4,0,18,21,5,0,26,22,5,0,27
76709,339,"ŞCOALA NR.2 MATCA",MATCA,GL,1475,7,5,0,12,10,5,0,15,18,7,0,25,26,9,0,35,31,12,0,43
76709,340,"ŞCOALA NR.1 SUSENI",MATCA,GL,1813,8,1,0,9,24,1,0,25,34,2,0,36,45,2,0,47,49,4,0,53
76709,341,"SCOALA NR.1 MATCA",MATCA,GL,1533,1,0,0,1,5,0,0,5,10,3,0,13,11,3,0,14,12,4,0,16
76709,342,"SCOALA NR.1 MATCA",MATCA,GL,1588,3,0,0,3,11,1,0,12,13,1,0,14,17,2,0,19,20,5,0,25
76709,343,"ŞCOALA NR.1 MATCA",MATCA,GL,1597,3,0,0,3,9,0,0,9,20,0,0,20,32,0,0,32,33,0,0,33
76709,344,"SCOALA NR.3 MATCA",MATCA,GL,1878,3,0,0,3,7,0,0,7,10,0,0,10,15,2,0,17,15,2,0,17
76727,345,"SCOALA GIMNAZIALA NR 1 GHE. POALELUNGI MASTACANI",MĂSTĂCANI,GL,1115,2,0,0,2,6,2,0,8,13,2,0,15,18,7,0,25,19,7,0,26
76727,346,"SCOALA GIMNAZIALA NR. 3 MĂSTĂCANI",MĂSTĂCANI,GL,807,3,0,0,3,6,0,0,6,11,0,0,11,19,2,0,21,19,3,0,22
76736,347,"SCOALA GIMNAZIALA NR. 1 CHIRAFTEI",CHIRAFTEI,GL,1124,8,1,0,9,19,2,0,21,27,2,0,29,33,2,0,35,35,2,0,37
76736,348,"SCOALA GIMNAZIALA NR. 2 CHIRAFTEI",CHIRAFTEI,GL,1085,2,1,0,3,8,3,0,11,8,4,6,18,13,5,6,24,16,6,6,28
76754,349,"CAMIN CULTURAL",MOVILENI,GL,1580,4,1,0,5,15,3,0,18,22,3,0,25,28,3,0,31,34,3,0,37
76754,350,"SCOALA NR.2 MOVILENI",MOVILENI,GL,1182,7,1,0,8,9,1,0,10,14,3,0,17,23,8,0,31,25,8,0,33
75267,351,"SCOALA GIMNAZIALA NR.2",MUNTENI,GL,1383,12,3,0,15,16,3,0,19,20,3,0,23,33,4,0,37,40,4,0,44
75267,352,"SCOALA GENERALĂ NR.1 SAT MUNTENI",MUNTENI,GL,1640,6,5,0,11,10,6,0,16,17,8,0,25,20,8,0,28,22,9,0,31
75276,353,"SCOALA GENERALĂ FRUNZEASCA",FRUNZEASCA,GL,1006,4,4,0,8,7,6,0,13,11,8,0,19,16,8,0,24,19,8,1,28
75301,354,"SCOALA GENERALĂ – SAT ŢIGĂNEŞTI",ŢIGĂNEŞTI,GL,840,2,1,0,3,6,4,0,10,10,4,0,14,12,4,0,16,13,4,0,17
75310,355,"SCOALA GENERALĂ UNGURENI",UNGURENI,GL,1136,6,0,0,6,10,0,0,10,17,1,0,18,22,2,0,24,22,2,0,24
76772,356,"SCOALA GENERALA NAMOLOASA",NĂMOLOASA,GL,809,9,1,0,10,16,4,0,20,21,4,0,25,27,4,0,31,27,4,0,31
76790,357,"SCOALA GENERALA NAMOLOASA SAT","NĂMOLOASA SAT",GL,925,7,1,0,8,18,1,0,19,29,2,0,31,38,2,0,40,46,5,0,51
75285,358,"CĂMINUL CULTURAL DIN SATUL NEGRILEŞTI",NEGRILEŞTI,GL,1407,4,1,0,5,9,2,0,11,12,3,0,15,33,4,0,37,36,4,0,40
75294,359,"SCOALA GENERALĂ SLOBOZIA BLĂNEASA","SLOBOZIA BLĂNEASA",GL,761,3,0,0,3,9,2,0,11,17,2,0,19,28,8,0,36,30,8,0,38
76816,360,"ŞCOALA NICOREŞTI",NICOREŞTI,GL,1174,5,1,0,6,12,2,0,14,20,7,0,27,25,9,0,34,29,9,0,38
76852,361,"ŞCOALA FÎNTÂNI",FÎNTÎNI,GL,497,9,2,0,11,10,6,0,16,12,6,0,18,17,6,0,23,18,7,0,25
76834,362,"ŞCOALA COASTA LUPEI","COASTA LUPEI",GL,268,1,5,0,6,1,5,0,6,3,5,0,8,4,8,0,12,4,9,0,13
76898,363,"ŞCOALA PISCU CORBULUI","PISCU CORBULUI",GL,243,2,0,0,2,5,0,0,5,8,0,0,8,11,1,0,12,11,1,0,12
76889,364,"ŞCOALA MĂLURENI",MĂLURENI,GL,164,2,0,0,2,3,1,0,4,4,1,0,5,4,2,0,6,5,3,0,8
76870,365,"ŞCOALA IONĂŞEŞTI",IONĂŞEŞTI,GL,549,7,0,0,7,8,0,0,8,12,0,0,12,12,0,0,12,13,0,0,13
76843,366,"ŞCOALA DOBRINEŞTI.",DOBRINEŞTI,GL,402,5,2,0,7,5,2,0,7,5,2,0,7,5,3,0,8,7,3,0,10
76941,367,"SCOALA GIMNAZIALA OANCEA",OANCEA,GL,1235,8,0,0,8,17,0,0,17,39,0,0,39,65,10,0,75,73,11,0,84
76978,368,"SCOALA NR.1 PECHEA",PECHEA,GL,1308,0,0,0,0,6,1,0,7,15,6,0,21,23,6,0,29,24,6,0,30
76978,369,"SCOALA NR.2 PECHEA",PECHEA,GL,1452,2,2,0,4,7,5,0,12,14,5,0,19,19,6,0,25,20,6,0,26
76978,370,"SCOALA NR.3 PECHEA",PECHEA,GL,1437,5,6,0,11,10,6,0,16,15,6,0,21,24,6,0,30,28,6,0,34
76978,371,"GRĂDINIŢA NR.2 PECHEA",PECHEA,GL,1336,4,2,0,6,15,4,0,19,19,4,0,23,31,5,0,36,33,5,0,38
76978,372,"CĂMINUL CULTURAL PECHEA",PECHEA,GL,1924,6,1,0,7,16,3,0,19,21,3,0,24,27,3,0,30,29,4,0,33
76978,373,"SCOALA NR.4 PECHEA",PECHEA,GL,1733,8,1,0,9,30,2,0,32,60,2,0,62,87,2,0,89,88,2,1,91
77000,374,"CĂMINUL CULTURAL ” PANAIT IONPOET” PISCU",PISCU,GL,1127,4,5,0,9,26,7,0,33,36,10,0,46,55,18,0,73,57,19,0,76
77000,375,"SCOALAGIMNAZIALĂ ”DIMITRIE LUCHIAN ”CORP B , PISCU",PISCU,GL,933,7,0,0,7,21,0,0,21,31,0,0,31,40,2,0,42,44,2,0,46
77000,376,"SCOALAGIMNAZIALĂ ” STEFAN CEL MARE” PISCU",PISCU,GL,1525,17,1,0,18,29,1,0,30,36,1,0,37,51,1,0,52,59,6,0,65
77019,377,"ȘCOALAPRIMARĂ VAMEȘ",VAMEŞ,GL,447,4,0,0,4,14,0,0,14,21,0,0,21,26,0,0,26,26,0,0,26
76905,378,"GRADINITA CU PROGRAM NORMAL NR.1 COMUNA POIANA,JUDETUL GALATI",POIANA,GL,1021,14,7,0,21,24,9,0,33,28,14,43,85,30,15,43,88,57,15,43,115
76923,379,"SCOALA PRIMARA NR.1 SAT VISINA, COMUNA POIANA, JUDETUL GALATI",VIŞINA,GL,395,7,3,0,10,10,4,0,14,16,4,0,20,17,4,0,21,19,4,0,23
77037,380,"SCOALA GIMNAZIALĂ",PRIPONEŞTI,GL,781,7,5,0,12,10,5,0,15,12,5,0,17,18,6,0,24,19,6,0,25
77046,381,"CĂMIN CULTURAL",CIORĂŞTI,GL,831,1,0,0,1,4,2,0,6,18,4,0,22,23,5,0,28,25,6,0,31
77064,382,"ȘCOALA PRIMARĂ",LIEŞTI,GL,170,3,2,0,5,6,4,0,10,7,5,0,12,11,5,0,16,14,8,0,22
75597,383,"CĂMINUL CULTURAL RĂDEŞTI",RĂDEŞTI,GL,955,31,6,0,37,46,11,0,57,68,11,0,79,99,14,0,113,105,14,0,119
75579,384,"GRĂDINIŢA CRUCEANU",CRUCEANU,GL,242,6,2,0,8,10,3,0,13,16,3,0,19,16,3,0,19,25,3,0,28
77091,385,"FOSTA GRADINITA NR. 1 REDIU",REDIU,GL,1322,4,1,0,5,12,2,0,14,19,6,0,25,28,9,0,37,30,9,0,39
77108,386,"SCOALA NR1 PLEVNA",PLEVNA,GL,460,5,3,0,8,13,4,0,17,19,8,0,27,27,8,0,35,27,8,0,35
77162,387,"GRADINITA DE COPII SCHELA",SCHELA,GL,1397,1,0,0,1,8,0,0,8,17,1,0,18,26,3,0,29,36,4,0,40
77162,388,"GRADINITA DE COPII SCHELA",SCHELA,GL,1170,7,0,0,7,17,2,0,19,18,5,0,23,26,7,0,33,39,11,0,50
77171,389,"SCOALA GENERALA NEGREA",NEGREA,GL,538,6,1,0,7,11,2,0,13,15,2,0,17,16,3,0,19,16,3,0,19
77135,390,"CAMINUL CULTURAL",SCÎNTEIEŞTI,GL,738,2,3,0,5,11,3,0,14,15,4,0,19,17,8,0,25,21,8,0,29
77144,391,"CAMINUL CULTURAL",FÎNTÎNELE,GL,1283,9,1,0,10,18,1,0,19,26,1,0,27,38,3,0,41,44,7,0,51
77199,392,"SCOALA GIMNAZIALA SLOBOZIA-CONACHI","SLOBOZIA CONACHI",GL,1393,9,0,0,9,19,2,0,21,25,3,0,28,34,3,0,37,34,3,0,37
77199,393,"CENTRUL DE FORMARE PROFESIONALA","SLOBOZIA CONACHI",GL,1230,3,2,0,5,8,2,0,10,12,3,0,15,20,3,0,23,21,5,0,26
77215,394,"SCOALA GIMNAZIALA IZVOARELE",IZVOARELE,GL,837,2,4,0,6,5,4,0,9,9,4,0,13,11,4,0,15,15,6,0,21
77233,395,"SCOALA GENERALĂ “SFÂNTA CUVIOASĂ PARASCHEVA” SMÎRDAN",SMÎRDAN,GL,1398,7,3,0,10,14,4,0,18,15,4,0,19,21,8,0,29,21,8,0,29
77233,396,"ŞCOALA GENERALĂ“SFÂNTA CUVIOASĂ PARASCHEVA” SMÂRDAN",SMÎRDAN,GL,1147,7,1,0,8,10,2,0,12,14,4,0,18,22,5,0,27,24,5,0,29
77251,397,"SCOALA GIMNAZIALĂ “MIHAIL ŞI GAVRIL” M.KOGĂLNICEANU","MIHAIL KOGĂLNICEANU",GL,872,3,1,0,4,9,3,0,12,13,9,0,22,18,9,0,27,19,10,0,29
77242,398,"SCOALA PRIMARĂ NR.1 CIŞMELE",CIŞMELE,GL,1217,8,0,0,8,12,1,0,13,20,1,0,21,26,7,0,33,29,8,0,37
77279,399,"GRADINITA SMULTI",SMULŢI,GL,1154,3,4,0,7,17,7,0,24,29,9,0,38,50,13,0,63,52,13,0,65
77297,400,"CĂMINUL CULTURAL SUCEVENI",SUCEVENI,GL,966,26,7,0,33,60,11,0,71,84,12,0,96,107,21,0,128,129,21,0,150
77304,401,"SCOALA GIMNAZIALĂ ROGOJENI",ROGOJENI,GL,462,10,2,0,12,20,5,0,25,28,5,0,33,47,8,0,55,54,10,0,64
77117,402,"SCOALA GIMNAZIALĂ NR.1 SUHURLUI",SUHURLUI,GL,1165,9,7,0,16,11,8,0,19,16,8,0,24,19,10,0,29,20,10,0,30
75123,403,"SCOALA GIMNAZIALA NR. 1",ŞENDRENI,GL,1660,7,1,0,8,22,4,0,26,28,5,0,33,39,6,0,45,44,6,0,50
75123,404,"SCOALA GIMNAZIALA NR. 1",ŞENDRENI,GL,1158,5,0,0,5,19,2,0,21,27,2,0,29,38,3,0,41,38,3,0,41
75132,405,"GRADINITA MOVILENI",MOVILENI,GL,568,10,0,0,10,13,0,0,13,18,0,0,18,19,0,0,19,26,0,0,26
75141,406,"GRADINITA SERBESTII VECHI","ŞERBEŞTII VECHI",GL,665,2,1,0,3,6,1,0,7,10,1,0,11,19,1,0,20,21,1,0,22
77322,407,"ŞCOALA PRIMARĂ DE 4 CLASE, TUDOR VLADIMIRESCU","TUDOR VLADIMIRESCU",GL,819,6,3,0,9,12,4,0,16,22,7,0,29,50,12,0,62,60,15,0,75
77322,408,"GRĂDINIŢA TUDOR VLADIMIRESCU,","TUDOR VLADIMIRESCU",GL,1383,10,1,0,11,16,5,0,21,36,5,0,41,53,5,0,58,55,5,0,60
77322,409,"SCOALA GENERALA DE 4 ANI - PRIVAL","TUDOR VLADIMIRESCU",GL,938,8,0,0,8,13,3,0,16,21,6,0,27,41,8,0,49,47,17,0,64
77322,410,"LICEUL TEHNOLOGIC ""TUDOR VLADIMIRESCU""","TUDOR VLADIMIRESCU",GL,1225,12,0,0,12,22,2,0,24,36,5,0,41,50,5,0,55,53,7,0,60
77340,411,"GRADINITA TULUCESTI",TULUCEŞTI,GL,1621,12,1,0,13,17,8,0,25,25,8,0,33,44,11,0,55,44,11,0,55
77340,412,"SCOALA TULUCESTI",TULUCEŞTI,GL,1950,14,1,0,15,18,10,0,28,27,15,0,42,36,15,0,51,37,15,0,52
77368,413,"SCOALA TATARCA",TĂTARCA,GL,701,5,2,0,7,14,4,0,18,16,4,0,20,19,6,0,25,19,6,0,25
77359,414,"SCOALA SIVITA",ŞIVIŢA,GL,1061,6,0,0,6,11,0,0,11,17,0,0,17,25,0,0,25,30,0,0,30
77359,415,"ŞCOALA VECHE ŞIVIŢA",ŞIVIŢA,GL,1061,4,0,0,4,9,1,0,10,14,1,0,15,20,1,0,21,23,4,0,27
77386,416,"SCOALA TUDOR PAMFILE",ŢEPU,GL,1171,5,3,0,8,10,6,0,16,18,9,0,27,28,9,0,37,29,9,0,38
77386,417,"GRĂDINIŢA PROFESOR IOAN BASOC",ŢEPU,GL,860,9,0,0,9,11,0,0,11,12,1,0,13,13,1,0,14,20,1,0,21
77411,418,"ȘCOALA GIMNAZIALĂNR. 1 UMBRĂREȘTI",UMBRĂREŞTI,GL,1718,3,9,0,12,9,10,0,19,19,10,0,29,19,10,0,29,20,10,0,30
77466,419,"ȘCOALA GIMNAZIALĂ„ SFÂNTUL STELIAN” UMBRĂREȘTI - DEAL",UMBRĂREŞTI-DEAL,GL,1193,4,1,0,5,16,3,0,19,41,7,0,48,44,8,0,52,49,8,0,57
77466,420,"ȘCOALA GIMNAZIALĂ„ SFÂNTUL STELIAN„ UMBRĂREȘTI - DEAL",UMBRĂREŞTI-DEAL,GL,831,4,0,0,4,10,0,0,10,19,0,0,19,26,0,0,26,26,1,0,27
77457,421,"ȘCOALA GIMNAZIALĂTORCEȘTI",TORCEŞTI,GL,594,4,5,0,9,4,5,0,9,5,7,0,12,9,9,0,18,10,9,0,19
77420,422,"ȘCOALA GIMNAZIALĂ CONDREA",CONDREA,GL,569,4,1,0,5,10,3,0,13,12,7,0,19,14,7,0,21,15,9,0,24
77439,423,"ȘCOALA GIMNAZIALĂ SALCIA",SALCIA,GL,723,1,0,0,1,5,3,0,8,8,3,0,11,12,5,0,17,13,5,0,18
77448,424,"ȘCOALA GIMNAZIALĂ SILIȘTEA",SILIŞTEA,GL,276,1,0,0,1,2,1,0,3,6,6,0,12,8,6,0,14,9,9,0,18
77484,425,"ȘCOALA GIMNAZIALĂ NR.1","VALEA MĂRULUI",GL,992,4,1,0,5,16,3,0,19,20,3,0,23,26,7,0,33,30,17,0,47
77484,426,"ȘCOALA GIMNAZIALĂ NR. 1","VALEA MĂRULUI",GL,812,8,0,0,8,10,0,0,10,12,2,0,14,19,2,0,21,20,2,0,22
77484,427,"ȘCOALA COASTA VĂII","VALEA MĂRULUI",GL,377,4,4,0,8,5,4,0,9,5,4,0,9,5,4,0,9,6,4,0,10
77493,428,"ȘCOALA MÎNDRESTI",MÎNDREŞTI,GL,810,3,1,0,4,10,3,0,13,19,3,0,22,33,4,15,52,33,4,15,52
75169,429,"SCOALA SFINTUL NICOLAE",VÎNĂTORI,GL,1196,9,3,0,12,36,6,0,42,37,7,0,44,40,8,0,48,41,8,0,49
75169,430,"SCOALA SFINTUL NICOLAE",VÎNĂTORI,GL,1144,16,4,0,20,35,6,0,41,39,10,0,49,42,12,0,54,47,13,0,60
75187,431,"SCOALA MARIA GRECU","ODAIA MANOLACHE",GL,1603,5,3,0,8,25,12,0,37,42,13,0,55,59,13,0,72,63,14,0,77
75178,432,"GRADINITA COPII",COSTI,GL,1105,6,4,0,10,16,5,0,21,22,9,0,31,25,12,0,37,26,13,0,39
77518,433,"SCOALA GIMNAZIALĂ VÎRLEZI",VÎRLEZI,GL,896,6,1,0,7,17,5,0,22,25,7,0,32,33,8,0,41,36,8,0,44
77527,434,"GRĂDINIŢA CRĂIEŞTI",CRĂIEŞTI,GL,652,6,5,0,11,11,8,0,19,13,13,0,26,16,14,4,34,24,16,4,44
77545,435,"ŞCOALA GIMNAZIALẶ '' SFÎNTUL IERARH NICOLAE ''",VLĂDEŞTI,GL,1089,3,1,0,4,17,2,0,19,28,2,0,30,37,7,0,44,37,7,0,44
77554,436,"ȘCOALA GIMNAZIALĂ BRĂNEȘTI",BRĂNEŞTI,GL,887,1,0,0,1,12,0,0,12,13,1,0,14,14,1,0,15,17,1,0,18
100530,1,"ŞCOALA GIMNAZIALĂ SFÂNTUL GHEORGHE",GIURGIU,GR,1167,20,0,0,20,41,0,0,41,55,0,0,55,72,0,0,72,75,3,0,78
100530,2,"GALERIILE DE ARTĂ",GIURGIU,GR,1021,23,4,0,27,78,7,0,85,102,9,0,111,119,9,0,128,128,10,0,138
100530,3,"PRIMĂRIA MUNICIPIULUI GIURGIU",GIURGIU,GR,1136,14,3,0,17,43,4,0,47,54,4,0,58,73,4,0,77,77,5,0,82
100530,4,"LICEUL ""TUDOR VIANU""",GIURGIU,GR,1192,21,3,0,24,39,3,0,42,53,3,0,56,64,4,0,68,66,4,0,70
100530,5,"ŞCOALA GIMNAZIALĂ MIRCEA CEL BĂTRÂN",GIURGIU,GR,1302,15,0,0,15,55,5,0,60,82,5,0,87,99,6,0,105,110,8,0,118
100530,6,"LICEUL TEHNOLOGIC MIRON NICOLESCU",GIURGIU,GR,1154,7,2,0,9,19,4,0,23,22,4,0,26,29,4,0,33,32,4,0,36
100530,7,"CANTINA SEMINARULUI TEOLOGIC TEOCTIST PATRIARHUL",GIURGIU,GR,847,13,2,0,15,17,2,0,19,19,4,0,23,23,5,0,28,27,6,0,33
100530,8,"COLEGIUL TEHNIC VICEAMIRAL IOAN BĂLĂNESCU",GIURGIU,GR,1001,1,0,0,1,7,0,0,7,11,3,0,14,19,3,0,22,20,3,0,23
100530,9,"LICEUL ""NICOLAE CARTOJAN""",GIURGIU,GR,1271,4,7,0,11,18,7,0,25,32,8,0,40,40,8,0,48,40,8,0,48
100530,10,"LICEUL ""NICOLAE CARTOJAN""",GIURGIU,GR,1259,9,0,0,9,24,5,0,29,29,8,0,37,37,8,0,45,38,8,0,46
100530,11,"PALATUL COPIILOR (PARCUL ELEVILOR)",GIURGIU,GR,1098,23,1,0,24,53,1,0,54,71,2,0,73,87,8,0,95,94,11,0,105
100530,12,"ŞCOALA GIMNAZIALĂ NR.3",GIURGIU,GR,1357,5,0,0,5,16,0,0,16,23,0,0,23,37,0,0,37,38,0,0,38
100530,13,"GRĂDINIŢA CU PROGRAM NORMAL NR.8 GORNENI",GIURGIU,GR,1319,30,2,0,32,44,2,0,46,61,6,0,67,82,6,0,88,94,6,0,100
100530,14,"DIRECŢIA PENTRU AGRICULTURĂ JUDEŢEANĂ",GIURGIU,GR,1369,3,0,0,3,8,0,0,8,8,0,114,122,10,0,114,124,12,0,114,126
100530,15,"DIRECŢIA PENTRU AGRICULTURĂ JUDEŢEANĂ",GIURGIU,GR,1176,12,4,0,16,26,4,137,167,31,4,137,172,39,4,137,180,40,4,137,181
100530,16,"GRĂDINIŢA CU PN NR.8 CĂRĂMIDARI",GIURGIU,GR,1787,15,0,0,15,48,1,0,49,58,1,130,189,70,3,130,203,78,3,130,211
100530,17,"A.J.O.F.M. GIURGIU",GIURGIU,GR,1582,17,0,0,17,41,0,0,41,55,1,0,56,80,2,0,82,87,2,0,89
100530,18,"A.J.O.F.M. GIURGIU",GIURGIU,GR,1114,22,0,0,22,46,4,0,50,65,4,0,69,88,5,0,93,100,6,0,106
100530,19,"SPITALUL JUDEŢEAN",GIURGIU,GR,1870,8,3,0,11,37,4,1,42,51,5,1,57,73,5,1,79,83,7,1,91
100530,20,"CLUBUL CADRELOR MILITARE ÎN RETRAGERE",GIURGIU,GR,1595,19,4,0,23,49,4,0,53,66,4,0,70,93,6,0,99,101,6,0,107
100530,21,"ŞCOALA GIMNAZIALĂ ACAD. MARIN VOICULESCU",GIURGIU,GR,1152,7,5,0,12,30,5,0,35,38,5,0,43,53,5,0,58,57,5,0,62
100530,22,"ŞCOALA GIMNAZIALĂ ACAD. MARIN VOICULESCU",GIURGIU,GR,1203,16,0,0,16,36,0,0,36,47,0,0,47,65,1,0,66,74,1,0,75
100530,23,"ŞCOALA GIMNAZIALĂ ACAD. MARIN VOICULESCU",GIURGIU,GR,1314,8,1,0,9,30,1,0,31,36,2,0,38,49,4,0,53,55,5,0,60
100530,24,"ŞCOALA GIMNAZIALĂ ACAD. MARIN VOICULESCU",GIURGIU,GR,1047,14,6,0,20,30,7,0,37,46,9,0,55,66,9,0,75,75,9,0,84
100530,25,"GRĂDINIŢA CU PROGRAM NORMAL NR.6",GIURGIU,GR,1287,5,1,0,6,33,5,0,38,47,6,0,53,53,6,0,59,61,6,0,67
100530,26,"ŞCOALA GIMNAZIALĂ NR.10",GIURGIU,GR,1107,7,0,0,7,20,0,0,20,29,0,0,29,52,3,0,55,52,3,0,55
100530,27,"ŞCOALAGIMNAZIALĂ NR.10",GIURGIU,GR,1109,8,2,0,10,25,2,0,27,43,2,0,45,58,2,0,60,59,2,0,61
100530,28,"ŞCOALAGIMNAZIALĂ NR.10",GIURGIU,GR,1134,8,4,0,12,22,6,0,28,36,6,0,42,43,6,0,49,46,7,0,53
100530,29,"ŞCOALA GIMNAZIALĂ NR,10",GIURGIU,GR,915,14,1,0,15,39,1,0,40,58,1,0,59,71,1,0,72,72,1,0,73
100530,30,"ŞCOALAGIMNAZIALĂ NR.5",GIURGIU,GR,912,8,2,0,10,18,3,0,21,28,3,0,31,46,3,0,49,49,3,0,52
100530,31,"ŞCOALA GIMNAZIALĂ NR.5",GIURGIU,GR,1212,12,0,0,12,30,1,0,31,45,1,0,46,57,5,0,62,65,5,0,70
100530,32,"ŞCOALA GIMNAZIALĂ NR.5",GIURGIU,GR,1196,15,4,0,19,26,5,0,31,39,7,0,46,59,7,0,66,67,7,0,74
100530,33,"PUNCTUL TERMIC NR. 35",GIURGIU,GR,1267,6,2,0,8,22,3,0,25,39,3,0,42,62,5,0,67,64,5,0,69
100530,34,"PUNCTUL TERMIC NR.35",GIURGIU,GR,812,3,2,0,5,22,4,0,26,37,4,0,41,53,4,0,57,55,4,0,59
100530,35,"PUNCTUL TERMIC NR.63",GIURGIU,GR,1173,19,0,0,19,49,2,0,51,69,2,0,71,83,2,0,85,89,2,0,91
100530,36,"GRĂDINIŢA CU PN NR.9",GIURGIU,GR,975,10,0,0,10,22,0,0,22,32,0,0,32,47,0,0,47,49,0,0,49
100530,37,"GRĂDINIŢA CU PP NR.9",GIURGIU,GR,1026,6,0,0,6,22,0,0,22,26,5,0,31,37,5,0,42,44,5,0,49
100530,38,"GRĂDINIŢA CĂSUŢA FERMECATĂ",GIURGIU,GR,1098,7,4,0,11,24,4,0,28,40,4,0,44,57,4,0,61,60,4,0,64
100530,39,"CANTINA DE AJUTOR SOCIAL",GIURGIU,GR,937,8,0,0,8,19,0,0,19,24,1,0,25,35,1,0,36,39,2,0,41
100530,40,"ŞCOALA GIMNAZIALĂ SAVIN POPESCU",GIURGIU,GR,1420,15,4,0,19,32,5,0,37,45,5,0,50,66,7,0,73,74,7,0,81
100530,41,"ŞCOALA GIMNAZIALĂ SAVIN POPESCU",GIURGIU,GR,1143,15,3,0,18,35,4,0,39,50,4,0,54,59,6,0,65,65,6,0,71
100530,42,"LICEUL TEHNOLOGIC ION BARBU",GIURGIU,GR,1245,10,0,0,10,25,6,0,31,34,7,0,41,62,7,0,69,66,8,0,74
100530,43,"CASA ARMATEI",GIURGIU,GR,1134,7,2,0,9,30,6,0,36,38,6,0,44,47,6,0,53,59,7,0,66
100530,44,"COLEGIUL NAŢIONAL ""ION MAIORESCU""",GIURGIU,GR,1012,16,2,0,18,42,5,0,47,60,8,0,68,78,12,0,90,91,12,0,103
100530,45,"COLEGIUL NAŢIONAL ""ION MAIORESCU""",GIURGIU,GR,982,22,2,0,24,61,4,0,65,71,5,0,76,86,6,0,92,93,6,0,99
100530,46,"ŞCOALA GIMNAZIALĂ NR.7",GIURGIU,GR,1420,21,1,10,32,63,3,10,76,92,7,10,109,114,9,10,133,128,11,10,149
100530,47,"ŞCOALA GIMNAZIALĂ MIHAI EMINESCU",GIURGIU,GR,1378,39,4,0,43,81,5,0,86,98,11,0,109,119,12,0,131,129,12,0,141
100530,48,"GRĂDINIŢA CU PN NR.3",GIURGIU,GR,1318,5,1,1,7,52,3,0,55,67,3,0,70,90,3,0,93,104,3,0,107
101207,49,"ŞCOALA GIMNAZIALĂ NR. 1 BOLINTIN-VALE",BOLINTIN-VALE,GR,1204,6,2,0,8,21,7,0,28,26,9,0,35,44,12,0,56,49,12,0,61
101207,50,"ŞCOALA GIMNAZIALĂ NR. 1 BOLINTIN-VALE",BOLINTIN-VALE,GR,1357,1,0,0,1,6,1,0,7,7,5,0,12,14,5,0,19,15,5,0,20
101207,51,"ŞCOALA GIMNAZIALĂ NR. 1 BOLINTIN-VALE",BOLINTIN-VALE,GR,1604,1,4,0,5,10,5,0,15,14,5,0,19,14,6,0,20,14,7,0,21
101207,52,"LICEU TEHNOLOGIC ""DIMITRIE BOLINTINEANU""",BOLINTIN-VALE,GR,883,5,5,0,10,15,10,0,25,18,12,0,30,25,13,0,38,30,14,0,44
101207,53,PRIMĂRIE,BOLINTIN-VALE,GR,1714,5,4,0,9,16,7,0,23,24,15,0,39,32,19,0,51,34,22,0,56
101225,54,"ŞCOALA GIMNAZIALĂ NR. 1 MALU SPART","MALU SPART",GR,1407,2,2,0,4,7,2,0,9,16,4,0,20,29,4,0,33,30,6,0,36
101225,55,"ŞCOALA GIMNAZIALĂ NR. 1 MALU SPART","MALU SPART",GR,1559,6,1,0,7,14,1,0,15,23,2,0,25,27,2,0,29,31,3,0,34
101216,56,"GRĂDINIŢA CRIVINA",CRIVINA,GR,744,4,3,0,7,6,3,0,9,12,4,0,16,17,5,0,22,17,5,0,22
104145,57,"LICEUL TEHNOLOGIC TIU DUMITRESCU",MIHĂILEŞTI,GR,1002,13,0,0,13,27,4,0,31,40,4,0,44,56,14,0,70,59,14,0,73
104145,58,"LICEUL TEHNOLOGIC TIU DUMITRESCU",MIHĂILEŞTI,GR,893,10,1,0,11,20,9,0,29,28,11,0,39,33,12,0,45,35,12,0,47
104145,59,"LICEUL TEHNOLOGIC TIU DUMITRESCU",MIHĂILEŞTI,GR,968,10,0,0,10,28,0,0,28,36,2,0,38,51,3,0,54,52,3,0,55
104145,60,"ŞCOALA PRIMARĂ NR. 1 MIHĂILEŞTI-TUFA",MIHĂILEŞTI,GR,1084,3,3,0,6,19,12,0,31,26,15,0,41,27,16,0,43,27,16,0,43
104145,61,"ŞCOALA PRIMARĂ NR. 2 MIHĂILEŞTI-DRĂGĂNESCU",MIHĂILEŞTI,GR,365,6,0,0,6,15,7,0,22,21,12,0,33,29,26,0,55,30,27,0,57
104172,62,"ŞCOALA GIMNAZIALĂ NR. 1 POPEŞTI",POPEŞTI,GR,874,4,2,0,6,10,2,0,12,20,3,0,23,27,8,0,35,31,9,0,40
104163,63,"ŞCOALA PRIMARĂ NR. 3 NOVACI",NOVACI,GR,937,2,2,0,4,6,4,0,10,10,5,0,15,12,7,0,19,14,12,0,26
100790,64,"ŞCOALA GIMNAZIALĂ NR. 1 ADUNAŢII COPĂCENI",ADUNAŢII-COPĂCENI,GR,1568,9,0,0,9,16,2,0,18,27,4,0,31,39,5,0,44,55,5,0,60
100790,65,"ŞCOALA GIMNAZIALĂ NR. 1 ADUNAŢII COPĂCENI",ADUNAŢII-COPĂCENI,GR,1147,4,0,0,4,15,0,0,15,29,0,0,29,37,5,0,42,37,5,0,42
100807,66,"ŞCOALA GIMNAZIALĂ NR. 2 DĂRĂŞTI VLAŞCA",DĂRĂŞTI-VLAŞCA,GR,1645,6,0,0,6,28,5,0,33,54,9,0,63,66,17,0,83,75,18,0,93
100825,67,"GRĂDINIȚA CU PROGRAM NORMAL NR. 3 VARLAAM",VARLAAM,GR,477,6,4,0,10,9,6,0,15,12,6,0,18,15,8,0,23,17,8,0,25
100816,68,"GRĂDINIȚA CU PROGRAM NORMAL NR. 4 MOGOŞEŞTI",MOGOŞEŞTI,GR,380,3,4,0,7,4,5,0,9,13,6,0,19,14,6,0,20,17,6,0,23
101010,69,"ŞCOALA GIMNAZIALA ”MARIN M. ȚICULESCU” BĂNEASA",BĂNEASA,GR,1138,6,5,0,11,12,6,0,18,17,7,0,24,27,9,0,36,31,11,0,42
101010,70,"ŞCOALA PIMARĂ NR.5 BĂNEASA",BĂNEASA,GR,576,5,5,0,10,8,6,0,14,9,6,0,15,11,6,0,17,12,6,0,18
101010,71,"ŞCOALA PRIMARĂ NR.2 BĂNEASA",BĂNEASA,GR,806,5,1,0,6,13,2,0,15,16,4,0,20,21,5,0,26,22,5,0,27
101038,72,"ŞCOALA GIMNAZIALĂ ”REMUS BEGNESCU” PIETRELE",PIETRELE,GR,878,1,0,0,1,3,1,0,4,5,1,0,6,10,2,0,12,15,2,0,17
101029,73,"ŞCOALA PRIMARĂ NR. 3 FRASINU",FRASINU,GR,346,2,0,0,2,7,2,0,9,8,4,0,12,14,4,0,18,18,4,0,22
101047,74,"ŞCOALA PRIMARĂNR. 6SF. GHEORGHE","SFÎNTU GHEORGHE",GR,208,0,4,0,4,3,4,0,7,3,5,0,8,5,9,0,14,6,12,0,18
101172,75,"CĂMINUL CULTURAL BOLINTIN - DEAL",BOLINTIN-DEAL,GR,1411,1,0,0,1,6,0,0,6,12,5,0,17,19,8,0,27,20,10,0,30
101172,76,"ŞCOALA GIMNAZIALĂ BANU BALEANU",BOLINTIN-DEAL,GR,1198,4,1,0,5,9,4,0,13,17,4,0,21,29,13,0,42,29,14,0,43
101172,77,"GRĂDINIŢA DE COPII BOLINTIN - DEAL",BOLINTIN-DEAL,GR,987,3,4,0,7,15,4,0,19,33,4,0,37,39,4,0,43,40,4,0,44
101181,78,"ŞCOALA GIMNAZIALĂ NR. 2 MIHAI VODĂ","MIHAI VODĂ",GR,1593,9,2,0,11,12,4,0,16,19,6,0,25,33,14,0,47,35,15,0,50
101387,79,"ȘCOALA GIMNAZIALĂ NR. 1",BUCŞANI,GR,788,5,3,0,8,8,7,0,15,11,7,0,18,12,7,0,19,12,9,0,21
101430,80,"ŞCOALA GIMNAZIALĂ NR. 2","VADU LAT",GR,553,2,0,0,2,2,1,0,3,2,1,0,3,5,3,0,8,7,5,0,12
101421,81,"ŞCOALA PRIMARĂ NR. 3",PODIŞOR,GR,448,1,4,0,5,4,4,0,8,8,7,0,15,11,8,0,19,13,9,0,22
101412,82,"GRĂDINIȚA CU PROGRAM NORMAL NR. 6",OBEDENI,GR,367,4,4,0,8,6,7,0,13,6,11,0,17,13,14,0,27,18,14,0,32
101449,83,"ŞCOALA PRIMARĂ NR. 4",UIEŞTI,GR,256,4,1,0,5,9,3,0,12,12,3,0,15,16,5,0,21,16,6,0,22
101403,84,"ŞCOALA PRIMARĂ NR. 5",GOLEASCA,GR,358,1,1,0,2,4,1,0,5,11,3,0,14,22,3,0,25,26,3,0,29
101528,85,"CĂMINUL CULTURAL BULBUCATA",BULBUCATA,GR,1082,2,3,0,5,9,11,0,20,16,19,0,35,38,26,0,64,40,26,0,66
101626,86,"ŞCOALA GIMNAZIALA NR1BUTURUGENI",BUTURUGENI,GR,1019,7,0,0,7,19,3,0,22,24,6,0,30,31,7,0,38,35,8,0,43
101626,87,"CAMIN CULTURAL BUTURUGENI",BUTURUGENI,GR,600,9,0,0,9,17,2,0,19,19,2,0,21,26,5,0,31,35,5,0,40
101635,88,"ŞCOALA GIMNAZIALA NR 2 PĂDURENI",PĂDURENI,GR,1198,6,0,0,6,22,3,0,25,27,5,0,32,47,5,0,52,59,10,0,69
101653,89,"GRADINITA CU PROGRAM NORMAL NR 4POŞTA",POŞTA,GR,338,2,0,0,2,5,1,0,6,6,2,0,8,11,2,0,13,14,3,0,17
101671,90,"ŞCOALA VECHE CĂLUGĂRENI( MUZEU ).",CĂLUGĂRENI,GR,1455,7,31,0,38,11,36,0,47,19,38,0,57,21,45,0,66,22,45,0,67
101680,91,GRADINITABRĂNIŞTARI,BRĂNIŞTARI,GR,603,2,3,0,5,6,5,0,11,13,7,0,20,20,11,0,31,20,13,0,33
101715,92,"ŞCOALA GIMNAZIALA NR.3UZUNU",UZUNU,GR,1195,5,0,0,5,8,2,0,10,12,2,0,14,15,4,0,19,16,4,0,20
101706,93,"CĂMINUL CULTURAL HULUBEŞTI",HULUBEŞTI,GR,1323,7,0,0,7,16,1,0,17,22,2,0,24,26,3,0,29,26,3,0,29
101993,94,"CĂMINUL CULTURAL CLEJANI",CLEJANI,GR,1334,16,13,0,29,36,28,0,64,56,35,0,91,118,51,14,183,151,59,14,224
102008,95,"GRĂDINIŢA CU PN NR.3 NEAJLOV",NEAJLOVU,GR,1135,25,3,0,28,62,15,18,95,107,19,18,144,178,34,18,230,211,39,18,268
102080,96,"ŞCOALA GIMNAZIALA NR. 1 COLIBAŞI",COLIBAŞI,GR,897,7,1,0,8,12,3,0,15,19,3,0,22,23,8,0,31,26,8,0,34
102080,97,"ŞCOALA PRIMARA NR. 3 COLIBAŞI",COLIBAŞI,GR,739,0,0,0,0,1,3,0,4,1,5,0,6,29,7,0,36,42,9,0,51
102099,98,"ŞCOALA GIMNAZIALA NR. 2 CÂMPURELU",CÎMPURELU,GR,1085,5,5,0,10,9,5,0,14,11,7,0,18,20,7,0,27,27,7,0,34
102115,99,"LICEUL TEHNOLOGIC NR. 1 COMANA",COMANA,GR,837,19,11,0,30,37,28,0,65,67,47,0,114,105,63,0,168,114,66,0,180
102115,100,"LICEUL TEHNOLOGIC NR. 1 COMANA",COMANA,GR,879,17,8,0,25,42,18,0,60,73,26,0,99,109,30,0,139,116,31,0,147
102124,101,"GRADINITA CU PROGRAM NORMAL NR. 1 BUDENI",BUDENI,GR,581,18,12,0,30,43,29,0,72,68,38,0,106,101,57,0,158,135,69,0,204
102133,102,"ŞCOALA GIMNAZIALA NR. 3 FALASTOACA",FALAŞTOACA,GR,628,6,3,0,9,9,4,0,13,13,7,0,20,17,12,0,29,18,13,0,31
102142,103,"ŞCOALA GIMNAZIALA NR. 2 GRADISTEA",GRĂDIŞTEA,GR,1207,7,6,0,13,13,10,0,23,27,15,0,42,49,21,0,70,57,25,0,82
102151,104,"ŞCOALA GIMNAZIALA NR. 1 VLAD-TEPES","VLAD ŢEPEŞ",GR,1336,43,10,0,53,80,22,0,102,119,45,0,164,167,62,0,229,188,67,0,255
104029,105,"GRĂDINIŢA DE COPII COSOBA",COSOBA,GR,1085,6,1,0,7,11,2,0,13,19,5,0,24,31,6,0,37,35,6,0,41
104029,106,"GRĂDINIŢA DE COPII COSOBA",COSOBA,GR,1067,4,2,0,6,8,3,0,11,16,7,0,23,27,10,0,37,31,10,0,41
102357,107,"ŞCOALA GIMNAZIALĂ NICOLAE CREVEDIA","CREVEDIA MARE",GR,1203,15,0,0,15,21,9,0,30,30,11,0,41,54,12,0,66,64,12,0,76
102375,108,"ŞCOALAPRIMARĂ NR 1 DEALU",DEALU,GR,1074,4,6,0,10,28,6,0,34,42,6,0,48,91,7,0,98,102,8,0,110
102366,109,"ŞCOALA GIMNAZIALĂ DUMITRU PĂTRAȘCU","CREVEDIA MICĂ",GR,1537,13,5,0,18,20,6,0,26,30,6,0,36,85,8,0,93,103,9,0,112
102455,110,"CAMIN CULTURAL",DAIA,GR,508,10,0,0,10,14,1,0,15,22,1,0,23,30,4,0,34,38,6,0,44
102455,111,"SCOALA GIMNAZIALA NR.1 DAIA",DAIA,GR,288,0,15,0,15,6,19,0,25,8,19,0,27,11,19,0,30,11,19,0,30
102464,112,"GRADINIŢA CU PROGRAM NORMALNR.2 PLOPŞORU",PLOPŞORU,GR,611,5,0,0,5,10,2,0,12,13,2,0,15,13,3,0,16,15,4,0,19
102464,113,"GRĂDINIŢA CU PROGRAM NORMAL NR.3 PLOPŞORU",PLOPŞORU,GR,726,5,1,0,6,6,1,0,7,8,4,0,12,13,4,0,17,17,9,0,26
102801,114,"ŞCOALA GIMNAZIALĂ NR.2 STOENEŞTI",STOENEŞTI,GR,1584,1,1,0,2,8,4,0,12,20,5,0,25,27,7,0,34,34,7,0,41
102810,115,"ŞCOALA GIMNAZIALĂ NR.1 FLOREŞTI",FLOREŞTI,GR,1153,4,0,0,4,13,0,0,13,14,3,0,17,29,5,0,34,30,5,0,35
102810,116,"ŞCOALA GIMNAZIALĂ NR.1 FLOREŞTI",FLOREŞTI,GR,1016,4,1,0,5,8,2,0,10,9,3,0,12,17,5,0,22,18,5,0,23
102810,117,"ŞCOALA GIMNAZIALĂ NR.1 FLOREŞTI",FLOREŞTI,GR,1202,3,2,0,5,8,7,0,15,12,7,0,19,20,9,0,29,30,12,0,42
102829,118,"ŞCOALA GIMNAZIALĂ NR.3 PALANCA",PALANCA,GR,1217,2,0,0,2,7,0,0,7,10,2,0,12,16,2,0,18,18,2,0,20
102829,119,"ŞCOALA GIMNAZIALĂ NR.3 PALANCA",PALANCA,GR,981,0,3,0,3,2,4,0,6,4,4,0,8,7,4,0,11,9,7,0,16
102918,120,"CĂMINUL CULTURAL FRĂTEŞTI",FRĂTEŞTI,GR,1409,10,1,0,11,13,3,0,16,14,3,0,17,21,6,0,27,24,6,0,30
102918,121,"ŞCOALAGIMNAZIALA NR.2 LUNCA FRĂTEŞTI",FRĂTEŞTI,GR,648,4,1,0,5,8,3,0,11,9,4,0,13,17,4,0,21,17,4,0,21
102936,122,"CĂMINUL CULTURAL REMUŞ",REMUŞ,GR,1679,7,43,0,50,17,48,0,65,20,48,0,68,33,52,0,85,38,53,0,91
102927,123,"GRADINITACU PROGRAM NORMAL NR 3CETATEA",CETATEA,GR,401,2,1,0,3,11,1,0,12,23,3,0,26,24,7,0,31,26,7,0,33
102927,124,"GRADINITA CU PROGRAM NORMAL NR 4 CETATEA (BĂLĂNOAIA)",CETATEA,GR,222,2,3,0,5,9,6,0,15,12,8,0,20,12,9,0,21,15,9,0,24
103096,125,"ȘCOALAGIMNAZIALA NR. 1SAT GĂISENI , COM GĂISENI .",GĂISENI,GR,988,3,0,0,3,9,1,0,10,14,1,0,15,22,5,0,27,23,5,0,28
103096,126,"ȘCOALAGIMNAZIALA NR. 1SAT GĂISENI , COM GĂISENI ,",GĂISENI,GR,842,4,2,0,6,5,3,0,8,12,5,0,17,17,6,0,23,19,7,0,26
103112,127,"ȘCOALAGIMNAZIALA NR. 2 ,SAT CĂSCIOARELE COM GĂISENI",CĂSCIOARELE,GR,890,3,0,0,3,5,2,0,7,7,4,0,11,19,4,0,23,20,4,0,24
103112,128,"ȘCOALAGIMNAZIALA NR. 2SAT CĂSCIOARELE,COM GĂISENI",CĂSCIOARELE,GR,756,0,3,0,3,2,3,0,5,6,5,0,11,10,5,0,15,12,5,0,17
103103,129,"ȘCOALAPRIMARĂ NR. 3 SAT CĂRPENIȘU , COM GĂISENI",CĂRPENIŞU,GR,682,2,5,0,7,6,6,0,12,10,9,0,19,18,13,0,31,19,13,0,32
103121,130,"FOSTA ŞCOALA CU CLASELE I-IV PODU POPA NAE","PODU POPA NAE",GR,130,2,6,0,8,2,6,0,8,6,6,0,12,9,8,0,17,10,9,0,19
103210,131,"ŞCOALADIN CETĂTUIA",CETĂŢUIA,GR,144,3,3,0,6,8,9,0,17,9,9,0,18,12,12,0,24,13,12,0,25
103201,132,"ŞCOALA GIMNAZIALĂ ""DRĂGHICI DAVILA""",GĂUJANI,GR,936,10,0,0,10,21,0,0,21,28,1,0,29,41,1,0,42,45,1,0,46
103229,133,"GRĂDINIŢA CU PROGRAMNORMAL NR.1 PIETRIŞU",PIETRIŞU,GR,776,5,4,0,9,13,4,0,17,18,4,0,22,26,4,0,30,28,4,0,32
103247,134,"SCOALA GIMNAZIALA NR.1GHIMPATI",GHIMPAŢI,GR,1241,10,2,0,12,37,3,4,44,53,3,6,62,80,8,10,98,85,8,10,103
103247,135,"CLADIREA PRIMARIEI GHIMPATI",GHIMPAŢI,GR,563,11,4,0,15,21,11,0,32,25,16,57,98,35,20,57,112,39,21,57,117
103256,136,"GRĂDINIŢA CU PROGRAM NORMAL NR.5 COPACIU",COPACIU,GR,745,22,4,0,26,31,7,0,38,36,7,19,62,47,11,19,77,53,14,19,86
103265,137,"FOSTA ŞCOALA CU CLASELE I-VIII NAIPU",NAIPU,GR,1272,20,2,0,22,30,6,0,36,41,10,56,107,51,18,56,125,57,19,56,132
103274,138,"ŞCOALA PRIMARA NR.4 VALEA PLOPILOR","VALEA PLOPILOR",GR,520,13,0,0,13,24,2,0,26,37,3,0,40,63,3,0,66,90,3,0,93
103318,139,"CĂMINUL CULTURAL GOGOŞARI",GOGOŞARI,GR,645,12,2,0,14,21,9,0,30,34,20,0,54,47,30,0,77,49,31,0,80
103345,140,"FOSTA ŞCOALA RĂLEŞTI",RĂLEŞTI,GR,121,2,6,0,8,5,7,0,12,6,8,0,14,9,10,0,19,9,10,0,19
103327,141,"FOSTA PRIMĂRIE",DRĂGHICEANU,GR,91,8,5,0,13,9,8,0,17,12,9,0,21,12,11,0,23,12,12,0,24
103336,142,"DISPENSAR UMAN IZVORU",IZVORU,GR,530,6,4,0,10,15,14,0,29,22,15,0,37,37,23,0,60,44,24,0,68
103381,143,"ŞCOALA GIMNAZIALĂNR.1 GOSTINARI",GOSTINARI,GR,1523,11,1,0,12,47,4,0,51,66,7,0,73,88,13,0,101,131,24,0,155
103390,144,"ŞCOALA PRIMARĂ NR.3 MIRONEŞTI",MIRONEŞTI,GR,340,4,0,0,4,11,12,0,23,15,14,0,29,15,16,0,31,15,16,0,31
103363,145,"SCOALA GIMNAZIALA ANGHEL MARES - LOCAL GRADINITA GOSTINU",GOSTINU,GR,737,10,0,0,10,35,3,0,38,89,3,0,92,147,3,0,150,147,12,0,159
103363,146,"SCOALA GIMNAZIALA ANGHEL MARES- LOCAL GRADINITA GOSTINU",GOSTINU,GR,822,12,1,0,13,48,5,0,53,89,5,0,94,120,5,0,125,141,10,0,151
103416,147,"ŞCOALA GIMNZIALA NR. 1 GRADINARI",GRĂDINARI,GR,843,10,5,0,15,23,5,0,28,36,15,0,51,51,16,0,67,51,24,0,75
103425,148,"ŞCOALA GIMNAZIALA NR. 2 TÂNTAVA",TÎNTAVA,GR,1003,2,2,0,4,9,5,0,14,17,6,0,23,35,11,0,46,35,13,0,48
103434,149,"ŞCOALAPRIMARA NR. 3ZORILE",ZORILE,GR,848,14,2,0,16,22,2,0,24,36,7,0,43,47,10,0,57,53,10,0,63
103489,150,"ŞCOALA GIMNAZIALĂ NR.1 GREACA",GREACA,GR,1411,10,2,0,12,27,7,0,34,40,12,0,52,66,18,0,84,76,19,0,95
103498,151,"ŞCOALA PUŢU GRECI","PUŢU GRECI",GR,271,2,1,0,3,4,2,0,6,7,2,0,9,7,2,0,9,7,2,0,9
103504,152,"ŞCOALA ZBOIU",ZBOIU,GR,245,5,3,0,8,9,3,0,12,10,3,0,13,11,5,0,16,11,5,0,16
103657,153,"ŞCOALA GIMNAZIALĂ ""ELINA BASARAB"" HERĂŞTI",HERĂŞTI,GR,1715,9,5,0,14,12,5,0,17,21,10,0,31,36,11,0,47,45,12,0,57
103648,154,"LICEUL ""UDRISTE NASTUREL HOTARELE",HOTARELE,GR,1097,7,3,0,10,15,6,0,21,17,9,0,26,18,10,0,28,28,10,0,38
103648,155,"GRADINITA CU PROGRAM NORMALNR. 2",HOTARELE,GR,586,2,2,0,4,4,3,0,7,6,3,0,9,13,4,0,17,17,6,0,23
103648,156,"LICEUL ""UDRIŞTE NĂSTUREL""",HOTARELE,GR,633,0,2,0,2,0,4,0,4,2,5,0,7,8,5,0,13,13,5,0,18
103648,157,"GRADINITA CU PROGRAM NORMAL NR. 3",HOTARELE,GR,601,3,1,0,4,4,1,0,5,7,5,0,12,8,7,0,15,8,7,0,15
103700,158,"CĂMINUL CULTURAL IEPUREŞTI",IEPUREŞTI,GR,843,10,7,0,17,13,25,0,38,14,29,0,43,26,42,0,68,29,42,0,71
103737,159,"GRADINITA CU PROGRAM NORMAL NR. 2 GORNENI",GORNENI,GR,530,7,0,0,7,8,2,0,10,11,9,0,20,12,12,0,24,12,14,0,26
103746,160,"ŞCOALA STÂLPU",STÎLPU,GR,202,1,3,0,4,3,5,0,8,4,5,0,9,16,8,0,24,18,9,0,27
103666,161,"ŞCOALA GIMNAZIALĂ STOLNICUL CONSTANTIN CANTACUZINO - ISVOARELE",ISVOARELE,GR,1120,3,1,0,4,3,2,0,5,7,4,0,11,10,5,0,15,11,5,0,16
103684,162,"ŞCOALA TEIUŞU",TEIUŞU,GR,176,0,0,0,0,2,0,0,2,4,0,0,4,11,2,0,13,11,2,0,13
103906,163,"ŞCOALA GIMNAZIALA NR.1 IZVOARELE",IZVOARELE,GR,1036,3,3,0,6,13,6,0,19,18,8,0,26,26,9,0,35,28,11,0,39
103915,164,"ŞCOALA GIMNAZIALA NR.2 CHIRIACU",CHIRIACU,GR,1040,10,2,0,12,17,2,0,19,19,2,0,21,19,4,0,23,27,5,0,32
103933,165,"ŞCOALA GENERALĂ PETRU RAREŞ","PETRU RAREŞ",GR,75,2,8,0,10,9,22,0,31,14,30,0,44,17,36,0,53,20,41,0,61
103951,166,"GRADINITA CU PROGRAM NORMAL NR.3 VALEA BUJORULUI","VALEA BUJORULUI",GR,396,2,3,0,5,5,3,0,8,10,3,0,13,16,5,0,21,19,8,0,27
103924,167,"SEDIUL FOSTEI SECŢII DE MECANIZARE A SATULUI DIMITRIE CANTEMIR","DIMITRIE CANTEMIR",GR,136,1,3,0,4,2,7,0,9,6,9,0,15,8,11,0,19,8,13,0,21
103942,168,"ŞCOALA GENERALĂ RADU VODĂ","RADU VODĂ",GR,174,6,2,0,8,6,2,0,8,15,3,0,18,27,7,0,34,27,7,0,34
104001,169,PRIMĂRIE,JOIŢA,GR,1785,4,4,0,8,20,6,0,26,33,9,0,42,45,10,0,55,72,16,0,88
104010,170,"ȘCOALA GIMNAZIALĂNR.2 BÎCU",BÎCU,GR,1236,8,0,0,8,20,8,0,28,31,12,0,43,41,19,0,60,53,22,0,75
104056,171,"CĂMINUL CULTURAL LETCA NOUĂ","LETCA NOUĂ",GR,717,7,2,0,9,11,4,0,15,19,10,0,29,28,17,0,45,30,18,0,48
104065,172,"CĂMINUL CULTURAL LETCA VECHE","LETCA VECHE",GR,755,7,4,0,11,35,12,0,47,46,17,0,63,58,20,0,78,60,21,0,81
104074,173,"ŞCOALAGIMNAZIALĂ NR 2MILCOVĂŢU",MILCOVĂŢU,GR,1111,3,3,0,6,18,6,0,24,79,14,0,93,101,23,0,124,104,26,0,130
105927,174,"CĂMINUL CULTURAL MALU",MALU,GR,950,8,3,0,11,18,9,0,27,28,9,0,37,34,10,0,44,41,10,0,51
105927,175,"GRĂDINIŢA MALU",MALU,GR,868,6,0,0,6,19,0,0,19,25,0,0,25,26,0,0,26,26,0,0,26
104127,176,"SCOALA GIMNAZIALA DUMITRU CONSTANTIN MIHAI BRAVU","MIHAI BRAVU",GR,1050,16,4,0,20,35,11,0,46,60,23,0,83,110,28,0,138,133,28,0,161
104127,177,"SCOALA GIMNAZIALA DUMITRU CONSTANTIN MIHAI BRAVU","MIHAI BRAVU",GR,858,13,3,0,16,47,6,0,53,83,12,0,95,120,20,0,140,133,23,0,156
104234,178,"ŞCOALA GIMNAZIALĂNR. 1 MÂRŞA",MÂRŞA,GR,973,8,0,0,8,17,1,0,18,27,1,0,28,34,2,0,36,35,4,0,39
104234,179,"ŞCOALA GIMNAZIALĂ NR. 1MÂRŞA",MÂRŞA,GR,1230,7,0,0,7,15,0,0,15,25,1,0,26,46,3,0,49,48,3,0,51
104494,180,"ŞCOALA GIMNAZIALA ,, SFANTUL NECTARIE"" OGREZENI",OGREZENI,GR,972,0,2,0,2,5,7,0,12,7,7,0,14,16,11,0,27,18,11,0,29
104494,181,"ŞCOALA GIMNAZIALA ,, AUREL SOLACOLU"" OGREZENI",OGREZENI,GR,1269,2,0,0,2,2,5,0,7,5,8,0,13,11,8,0,19,11,8,0,19
104494,182,"GRĂDINIŢA ,, IRIS"" OGREZENI",OGREZENI,GR,815,2,2,0,4,13,2,0,15,19,3,0,22,28,5,0,33,30,6,0,36
104500,183,"ŞCOALA PRIMARA NR.1 HOBAIA",HOBAIA,GR,737,1,0,0,1,4,1,0,5,7,2,0,9,16,2,0,18,19,4,0,23
104528,184,"CĂMINUL CULTURAL OINACU",OINACU,GR,1468,10,1,0,11,36,11,0,47,50,15,0,65,64,21,0,85,106,21,0,127
104537,185,"GRADINITA NR. 2 BRANISTEA",BRANIŞTEA,GR,823,6,0,0,6,11,2,0,13,18,3,0,21,32,7,0,39,36,7,0,43
180082,186,"GRADINITA NR. 3 COMASCA",COMASCA,GR,514,2,4,0,6,2,4,0,6,5,4,0,9,9,5,0,14,23,5,0,28
104699,187,"CĂMINUL CULTURAL PRUNDU",PRUNDU,GR,1716,10,0,0,10,17,3,0,20,22,3,0,25,32,4,0,36,38,4,0,42
104699,188,"ŞCOALA PRIMARĂ NR.1 PRUNDU",PRUNDU,GR,1084,4,0,0,4,8,0,0,8,14,2,0,16,22,2,0,24,30,2,0,32
104706,189,"ŞCOALA PRIMARĂ NR.1 PUIENI",PUIENI,GR,608,1,0,0,1,5,1,0,6,7,2,0,9,8,4,0,12,10,4,0,14
104724,190,"CASA DE CULTURĂ PUTINEIU",PUTINEIU,GR,1001,10,3,0,13,40,18,0,58,75,25,0,100,121,29,0,150,181,36,0,217
104733,191,"ŞCOALA HODIVOAIA",HODIVOAIA,GR,318,3,4,0,7,8,6,0,14,20,11,0,31,34,22,0,56,64,22,0,86
104742,192,"ŞCOALA VIERU",VIERU,GR,567,3,4,0,7,9,7,0,16,14,9,0,23,28,9,0,37,28,11,0,39
104797,193,"ŞCOALA GIMNAZIALĂ ”CONSTANTIN STĂNCESCU”",RĂSUCENI,GR,796,11,2,0,13,24,8,0,32,48,14,0,62,79,24,0,103,113,26,0,139
104797,194,"ŞCOALA GENERALĂ NR. 2RĂSUCENI",RĂSUCENI,GR,305,7,3,0,10,18,6,0,24,38,16,0,54,80,30,0,110,94,41,0,135
104813,195,"ŞCOALA GIMNAZIALĂ NR.1 CUCURUZU",CUCURUZU,GR,721,9,2,0,11,25,2,0,27,30,4,0,34,40,7,0,47,45,7,0,52
104868,196,"GRADINITA CU PROGRAM NORMAL NR. 1 ROATA MICA","ROATA MICĂ",GR,411,1,3,0,4,3,5,0,8,5,7,0,12,9,7,0,16,9,7,0,16
104840,197,"GRĂDINIŢA CU PROGRAM NORMAL ROATA DE JOS","ROATA DE JOS",GR,912,4,0,0,4,10,1,0,11,20,3,0,23,28,4,0,32,31,4,0,35
104859,198,"GRĂDINIŢA CU PROGRAM NORMAL CARTOJANI",CARTOJANI,GR,789,1,0,0,1,2,0,0,2,3,1,0,4,4,3,0,7,5,3,0,8
104840,199,"ŞCOALA GIMNAZIALA NR. 1 ROATA DE JOS","ROATA DE JOS",GR,996,6,3,0,9,16,4,0,20,33,8,0,41,47,9,0,56,48,9,0,57
104877,200,"ŞCOALA PRIMARA NR. 2 SADINA",SADINA,GR,1261,3,0,0,3,13,2,0,15,14,2,0,16,24,4,0,28,28,4,0,32
104859,201,"ŞCOALA GIMNAZIALA NR. 2 CARTOJANI",CARTOJANI,GR,1037,6,0,0,6,7,1,0,8,9,1,0,10,10,2,0,12,10,2,0,12
104859,202,"ŞCOALA GIMNAZIALA NR. 2 CARTOJANI",CARTOJANI,GR,1151,3,2,0,5,5,2,0,7,5,2,0,7,8,2,0,10,9,2,0,11
104038,203,"ŞCOALA GIMNAZIALA NR. 1 SABARENI",SĂBĂRENI,GR,1058,11,4,0,15,30,14,0,44,40,15,0,55,51,16,10,77,58,18,10,86
104038,204,"ŞCOALA GIMNAZIALA NR. 1 SABARENI",SĂBĂRENI,GR,1098,15,3,0,18,27,3,0,30,33,5,0,38,47,7,12,66,49,9,12,70
104984,205,ŞCOALASCHITU,SCHITU,GR,180,9,1,0,10,14,5,0,19,20,5,0,25,30,6,0,36,30,6,0,36
104993,206,"ŞCOALA PRIMARA FLORIN NICULESCU BILA",BILA,GR,335,11,0,0,11,18,6,0,24,27,6,0,33,39,8,0,47,42,8,0,50
105008,207,"ŞCOALA PRIMARA , NR.1 CAMINEASCA",CĂMINEASCA,GR,426,6,2,0,8,14,3,0,17,18,7,0,25,29,10,0,39,30,10,0,40
105017,208,"ŞCOALA GIMNAZIALA PROF. DINU NICOLAE VLASIN",VLAŞIN,GR,392,5,2,0,7,5,2,0,7,16,13,0,29,19,13,0,32,23,13,0,36
105115,209,"PRIMARIA SINGURENI",SINGURENI,GR,1182,12,4,0,16,22,14,0,36,33,21,0,54,46,24,0,70,51,26,0,77
105124,210,"ŞCOALA PRIMARĂ NR.2 CRÎNGURI",CRÎNGURI,GR,590,1,0,0,1,2,3,0,5,4,4,0,8,10,7,0,17,14,8,0,22
105133,211,"GRĂDINIŢA CU PROGRAM NORMAL NR. 3 STEJARU",STEJARU,GR,607,6,4,0,10,11,6,0,17,13,6,0,19,19,8,0,27,22,9,0,31
100558,212,"ŞCOALA GIMNAZIALĂ NR.1 SLOBOZIA",SLOBOZIA,GR,820,4,2,0,6,16,3,0,19,26,9,0,35,35,9,0,44,40,10,0,50
100558,213,"GRĂDINIŢA DE COPII SLOBOZIA",SLOBOZIA,GR,1169,9,4,0,13,13,5,0,18,19,8,0,27,40,11,0,51,52,14,0,66
105302,214,"ȘCOALA GIMNAZIALĂ NR. 1 STĂNEȘTI",STĂNEŞTI,GR,1058,4,2,0,6,7,4,0,11,10,8,0,18,15,10,0,25,19,10,0,29
105320,215,"ŞCOALA PRIMARĂ NR. 2 GHIZDARU",GHIZDARU,GR,411,5,4,0,9,7,6,0,13,9,8,0,17,14,8,0,22,14,8,0,22
105311,216,"GRĂDINIȚA CU PROGRAM NORMAL NR. 4BĂLANU",BĂLANU,GR,416,5,2,0,7,5,3,0,8,9,3,0,12,16,4,0,20,17,6,0,23
105339,217,"GRĂDINIȚA CU PROGRAM NORMAL NR. 3ONCEŞTI",ONCEŞTI,GR,282,4,5,0,9,6,5,0,11,9,6,0,15,14,6,0,20,14,6,0,20
105366,218,"ŞCOALA CU CLASELE I-IV IANCULEŞTI",IANCULEŞTI,GR,220,5,5,0,10,6,8,0,14,7,8,0,15,17,8,0,25,22,9,0,31
105357,219,"CĂMINUL CULTURAL STOENEŞTI",STOENEŞTI,GR,900,52,10,0,62,113,18,0,131,143,34,0,177,186,38,0,224,209,42,0,251
105357,220,"GRĂDINIŢĂ CU PROGRAM NORMAL",STOENEŞTI,GR,368,10,7,0,17,15,8,0,23,22,8,0,30,44,12,0,56,53,20,0,73
105375,221,"ŞCOALA CU CLASELE I-IV MIRĂU",MIRĂU,GR,124,8,3,0,11,16,4,0,20,27,7,0,34,37,10,0,47,44,12,0,56
154718,222,"CĂMINUL CULTURAL TOPORU",TOPORU,GR,1003,13,4,0,17,13,5,0,18,45,13,49,107,66,16,49,131,71,22,49,142
154727,223,"ŞCOALA PRIMARA NR. 2TOMULEŞTI",TOMULEŞTI,GR,498,10,6,0,16,21,16,0,37,32,20,26,78,57,27,26,110,64,30,26,120
105632,224,"SCOALA PRIMARA NR.3 ULMI",ULMI,GR,922,5,4,0,9,10,4,0,14,21,7,0,28,24,16,0,40,25,16,0,41
105696,225,"SCOALA GIMNAZIALA NR.1 POENARI",POENARI,GR,1123,4,1,0,5,16,5,0,21,27,6,0,33,38,9,0,47,40,9,0,49
105703,226,"SCOALA GIMNAZIALA ""NICOLAE LAHOVARY",TRESTIENI,GR,1012,2,0,0,2,9,0,0,9,10,0,0,10,22,0,0,22,30,1,0,31
105703,227,"SCOALA GIMNAZIALA NICOLAE LAHOVARY""",TRESTIENI,GR,968,9,0,0,9,12,3,0,15,14,4,0,18,17,14,0,31,19,16,0,35
105650,228,"GRĂDINIŢA ""MARIN MOGESCU""",DRĂGĂNEASCA,GR,639,7,1,0,8,13,2,0,15,20,4,0,24,31,6,0,37,38,8,0,46
105678,229,"SCOALA PRIMARA NR.2 ICOANA",ICOANA,GR,908,4,1,0,5,9,1,0,10,10,1,0,11,17,1,0,18,18,1,0,19
105669,230,"GRADINITA NR.4 GHIONEA",GHIONEA,GR,465,2,5,0,7,2,6,0,8,9,6,0,15,26,8,0,34,32,8,0,40
105785,231,"SCOALA GIMNAZIALA NR.1 VALEA DRAGULUI","VALEA DRAGULUI",GR,1270,2,3,0,5,7,4,0,11,13,4,0,17,20,4,0,24,32,8,0,40
105785,232,"GRADINITA NR.2 VALEA DRAGULUI","VALEA DRAGULUI",GR,1110,5,0,0,5,11,1,0,12,14,3,0,17,25,6,0,31,34,8,0,42
105883,233,"ȘCOALA GIMNAZIALĂ NR.1 VĂRĂȘTI",VĂRĂŞTI,GR,1033,0,5,0,5,8,7,0,15,17,8,0,25,21,10,0,31,32,13,0,45
105883,234,"ŞCOALA GIMNAZIALĂ NR.1 VĂRĂŞTI",VĂRĂŞTI,GR,876,4,7,0,11,12,10,0,22,20,13,0,33,35,14,0,49,46,14,0,60
105883,235,"ŞCOALA PRIMARĂ NR.3 OBEDENI",VĂRĂŞTI,GR,927,19,1,0,20,32,4,0,36,43,4,0,47,71,8,0,79,80,8,0,88
105892,236,"ŞCOALA GIMNAZIALĂ NR.2 DOBRENI",DOBRENI,GR,1918,11,3,0,14,19,3,0,22,22,4,0,26,43,7,0,50,55,7,0,62
105918,237,"ŞCOALA JAPCA",VEDEA,GR,656,4,4,0,8,12,4,0,16,22,4,0,26,24,5,0,29,24,6,0,30
105918,238,"CĂMIN CULTURAL VEDEA",VEDEA,GR,757,6,4,0,10,10,5,0,15,14,5,0,19,20,8,0,28,24,8,0,32
105918,239,"ŞCOALA GIMNAZIALA ""APOSTOL ARSACHE""VEDEA",VEDEA,GR,796,6,0,0,6,9,2,0,11,13,7,0,20,16,11,0,27,18,13,0,31
105981,240,"ŞCOALA GIMNAZIALĂ NR. 1 VÂNĂTORII MICI","VÂNĂTORII MICI",GR,818,9,2,0,11,13,4,0,17,15,4,0,19,19,5,0,24,21,5,0,26
106014,241,"ŞCOALA GIMNAZIALĂ NR. 2 IZVORU",IZVORU,GR,633,8,1,0,9,13,1,0,14,20,1,0,21,30,3,0,33,32,3,0,35
106041,242,"ŞCOALA GIMNAZIALĂ NR. 3 VÂNĂTORII MARI","VÎNĂTORII MARI",GR,935,6,2,0,8,16,2,0,18,19,4,0,23,30,4,0,34,30,4,0,34
106023,243,"ŞCOALA PRIMARĂ NR.5 POIANA LUI STÂNGĂ","POIANA LUI STÎNGĂ",GR,566,4,2,0,6,15,6,0,21,19,8,0,27,32,9,0,41,34,9,0,43
105990,244,"ŞCOALA PRIMARĂ NR.6 CORBEANCA",CORBEANCA,GR,390,0,0,0,0,1,1,0,2,2,2,0,4,6,2,0,8,7,2,0,9
106005,245,"ŞCOALA PRIMARĂ NR.7 CUPELE",CUPELE,GR,368,10,3,0,13,13,4,0,17,18,4,0,22,23,5,0,28,23,5,0,28
86696,1,"CASA DE CULTURĂ DRĂGAN MUNTEAN",DEVA,HD,1759,19,0,0,19,55,8,0,63,86,11,0,97,110,14,0,124,125,20,0,145
86696,2,"CASA DE CULTURĂ DRĂGAN MUNTEAN",DEVA,HD,1264,10,0,0,10,53,1,0,54,65,4,0,69,83,5,0,88,94,9,0,103
86696,3,"CASA DE CULTURĂ DRĂGAN MUNTEAN",DEVA,HD,1560,7,3,0,10,46,4,0,50,66,6,0,72,86,6,0,92,96,7,0,103
86696,4,"ŞCOALA GIMNAZIALĂ “ANDREI ŞAGUNA”",DEVA,HD,1399,7,0,0,7,42,0,0,42,64,0,0,64,86,4,0,90,99,6,0,105
86696,5,"ŞCOALA GIMNAZIALĂ “ANDREI ŞAGUNA”",DEVA,HD,1437,13,1,0,14,50,3,0,53,79,4,0,83,98,6,1,105,107,6,1,114
86696,6,"ŞCOALA GIMNAZIALĂ “ANDREI ŞAGUNA”",DEVA,HD,1395,9,0,0,9,35,0,0,35,54,4,0,58,75,6,0,81,81,7,0,88
86696,7,"GRĂDINIȚA CU PROGRAM PRELUNGIT NR 7",DEVA,HD,1233,12,4,0,16,54,4,0,58,92,7,0,99,106,7,0,113,117,9,0,126
86696,8,"COLEGIUL NAŢIONAL PEDAGOGIC""REGINA MARIA""",DEVA,HD,1206,15,1,0,16,45,2,0,47,67,2,0,69,75,4,0,79,88,6,0,94
86696,9,"LICEUL DE ARTE SIGISMUND TODUTA (FOSTA ŞCOALA GENERALĂ “ LUCIAN BLAGA” NR.2)",DEVA,HD,1292,1,0,0,1,52,7,0,59,68,9,0,77,81,16,0,97,92,18,0,110
86696,10,"GALERIA FORMA",DEVA,HD,1321,21,0,0,21,63,5,0,68,87,10,0,97,100,10,0,110,120,10,0,130
86696,11,"COLEGIUL NAŢIONAL “DECEBAL”",DEVA,HD,1180,21,2,0,23,55,3,0,58,69,5,0,74,78,5,0,83,85,5,0,90
86696,12,"COLEGIUL NAȚIONAL SPORTIV CETATE DEVA",DEVA,HD,1423,23,0,0,23,57,7,0,64,80,8,0,88,95,8,0,103,106,11,0,117
86696,13,"ŞCOALĂPRIMARA VIILE NOI",DEVA,HD,878,6,2,0,8,23,2,0,25,39,3,0,42,54,3,0,57,67,3,0,70
86696,14,"LICEUL DE ARTE SIGISMUND TODUȚA (FOSTA ŞCOALA GENERALĂ ""LUCIAN BLAGA“ NR.2)",DEVA,HD,1269,11,0,0,11,47,3,0,50,64,4,0,68,94,5,0,99,104,5,0,109
86696,15,"DIRECȚIA GENERALĂ DE ASISTENȚĂ SOCIALĂ ȘI PROTECȚIA COPILULUI",DEVA,HD,1105,10,4,0,14,37,6,0,43,55,7,0,62,70,10,0,80,78,11,0,89
86696,16,"DIRECŢIA SILVICĂ DEVA",DEVA,HD,1309,24,5,0,29,59,5,0,64,70,6,0,76,100,7,0,107,109,7,0,116
86696,17,"SPITAL JUDEȚEAN DEVA",DEVA,HD,1382,11,3,0,14,55,10,3,68,67,25,13,105,72,39,26,137,78,45,26,149
86696,18,"ŞCOALA GIMNAZIALĂ“ANDREI ŞAGUNA”",DEVA,HD,1299,9,0,0,9,27,7,0,34,47,8,0,55,60,8,0,68,64,8,0,72
86696,19,"ŞCOALA GIMNAZIALĂ“ANDREI ŞAGUNA”",DEVA,HD,1501,10,7,0,17,45,8,0,53,61,8,0,69,76,8,0,84,92,8,0,100
86696,20,"SALA SPORTURILOR",DEVA,HD,1326,13,1,0,14,28,5,0,33,48,8,0,56,68,10,0,78,69,11,0,80
86696,21,"COLEGIUL TEHNIC “TRANSILVANIA”",DEVA,HD,964,12,1,0,13,37,3,0,40,46,7,0,53,59,8,0,67,65,9,0,74
86696,22,"COLEGIUL TEHNIC “TRANSILVANIA”",DEVA,HD,1636,7,2,0,9,37,2,0,39,52,2,0,54,73,4,0,77,83,4,0,87
86696,23,"COLEGIUL TEHNIC “TRANSILVANIA”",DEVA,HD,793,4,3,0,7,12,3,0,15,20,3,0,23,28,3,0,31,30,3,0,33
86696,24,"LICEUL DE ARTE “SIGISMUND TODUŢĂ”",DEVA,HD,1232,6,3,0,9,41,7,0,48,61,8,0,69,84,10,0,94,95,14,0,109
86696,25,"COLEGIUL TEHNIC “TRANSILVANIA” (FOSTAŞCOALĂ GENERALĂ)",DEVA,HD,1536,11,4,0,15,50,9,0,59,72,10,0,82,91,13,0,104,94,16,0,110
86696,26,"COLEGIUL TEHNIC “TRANSILVANIA” (FOSTAŞCOALĂ GENERALĂ)",DEVA,HD,1346,9,0,0,9,37,7,0,44,58,8,0,66,84,8,0,92,91,8,0,99
86696,27,"COLEGIUL TEHNIC “TRANSILVANIA” (FOSTAŞCOALĂ GENERALĂ)",DEVA,HD,1672,17,1,0,18,44,2,0,46,71,2,0,73,97,2,0,99,98,3,0,101
86696,28,"COLEGIUL TEHNIC“ TRANSILVANIA”",DEVA,HD,1506,13,0,0,13,47,0,0,47,66,1,0,67,73,1,0,74,84,1,0,85
86696,29,"CLUB ŞCOLAR SPORTIV",DEVA,HD,1411,20,5,0,25,56,6,0,62,80,9,0,89,89,9,0,98,106,10,0,116
86696,30,"CASA MAGHIARĂ DEVA ( FOSTA CASA ARMATEI)",DEVA,HD,1102,8,2,0,10,21,4,0,25,37,4,0,41,51,4,0,55,64,7,0,71
86696,31,"CASA MAGHIARĂ DEVA (FOSTA CASA ARMATEI)",DEVA,HD,1114,11,0,0,11,31,4,0,35,52,6,0,58,73,7,0,80,75,7,0,82
86696,32,"COLEGIUL TEHNIC ENERGETIC DRAGOMIR HURMUZESCU (FOSTA ŞCOALĂ GENERALĂ “OCTAVIAN GOGA”)",DEVA,HD,1435,8,2,0,10,19,3,0,22,29,6,0,35,45,6,0,51,51,6,0,57
86696,33,"COLEGIUL TEHNIC ENERGETIC DRAGOMIR HURMUZESCU (FOSTA ŞCOALĂ GENERALĂ “OCTAVIAN GOGA”)",DEVA,HD,1774,6,3,0,9,33,4,0,37,55,4,0,59,63,5,0,68,68,5,0,73
86696,34,"COLEGIUL TEHNIC ENERGETIC DRAGOMIR HURMUZESCU (FOSTA ŞCOALĂ GENERALĂ “OCTAVIAN GOGA”)",DEVA,HD,1487,8,0,0,8,38,0,0,38,57,0,0,57,68,0,0,68,80,0,0,80
86696,35,"GRADINIŢA P.N. NR.3",DEVA,HD,1610,24,0,0,24,35,0,0,35,61,1,0,62,87,1,0,88,95,3,0,98
86696,36,"GRADINIŢA P.N. NR.3",DEVA,HD,1599,8,4,0,12,42,4,0,46,62,4,0,66,81,4,0,85,85,6,0,91
86696,37,"LICEUL DE ARTE SIGISMUND TODUŢĂ-GALERIA DE ARTĂ",DEVA,HD,1490,11,7,0,18,50,7,0,57,69,7,0,76,96,7,0,103,108,7,0,115
86696,38,"LICEUL TEHNOLOGIC “GRIGORE MOISIL”(FOSTUL LICEU MINIER)",DEVA,HD,863,2,0,0,2,12,2,0,14,22,5,0,27,36,5,0,41,39,5,0,44
86696,39,"COLEGIUL TEHNIC ENERGETIC DRAGOMIR HURMUZESCU (FOSTA ȘCOALĂ GENERALĂ. NR.5)",DEVA,HD,1257,12,1,0,13,25,7,0,32,42,7,0,49,57,8,0,65,60,8,0,68
86696,40,"COLEGIUL TEHNIC ENERGETIC DRAGOMIR HURMUZESCU (FOSTA ȘCOALĂ GENERALĂ. NR.5)",DEVA,HD,951,17,0,0,17,32,0,0,32,38,0,0,38,47,0,0,47,52,0,0,52
86696,41,"COLEGIUL TEHNIC ENERGETIC DRAGOMIR HURMUZESCU (FOSTA ȘCOALĂ GENERALĂ. NR.5)",DEVA,HD,951,11,0,0,11,34,1,0,35,51,3,0,54,58,6,0,64,65,6,0,71
86730,42,"ȘCOALA PRIMARĂ CRISTUR",CRISTUR,HD,1405,2,0,0,2,15,0,0,15,28,1,0,29,42,1,0,43,44,1,0,45
86703,43,"CĂMINUL CULTURAL SÎNTUHALM",SÎNTUHALM,HD,609,0,1,0,1,2,1,0,3,8,3,0,11,11,3,0,14,13,3,0,16
86696,44,"ŞCOALĂPRIMARĂ VIILE NOI",DEVA,HD,878,9,0,0,9,27,0,0,27,34,2,0,36,48,2,0,50,50,2,0,52
86696,45,"ADĂPOSTUL DE URGENŢĂ PE TIMP DE NOAPTE",DEVA,HD,756,4,0,0,4,17,0,0,17,36,0,0,36,51,1,0,52,62,1,0,63
86696,46,"CANTINA DE AJUTOR SOCIAL (FOSTA CANTINA LICEU MINER)",DEVA,HD,1076,16,0,0,16,50,0,0,50,63,0,0,63,89,2,0,91,94,2,0,96
87308,47,"CASA DE CULTURA",BRAD,HD,899,13,1,0,14,32,1,0,33,39,2,0,41,56,2,32,90,66,5,32,103
87308,48,"CASA DE CULTURA",BRAD,HD,966,11,2,0,13,34,2,0,36,43,2,0,45,56,2,0,58,63,2,0,65
87308,49,"ŞCOALA GIMNAZIALA „MIRCEA SÂNTIMBREANU”",BRAD,HD,1606,21,4,0,25,55,5,0,60,76,7,0,83,83,7,0,90,89,7,0,96
87308,50,"ŞCOALA GIMNAZIALĂ „MIRCEA SÂNTIMBREANU”",BRAD,HD,1299,6,0,0,6,24,0,0,24,34,0,0,34,44,0,0,44,45,0,0,45
87308,51,"ŞCOALA GIMNAZIALĂ „MIRCEA SÂNTIMBREANU”",BRAD,HD,1259,3,0,0,3,16,1,0,17,27,2,0,29,35,4,0,39,39,6,0,45
87308,52,"ŞCOALA GIMNAZIALĂ „MIRCEA SÂNTIMBREANU”",BRAD,HD,1315,19,0,0,19,42,0,0,42,57,0,0,57,64,2,0,66,170,2,0,172
87308,53,"COLEGIUL NAŢIONAL „AVRAM IANCU”",BRAD,HD,1011,8,4,0,12,22,4,0,26,33,5,0,38,47,7,0,54,49,7,0,56
87308,54,"COLEGIUL NAŢIONAL „AVRAM IANCU”",BRAD,HD,1042,7,1,0,8,14,1,0,15,22,1,0,23,31,1,0,32,38,1,0,39
87308,55,"GRĂDINIŢA P.P. ""FLOARE DE COLŢ""",BRAD,HD,1101,13,0,0,13,27,0,0,27,36,0,0,36,44,0,0,44,48,0,0,48
87308,56,"ŞCOALA GIMNAZIALĂ „HOREA CLOŞCA ŞI CRIŞAN”",BRAD,HD,1083,7,4,0,11,19,4,0,23,29,4,0,33,41,5,0,46,46,5,0,51
87353,57,"ŞCOALA GENERALĂ VALEA BRADULUI","VALEA BRADULUI",HD,642,1,4,0,5,6,5,0,11,10,7,0,17,19,7,0,26,23,7,0,30
87344,58,"CĂMINUL CULTURAL ŢĂRĂŢEL",ŢĂRĂŢEL,HD,611,0,0,0,0,2,0,0,2,2,1,0,3,7,1,0,8,14,1,0,15
87317,59,"CĂMINUL CULTURAL MESTEACĂN",MESTEACĂN,HD,467,3,0,0,3,3,0,0,3,7,1,0,8,12,2,0,14,12,2,0,14
87335,60,"CĂMINUL CULTURAL RUDA-BRAD",RUDA-BRAD,HD,162,1,2,0,3,5,3,0,8,5,3,0,8,8,3,0,11,8,3,0,11
86829,61,"ȘCOALA GIMNAZIALĂ NR. 1 ( FOSTA ȘCOALĂ GENERALĂ NR. 12)",HUNEDOARA,HD,1499,21,0,0,21,37,0,0,37,49,0,0,49,63,0,0,63,67,0,0,67
86829,62,"ȘCOALA GIMNAZIALĂ NR. 1 ( FOSTA ȘCOALĂ GENERALĂ NR. 12)",HUNEDOARA,HD,1458,4,2,0,6,13,2,0,15,26,3,0,29,33,3,0,36,36,3,0,39
86829,63,"ȘCOALA GIMNAZIALĂ NR. 1 ( FOSTA ȘCOALĂ GENERALĂ NR. 12)",HUNEDOARA,HD,1465,11,0,0,11,33,0,0,33,51,0,0,51,72,0,0,72,72,0,0,72
86829,64,"ŞCOALA GIMNAZIALĂ NR. 1 (FOSTA ȘCOALĂ GENERALĂ NR. 9)",HUNEDOARA,HD,1465,8,5,0,13,24,6,0,30,42,7,0,49,70,8,0,78,75,8,0,83
86829,65,"ŞCOALA GIMNAZIALĂ NR. 1 (FOSTA ŞCOALĂ GENERALĂ NR. 9)",HUNEDOARA,HD,1528,7,5,0,12,44,6,0,50,74,6,0,80,99,8,0,107,103,8,0,111
86829,66,"ŞCOALA GIMNAZIALĂ NR. 1 (FOSTA ŞCOALĂ GENERALĂ NR. 9)",HUNEDOARA,HD,1533,16,4,0,20,43,5,0,48,66,5,0,71,103,5,0,108,109,5,0,114
86829,67,"ŞCOALA GIMNAZIALĂ NR. 1 (FOSTA ŞCOALĂ GENERALĂ NR. 9)",HUNEDOARA,HD,1469,10,5,0,15,42,7,0,49,68,7,0,75,103,9,0,112,111,9,0,120
86829,68,"ŞCOALA GIMNAZIALĂ NR. 1 (FOSTA ŞCOALĂ GENERALĂ NR. 9)",HUNEDOARA,HD,1327,13,2,0,15,39,2,0,41,58,2,0,60,68,2,0,70,77,2,0,79
86829,69,"GRĂDINIŢA CU PROGRAM NORMAL MICRO VII PN6",HUNEDOARA,HD,1271,3,7,0,10,35,7,0,42,49,9,0,58,69,9,0,78,76,9,0,85
86829,70,"COLEGIUL ECONOMIC ""EMANUIL GOJDU"" (FOSTUL LICEU NR. 2)",HUNEDOARA,HD,1287,13,3,0,16,38,4,0,42,56,5,0,61,80,5,0,85,85,6,0,91
86829,71,"LICEUL TEHNOLOGIC ""CONSTANTIN BURSAN"" (FOSTUL LICEU NR. 3)",HUNEDOARA,HD,1308,12,2,0,14,35,4,0,39,56,4,0,60,68,7,0,75,76,8,0,84
86829,72,"COLEGIUL NAŢIONALDE INFORMATICĂ ""TRAIAN LALESCU"" (CLĂDIREA NOUĂ)",HUNEDOARA,HD,1398,22,1,0,23,49,7,0,56,70,7,0,77,84,7,0,91,86,7,0,93
86829,73,"COLEGIUL NAŢIONALDE INFORMATICĂ ""TRAIAN LALESCU"" ( FOSTA ŞCOALĂ GENERALĂ NR. 4)",HUNEDOARA,HD,1127,21,0,0,21,46,2,0,48,68,4,0,72,87,4,0,91,117,7,0,124
86829,74,"COLEGIUL NAŢIONALDE INFORMATICĂ ""TRAIAN LALESCU"" ( FOSTA ŞCOALĂ GENERALĂ NR. 4)",HUNEDOARA,HD,1297,12,1,0,13,23,3,19,45,34,4,19,57,37,6,19,62,37,6,19,62
86829,75,"COLEGIUL NAȚIONAL ”IANCU DE HUNEDOARA” (FOSTA ȘCOALĂ GENERALĂ NR. 5)",HUNEDOARA,HD,1499,20,4,0,24,38,6,0,44,56,7,0,63,70,7,0,77,76,7,0,83
86829,76,"COLEGIUL NAȚIONAL ”IANCU DE HUNEDOARA” (FOSTA ȘCOALĂ GENERALĂ NR. 5)",HUNEDOARA,HD,1138,25,0,0,25,37,0,0,37,57,0,0,57,72,3,0,75,73,3,0,76
86829,77,"COLEGIUL NAȚIONAL ”IANCU DE HUNEDOARA” (FOSTA ȘCOALĂ GENERALĂ NR. 5)",HUNEDOARA,HD,1229,24,0,0,24,44,0,0,44,65,0,0,65,86,0,0,86,89,0,0,89
86865,78,"ŞCOALA PRIMARĂ HĂŞDAT",HĂŞDAT,HD,373,3,0,0,3,7,0,0,7,13,0,0,13,17,0,0,17,18,0,0,18
86829,79,"ŞCOALA GIMNAZIALĂ NR.6 (FOSTA ȘCOALĂ GENERALĂ NR. 6)",HUNEDOARA,HD,1548,21,0,0,21,66,0,0,66,77,1,0,78,102,1,0,103,119,1,0,120
86829,80,"ŞCOALA GIMNAZIALĂ NR.6 (FOSTA ȘCOALĂ GENERALĂ NR. 6)",HUNEDOARA,HD,1596,15,0,0,15,39,3,0,42,55,4,0,59,77,8,0,85,82,8,0,90
86829,81,"COLEGIUL TEHNIC ""MATEI CORVIN"" (FOSTUL LICEU NR. 1)",HUNEDOARA,HD,1111,9,4,0,13,38,5,0,43,55,5,0,60,83,5,0,88,89,5,0,94
86829,82,"GRĂDINIŢA CU PROGRAM NORMAL NR.4 MICRO I (LÂNGĂ FOSTA ŞCOALĂ GENERALĂ NR. 3)",HUNEDOARA,HD,1571,26,4,0,30,65,4,0,69,109,4,0,113,123,7,0,130,134,7,0,141
86829,83,"GRĂDINIŢA CU PROGRAM PRELUNGIT ""PITICOT""",HUNEDOARA,HD,911,12,3,0,15,37,4,0,41,53,4,0,57,72,4,0,76,74,4,0,78
86829,84,"GRĂDINIŢA CU PROGRAM PRELUNGIT ""PITICOT""",HUNEDOARA,HD,1213,16,1,0,17,40,1,0,41,58,1,0,59,78,1,0,79,81,1,0,82
86829,85,"COLEGIUL ECONOMIC ""EMANUIL GOJDU"" (FOSTA ŞCOALĂ GENERALĂ NR. 3)",HUNEDOARA,HD,1406,16,0,0,16,61,1,0,62,79,3,0,82,100,8,0,108,105,24,0,129
86829,86,"COLEGIUL ECONOMIC ""EMANUIL GOJDU"" (FOSTA ŞCOALĂ GENERALĂ NR. 3)",HUNEDOARA,HD,1395,8,1,0,9,51,2,0,53,70,3,0,73,95,9,0,104,99,18,0,117
86829,87,"ŞCOALA GIMNAZIALĂ NR. 7 (FOSTA ȘCOALĂ GENERALĂ NR. 7)",HUNEDOARA,HD,1202,15,0,0,15,48,0,0,48,69,0,0,69,88,0,0,88,96,0,0,96
86829,88,"ŞCOALA GIMNAZIALĂ NR. 7 (FOSTA ȘCOALĂ GENERALĂ NR. 7)",HUNEDOARA,HD,1221,14,0,0,14,41,4,0,45,67,5,0,72,89,5,0,94,90,6,0,96
86829,89,"ŞCOALA GIMNAZIALĂ NR. 7 (FOSTA ȘCOALĂ GENERALĂ NR. 7)",HUNEDOARA,HD,1218,13,3,0,16,39,7,0,46,68,9,0,77,92,11,0,103,97,11,0,108
86829,90,"COLEGIUL ECONOMIC ”EMANUIL GOJDU” (FOSTA ȘCOALĂ GENERALĂ NR. 8)",HUNEDOARA,HD,1161,14,2,0,16,48,3,0,51,66,4,0,70,75,8,0,83,82,8,0,90
86829,91,"COLEGIUL ECONOMIC ”EMANUIL GOJDU” (FOSTA ȘCOALĂ GENERALĂ NR. 8)",HUNEDOARA,HD,1058,15,3,0,18,38,3,0,41,47,6,0,53,64,6,0,70,68,6,0,74
86829,92,"GRĂDINIŢA CU PROGRAM PRELUNGIT PP4 ""FLOAREA SOARELUI""",HUNEDOARA,HD,1159,16,0,0,16,48,2,0,50,70,4,0,74,85,10,0,95,95,10,0,105
86829,93,"GRĂDINIŢA CU ORAR NORMAL MICRO III PN 2 ""ZORI DE ZI""",HUNEDOARA,HD,1341,16,4,0,20,46,4,0,50,66,5,0,71,89,6,0,95,94,6,0,100
86829,94,"ŞCOALA GIMNAZIALĂ NR. 2 (FOSTAŞCOALĂ GENERALĂ NR. 2)",HUNEDOARA,HD,1544,20,4,0,24,53,4,0,57,90,4,0,94,121,4,0,125,131,5,0,136
86829,95,"ŞCOALA GIMNAZIALĂ NR. 2 (FOSTAŞCOALĂ GENERALĂ NR. 2)",HUNEDOARA,HD,1540,16,0,0,16,48,0,0,48,90,1,0,91,112,1,0,113,121,1,0,122
86829,96,"ŞCOALA GIMNAZIALĂ NR. 2 (FOSTAŞCOALĂ GENERALĂ NR. 2)",HUNEDOARA,HD,1345,23,0,0,23,58,0,0,58,80,1,0,81,109,2,0,111,125,2,0,127
86829,97,"ŞCOALA GIMNAZIALĂ NR. 2 (FOSTAŞCOALĂ GENERALĂ NR. 2)",HUNEDOARA,HD,1555,22,0,0,22,55,1,0,56,94,2,0,96,112,2,0,114,117,4,0,121
86829,98,"CENTRUL ŞCOLAR PENTRU EDUCAŢIE INCLUZIVĂ ""RUDOLF STEINER"" (FOSTUL CENTRU DE ZI)",HUNEDOARA,HD,1171,9,5,0,14,19,5,0,24,39,5,0,44,49,6,0,55,56,6,0,62
86829,99,"CENTRUL ŞCOLAR PENTRU EDUCAŢIE INCLUZIVĂ ""RUDOLF STEINER"" (FOSTUL CENTRU DE ZI)",HUNEDOARA,HD,1177,10,1,0,11,18,1,0,19,47,1,0,48,74,1,22,97,78,1,22,101
86829,100,"ȘCOALA GIMNAZIALĂ NR. 2 (FOSTA ȘCOALĂ GENERALĂ NR. 11)",HUNEDOARA,HD,1353,16,4,0,20,43,4,0,47,75,4,0,79,101,6,0,107,111,9,0,120
86829,101,"ȘCOALA GIMNAZIALĂ NR. 2 (FOSTA ȘCOALĂ GENERALĂ NR. 11)",HUNEDOARA,HD,1475,9,0,0,9,38,0,0,38,67,0,0,67,92,0,0,92,102,0,0,102
86829,102,"ȘCOALA GIMNAZIALĂ NR. 2 (FOSTA ȘCOALĂ GENERALĂ NR. 11)",HUNEDOARA,HD,1244,16,0,0,16,47,1,0,48,65,2,0,67,86,3,0,89,90,3,0,93
86829,103,"ȘCOALA GIMNAZIALĂ NR. 2 (FOSTA ȘCOALĂ GENERALĂ NR. 11)",HUNEDOARA,HD,1311,12,4,0,16,32,4,0,36,52,4,0,56,77,4,0,81,92,4,0,96
86829,104,"CĂMIN CULTURAL BUITURI",HUNEDOARA,HD,674,4,0,0,4,10,0,0,10,26,1,0,27,37,1,0,38,39,1,0,40
86829,105,"SEDIUL PRIMĂRIEI MUNICIPIULUI HUNEDOARA (FOSTA B.R.D.)",HUNEDOARA,HD,1627,14,4,0,18,46,7,0,53,68,8,0,76,78,8,34,120,86,8,34,128
86838,106,"ŞCOALA PRIMARĂ RĂCĂŞTIA",RĂCĂŞTIA,HD,537,1,0,0,1,16,0,0,16,24,0,0,24,36,0,0,36,41,0,0,41
86829,107,"COLEGIUL NAȚIONAL ”IANCU DE HUNEDOARA” (FOSTA ȘCOALĂ GENERALĂ ZLAȘTI)",HUNEDOARA,HD,448,7,0,0,7,15,0,0,15,15,0,0,15,18,3,0,21,27,3,0,30
86847,108,"CĂMIN CULTURAL BOŞ (GRĂDINIŢA)",BOŞ,HD,495,6,2,0,8,10,3,0,13,11,3,0,14,24,6,0,30,29,6,0,35
86874,109,"ŞCOALA PRIMARĂ PEŞTIŞUL MARE","PEŞTIŞU MARE",HD,1053,7,0,0,7,24,1,0,25,30,1,0,31,42,2,0,44,43,2,0,45
87068,110,"ŞCOALA GIMNAZIALĂ NR. 1, LUPENI",LUPENI,HD,1575,6,4,0,10,31,4,0,35,40,5,0,45,47,5,0,52,53,5,0,58
87068,111,"ŞCOALA GIMNAZIALĂ NR. 1",LUPENI,HD,1372,9,0,0,9,34,1,37,72,46,2,37,85,59,3,37,99,61,3,37,101
87068,112,"ŞCOALA GIMNAZIALĂ NR. 1",LUPENI,HD,1139,12,0,0,12,28,0,0,28,38,1,0,39,51,1,0,52,51,1,0,52
87068,113,"GRĂDINIȚA CU PROGRAM NORMALŞCOALA GIMNAZIALĂ NR. 1",LUPENI,HD,857,6,5,0,11,21,5,0,26,34,5,0,39,42,5,0,47,44,5,0,49
87068,114,"SPCLEP LUPENI",LUPENI,HD,1722,12,5,0,17,50,5,0,55,73,8,0,81,84,8,0,92,95,8,0,103
87068,115,"ŞCOALA GIMNAZIALĂ NR. 3",LUPENI,HD,1023,9,4,0,13,42,5,0,47,61,6,0,67,70,6,0,76,73,6,0,79
87068,116,"ŞCOALA GIMNAZIALĂ NR. 3",LUPENI,HD,1012,9,1,0,10,29,2,0,31,52,7,0,59,69,9,0,78,71,9,0,80
87068,117,"GRĂDINIŢA CU PROGRAM NORMAL NR. 1 LUPENI",LUPENI,HD,1319,10,0,0,10,47,5,0,52,62,5,0,67,92,5,0,97,98,5,0,103
87068,118,"GRĂDINIŢA CU PROGRAM NORMAL NR. 1 LUPENI",LUPENI,HD,1616,10,3,0,13,28,4,0,32,58,4,0,62,66,4,0,70,74,4,0,78
87068,119,"GRĂDINIȚA CU PROGRAM SĂPTĂMÂNAL LUMEA COPIILOR",LUPENI,HD,1606,11,1,0,12,48,4,0,52,82,5,0,87,98,7,0,105,105,7,0,112
87068,120,"LICEUL TEORETIC ""MIRCEA ELIADE"" LUPENI",LUPENI,HD,1432,23,0,0,23,54,1,0,55,79,1,0,80,100,1,0,101,111,2,0,113
87068,121,"LICEUL TEORETIC ""MIRCEA ELIADE"" LUPENI",LUPENI,HD,948,7,4,0,11,16,4,0,20,24,5,0,29,39,5,0,44,45,5,0,50
87068,122,"ŞCOALA GIMNAZIALĂ NR. 2 LUPENI",LUPENI,HD,1340,11,1,0,12,49,1,0,50,66,1,0,67,83,2,0,85,94,2,0,96
87068,123,"ŞCOALA GIMNAZIALĂ NR. 2 LUPENI",LUPENI,HD,1071,18,0,0,18,53,0,0,53,79,0,0,79,108,0,0,108,115,0,0,115
87068,124,"GRĂDINIŢA CU PROGRAM NORMAL NR. 2 LUPENI",LUPENI,HD,954,5,0,0,5,22,0,0,22,31,0,0,31,37,0,0,37,38,0,0,38
87068,125,"GRĂDINIŢA CU PROGRAM NORMAL NR. 2 LUPENI",LUPENI,HD,976,7,1,0,8,21,3,0,24,32,4,0,36,38,4,0,42,44,4,0,48
87068,126,"GRĂDINIŢA CU PROGRAM NORMAL NR. 2 LUPENI",LUPENI,HD,1279,5,5,0,10,31,5,0,36,58,5,0,63,65,5,0,70,71,5,0,76
87068,127,"SC UNIVERSAL EDIL SA",LUPENI,HD,813,5,9,0,14,14,10,0,24,20,12,0,32,25,12,0,37,26,12,0,38
87647,128,"CASA DE CULTURĂ",ORĂŞTIE,HD,1648,20,0,0,20,58,0,0,58,69,13,0,82,89,15,1,105,95,16,1,112
87647,129,"CREŞA MUNICIPALĂ",ORĂŞTIE,HD,1591,10,3,0,13,35,4,0,39,55,4,0,59,76,4,0,80,79,4,0,83
87647,130,"GRĂDINIŢA CU PROGRAM NORMAL ""SCUFIŢA ROŞIE""",ORĂŞTIE,HD,1460,9,0,0,9,41,3,0,44,59,4,0,63,78,5,0,83,90,5,0,95
87647,131,"ŞC. GIM. ""D.STANCA""",ORĂŞTIE,HD,1491,13,0,0,13,25,0,0,25,33,6,0,39,44,6,0,50,47,6,0,53
87647,132,"COMPLEX SERVICII PENTRU VÂRSTNICI",ORĂŞTIE,HD,1673,12,0,20,32,27,6,20,53,39,8,20,67,46,8,20,74,48,9,20,77
87647,133,"ŞC.GIM. ""DR. AUREL VLAD""",ORĂŞTIE,HD,1536,17,0,0,17,41,4,0,45,53,5,0,58,68,5,0,73,79,5,0,84
87647,134,"ŞC.GIM. I-IV GARĂ",ORĂŞTIE,HD,1489,3,0,0,3,11,0,0,11,17,0,0,17,24,0,0,24,32,0,0,32
87647,135,"OFICIUL DE GOSPODĂRIRE A APELOR",ORĂŞTIE,HD,1739,12,0,0,12,34,2,0,36,50,2,0,52,80,4,0,84,97,4,0,101
87647,136,"LIC.TEHNOLOGIC ""N.OLAHUS""",ORĂŞTIE,HD,1393,20,2,0,22,38,2,0,40,57,2,0,59,69,2,0,71,77,3,0,80
87647,137,"COLEGIUL NAŢIONAL ""AUREL VLAICU""",ORĂŞTIE,HD,1361,9,0,0,9,14,0,0,14,14,6,0,20,27,7,0,34,30,7,0,37
87647,138,"PRIMĂRIA MUNICIPIULUI ORĂŞTIE",ORĂŞTIE,HD,1420,21,5,0,26,39,6,0,45,48,6,0,54,61,9,0,70,66,9,0,75
87647,139,"SERVICIUL PUBLIC DE ASISTENŢĂ SOCIALĂ",ORĂŞTIE,HD,1758,13,1,0,14,40,1,0,41,58,1,0,59,78,1,0,79,82,1,0,83
87004,140,"ȘCOALA GIMNAZIALĂ ""I. G. DUCA"" (ȘCOALA GENERALĂ NR.1) SEDIUL VECHI",PETROŞANI,HD,1686,11,2,0,13,65,3,0,68,93,5,0,98,122,8,0,130,130,8,0,138
87004,141,"ȘCOALA GIMNAZIALĂ I.G.DUCA (ȘCOALA GENERALĂ NR. 1 - SEDIUL VECHI)",PETROŞANI,HD,1540,11,4,0,15,61,4,0,65,85,7,0,92,112,11,0,123,122,12,0,134
87004,142,"ȘCOALA GIMNAZIALĂ I.G. DUCA (ȘCOALA GENERALĂ NR. 1 - SEDIUL NOU)",PETROŞANI,HD,1387,9,0,0,9,61,2,0,63,98,5,0,103,122,5,0,127,128,5,0,133
87004,143,"AMFITEATRUL UNIVERSITĂȚII",PETROŞANI,HD,1420,8,0,0,8,56,1,0,57,79,1,0,80,97,2,0,99,105,2,0,107
87004,144,"CLUB SPORTIV ȘCOLAR",PETROŞANI,HD,1011,7,5,0,12,43,7,0,50,57,9,0,66,76,9,0,85,84,9,0,93
87004,145,"ȘCOALA GIMNAZIALĂ AVRAM STANCA (ȘCOALA GENERALĂ NR.4)",PETROŞANI,HD,1076,7,4,0,11,26,4,0,30,48,4,0,52,64,4,0,68,65,4,0,69
87004,146,"ȘCOALA GIMNAZIALĂ AVRAM STANCA (ȘCOALA GENERALĂ NR.4)",PETROŞANI,HD,1690,9,5,0,14,43,8,0,51,66,8,0,74,88,10,0,98,98,10,0,108
87004,147,"COLEGIUL NAȚIONAL ""MIHAI EMINESCU"" (LICEUL TEORETIC)",PETROŞANI,HD,1826,12,1,0,13,60,1,0,61,69,1,0,70,75,1,0,76,85,1,0,86
87004,148,"GRĂDINIȚA NR.3 CU PROGRAM PRELUNGIT",PETROŞANI,HD,931,13,1,0,14,38,1,0,39,56,1,0,57,68,2,0,70,73,2,0,75
87004,149,"COLEGIUL NAȚIONAL DE INFORMATICĂ CARMEN SYLVA (LICEUL DE INFORMATICĂ)",PETROŞANI,HD,1420,7,1,0,8,58,3,0,61,88,3,0,91,109,3,0,112,118,4,0,122
87004,150,"COLEGIUL ECONOMIC ""HERMES """,PETROŞANI,HD,1522,10,2,0,12,33,3,0,36,59,4,62,125,69,4,62,135,80,5,62,147
87004,151,"ȘCOALA GIMNAZIALĂ I.G.DUCA (ȘCOALA GENERALĂ NR.5)",PETROŞANI,HD,1557,13,5,0,18,48,6,0,54,61,6,0,67,76,10,0,86,79,13,0,92
87004,152,"ȘCOALA GIMNAZIALĂ ""I.G. DUCA"" (ȘCOALA GENERALĂ NR.5)",PETROŞANI,HD,1463,20,2,0,22,73,3,0,76,91,3,0,94,108,3,0,111,111,3,0,114
87004,153,"ȘCOALA GIMNAZIALĂ CARMEN SYLVA (ȘCOALA GENERALĂ NR.6)",PETROŞANI,HD,1675,27,4,0,31,56,6,0,62,90,6,0,96,117,7,0,124,126,8,0,134
87004,154,"ȘCOALA GIMNAZIALĂ CARMEN SYLVA (ȘCOALA GENERALĂ NR.6)",PETROŞANI,HD,1689,9,1,0,10,34,3,0,37,41,3,0,44,54,6,0,60,55,6,0,61
87004,155,"GRĂDINIȚA CU PROGRAM PRELUNGIT AEROPORT",PETROŞANI,HD,893,12,5,0,17,27,5,0,32,41,5,0,46,57,5,0,62,61,6,0,67
87004,156,"BIBLIOTECA MUNICIPALĂ PETROȘANI",PETROŞANI,HD,1504,10,4,0,14,30,5,0,35,44,6,0,50,64,6,0,70,73,6,0,79
87004,157,"BIBLIOTECA MUNICIPALĂ PETROȘANI",PETROŞANI,HD,1764,7,3,0,10,26,5,0,31,55,5,0,60,76,5,0,81,94,5,0,99
87004,158,"ȘCOALA GIMNAZIALĂ NR.7",PETROŞANI,HD,1742,18,0,0,18,40,1,0,41,60,1,0,61,74,1,0,75,84,4,0,88
87004,159,"ȘCOALA GIMNAZIALĂ NR.7",PETROŞANI,HD,1870,19,6,0,25,52,7,0,59,73,7,0,80,101,7,0,108,107,7,0,114
87004,160,"S.C. GENERAL TRANS S.A.",PETROŞANI,HD,659,0,0,0,0,4,6,0,10,4,6,0,10,6,6,0,12,8,8,0,16
87004,161,"CASA PENSIONARILOR",PETROŞANI,HD,1470,4,0,0,4,24,0,0,24,31,0,0,31,41,4,0,45,45,4,0,49
87004,162,"CASA PENSIONARILOR",PETROŞANI,HD,1062,3,0,0,3,20,0,0,20,30,0,0,30,33,3,0,36,34,4,0,38
87004,163,"ȘCOALA GIMNAZIALĂ NR. 2",PETROŞANI,HD,1243,9,1,0,10,27,2,0,29,39,3,0,42,61,3,0,64,63,3,0,66
87004,164,"SEDIUL S.C. TERMOFICARE",PETROŞANI,HD,1154,12,0,0,12,30,0,0,30,41,1,0,42,50,2,0,52,55,2,0,57
87004,165,"COLEGIUL NAŢIONAL ""MIHAI EMINESCU"" (ŞCOALA GIMNAZIALĂ DÂLJA MARE)",PETROŞANI,HD,177,0,0,0,0,9,0,0,9,9,2,0,11,10,2,0,12,15,2,0,17
87184,166,"GRĂDINIȚA PN+PP NR. 1",VULCAN,HD,1208,12,5,0,17,29,8,0,37,48,8,0,56,64,8,0,72,72,9,0,81
87184,167,"ȘCOALĂ GIMNAZIALĂ NR. 4",VULCAN,HD,1058,11,0,0,11,31,2,0,33,53,2,0,55,63,2,0,65,64,2,0,66
87184,168,"ȘCOALA GIMNAZIALĂ NR. 4",VULCAN,HD,1105,25,0,0,25,56,1,0,57,77,2,0,79,101,2,0,103,101,2,0,103
87184,169,"CANTINA DE AJUTOR SOCIAL",VULCAN,HD,1344,19,3,0,22,45,3,0,48,75,4,0,79,89,6,0,95,98,6,0,104
87184,170,"COLEGIUL TEHNIC MIHAI VITEAZU",VULCAN,HD,1099,9,2,0,11,27,3,0,30,46,3,0,49,60,3,0,63,60,3,0,63
87184,171,"COLEGIUL TEHNIC MIHAI VITEAZU",VULCAN,HD,1089,7,4,0,11,26,4,0,30,44,6,0,50,61,6,0,67,62,7,0,69
87184,172,"ȘCOALA GIMNAZIALĂ NR. 5",VULCAN,HD,1356,11,0,0,11,39,0,0,39,58,0,0,58,78,0,0,78,82,0,1,83
87184,173,"ȘCOALA GIMNAZIALĂ NR. 5",VULCAN,HD,1502,17,0,0,17,43,0,0,43,75,2,0,77,99,3,0,102,105,3,0,108
87184,174,"STADIONUL CENTRAL",VULCAN,HD,1290,11,1,0,12,26,1,0,27,41,1,0,42,59,1,0,60,63,1,0,64
87184,175,"SALA DE SPORT",VULCAN,HD,1494,13,0,0,13,53,1,0,54,71,1,0,72,86,2,0,88,91,2,0,93
87184,176,"ȘCOALA GIMNAZIALĂ NR. 6",VULCAN,HD,1304,6,7,0,13,18,7,0,25,27,10,0,37,29,10,0,39,29,10,0,39
87184,177,"ȘCOALA GIMNAZIALĂ NR. 6",VULCAN,HD,1391,12,0,0,12,34,0,0,34,57,0,0,57,80,1,0,81,82,1,0,83
87184,178,"ȘCOALA GIMNAZIALĂ NR. 6,",VULCAN,HD,1464,13,4,0,17,40,5,0,45,55,5,0,60,71,5,0,76,79,5,0,84
87184,179,"GRĂDINIȚA CU PROGRAM NORMAL DIN CADRUL ȘCOLII GIMNAZIALE NR. 6",VULCAN,HD,1324,10,2,0,12,29,4,0,33,50,4,0,54,54,4,0,58,56,4,0,60
87184,180,"ȘCOALA GIMNAZIALĂ TEODORA LUCACIU",VULCAN,HD,1223,10,0,0,10,46,0,0,46,57,0,0,57,67,1,0,68,67,1,0,68
87184,181,"ȘCOALA GIMNAZIALĂ TEODORA LUCACIU",VULCAN,HD,968,10,0,0,10,31,0,0,31,37,0,0,37,53,2,0,55,61,3,0,64
87184,182,"CLUBUL COPIILOR ȘI ELEVILOR",VULCAN,HD,929,4,0,0,4,28,0,0,28,44,0,0,44,47,0,0,47,50,0,0,50
87184,183,"ȘCOALA NR. 2",VULCAN,HD,845,3,4,0,7,12,5,0,17,20,5,0,25,22,5,0,27,23,5,0,28
87184,184,"ȘCOALA GIMNAZIALĂ NR. 3",VULCAN,HD,1433,20,3,0,23,49,4,0,53,67,4,0,71,78,4,0,82,83,4,0,87
87228,185,"SCOALA GIMNAZIALA ""SF. VARVARA"" ANINOASA",ANINOASA,HD,1568,12,0,0,12,35,0,0,35,47,0,0,47,60,0,0,60,64,0,0,64
87228,186,"STADIONUL ""MINERUL ANINOASA""",ANINOASA,HD,875,0,0,0,0,8,0,0,8,28,2,0,30,33,2,0,35,40,2,0,42
87237,187,"SCOALA GIMNAZIALA ISCRONI",ISCRONI,HD,1330,6,0,0,6,13,0,0,13,25,1,0,26,35,1,0,36,38,1,0,39
87433,188,"CONSILIUL LOCAL CĂLAN",CĂLAN,HD,1079,6,4,0,10,20,4,0,24,32,9,0,41,39,10,0,49,44,10,0,54
87433,189,"ŞCOALA GIMNAZIALĂ",CĂLAN,HD,1147,17,1,0,18,43,2,0,45,49,3,0,52,58,3,0,61,58,3,0,61
87433,190,"ŞCOALA GIMNAZIALĂ",CĂLAN,HD,1478,11,1,0,12,35,1,0,36,47,1,0,48,66,2,0,68,72,2,0,74
87433,191,"LICEU TEHNOLOGIC OVID DENSUŞIANU",CĂLAN,HD,1548,6,0,0,6,25,0,0,25,42,1,0,43,76,1,0,77,81,1,0,82
87433,192,"CENTRUL DE SĂNĂTATE MULTIFUNCŢIONAL",CĂLAN,HD,1505,15,0,0,15,35,0,0,35,45,0,0,45,69,1,0,70,72,4,0,76
87433,193,"CASA CĂSĂTORIILOR",CĂLAN,HD,1402,21,0,0,21,52,0,0,52,78,1,0,79,88,2,2,92,94,2,2,98
87488,194,"CĂMINUL CULTURAL","NĂDĂŞTIA DE JOS",HD,262,4,4,0,8,7,4,0,11,8,4,1,13,11,4,1,16,13,4,1,18
87497,195,"CĂMINUL CULTURAL","NĂDĂŞTIA DE SUS",HD,226,2,0,0,2,8,0,0,8,12,1,0,13,13,1,0,14,13,5,0,18
87530,196,"CĂMINUL CULTURAL",STREI,HD,313,0,0,0,0,3,0,0,3,5,0,0,5,8,0,0,8,9,0,0,9
87549,197,"CĂMINUL CULTURAL",STREI-SĂCEL,HD,157,0,3,0,3,3,5,0,8,6,5,0,11,8,5,0,13,11,6,0,17
87558,198,"CĂMINUL CULTURAL","VALEA SÎNGEORGIULUI",HD,258,0,0,0,0,0,0,0,0,0,0,0,0,6,4,0,10,9,5,0,14
87451,199,"ŞCOALA PRIMARĂ",BATIZ,HD,491,1,5,0,6,3,6,0,9,3,6,0,9,5,6,0,11,6,6,0,12
87479,200,"ŞCOALA PRIMARĂ",GRID,HD,205,0,0,0,0,3,2,0,5,4,2,0,6,5,2,0,7,5,2,0,7
87512,201,"ŞCOALA PRIMARĂ SÎNCRAI",SÎNCRAI,HD,258,3,0,0,3,5,0,0,5,7,0,0,7,7,0,0,7,7,0,0,7
87521,202,"CASA PAROHIALĂ","SÎNTĂMĂRIA DE PIATRĂ",HD,131,3,0,0,3,6,0,0,6,6,0,0,6,7,0,0,7,7,0,0,7
87442,203,"CĂMINUL CULTURAL STREISÎNGEORGIU",STREISÎNGEORGIU,HD,631,10,1,0,11,21,4,0,25,26,4,0,30,29,4,0,33,30,4,0,34
89570,204,"SEDIUL PRIMARIEI GEOAGIU",GEOAGIU,HD,1199,1,0,0,1,9,5,0,14,11,11,0,22,15,13,0,28,23,13,64,100
89570,205,"GRĂDINIŢA CU PROGRAM NORMAL NR.1 GEOAGIU,",GEOAGIU,HD,1191,4,0,0,4,7,1,0,8,15,1,0,16,16,2,0,18,16,2,0,18
89589,206,"CĂMINUL CULTURAL AUREL VLAICU","AUREL VLAICU",HD,774,6,4,0,10,18,7,0,25,29,7,0,36,40,8,0,48,45,8,0,53
89605,207,"CĂMINUL CULTURAL BOZES",BOZEŞ,HD,175,2,1,0,3,3,1,0,4,3,1,0,4,4,1,0,5,4,1,0,5
89614,208,"ŞCOALA PRIMARĂ CIGMAU",CIGMĂU,HD,89,1,0,0,1,1,0,0,1,1,3,0,4,2,3,0,5,2,3,0,5
89632,209,"SCOALA PRIMARA GEOAGIU BAI",GEOAGIU-BĂI,HD,369,2,10,0,12,4,69,0,73,13,122,0,135,21,159,0,180,21,161,0,182
89623,210,"ŞCOALA PRIMARĂ GELMAR",GELMAR,HD,384,7,0,0,7,13,0,0,13,17,0,0,17,29,1,0,30,29,1,0,30
89641,211,"CĂMINUL CULTURAL HOMOROD",HOMOROD,HD,292,2,2,0,4,2,2,0,4,2,3,0,5,4,5,0,9,7,5,0,12
89669,212,"ŞCOALĂ PRIMARĂ RENGHET",RENGHET,HD,175,1,1,0,2,1,3,0,4,1,3,0,4,2,3,0,5,2,3,0,5
89678,213,"ŞCOALA PRIMARĂ VĂLENI",VĂLENI,HD,43,1,0,0,1,1,1,0,2,1,1,0,2,1,1,0,2,1,1,0,2
87585,214,"PRIMĂRIA ORAŞULUI HAŢEG",HAŢEG,HD,1549,29,1,0,30,71,8,0,79,87,16,0,103,117,21,0,138,136,23,0,159
87585,215,"ȘCOALA GIMNAZIALĂ ""OVID DENSUȘIANU"", HAȚEG",HAŢEG,HD,1566,10,6,0,16,34,6,0,40,62,11,0,73,71,21,0,92,81,25,0,106
87585,216,"ȘCOALA GIMNAZIALĂ ""ARON DENSUȘIANU"", HAȚEG",HAŢEG,HD,1642,14,16,0,30,53,19,0,72,79,21,0,100,99,23,0,122,107,48,0,155
87585,217,"COLEGIUL NAŢIONAL ,,I.C.BRĂTIANU"" HAŢEG",HAŢEG,HD,1586,30,2,0,32,67,4,0,71,106,7,0,113,130,14,0,144,140,15,0,155
87585,218,"CANTINA SOCIALĂ HAŢEG",HAŢEG,HD,1727,22,3,0,25,83,6,0,89,105,9,0,114,154,9,0,163,171,12,0,183
87594,219,"ŞCOALA PRIMARĂ NĂLAŢVAD",NĂLAŢVAD,HD,313,4,0,0,4,10,0,0,10,18,0,0,18,29,0,0,29,43,0,0,43
87601,220,"SCOALA PRIMARĂ SIVAŞU DE JOS","SILVAŞU DE JOS",HD,313,2,0,0,2,15,4,0,19,15,6,0,21,16,6,0,22,18,7,0,25
87610,221,"ȘCOALA PRIMARĂ SILVAȘU DE SUS","SILVAŞU DE SUS",HD,272,4,3,0,7,23,19,0,42,29,24,0,53,34,26,0,60,34,26,0,60
87086,222,"CASA DE CULTURA ""LADISLAU SCHMIDT""",PETRILA,HD,1483,9,0,0,9,37,2,0,39,61,2,0,63,77,2,0,79,89,3,0,92
87086,223,"SC EDIL URBAN SERV SA",PETRILA,HD,1446,9,3,0,12,33,4,0,37,45,5,0,50,65,5,0,70,80,6,0,86
87086,224,"SC EDIL SAL PREST SA",PETRILA,HD,1402,14,3,0,17,52,3,0,55,68,3,0,71,83,3,0,86,85,3,0,88
87086,225,"SCOALA GIMNAZIALA I.D. SARBU",PETRILA,HD,1244,9,7,0,16,29,7,0,36,51,8,0,59,72,9,0,81,83,10,0,93
87086,226,"CLUBUL COPIILOR",PETRILA,HD,1370,9,0,0,9,30,0,0,30,46,0,0,46,70,0,0,70,82,0,0,82
87086,227,"SCOALA GIMNAZIALA NR. 6SECTIA 1",PETRILA,HD,1279,12,3,0,15,43,3,0,46,74,3,0,77,92,4,0,96,99,4,0,103
87086,228,"SCOALA GIMNAZIALA NR. 6 SECTIA 2",PETRILA,HD,974,9,4,0,13,32,4,0,36,45,4,0,49,59,4,0,63,63,4,0,67
87086,229,"SCOALA GIMNAZIALA NR. 5SECTIA 1",PETRILA,HD,1444,12,0,0,12,49,0,0,49,76,2,0,78,103,3,0,106,114,3,0,117
87086,230,"SCOALA GIMNAZIALA NR. 5SECTIA 2",PETRILA,HD,1379,5,3,0,8,31,5,0,36,55,5,0,60,72,5,0,77,87,6,0,93
87086,231,"GRADINITA PN",PETRILA,HD,1345,4,7,0,11,25,7,0,32,39,7,0,46,57,8,0,65,68,8,0,76
87086,232,"COLEGIUL CONSTANTIN BRANCUSI",PETRILA,HD,975,13,3,0,16,20,3,0,23,33,3,0,36,50,5,0,55,54,5,0,59
87086,233,"CASA PENSIONARILOR LONEA",PETRILA,HD,1188,7,0,0,7,27,0,0,27,44,0,0,44,58,0,0,58,67,0,0,67
87086,234,"SCOALA GIMNAZIALA ANA COLDA",PETRILA,HD,1464,13,3,0,16,35,3,0,38,69,4,0,73,117,6,0,123,122,7,0,129
87095,235,"SCOALA PRIMARANR. 3 CIMPA",CIMPA,HD,1429,7,6,0,13,31,6,0,37,51,6,0,57,78,7,0,85,86,9,0,95
87086,236,"GRADINITA CU PROGRAM NORMAL ANA COLDA",PETRILA,HD,1201,10,0,0,10,39,3,16,58,60,4,16,80,80,4,17,101,81,4,17,102
87102,237,"SCOALA PRIMARA NR. 4, F.N. , JIET",JIEŢ,HD,563,2,0,0,2,6,0,0,6,10,0,0,10,15,0,0,15,15,0,0,15
87674,238,"SCOALA GIMNAZIALA ,,SIGISMUND TODUTA '' SIMERIA",SIMERIA,HD,1594,23,0,0,23,48,4,0,52,73,5,0,78,106,6,0,112,117,6,0,123
87674,239,"SCOALA GIMNAZIALA ,,SIGISMUND TODUTA '' SIMERIA",SIMERIA,HD,1483,15,3,0,18,47,10,0,57,68,11,0,79,92,14,0,106,100,15,0,115
87674,240,"GRADINITA CU PROGRAM NORMAL NR.1 SIMERIA",SIMERIA,HD,1521,15,0,0,15,45,1,0,46,62,5,0,67,80,5,0,85,91,9,0,100
87674,241,"GRADINITA P.P.1",SIMERIA,HD,1515,17,1,0,18,49,2,0,51,80,3,0,83,100,3,0,103,107,3,0,110
87674,242,"OCOLUL SILVIC SIMERIA",SIMERIA,HD,1406,8,2,0,10,32,2,0,34,55,3,0,58,69,5,0,74,81,5,0,86
87674,243,"COLEGIUL TEHNIC DE TRANSPORT FEROVIAR ,,ANGHEL SALIGNY'' SIMERIA",SIMERIA,HD,1243,14,2,0,16,35,4,0,39,46,5,0,51,64,10,0,74,71,15,0,86
87674,244,"STATIA CFR SIMERIA",SIMERIA,HD,1042,9,13,0,22,26,16,0,42,43,16,0,59,55,17,0,72,65,17,0,82
87709,245,"SCOALA GENERALA SIMERIA VECHE","SIMERIA VECHE",HD,357,8,0,0,8,13,0,0,13,21,0,0,21,27,0,0,27,31,0,0,31
87736,246,"CASA SATULUI UROI",UROI,HD,539,4,2,0,6,9,3,0,12,13,3,0,16,21,3,0,24,28,3,0,31
87718,247,"SCOALA GENERALA SÎNTANDREI",SÎNTANDREI,HD,949,10,2,0,12,25,2,0,27,41,6,0,47,51,10,0,61,53,12,0,65
87148,248,"CENTRULNAŢIONAL DE INFORMARE ŞI PROMOVARE TURISTICĂ",URICANI,HD,1925,18,0,0,18,54,2,0,56,84,2,0,86,96,7,0,103,101,7,0,108
87148,249,"SCOALA GIMNAZIALA ""BUCURA""",URICANI,HD,1904,10,0,0,10,37,1,0,38,59,2,0,61,98,3,0,101,105,3,0,108
87148,250,"LICEUL TEHNOLOGIC ""RETEZAT""",URICANI,HD,1809,21,0,0,21,66,0,0,66,92,1,0,93,117,1,0,118,121,1,0,122
87148,251,"CASA DE CULTURA, URICANI,SALA PARTER",URICANI,HD,1747,9,2,0,11,37,2,0,39,73,3,0,76,92,4,0,96,99,4,0,103
87157,252,"ŞCOALA PRIMARĂ CÎMPU LUI NEAG","CÎMPU LUI NEAG",HD,414,4,4,0,8,5,5,0,10,12,5,0,17,14,5,0,19,14,5,0,19
87754,253,"ŞCOALA GIMNAZIALĂ,,AVRAM IANCU,, BAIA DE CRIŞ","BAIA DE CRIŞ",HD,608,2,1,0,3,12,1,0,13,15,1,0,16,26,3,0,29,27,3,0,30
87790,254,"SCOALA PRIMARA LUNCA",LUNCA,HD,235,3,0,0,3,5,2,0,7,6,5,0,11,6,5,0,11,7,5,0,12
87781,255,"SCOALA PRIMARA CARASTAU",CĂRĂSTĂU,HD,162,1,3,0,4,1,4,0,5,6,5,0,11,10,5,0,15,10,6,0,16
87807,256,"CAMIN CULTURAL RISCA",RIŞCA,HD,190,5,0,0,5,10,1,0,11,14,1,0,15,16,2,0,18,17,2,0,19
87816,257,"SCOALA PRIMARA RISCULITA",RIŞCULIŢA,HD,411,5,1,0,6,10,2,0,12,11,2,0,13,17,3,0,20,19,3,0,22
87825,258,"SCOALA PRIMARA TEBEA",ŢEBEA,HD,588,10,0,0,10,18,0,0,18,23,2,0,25,29,4,0,33,31,4,0,35
87852,259,"BALŞA, SEDIUL PRIMĂRIEI COMUNEI",BALŞA,HD,234,0,0,0,0,1,0,0,1,2,0,1,3,7,1,1,9,7,1,1,9
87870,260,"ARDEU, CĂMINUL CULTURAL",ARDEU,HD,49,5,1,0,6,5,1,0,6,7,2,0,9,7,2,0,9,7,2,0,9
87905,261,"MADA, CĂMINUL CULTURAL",MADA,HD,89,2,0,0,2,2,0,0,2,3,0,0,3,4,2,0,6,5,2,0,7
87987,262,"VOIA, CĂMINUL CULTURAL",VOIA,HD,70,1,1,0,2,2,2,0,4,4,3,0,7,5,4,0,9,5,4,0,9
87978,263,"VĂLIŞOARA, ŞCOALA GENERALĂ",VĂLIŞOARA,HD,48,1,0,0,1,1,0,0,1,2,1,0,3,3,3,0,6,7,3,0,10
87861,264,"ALMAŞU MIC DE MUNTE, ŞCOALA GENERALĂ","ALMAŞU MIC DE MUNTE",HD,60,3,2,0,5,4,3,0,7,4,3,0,7,4,5,0,9,5,5,0,10
87923,265,"POIANA, CĂMINUL CULTURAL",POIANA,HD,85,1,1,0,2,1,1,0,2,3,2,0,5,3,2,0,5,3,2,0,5
87932,266,"POIENIŢA, CĂMINUL CULTURAL",POIENIŢA,HD,66,1,0,0,1,1,1,0,2,3,2,0,5,5,4,0,9,5,4,0,9
88001,267,"SCOALA PRIMARĂ BARU",BARU,HD,1610,31,4,0,35,78,9,0,87,127,11,0,138,153,17,57,227,174,18,57,249
88010,268,"SCOALA PRIMARĂ LIVADIA",LIVADIA,HD,533,7,3,0,10,16,4,18,38,31,4,18,53,46,8,18,72,47,8,18,73
88038,269,"SCOALA PRIMARĂ VALEA LUPULUI","VALEA LUPULUI",HD,163,5,2,0,7,8,3,0,11,14,4,9,27,19,7,9,35,23,7,9,39
88056,270,"CĂMINUL CULTURAL BĂCIA, NR. 235",BĂCIA,HD,818,5,3,0,8,11,5,0,16,20,6,0,26,29,7,0,36,29,10,0,39
88083,271,"ŞCOALA PRIMARĂ TOTIA, NR.3",TOTIA,HD,83,0,5,0,5,0,5,0,5,0,5,0,5,0,5,0,5,0,5,0,5
88074,272,"ŞCOALA PRIMARĂ TÎMPA, NR.28",TÎMPA,HD,663,6,0,0,6,13,0,0,13,20,2,0,22,31,2,0,33,37,4,0,41
88109,273,"CĂMINUL CULTURAL BĂIŢA",BĂIŢA,HD,1009,3,0,0,3,11,8,0,19,15,9,0,24,25,11,0,36,44,11,0,55
88154,274,"ŞCOALA PRIMARA HĂRŢĂGANI",HĂRŢĂGANI,HD,615,4,0,0,4,8,0,0,8,8,0,0,8,8,1,0,9,10,1,0,11
88127,275,"CĂMINUL CULTURAL CĂINELU DE SUS","CĂINELU DE SUS",HD,339,4,5,0,9,6,5,0,11,6,6,0,12,8,6,0,14,9,6,0,15
88172,276,"ŞCOALA PRIMARĂ ORMINDEA",ORMINDEA,HD,456,2,0,0,2,5,0,0,5,5,0,0,5,13,2,0,15,13,3,0,16
88145,277,"CĂMINUL CULTURAL FIZEŞ",FIZEŞ,HD,259,5,2,0,7,7,3,0,10,10,4,0,14,11,5,0,16,12,5,0,17
88163,278,"CĂMINUL CULTURAL LUNCA",LUNCA,HD,238,3,1,0,4,7,1,0,8,10,1,0,11,17,4,0,21,22,8,0,30
87255,279,"CĂMIN CULTURAL BĂNIȚA",BĂNIŢA,HD,988,9,0,0,9,14,0,0,14,17,1,0,18,20,1,0,21,23,1,0,24
88225,280,"PRIMARIA COMUNEI BĂTRÎNA",BĂTRÎNA,HD,96,1,0,0,1,4,4,0,8,10,4,0,14,11,5,0,16,11,5,0,16
88270,281,"CAMINUL CULTURAL",BERIU,HD,585,5,1,0,6,13,1,0,14,18,1,0,19,18,2,0,20,20,2,0,22
88289,282,SCOALAPRIMARĂ,CĂSTĂU,HD,1061,7,4,0,11,14,7,0,21,28,8,0,36,31,9,0,40,39,9,0,48
88298,283,"SCOALA PRIMARĂ",CUCUIŞ,HD,106,1,0,0,1,3,0,0,3,5,0,0,5,6,2,0,8,7,2,0,9
88314,284,"SCOALA PRIMARĂ","ORĂŞTIOARA DE JOS",HD,285,5,0,0,5,5,0,0,5,5,0,0,5,10,2,0,12,12,2,0,14
88332,285,"SCOALA PRIMARĂ",SERECA,HD,208,2,0,0,2,3,2,0,5,3,2,0,5,6,2,0,8,9,2,0,11
88341,286,"SCOALA PRIMARĂ SIBIŞEL",SIBIŞEL,HD,571,3,3,0,6,4,3,0,7,7,4,0,11,8,6,0,14,10,6,0,16
88369,287,"CAMINUL CULTURAL BLAJENI",BLĂJENI,HD,522,2,0,0,2,7,2,0,9,9,2,0,11,15,2,0,17,15,2,0,17
88387,288,"SCOALA PRIMARA CRIS",CRIŞ,HD,246,3,0,0,3,8,0,0,8,8,2,0,10,9,2,0,11,11,5,0,16
88378,289,"SCOALA PRIMARA BLAJENI VULCAN",BLĂJENI-VULCAN,HD,80,1,3,0,4,1,4,0,5,1,4,0,5,3,5,0,8,8,5,0,13
88421,290,"SCOALA PRIMARA RET",REŢ,HD,81,0,0,0,0,0,0,0,0,0,0,0,0,0,0,0,0,0,0,0,0
88458,291,"CĂMINUL CULTURAL BOSOROD",BOŞOROD,HD,793,6,0,0,6,11,0,0,11,16,0,0,16,21,0,0,21,26,2,0,28
88485,292,"CENTRUL LOCAL DE INFORMARE TURISTICĂ",CHITID,HD,477,4,0,0,4,7,1,0,8,21,1,0,22,28,2,0,30,30,2,0,32
88500,293,"CĂMINUL CULTURAL LUNCANI",LUNCANI,HD,107,2,1,0,3,4,2,0,6,5,2,0,7,5,3,0,8,5,3,0,8
88528,294,"CĂMINUL CULTURAL URSICI",URSICI,HD,52,0,0,0,0,0,0,0,0,2,0,0,2,2,4,0,6,3,5,0,8
88467,295,"CĂMINUL CULTURAL ALUN",ALUN,HD,64,0,0,0,0,0,0,0,0,0,0,0,0,2,2,0,4,5,5,0,10
88537,296,"CĂMINUL CULTURAL TIRSA",TÎRSA,HD,169,3,0,0,3,3,2,0,5,4,3,0,7,5,4,0,9,5,4,0,9
88555,297,"CĂMIN CULTURAL BRĂNIŞCA",BRĂNIŞCA,HD,523,5,0,0,5,13,3,0,16,17,10,11,38,23,11,11,45,26,13,11,50
88564,298,"CĂMIN CULTURAL BOZ",BOZ,HD,367,3,2,0,5,3,3,0,6,5,3,0,8,8,3,0,11,9,3,0,12
88617,299,"CĂMIN CULTURAL ROVINA",ROVINA,HD,187,1,1,0,2,1,2,0,3,5,3,0,8,9,4,0,13,12,4,0,16
88626,300,"CĂMIN CULTURAL TÎRNAVA",TÎRNAVA,HD,100,1,0,0,1,3,0,0,3,3,0,0,3,4,1,0,5,4,2,0,6
88635,301,"CĂMIN CULTURAL TÎRNĂVIŢA",TÎRNĂVIŢA,HD,143,0,0,0,0,1,0,0,1,1,0,0,1,6,2,0,8,7,2,0,9
88636,302,"CĂMIN CULTURAL FURCŞOARA",FURCŞOARA,HD,48,1,3,0,4,1,5,0,6,1,7,0,8,1,7,0,8,1,7,0,8
88653,303,"ŞCOALA GIMNAZIALA BRETEA ROMANA","BRETEA ROMÂNĂ",HD,231,1,0,0,1,7,7,0,14,7,7,0,14,12,9,0,21,12,9,0,21
88680,304,"CĂMIN CULTURAL","BRETEA STREIULUI",HD,217,3,1,0,4,12,5,0,17,14,6,0,20,17,7,0,24,21,9,0,30
88742,305,"CĂMIN CULTURAL",RUŞI,HD,210,3,6,0,9,3,6,0,9,6,6,0,12,7,6,0,13,9,6,0,15
88662,306,"ŞCOALA PRIMARA",BĂŢĂLAR,HD,201,0,0,0,0,7,0,0,7,9,0,0,9,10,4,0,14,11,5,0,16
88724,307,"ŞCOALA PRIMARA","OCOLIŞU MARE",HD,176,2,0,0,2,4,1,0,5,6,3,0,9,7,4,0,11,10,4,0,14
88699,308,"CĂMIN CULTURAL COVRAGIU",COVRAGIU,HD,135,0,1,0,1,0,1,0,1,1,1,0,2,1,5,0,6,3,6,0,9
88706,309,"ŞCOALĂ PRIMARĂ",GÎNŢAGA,HD,230,4,2,0,6,4,3,0,7,12,3,0,15,17,3,0,20,17,3,0,20
88715,310,"ŞCOALĂ PRIMARĂ",MĂCEU,HD,263,4,3,0,7,4,4,0,8,4,6,0,10,5,6,0,11,5,6,0,11
88733,311,"ŞCOALĂ PRIMARĂ",PLOPI,HD,225,0,2,0,2,0,2,0,2,1,2,0,3,3,4,0,7,6,4,0,10
88760,312,"ŞCOALĂ PRIMARĂ","VÎLCELELE BUNE",HD,324,1,0,0,1,5,0,0,5,11,2,0,13,21,3,0,24,27,8,0,35
88751,313,"ŞCOALĂ PRIMARĂ VÎLCELE",VÎLCELE,HD,221,2,0,0,2,5,5,0,10,9,5,0,14,12,5,1,18,12,5,1,18
88797,314,"PRIMĂRIA COMUNEI BUCEŞ",BUCEŞ,HD,131,3,0,0,3,5,0,0,5,6,0,0,6,9,1,0,10,11,3,0,14
88804,315,"SCOALA PRIMARA BUCES-VULCAN",BUCEŞ-VULCAN,HD,180,1,0,0,1,1,0,0,1,2,0,0,2,2,0,0,2,2,0,0,2
88813,316,"SCOALA PRIMARA DUPAPIATRA",DUPĂPIATRĂ,HD,402,1,0,0,1,3,0,0,3,4,0,0,4,7,0,0,7,7,0,0,7
88822,317,"SCOALA PRIMARA GROHOTELE",GROHOŢELE,HD,165,2,2,0,4,8,2,0,10,8,2,0,10,8,4,0,12,9,4,0,13
88831,318,"SCOALA PRIMARA MIHAILENI",MIHĂILENI,HD,350,0,0,0,0,0,0,0,0,1,0,0,1,4,0,0,4,12,2,0,14
88840,319,"SCOALA PRIMARA STANIJA",STĂNIJA,HD,322,2,0,0,2,5,0,0,5,8,3,0,11,10,3,0,13,10,3,0,13
88877,320,"CAMINUL CULTURAL",BUCUREŞCI,HD,505,1,1,0,2,5,1,0,6,9,1,0,10,11,1,0,12,18,1,0,19
88886,321,"CAMINUL CULTURAL",CURECHIU,HD,273,5,1,0,6,10,1,0,11,14,2,0,16,24,2,0,26,25,2,0,27
88902,322,"CAMINUL CULTURAL",ROVINA,HD,129,0,0,0,0,0,0,0,0,0,2,0,2,3,4,0,7,3,4,0,7
88895,323,"CAMINUL CULTURAL",MERIŞOR,HD,73,0,0,0,0,1,0,0,1,1,0,0,1,3,3,0,6,3,3,0,6
88911,324,"CAMINUL CULTURAL",ŞESURI,HD,344,4,1,0,5,11,1,0,12,13,1,0,14,19,2,0,21,23,2,0,25
88939,325,"PRIMARIA BULZESTII DE SUSSALA DE SEDINTA","BULZEŞTII DE SUS",HD,137,5,0,0,5,8,1,0,9,10,2,0,12,10,3,0,13,11,3,0,14
88948,326,"SCOALA PRIMARA BULZESTII DE JOS","BULZEŞTII DE JOS",HD,95,3,0,0,3,9,1,0,10,10,2,0,12,12,2,0,14,12,2,0,14
89035,327,"CĂMINUL CULTURAL BUNILA",BUNILA,HD,66,5,0,0,5,5,0,0,5,5,0,0,5,5,0,0,5,6,0,0,6
89053,328,"CLADIRE DISPENSAR MEDICAL CERNISOARA FLORESE","CERNIŞOARA FLORESE",HD,170,0,0,0,0,5,1,0,6,9,1,0,10,12,2,0,14,12,2,0,14
89062,329,"CAMINUL CULTURAL POIENITA VOINII","POIENIŢA VOINII",HD,68,0,0,0,0,2,2,0,4,6,2,0,8,8,2,0,10,10,2,0,12
89099,330,"CAMIN CULTURAL BURJUC",BURJUC,HD,140,2,2,0,4,7,4,0,11,10,5,0,15,12,5,0,17,12,5,0,17
89133,331,"CAMIN CULTURALTĂTĂRĂŞTI",TĂTĂRĂŞTI,HD,149,2,0,0,2,3,2,0,5,3,3,0,6,9,5,0,14,10,6,0,16
89142,332,"CAMIN CULTURAL TISA",TISA,HD,94,0,0,0,0,1,0,0,1,3,0,0,3,4,0,0,4,5,0,0,5
89115,333,"ŞCOALAPRIMARA GLODGHILEŞTI",GLODGHILEŞTI,HD,168,0,0,0,0,8,0,0,8,8,0,0,8,10,0,0,10,13,0,0,13
89106,334,"ŞCOALAPRIMARA BRĂDĂŢEL",BRĂDĂŢEL,HD,119,0,0,0,0,0,0,0,0,0,0,0,0,1,5,0,6,3,5,0,8
86758,335,"CĂMINUL CULTURAL CÎRJIŢI",CÂRJIŢI,HD,107,0,0,0,0,0,4,0,4,2,4,0,6,5,4,0,9,7,4,0,11
86776,336,"CĂMINUL CULTURAL CHERGHEŞ",CHERGHEŞ,HD,73,2,2,0,4,3,2,0,5,5,3,0,8,6,3,0,9,6,4,0,10
86794,337,"CĂMINUL CULTURAL POPEŞTI",POPEŞTI,HD,114,1,1,0,2,2,1,0,3,3,4,0,7,3,4,0,7,4,8,0,12
86767,338,"CĂMINUL CULTURAL ALMAŞU SEC","ALMAŞU SEC",HD,167,2,0,0,2,4,0,0,4,4,2,0,6,11,3,0,14,17,3,0,20
86785,339,"CĂMINUL CULTURAL COZIA",COZIA,HD,134,5,0,0,5,8,0,0,8,8,0,0,8,8,0,0,8,10,0,0,10
89160,340,"CASA COMUNALĂ CERBĂL-SALA DE ŞEDINŢĂ A CONSILIULUI LOCAL CERBĂL",CERBĂL,HD,177,7,0,0,7,12,2,0,14,21,3,0,24,24,6,0,30,26,6,0,32
89188,341,"ŞCOALA PRIMARĂ FEREGI",FEREGI,HD,112,5,2,0,7,8,3,0,11,11,3,0,14,12,3,0,15,12,3,0,15
89213,342,"ŞCOALA PRIMARĂ POIANA RĂCHIŢELII","POIANA RĂCHIŢELII",HD,101,4,2,0,6,6,2,0,8,6,2,0,8,7,4,0,11,7,4,0,11
89259,343,"CAMINUL CULTURAL","CERTEJU DE SUS",HD,1238,20,2,0,22,41,4,0,45,54,6,0,60,73,6,0,79,77,6,0,83
89286,344,"CAMINUL CULTURAL",HONDOL,HD,443,4,2,0,6,7,2,0,9,12,2,0,14,20,2,0,22,23,2,0,25
89311,345,"CAMINUL CULTURAL",SĂCĂRÎMB,HD,143,3,2,0,5,4,4,0,8,5,4,0,9,5,4,0,9,5,4,0,9
89277,346,"SPAȚIU ADMINISTRATIV BOCȘA MICĂ","BOCŞA MICĂ",HD,91,2,4,0,6,6,4,0,10,6,4,0,10,16,4,0,20,18,4,0,22
89295,347,"CĂMINUL CULTURAL",MĂGURA-TOPLIŢA,HD,84,3,1,0,4,6,1,0,7,7,1,0,8,9,1,0,10,14,1,0,15
89320,348,"CĂMINUL CULTURAL","TOPLIŢA MUREŞULUI",HD,72,1,1,0,2,1,2,0,3,3,3,0,6,4,4,0,8,4,4,0,8
89302,349,"SCOALA PRIMARĂ NOJAG",NOJAG,HD,202,2,6,0,8,3,6,0,9,5,6,0,11,7,8,0,15,8,8,0,16
89339,350,"SCOALA PRIMARĂ VĂRMAGA",VĂRMAGA,HD,246,0,2,0,2,3,4,0,7,5,7,0,12,6,7,0,13,6,7,0,13
87406,351,"CAMINUL CULTURAL",ZDRAPŢI,HD,741,0,2,0,2,4,2,0,6,11,4,0,15,19,6,0,25,20,9,0,29
87371,352,"SCOALA GENERALA NR 1 CRIŞCIOR",CRIŞCIOR,HD,1350,9,4,0,13,23,4,0,27,41,7,0,48,47,8,0,55,50,8,0,58
87371,353,"LICEUL TEHNOLOGIC CRIŞAN CRIŞCIOR",CRIŞCIOR,HD,1242,10,1,0,11,20,1,0,21,27,3,0,30,39,3,0,42,40,3,0,43
89357,354,"SCOALA GIMNAZIALA DENSUS",DENSUŞ,HD,499,7,1,0,8,20,12,0,32,24,16,0,40,27,17,0,44,29,18,0,47
89384,355,"ŞCOALA PRIMARĂ PEŞTEANA",PEŞTEANA,HD,300,5,0,0,5,5,0,0,5,6,0,0,6,11,1,0,12,16,1,0,17
89393,356,"SCOALA PRIMARA PESTENITA",PEŞTENIŢA,HD,217,4,0,0,4,5,0,0,5,7,0,0,7,12,2,0,14,16,2,0,18
89419,357,"CAMINUL CULTURAL STEI",ŞTEI,HD,158,2,0,0,2,5,2,0,7,6,2,0,8,10,2,0,12,11,5,0,16
89400,358,"SCOALA PRIMARA POIENI",POIENI,HD,70,2,4,0,6,4,4,0,8,5,4,0,9,5,5,0,10,5,5,0,10
89437,359,CĂMINULCULTURALDOBRA,DOBRA,HD,1313,5,2,0,7,22,8,0,30,30,10,0,40,41,13,0,54,52,20,0,72
89473,360,CĂMINULCULTURALLAPUSNIC,LĂPUŞNIC,HD,395,3,0,0,3,7,4,0,11,7,5,0,12,8,8,0,16,14,8,0,22
89516,361,"CAMINUL CULTURAL RADULESTI",RĂDULEŞTI,HD,153,2,7,0,9,2,7,0,9,4,7,0,11,5,7,0,12,5,7,0,12
89534,362,CĂMINULCULTURALSTANCESTI,STÎNCEŞTI,HD,105,4,5,0,9,5,5,0,10,7,5,0,12,9,6,0,15,9,6,0,15
89525,363,"SCOALA PRIMARA ROSCANI",ROŞCANI,HD,561,4,0,0,4,7,4,0,11,16,5,0,21,21,6,0,27,28,6,0,34
89491,364,"CĂMINUL CULTURAL PANC",PANC,HD,145,2,3,0,5,4,3,0,7,6,3,0,9,13,7,0,20,16,7,0,23
91740,365,"SALA DE SEDINTE CONSILIUL LOCAL","GENERAL BERTHELOT",HD,542,1,1,0,2,13,1,0,14,15,3,0,18,16,5,0,21,17,6,0,23
91786,366,"SCOALA PRIMARA TUSTEA",TUŞTEA,HD,227,3,1,0,4,10,1,0,11,10,3,0,13,12,3,0,15,13,3,0,16
86892,367,"PRIMARIA GHELARI",GHELARI,HD,639,2,1,0,3,11,1,0,12,16,1,0,17,20,1,0,21,23,1,0,24
86892,368,"CĂMINUL CULTURAL ""MINERUL""",GHELARI,HD,892,14,0,0,14,27,1,0,28,30,1,0,31,40,2,0,42,45,2,0,47
86927,369,"CĂMIN CULTURAL",RUDA,HD,138,3,1,0,4,8,2,0,10,8,2,0,10,13,5,0,18,14,6,0,20
86918,370,"MAGAZIN ABC",PLOP,HD,23,2,4,0,6,3,4,0,7,8,7,0,15,10,7,0,17,11,7,0,18
86909,371,DISPENSAR,GOVĂJDIA,HD,76,0,0,0,0,1,0,0,1,2,0,0,2,3,0,0,3,3,0,0,3
89696,372,"SALĂ DE ŞEDINŢE PRIMARIA COMUNEI GURASADA",GURASADA,HD,598,1,1,0,2,7,1,0,8,10,1,0,11,13,2,0,15,15,3,0,18
89749,373,"CĂMIN CULTURAL CÎMPURI-SURDUC",CÎMPURI-SURDUC,HD,364,4,0,0,4,11,1,0,12,21,3,0,24,28,3,0,31,37,3,0,40
89712,374,"CĂMIN CULTURAL BOIU DE SUS","BOIU DE SUS",HD,95,1,0,0,1,1,0,0,1,2,0,0,2,2,3,0,5,2,3,0,5
89721,375,"ŞCOALA GENERALĂ CĂRMĂZĂNEŞTI",CĂRMĂZĂNEŞTI,HD,93,2,0,0,2,3,0,0,3,4,1,0,5,5,3,0,8,5,3,0,8
89810,376,"DISPENSAR MEDICAL HĂRĂU",HĂRĂU,HD,662,1,1,0,2,5,4,0,9,10,6,0,16,18,6,0,24,22,7,0,29
89829,377,"CĂMINUL CULTURAL BANPOTOC",BANPOTOC,HD,389,2,0,0,2,9,0,0,9,12,0,0,12,14,0,0,14,14,1,0,15
89838,378,"ŞCOALA PRIMARĂ BÎRSĂU",BÎRSĂU,HD,426,0,0,0,0,4,3,0,7,7,4,0,11,13,4,0,17,13,4,0,17
89847,379,"ŞCOALA PRIMARĂ CHIMINDIA",CHIMINDIA,HD,312,1,2,0,3,4,2,0,6,12,4,0,16,23,6,0,29,25,8,0,33
89865,380,"CĂMINUL CULTURALDINILIA",ILIA,HD,1456,11,3,0,14,28,6,0,34,45,8,0,53,81,10,0,91,97,10,0,107
89883,381,"ȘCOALA PRIMARĂ BRETEA MUREȘANĂ","BRETEA MUREŞANĂ",HD,507,4,3,0,7,13,6,0,19,17,7,0,24,18,8,0,26,20,11,0,31
89936,382,"CĂMINUL CULTURAL DIN SÎRBI",SÎRBI,HD,358,1,0,0,1,3,0,0,3,3,0,0,3,4,0,0,4,5,0,0,5
89945,383,"CĂMINUL CULTURAL DIN VALEA LUNGĂ","VALEA LUNGĂ",HD,89,5,3,0,8,5,3,0,8,5,3,0,8,6,3,0,9,7,4,0,11
89874,384,"CĂMINUL CULTURAL DINBACEA",BACEA,HD,307,3,1,0,4,5,3,0,8,8,3,0,11,14,4,0,18,14,4,0,18
89892,385,"CĂMINUL CULTURAL DINBRÎZNIC",BRÎZNIC,HD,183,2,1,0,3,6,5,0,11,9,7,0,16,14,10,0,24,15,12,0,27
89927,386,"CĂMINUL CULTURAL DINSĂCĂMAŞ",SĂCĂMAŞ,HD,174,0,0,0,0,2,0,0,2,4,0,0,4,6,2,0,8,6,2,0,8
89963,387,"CĂMINUL CULTURAL LĂPUGIU DE JOS","LĂPUGIU DE JOS",HD,381,2,2,0,4,3,3,0,6,5,3,0,8,9,4,0,13,11,5,0,16
90048,388,"CĂMINUL CULTURAL OHABA",OHABA,HD,406,3,2,0,5,7,2,0,9,14,2,0,16,21,6,0,27,23,7,0,30
90020,389,"CĂMINUL CULTURAL LĂPUGIU DE SUS","LĂPUGIU DE SUS",HD,306,3,0,0,3,7,2,0,9,7,2,0,9,11,5,0,16,17,7,0,24
90075,390,"PRIMARIA COMUNEI LELESE, SALA BIBLIONET",LELESE,HD,162,1,0,0,1,1,0,0,1,2,1,0,3,2,1,0,3,5,2,0,7
90084,391,"CĂMINUL CULTURAL CERIȘOR",CERIŞOR,HD,83,0,2,0,2,0,2,0,2,1,2,0,3,1,2,0,3,2,5,0,7
90093,392,"CAMIN CULTURAL RUNCU MARE","RUNCU MARE",HD,86,0,0,0,0,1,0,0,1,1,0,0,1,2,2,0,4,2,2,0,4
90128,393,"ŞCOALA GIMNAZIALĂ LUNCA CERNII DE JOS","LUNCA CERNII DE JOS",HD,382,0,0,0,0,1,0,0,1,2,0,0,2,2,2,0,4,4,3,0,7
90182,394,"CĂMIN CULTURAL NEGOIU",NEGOIU,HD,155,0,0,0,0,1,2,0,3,1,2,0,3,3,2,0,5,3,2,0,5
90173,395,"CĂMIN CULTURAL MERIA",MERIA,HD,223,2,0,0,2,3,0,0,3,5,0,0,5,6,0,0,6,9,1,0,10
90217,396,"CAMIN UL CULTURAL LUNCOIU DE JOS","LUNCOIU DE JOS",HD,886,4,0,0,4,10,1,0,11,16,1,0,17,22,1,0,23,25,1,0,26
90235,397,"ȘCOALA PRIMARĂ LUNCOIU DE SUS","LUNCOIU DE SUS",HD,631,3,4,0,7,6,4,0,10,10,4,0,14,15,5,0,20,17,6,0,23
90271,398,"SCOALA PRIMARA MĂRTINEŞTI",MĂRTINEŞTI,HD,233,4,3,0,7,9,5,0,14,9,5,0,14,10,9,0,19,12,9,0,21
90280,399,"CĂMIN CULTURAL DÎNCU MARE","DÎNCU MARE",HD,196,4,0,0,4,7,0,0,7,8,1,0,9,11,3,0,14,12,3,0,15
90299,400,"CAMIN CULTURAL DÂNCU MIC","DÎNCU MIC",HD,88,4,5,0,9,4,7,0,11,7,7,0,14,9,10,1,20,10,10,1,21
90306,401,"CAMIN CULTURAL JELEDINŢI",JELEDINŢI,HD,214,0,0,0,0,4,0,0,4,7,2,0,9,8,2,0,10,8,2,0,10
90324,402,"CAMIN CULTURAL TĂMĂŞASA",TĂMĂŞASA,HD,93,0,0,0,0,0,2,0,2,1,3,0,4,4,5,0,9,4,5,0,9
90351,403,"CAMIN CULTURAL ORASTIOARA DE SUS","ORĂŞTIOARA DE SUS",HD,408,2,0,0,2,3,0,0,3,3,0,0,3,9,0,0,9,13,3,0,16
90360,404,"CAMIN CULTURAL BUCIUM",BUCIUM,HD,269,1,0,0,1,5,0,0,5,8,0,0,8,13,0,0,13,13,0,0,13
90404,405,"SCOALA PRIMARA LUDESTII DE JOS","LUDEŞTII DE JOS",HD,284,2,1,0,3,5,3,0,8,6,5,0,11,7,5,0,12,7,5,0,12
90379,406,"CAMIN CULTURAL COSTESTI",COSTEŞTI,HD,425,7,1,0,8,9,15,0,24,10,15,0,25,13,15,0,28,16,15,0,31
90397,407,"SCOALA PRIMARA GRADISTE","GRĂDIŞTEA DE MUNTE",HD,138,0,0,0,0,2,1,0,3,2,1,0,3,2,3,0,5,4,4,0,8
90422,408,"SCOALA PRIMARA OCOLISU MIC","OCOLIŞU MIC",HD,303,6,0,0,6,10,0,0,10,13,1,0,14,13,1,0,14,13,2,0,15
90440,409,"ŞCOALA PRIMARĂ PESTIŞU MIC","PESTIŞU MIC",HD,178,4,0,0,4,9,0,0,9,10,0,0,10,17,1,0,18,21,1,0,22
90459,410,"CĂMINUL CULTURAL ALMAŞU MIC","ALMAŞU MIC",HD,55,1,3,0,4,1,7,0,8,4,7,0,11,5,8,0,13,5,8,0,13
90468,411,CĂMINULCULTURALCIULPĂZ,CIULPĂZ,HD,93,2,0,0,2,4,0,0,4,6,0,0,6,6,0,0,6,6,0,0,6
90495,412,"ȘCOALA PRIMARĂ JOSANI",JOSANI,HD,171,7,0,0,7,13,0,0,13,16,2,0,18,17,3,0,20,18,3,0,21
90501,413,"ȘCOALA PRIMARĂMĂNERĂU",MĂNERĂU,HD,246,8,0,0,8,16,0,0,16,21,0,0,21,25,3,0,28,30,6,0,36
90510,414,"ȘCOALA PRIMARĂ NANDRU",NANDRU,HD,139,3,0,0,3,6,2,0,8,7,4,0,11,12,4,0,16,13,5,0,18
90529,415,"ȘCOALA PRIMARĂ VALEA NANDRULUI","VALEA NANDRULUI",HD,124,1,1,0,2,1,1,0,2,4,1,0,5,5,1,0,6,8,1,0,9
90547,416,"ŞCOALA GIMNAZIALĂ PUI",PUI,HD,684,8,2,0,10,22,2,0,24,27,2,0,29,33,3,0,36,37,4,0,41
90636,417,"ŞCOALA PRIMARĂ RUŞOR",RUŞOR,HD,272,4,0,0,4,7,0,0,7,7,3,0,10,17,5,0,22,17,5,0,22
90556,418,"ŞCOALA PRIMARĂ BĂIEŞTI",BĂIEŞTI,HD,191,2,2,0,4,8,2,0,10,10,3,0,13,13,5,0,18,17,5,0,22
90583,419,"ŞCOALA PRIMARĂ GALAŢI",GALAŢI,HD,394,5,2,0,7,9,2,0,11,13,4,0,17,17,4,0,21,17,4,0,21
90574,420,"ŞCOALA PRIMARĂ FIZEŞTI",FIZEŞTI,HD,263,1,0,0,1,7,0,0,7,10,0,0,10,10,0,0,10,10,0,0,10
90645,421,"ŞCOALA PRIMARĂ ŞEREL",ŞEREL,HD,368,2,2,0,4,2,4,0,6,3,4,0,7,5,4,0,9,12,4,0,16
90627,422,"CĂMIN CULTURAL RÎU-BĂRBAT","RÎU BĂRBAT",HD,152,0,0,0,0,4,0,0,4,9,0,0,9,9,0,0,9,9,0,0,9
90592,423,"ŞCOALA PRIMARĂ HOBIŢA",HOBIŢA,HD,145,3,0,0,3,3,0,0,3,5,0,0,5,5,0,0,5,6,0,0,6
90654,424,"ŞCOALA PRIMARĂ URIC",URIC,HD,255,3,1,0,4,10,2,0,12,10,4,0,14,13,4,0,17,18,5,0,23
90618,425,"ŞCOALA PRIMARĂ PONOR",PONOR,HD,368,3,4,0,7,3,4,0,7,3,4,0,7,4,4,0,8,6,4,0,10
90609,426,"ŞCOALA PRIMARĂ OHABA PONOR",OHABA-PONOR,HD,210,1,0,0,1,3,0,0,3,3,0,0,3,3,0,0,3,3,0,0,3
90565,427,"ŞCOALA PRIMARĂ FEDERI",FEDERI,HD,201,1,0,0,1,3,0,0,3,5,0,0,5,5,3,0,8,5,3,0,8
90690,428,"CAMIN CULTURAL",BOIU,HD,131,5,0,0,5,5,2,0,7,5,2,0,7,9,2,0,11,9,2,0,11
90681,429,"CAMIN CULTURAL",BOBÎLNA,HD,396,1,1,0,2,3,3,0,6,4,3,0,7,10,4,0,14,14,7,0,21
90707,430,"CAMIN CULTURAL",FOLT,HD,137,2,0,0,2,2,1,0,3,2,1,0,3,3,1,0,4,4,1,0,5
90716,431,"CAMIN CULTURAL",RAPOLŢEL,HD,183,1,1,0,2,1,2,0,3,6,2,0,8,7,2,0,9,7,2,0,9
90672,432,"PRIMARIA RAPOLTU MARE","RAPOLTU MARE",HD,764,5,0,0,5,5,0,0,5,7,0,0,7,10,0,0,10,11,0,0,11
90734,433,"CAMINUL CULTURAL RĂCHITOVA",RĂCHITOVA,HD,537,10,0,0,10,20,2,0,22,26,3,0,29,29,3,0,32,43,9,0,52
90743,434,"SCOALA PRIMARA BOIȚA",BOIŢA,HD,365,6,0,0,6,7,0,0,7,17,2,0,19,27,2,0,29,31,2,0,33
90798,435,"SCOALA PRIMARA VĂLIOARA",VĂLIOARA,HD,191,2,0,0,2,3,2,0,5,3,3,0,6,9,7,0,16,9,8,0,17
90887,436,"ŞCOALA GENERALĂ RÎU DE MORI","RÂU DE MORI",HD,841,12,1,0,13,14,5,0,19,23,5,0,28,31,5,0,36,41,5,0,46
90903,437,"ȘCOALA PRIMARĂ CLOPOTIVA",CLOPOTIVA,HD,693,6,1,0,7,12,2,0,14,12,2,0,14,25,4,0,29,27,13,0,40
90921,438,"CĂMINUL CULTURAL OSTROV",OSTROV,HD,379,0,0,0,0,2,1,0,3,7,1,0,8,13,1,0,14,14,1,0,15
90985,439,"CĂMINUL CULTURALVALEA DÎLJII","VALEA DÎLJII",HD,192,2,0,0,2,3,0,0,3,8,0,0,8,15,0,0,15,17,0,0,17
90976,440,"ȘCOALA PRIMARĂ UNCIUC",UNCIUC,HD,181,0,5,0,5,1,5,0,6,7,5,0,12,8,5,0,13,10,6,0,16
90958,441,"ȘCOALA PRIMARĂ SIBIȘEL",SIBIŞEL,HD,307,3,3,0,6,4,5,0,9,5,11,0,16,17,11,0,28,20,11,0,31
90814,442,"CĂMINUL CULTURAL RIBIŢA",RIBIŢA,HD,514,5,1,0,6,10,1,0,11,16,2,0,18,17,4,0,21,17,4,0,21
90823,443,"CĂMINUL CULTURAL CRIŞANCLADIRE PARTER",CRIŞAN,HD,359,4,0,0,4,22,12,0,34,32,13,0,45,33,13,0,46,33,13,0,46
90832,444,"ŞCOALA PRIMARĂ DUMBRAVA DE JOS","DUMBRAVA DE JOS",HD,142,0,0,0,0,0,0,0,0,2,0,0,2,5,4,0,9,6,4,0,10
90841,445,"ŞCOALA PRIMARĂ DUMBRAVA DE SUS","DUMBRAVA DE SUS",HD,56,1,0,0,1,3,2,0,5,3,2,0,5,3,2,0,5,4,2,0,6
90869,446,"CĂMINUL CULTURAL UIBĂREŞTI",UIBĂREŞTI,HD,60,3,5,0,8,3,6,0,9,3,6,0,9,5,6,0,11,6,6,0,12
91009,447,"SCOALA PRIMARA ROMOS",ROMOS,HD,975,4,1,0,5,13,2,0,15,21,4,0,25,33,4,0,37,34,5,0,39
91036,448,"SCOALA PRIMARA ROMOSEL",ROMOŞEL,HD,591,3,3,0,6,5,3,0,8,7,3,0,10,8,3,0,11,9,3,0,12
91045,449,"SCOALA PRIMARA VAIDEI",VAIDEI,HD,509,3,3,0,6,10,5,0,15,12,6,0,18,18,10,0,28,19,11,0,30
91027,450,"SCOALA PRIMARA PISCHINTI",PIŞCHINŢI,HD,184,2,2,0,4,4,5,0,9,7,5,0,12,9,6,0,15,11,6,0,17
91063,451,"CAMINUL CULTURAL SARMIZEGETUSA",SARMIZEGETUSA,HD,465,10,1,0,11,20,2,0,22,25,2,0,27,34,3,0,37,42,5,0,47
91072,452,"SCOALA PRIMARA BREAZOVA",BREAZOVA,HD,153,7,3,0,10,10,3,0,13,28,4,0,32,30,6,0,36,30,6,0,36
91081,453,"SCOALA PRIMARA HOBITA-GRADISTE",HOBIŢA-GRĂDIŞTE,HD,110,4,1,0,5,9,1,0,10,12,1,0,13,13,3,0,16,17,3,0,20
91090,454,"CAMINUL CULTURAL PAUCINESTI",PĂUCINEŞTI,HD,149,0,0,0,0,3,0,0,3,8,2,0,10,10,3,0,13,11,3,0,14
91107,455,"CAMINUL CULTURAL ZEICANI",ZEICANI,HD,106,3,0,0,3,9,1,0,10,11,5,0,16,12,8,0,20,12,9,0,21
91125,456,"CĂMINUL CULTURAL","SĂLAŞU DE SUS",HD,424,9,4,0,13,17,6,0,23,20,6,0,26,33,7,0,40,36,7,0,43
91214,457,"ŞCOALA PRIMARĂ SĂLAŞU DE JOS","SĂLAŞU DE JOS",HD,196,1,0,0,1,2,1,0,3,5,1,0,6,11,2,0,13,12,2,0,14
91161,458,"ŞCOALA GENERALĂ OHABA DE SUB PIATRĂ","OHABA DE SUB PIATRĂ",HD,163,3,3,0,6,5,3,0,8,14,4,0,18,14,4,0,18,17,6,0,23
91198,459,"ŞCOALA PRIMARĂ RÎU ALB","RÎU ALB",HD,163,2,0,0,2,9,3,0,12,9,3,0,12,9,3,0,12,10,3,0,13
91134,460,"CĂMIN CULTURAL COROIEŞTI",COROIEŞTI,HD,150,6,0,0,6,7,0,0,7,12,0,0,12,16,3,0,19,21,3,0,24
91170,461,"ŞCOALA GENERALĂ PAROŞ",PAROŞ,HD,272,1,0,0,1,5,0,0,5,7,0,0,7,10,0,0,10,11,0,0,11
91152,462,"ŞCOALA PRIMARĂ NUCŞOARA",NUCŞOARA,HD,242,2,1,0,3,2,1,0,3,3,1,0,4,4,1,0,5,4,1,0,5
91143,463,"CĂMIN CULTURAL MĂLĂIEŞTI",MĂLĂIEŞTI,HD,124,1,0,0,1,3,1,0,4,6,2,0,8,10,2,0,12,10,2,0,12
91223,464,"CĂMIN CULTURAL ZĂVOI",ZĂVOI,HD,105,6,0,0,6,6,1,0,7,6,1,0,7,7,1,0,8,11,1,0,12
91205,465,"ŞCOALA PRIMARĂ RÎU MIC","RÎU MIC",HD,143,0,0,0,0,2,0,0,2,2,0,0,2,5,0,0,5,5,0,0,5
91241,466,"CĂMINUL CULTURAL SÎNTĂMĂRIA-ORLEA",SÂNTĂMĂRIA-ORLEA,HD,635,2,0,0,2,15,0,0,15,22,0,0,22,28,0,0,28,33,0,0,33
91312,467,"ŞCOALA PRIMARĂ SUBCETATE",SUBCETATE,HD,480,1,0,0,1,8,3,0,11,17,4,0,21,24,4,0,28,28,5,0,33
91278,468,"CĂMINUL CULTURAL BUCIUM",BUCIUM-ORLEA,HD,175,0,1,0,1,5,2,0,7,7,3,0,10,9,4,0,13,9,4,0,13
91250,469,"CĂMINUL CULTURAL BALOMIR",BALOMIR,HD,269,7,0,0,7,13,1,0,14,16,1,0,17,19,3,0,22,27,3,0,30
91287,470,"ŞCOALA PRIMARĂ CIOPEIA",CIOPEIA,HD,327,2,2,0,4,6,2,0,8,7,2,0,9,11,2,0,13,11,2,0,13
91269,471,"ŞCOALA PRIMARĂ BĂRĂŞTII-HAŢEGULUI","BĂRĂŞTII HAŢEGULUI",HD,316,3,2,0,5,5,3,0,8,11,3,0,14,18,3,0,21,22,5,0,27
91296,472,ŞCOALASĂCEL,SĂCEL,HD,227,3,3,0,6,8,5,0,13,9,5,0,14,13,5,0,18,13,6,0,19
91303,473,"CĂMINUL CULTURAL SÎNPETRU",SÎNPETRU,HD,201,3,3,0,6,5,3,0,8,15,4,0,19,22,5,0,27,22,8,0,30
91349,474,"CĂMIN CULTURAL,SAT ŞOIMUŞ NR. 310",ŞOIMUŞ,HD,1088,7,3,0,10,20,4,0,24,26,5,0,31,38,9,0,47,39,9,0,48
91358,475,"CĂMIN CULTURAL,SAT BĂLATA NR. 37",BĂLATA,HD,357,4,6,0,10,6,8,0,14,12,8,0,20,13,9,0,22,17,9,0,26
91367,476,"CĂMIN CULTURAL SAT BOHOLT,NR. 39",BOHOLŢ,HD,271,3,0,0,3,5,0,0,5,6,0,0,6,6,5,0,11,8,7,0,15
91410,477,"CĂMIN CULTURAL SAT FORNĂDIA, NR. 71",FORNĂDIA,HD,179,4,0,0,4,6,0,0,6,7,0,0,7,10,1,0,11,11,1,0,12
91438,478,"ŞCOALA PRIMARĂ SATSULIGHETE NR. 88",SULIGHETE,HD,233,0,0,0,0,1,0,0,1,1,0,0,1,2,0,0,2,3,0,0,3
91429,479,"CĂMIN CULTURAL , SAT PĂULIŞ, NR. 61",PĂULIŞ,HD,563,3,1,0,4,6,2,0,8,7,2,0,9,14,2,0,16,14,3,0,17
91401,480,"CĂMIN CULTURAL SATCHIŞCĂDAGA, NR. 94",CHIŞCĂDAGA,HD,301,4,0,0,4,5,1,0,6,5,1,0,6,7,1,0,8,9,1,0,10
86945,481,"PRIMARIA COMUNEI TELIUCU INFERIOR","TELIUCU INFERIOR",HD,1197,10,1,0,11,32,3,0,35,40,4,0,44,54,7,0,61,61,9,0,70
86954,482,"CASA TINERETULUI CINCIȘAN",CINCIŞ-CERNA,HD,550,14,2,0,16,33,2,0,35,43,8,0,51,62,10,0,72,72,10,0,82
86963,483,"CAMIN CULTURAL",IZVOARELE,HD,76,3,1,0,4,9,1,0,10,10,1,0,11,15,2,0,17,16,3,0,19
86972,484,"CAMIN CULTURALSI RECREATIV PLOSCA","TELIUCU SUPERIOR",HD,268,5,3,0,8,8,3,0,11,9,3,0,12,12,3,0,15,12,3,0,15
91483,485,"CĂMIN CULTURAL",LIVADA,HD,97,1,0,0,1,2,0,0,2,2,0,0,2,3,0,0,3,4,0,0,4
91456,486,"CĂMINUL CULTURAL TOMEŞTI",TOMEŞTI,HD,439,1,0,0,1,3,0,0,3,6,0,0,6,12,0,0,12,15,2,0,17
91465,487,"CĂMIN CULTURAL DOBROŢ",DOBROŢ,HD,332,1,0,0,1,1,0,0,1,5,0,0,5,7,0,0,7,7,0,0,7
91544,488,CAMINULCULTURALTOPLITA,TOPLIŢA,HD,154,2,0,0,2,4,2,0,6,7,2,0,9,7,3,0,10,8,3,0,11
91599,489,SCOALAPRIMARAHASDAU,HĂŞDĂU,HD,303,5,1,0,6,7,1,0,8,10,1,0,11,15,1,0,16,16,4,0,20
91571,490,CAMINULCULTURALDABICA,DĂBÎCA,HD,130,0,0,0,0,5,2,0,7,5,2,0,7,5,2,0,7,5,2,0,7
91562,491,CAMINULCULTURALDEALUMIC,"DEALU MIC",HD,42,3,2,0,5,3,4,0,7,3,4,0,7,4,6,0,10,4,7,0,11
91615,492,"CĂMIN CULTURAL VĂLARI",VĂLARI,HD,29,0,0,0,0,1,0,0,1,5,4,0,9,5,6,0,11,5,6,0,11
91633,493,"CAMIN CULTURAL TOTESTI",TOTEŞTI,HD,333,7,0,0,7,14,0,0,14,20,0,0,20,31,0,0,31,33,1,0,34
91642,494,"CAMINUL CULTURAL CIRNESTI",CÎRNEŞTI,HD,383,8,0,0,8,11,0,0,11,12,0,6,18,25,0,6,31,25,0,6,31
91660,495,"SCOALA PRIMARA PACLISA",PĂCLIŞA,HD,510,18,6,0,24,37,18,0,55,49,18,0,67,67,18,20,105,72,18,20,110
91679,496,"SCOALA PRIMARA REEA",REEA,HD,347,7,0,0,7,11,3,0,14,14,5,0,19,32,6,1,39,39,7,1,47
91697,497,"CĂMINUL CULTURAL TURDAŞ",TURDAŞ,HD,412,11,0,0,11,28,1,0,29,33,1,0,34,36,1,0,37,42,2,2,46
91704,498,"CĂMINUL CULTURAL PRICAZ",PRICAZ,HD,1028,15,1,0,16,20,3,0,23,21,5,0,26,27,5,0,32,37,7,0,44
91722,499,"ŞCOALA PRIMARĂ SPINI",SPINI,HD,247,2,0,0,2,2,2,0,4,2,2,0,4,7,4,0,11,8,4,0,12
91802,500,"SCOALA GIMNAZIALA VAŢA DE JOS","VAŢA DE JOS",HD,878,2,4,0,6,8,4,0,12,19,4,0,23,24,5,0,29,24,5,0,29
91848,501,"ŞCOALA PRIMARA",CĂZĂNEŞTI,HD,164,0,0,0,0,0,0,0,0,0,2,0,2,1,3,0,4,2,3,0,5
91820,502,"ŞCOALA PRIMARA",BIRTIN,HD,250,7,2,0,9,8,3,0,11,13,3,0,16,20,3,0,23,22,3,0,25
91884,503,"ŞCOALA PRIMARA",PRĂVĂLENI,HD,230,1,0,0,1,2,0,0,2,3,0,0,3,6,0,0,6,10,0,0,10
91857,504,"ŞCOALA PRIMARA",CIUNGANI,HD,200,4,1,0,5,4,1,0,5,4,1,0,5,4,1,0,5,4,1,0,5
91893,505,"ŞCOALA PRIMARA PRIHODIŞTE",PRIHODIŞTE,HD,318,2,0,0,2,3,0,0,3,6,0,0,6,8,0,0,8,11,1,0,12
91919,506,"ŞCOALA PRIMARA TÎRNAVA DE CRIŞ","TÎRNAVA DE CRIŞ",HD,670,4,0,0,4,8,2,0,10,12,4,0,16,12,4,0,16,16,4,0,20
91866,507,"ŞCOALA PRIMARA OCIU",OCIU,HD,406,5,0,0,5,9,2,0,11,10,2,0,12,10,3,0,13,10,4,0,14
91946,508,"CĂMINUL CULTURAL VĂLIŞOARA",VĂLIŞOARA,HD,617,4,0,0,4,6,0,0,6,9,0,0,9,12,3,0,15,13,3,0,16
91955,509,"CĂMINUL CULTURAL DEALU MARE","DEALU MARE",HD,162,1,0,0,1,5,1,0,6,6,1,0,7,8,1,0,9,15,2,0,17
91964,510,"CĂMINUL CULTURAL SĂLIŞTIOARA",SĂLIŞTIOARA,HD,237,4,0,0,4,10,4,0,14,12,4,0,16,13,4,0,17,13,4,0,17
91991,511,"CĂMINUL CULTURAL VEŢEL",VEŢEL,HD,896,4,0,0,4,13,4,0,17,20,7,0,27,26,7,0,33,29,11,0,40
92051,512,"CĂMINUL CULTURAL MINTIA",MINTIA,HD,878,6,2,0,8,15,2,0,17,35,3,0,38,44,3,0,47,51,4,0,55
92042,513,"ȘCOALA PRIMARĂ LEȘNIC",LEŞNIC,HD,463,8,0,0,8,13,3,0,16,16,3,0,19,26,6,0,32,29,6,0,35
92079,514,"ŞCOALA PRIMARĂ MUNCELU MIC","MUNCELU MIC",HD,100,3,5,0,8,3,5,0,8,5,5,0,10,5,5,0,10,6,5,0,11
92060,515,"CĂMIN CULTURAL MUNCELU MARE","MUNCELU MARE",HD,66,0,0,0,0,3,7,0,10,3,7,0,10,3,7,0,10,5,12,0,17
92104,516,"CENTRUL DE INFORMARE TURISTICA VORTA",VORŢA,HD,133,2,0,0,2,4,0,0,4,5,0,0,5,8,0,0,8,8,0,0,8
92168,517,"CAMINUL CULTURAL VISCA",VISCA,HD,301,5,3,0,8,8,3,0,11,10,3,0,13,10,3,0,13,14,3,0,17
92159,518,"SCOALA PRIMARA VALEA POIENII","VALEA POIENII",HD,116,0,0,0,0,0,0,0,0,1,0,0,1,5,0,0,5,5,0,0,5
92122,519,"IMOBILUL NR 9 DIN SATUL COAJA",COAJA,HD,106,1,0,0,1,1,0,0,1,1,0,0,1,4,0,0,4,4,0,0,4
92186,520,"CĂMINUL CULTURAL ZAM",ZAM,HD,554,3,0,0,3,8,0,0,8,13,3,0,16,16,7,0,23,21,8,0,29
92266,521,"ŞCOALA PRIMARĂ POGĂNEŞTI",POGĂNEŞTI,HD,217,2,6,0,8,5,8,0,13,5,8,0,13,6,8,0,14,6,9,0,15
92202,522,"CĂMINUL CULTURAL ALMAŞ SĂLIŞTE",ALMAŞ-SĂLIŞTE,HD,124,0,0,0,0,0,0,0,0,0,0,0,0,0,0,0,0,0,0,0,0
92248,523,"CĂMINUL CULTURAL GODINEŞTI",GODINEŞTI,HD,105,0,1,0,1,0,1,0,1,3,3,0,6,5,3,0,8,5,3,0,8
92284,524,"CĂMINUL CULTURAL SĂLCIVA",SĂLCIVA,HD,390,7,0,0,7,10,0,0,10,15,0,0,15,16,0,0,16,17,0,0,17
83339,1,"TEATRUL MUNICIPAL ""CSIKI JÁTÉKSZÍN"" MIERCUREA-CIUC","MIERCUREA CIUC",HR,1557,11,5,0,16,26,5,0,31,46,5,0,51,57,11,0,68,65,14,0,79
83339,2,"LICEUL DE ARTE ”NAGY ISTVÁN” MIERCUREA-CIUC","MIERCUREA CIUC",HR,1583,4,0,0,4,29,2,0,31,42,3,0,45,51,3,0,54,55,3,0,58
83339,3,"CASA DE CULTURĂ A SINDICATELOR MIERCUREA-CIUC","MIERCUREA CIUC",HR,1600,4,3,0,7,24,9,0,33,37,11,0,48,49,14,0,63,54,15,0,69
83339,4,"ȘCOALA GIMNAZIALĂ ”NAGY IMRE” MIERCUREA-CIUC","MIERCUREA CIUC",HR,1584,1,0,0,1,20,0,0,20,26,0,0,26,36,0,0,36,40,0,0,40
83339,5,"ŞCOALA GIMNAZIALĂ „NAGY IMRE” MIERCUREA-CIUC","MIERCUREA CIUC",HR,1658,4,2,0,6,21,2,0,23,38,2,0,40,50,5,0,55,55,5,0,60
83339,6,"SALA DE SPORT „ERŐSS ZSOLT ARÉNA” MIERCUREA-CIUC","MIERCUREA CIUC",HR,1700,12,0,0,12,20,0,0,20,30,0,0,30,41,0,0,41,45,0,0,45
83339,7,"ȘCOALA GIMNAZIALĂ ”PETŐFI SÁNDOR” MIERCUREA-CIUC","MIERCUREA CIUC",HR,1449,4,0,0,4,21,0,0,21,28,1,0,29,41,2,0,43,47,5,0,52
83339,8,"ȘCOALA GIMNAZIALĂ ”PETŐFI SÁNDOR” MIERCUREA-CIUC","MIERCUREA CIUC",HR,1472,2,0,0,2,11,0,0,11,24,2,0,26,30,7,0,37,34,7,0,41
83339,9,"ȘCOALA GIMNAZIALĂ ”LIVIU REBREANU” MIERCUREA-CIUC","MIERCUREA CIUC",HR,1615,9,0,0,9,25,2,0,27,36,6,0,42,51,6,0,57,56,9,0,65
83339,10,"GRĂDINIŢA „NAPRAFORGÓ” MIERCUREA-CIUC","MIERCUREA CIUC",HR,1498,6,0,0,6,24,4,0,28,43,4,0,47,52,4,0,56,55,6,0,61
83339,11,"S.C. GOSCOM S.A MIERCUREA-CIUC","MIERCUREA CIUC",HR,1546,5,1,0,6,15,1,0,16,19,1,0,20,23,1,0,24,23,1,0,24
83339,12,"ȘCOALAGIMNAZIALĂ ”JÓZSEF ATTILA” MIERCUREA-CIUC","MIERCUREA CIUC",HR,1451,13,3,0,16,34,7,166,207,44,13,166,223,52,18,166,236,59,21,166,246
83339,13,"ȘCOALAGIMNAZIALĂ ”JÓZSEF ATTILA” MIERCUREA-CIUC","MIERCUREA CIUC",HR,1545,6,0,0,6,14,0,0,14,26,2,0,28,39,2,0,41,41,2,0,43
83339,14,"ȘCOALAGIMNAZIALĂ ”JÓZSEF ATTILA” MIERCUREA-CIUC","MIERCUREA CIUC",HR,1672,3,0,0,3,15,0,0,15,34,1,0,35,37,1,0,38,42,2,0,44
83339,15,"SALA DE SPORT A ȘCOLII GIMNAZIALE ”JÓZSEF ATTILA” MIERCUREA-CIUC","MIERCUREA CIUC",HR,1631,3,0,0,3,14,0,0,14,23,3,0,26,33,3,0,36,33,3,0,36
83339,16,"SALA DE SPORT A ȘCOLII GIMNAZILAE ”JÓZSEF ATTILA” MIERCUREA-CIUC","MIERCUREA CIUC",HR,1575,4,0,0,4,14,0,0,14,29,6,0,35,41,7,0,48,43,8,0,51
83339,17,"GRĂDINIŢA ”ARANYALMA” MIERCUREA-CIUC","MIERCUREA CIUC",HR,1693,6,5,0,11,19,5,0,24,28,5,0,33,44,5,0,49,53,5,0,58
83339,18,"LICEUL TEHNOLIGIC ”SZÉKELY KÁROLY” MIERCUREA-CIUC","MIERCUREA CIUC",HR,1479,4,1,0,5,15,1,0,16,19,2,0,21,33,2,0,35,33,2,0,35
83339,19,"LICEUL TEHNOLIGIC ”SZÉKELY KÁROLY” MIERCUREA-CIUC","MIERCUREA CIUC",HR,1459,5,1,0,6,13,2,0,15,18,2,0,20,24,3,0,27,25,3,0,28
83339,20,"ŞCOALA GIMNAZIALĂ ""XANTUS JANOS"" MIERCUREA-CIUC","MIERCUREA CIUC",HR,1211,2,0,0,2,9,0,0,9,11,0,0,11,20,0,0,20,24,0,0,24
83339,21,"SEDIUL ASOCIAȚIEI ”CSÍKSOMLYÓ” MIERCUREA-CIUC","MIERCUREA CIUC",HR,1785,7,2,0,9,14,2,0,16,31,3,0,34,43,5,0,48,47,6,0,53
83339,22,"CASA DE CULTURĂ TOPLIȚA MIERCUREA-CIUC","MIERCUREA CIUC",HR,1572,9,0,0,9,16,0,0,16,22,0,0,22,34,0,0,34,38,3,0,41
83357,23,"ȘCOALA GIMNAZIALĂ ”XÁNTUS JÁNOS” HARGHITA-BĂI MIERCUREA-CIUC",HARGHITA-BĂI,HR,190,1,1,0,2,1,1,0,2,1,2,0,3,2,2,0,4,2,2,0,4
83570,24,"ŞCOALA GIMNAZIALĂ ""KÓS KÁROLY""",GHEORGHENI,HR,1891,4,0,0,4,20,1,0,21,26,1,0,27,35,1,0,36,39,1,0,40
83570,25,"ŞCOALA GIMNAZIALĂ ""KÓS KÁROLY""",GHEORGHENI,HR,1764,3,0,0,3,11,0,0,11,21,0,0,21,26,1,0,27,26,1,0,27
83570,26,"ŞCOALA GIMNAZIALĂ ""KÓS KÁROLY""",GHEORGHENI,HR,1840,1,0,0,1,11,1,0,12,26,2,0,28,36,2,0,38,40,2,0,42
83570,27,"ŞCOALA GIMNAZIALĂ ""VASKERTES""",GHEORGHENI,HR,1745,4,2,0,6,20,3,0,23,26,3,0,29,33,3,0,36,36,4,0,40
83570,28,"ŞCOALA GIMNAZIALĂ ""VASKERTES""",GHEORGHENI,HR,1717,6,0,0,6,26,2,0,28,35,4,0,39,43,5,0,48,47,5,0,52
83570,29,"ŞCOALA GIMNAZIALĂ ""VASKERTES""",GHEORGHENI,HR,1894,11,1,0,12,21,1,0,22,29,1,0,30,34,1,0,35,34,1,0,35
83570,30,"LICEUL TEORETIC ""SALAMON ERNŐ""",GHEORGHENI,HR,1784,7,0,0,7,18,7,0,25,30,7,0,37,42,11,0,53,43,11,0,54
83570,31,"LICEUL TEHNOLOGIC ”FOGARASY MIHÁLY”",GHEORGHENI,HR,1809,6,1,0,7,14,2,0,16,21,3,0,24,34,4,0,38,35,4,0,39
83570,32,"COLEGIUL TEHNIC ""BATTHYÁNY IGNÁC""",GHEORGHENI,HR,1964,1,0,0,1,9,0,0,9,16,0,0,16,23,0,0,23,23,0,0,23
83598,33,"CORP DE CLĂDIRE CU20 DE APARTAMENTE","LACU ROŞU",HR,77,0,1,0,1,0,7,0,7,0,7,0,7,0,8,0,8,2,10,0,12
83142,34,"COLEGIUL TEHNIC ,,BÁNYAIJÁNOS""","ODORHEIU SECUIESC",HR,1497,2,1,0,3,5,1,0,6,10,4,0,14,24,4,0,28,29,4,0,33
83142,35,"COLEGIUL TEHNIC ,,BÁNYAIJÁNOS""","ODORHEIU SECUIESC",HR,1488,2,1,0,3,5,2,0,7,13,3,0,16,21,11,0,32,23,11,0,34
83142,36,"GRĂDINIŢA ,,ZSIBONGÓ""","ODORHEIU SECUIESC",HR,1301,3,0,0,3,19,6,0,25,30,6,0,36,43,8,0,51,44,9,0,53
83142,37,"COLEGIUL REFORMAT ""BACZKAMADARASI KIS GERGELY""","ODORHEIU SECUIESC",HR,1468,7,1,0,8,13,5,0,18,20,5,0,25,28,6,0,34,33,6,0,39
83142,38,"COLEGIUL REFORMAT ""BACZKAMADARASI KIS GERGELY""","ODORHEIU SECUIESC",HR,1131,0,0,0,0,7,5,0,12,8,5,0,13,12,5,0,17,13,5,0,18
83142,39,"CASĂ DE CULTURĂ","ODORHEIU SECUIESC",HR,1413,8,1,0,9,34,3,0,37,39,8,0,47,45,14,0,59,52,15,0,67
83142,40,"LICEUL TEHNOLOGIC ,,KÓS KÁROLY""","ODORHEIU SECUIESC",HR,1595,4,2,0,6,12,2,0,14,12,2,0,14,19,2,0,21,21,4,0,25
83142,41,"LICEUL TEHNOLOGIC ,,KÓS KÁROLY""","ODORHEIU SECUIESC",HR,1601,1,0,0,1,8,0,0,8,18,0,0,18,20,0,0,20,20,0,0,20
83142,42,"IMOBILUL DIN STRADA BETHLEN GÁBOR NR. 50","ODORHEIU SECUIESC",HR,1343,7,0,0,7,21,1,0,22,26,5,0,31,40,6,0,46,41,6,0,47
83142,43,"ŞCOALA GIMNAZIALĂ ,,ORBÁN BALÁZS""","ODORHEIU SECUIESC",HR,1441,6,0,0,6,13,0,0,13,26,0,0,26,35,0,0,35,36,0,0,36
83142,44,"ŞCOALA GIMNAZIALĂ ,,ORBÁN BALÁZS""","ODORHEIU SECUIESC",HR,1234,3,0,0,3,15,0,0,15,19,0,0,19,26,0,0,26,29,1,0,30
83142,45,"ŞCOALA GIMNAZIALĂ ,,ORBÁN BALÁZS""","ODORHEIU SECUIESC",HR,1095,1,0,0,1,12,0,0,12,16,0,0,16,19,0,0,19,22,0,0,22
83142,46,"ŞCOALA GIMNAZIALĂ ,,BETHLEN GÁBOR""","ODORHEIU SECUIESC",HR,1407,4,0,0,4,5,0,0,5,15,0,0,15,32,0,0,32,36,0,0,36
83142,47,"ŞCOALA GIMNAZIALĂ ,,BETHLEN GÁBOR""","ODORHEIU SECUIESC",HR,1408,1,0,0,1,2,0,0,2,7,0,0,7,13,0,0,13,17,0,0,17
83142,48,"ŞCOALA GIMNAZIALĂ ,,BETHLEN GÁBOR""","ODORHEIU SECUIESC",HR,1358,13,0,0,13,26,0,0,26,32,0,0,32,36,0,0,36,41,0,0,41
83142,49,"ŞCOALA GIMNAZIALĂ ,,BETHLEN GÁBOR""","ODORHEIU SECUIESC",HR,1475,4,4,0,8,12,4,0,16,17,5,0,22,20,5,0,25,22,5,0,27
83142,50,"ŞCOALA GIMNAZIALĂ ,,BETHLEN GÁBOR""","ODORHEIU SECUIESC",HR,1462,4,0,0,4,14,0,0,14,21,0,0,21,33,0,0,33,33,0,0,33
83142,51,"ŞCOALA GIMNAZIALĂ ,,MÓRA FERENC""","ODORHEIU SECUIESC",HR,1567,0,0,0,0,7,0,0,7,13,0,0,13,25,0,0,25,31,1,0,32
83142,52,"ŞCOALA GIMNAZIALĂ ,,MÓRA FERENC""","ODORHEIU SECUIESC",HR,1542,0,0,0,0,1,0,0,1,2,0,0,2,9,0,0,9,13,0,0,13
83142,53,"ŞCOALA GIMNAZIALĂ ,,MÓRA FERENC""","ODORHEIU SECUIESC",HR,1549,0,1,0,1,1,1,0,2,5,1,0,6,14,1,0,15,15,1,0,16
83142,54,"ŞCOALA GIMNAZIALĂ ,,MÓRA FERENC""","ODORHEIU SECUIESC",HR,1608,2,2,0,4,6,2,0,8,13,2,0,15,18,2,0,20,19,2,0,21
83142,55,"CLUBUL CASEI DE CULTURĂ BECLEAN","ODORHEIU SECUIESC",HR,1590,1,1,0,2,7,1,0,8,12,3,0,15,24,4,0,28,26,8,0,34
83641,56,"ŞCOALA GIMNAZIALĂ ""MIRON CRISTEA"" TOPLIŢA",TOPLIŢA,HR,1510,5,0,0,5,12,0,0,12,17,0,0,17,21,0,0,21,24,2,0,26
83641,57,"ŞCOALA GIMNAZIALĂ ""MIRON CRISTEA"" TOPLIŢA",TOPLIŢA,HR,1597,4,0,0,4,27,6,0,33,32,8,0,40,37,9,0,46,39,9,0,48
83641,58,"LICEUL TEORETIC ""KEMENY JANOS"" TOPLIŢA",TOPLIŢA,HR,1375,2,0,0,2,10,2,0,12,25,3,0,28,34,5,0,39,36,5,0,41
83641,59,"GRĂDINIŢA VOINICEL NR.1 TOPLIŢA",TOPLIŢA,HR,1059,2,6,0,8,3,6,0,9,6,6,0,12,7,6,0,13,8,6,0,14
83721,60,"ŞCOALA GIMNAZIALĂ ""SF. ILIE"" ZENCANI",ZENCANI,HR,1523,7,0,0,7,12,0,0,12,22,0,0,22,23,0,0,23,25,0,0,25
83641,61,"ŞCOALA GIMNAZIALĂ ""ANDREI ŞAGUNA"" VALE",TOPLIŢA,HR,1571,11,1,0,12,23,3,0,26,29,3,0,32,38,3,0,41,40,3,0,43
83641,62,"COLEGIUL NAŢIONAL ""MIHAI EMINESCU"" TOPLIŢA",TOPLIŢA,HR,998,4,0,0,4,9,1,0,10,16,1,0,17,25,2,0,27,28,2,0,30
83641,63,"ŞCOALA GIMNAZIALĂ ""SF. ILIE"" TOPLIŢA",TOPLIŢA,HR,1130,4,2,0,6,11,2,0,13,17,2,0,19,26,2,0,28,29,2,0,31
83641,64,"LICEUL ""O.C.TĂSLĂUANU"" TOPLIŢA",TOPLIŢA,HR,1309,6,0,0,6,14,0,0,14,20,3,0,23,35,4,0,39,35,4,0,39
83641,65,"ŞCOALA GIMNAZIALĂ ""ANDREI ŞAGUNA"" CĂLIMĂNEL",TOPLIŢA,HR,993,5,5,0,10,8,5,0,13,8,5,0,13,13,5,0,18,13,5,0,18
83696,66,"CABANA OCOLULUI SILVIC",SECU,HR,62,0,2,0,2,0,2,0,2,0,2,0,2,0,2,0,2,0,2,0,2
83437,67,"SEDIU PRIMARIE","BĂILE TUŞNAD",HR,1368,3,15,0,18,9,49,0,58,14,69,0,83,21,95,0,116,21,96,0,117
83473,68,"CASA DE CULTURĂ BĂLAN",BĂLAN,HR,1271,6,0,0,6,22,0,0,22,30,0,0,30,37,1,0,38,39,1,0,40
83473,69,"SCOALA GIMNAZIALĂ ""GEO BOGZA"" BĂLAN - CLĂDIRE ȘCOALA NR. 1",BĂLAN,HR,1324,4,0,0,4,13,2,0,15,23,2,0,25,32,2,0,34,33,3,0,36
83473,70,"ȘCOALA GIMNAZIALĂ ""GEO BOGZA"" BĂLAN - CORP A,B",BĂLAN,HR,1198,6,0,0,6,24,1,0,25,34,2,0,36,35,2,0,37,36,2,0,38
83473,71,"LICEUL TEHNOLOGIC ""LIVIU REBREANU"" BĂLAN - CLĂDIRE GRĂDINIȚA NR. 2",BĂLAN,HR,1257,6,2,0,8,19,2,0,21,28,3,0,31,32,3,0,35,32,3,0,35
83473,72,"CLUBUL ELEVILOR BĂLAN",BĂLAN,HR,1368,4,6,0,10,18,6,0,24,32,6,0,38,40,6,0,46,40,6,0,46
83507,73,"LICEUL TEHNOLOGIC „ZIMMETHAUSEN„",BORSEC,HR,900,0,4,0,4,2,8,0,10,5,8,0,13,5,8,0,13,5,8,0,13
83507,74,"SEDIUL CONSILIULUI LOCAL",BORSEC,HR,1408,9,0,0,9,24,2,0,26,28,3,0,31,35,5,0,40,39,6,0,45
85163,75,"CĂMINUL CULTURAL BETEŞTI",BETEŞTI,HR,646,1,0,0,1,1,0,0,1,1,0,0,1,2,0,0,2,2,0,0,2
83534,76,"ŞCOALA GIMNAZIALĂ ""PETŐFI SÁNDOR"" CRISTURU SECUIESC","CRISTURU SECUIESC",HR,1244,3,3,0,6,6,4,0,10,7,4,0,11,8,4,0,12,8,4,0,12
83534,77,"ŞCOALA GIMNAZIALĂ ""PETŐFI SÁNDOR"" CRISTURU SECUIESC","CRISTURU SECUIESC",HR,1547,0,0,0,0,4,0,0,4,6,0,0,6,6,0,0,6,7,0,0,7
83534,78,"PAROHIA ROMANO-CATOLICĂ CRISTURU SECUIESC","CRISTURU SECUIESC",HR,1439,6,0,0,6,12,3,0,15,14,3,0,17,21,5,0,26,22,5,0,27
83534,79,"ASOCIATIA INTREPRINZATORILOR PARTICULARI","CRISTURU SECUIESC",HR,1448,2,5,0,7,12,5,0,17,20,5,0,25,28,6,0,34,28,6,0,34
83534,80,"LICEUL TEOLOGIC UNITARIAN „BERDE MÓZES” CRISTURU SECUIESC","CRISTURU SECUIESC",HR,1657,2,0,0,2,3,0,0,3,9,0,0,9,17,0,0,17,17,0,0,17
83543,81,"CENTRUL DE PLANIFICARE A FAMILIEI FILIAŞ",FILIAŞ,HR,914,0,0,0,0,0,0,0,0,0,0,0,0,1,0,0,1,2,0,0,2
83758,82,"ŞCOALA GIMNAZIALĂ ""MÁRTONFFI JÁNOS"", VLĂHIŢA",VLĂHIŢA,HR,1335,0,0,0,0,2,0,0,2,6,0,0,6,9,1,0,10,9,1,0,10
83758,83,"ŞCOALA GIMNAZIALĂ ""MÁRTONFFI JÁNOS"", VLĂHIŢA",VLĂHIŢA,HR,1509,0,1,0,1,4,5,0,9,10,6,0,16,15,6,0,21,18,6,0,24
83758,84,"LICEUL TEHNOLOGIC ""GÁBOR ÁRON"", VLĂHIŢA",VLĂHIŢA,HR,1057,3,0,0,3,8,1,0,9,10,1,0,11,11,1,0,12,11,1,0,12
83758,85,"LICEUL TEHNOLOGIC ""GÁBOR ÁRON"", VLĂHIŢA",VLĂHIŢA,HR,1041,6,0,0,6,11,0,0,11,14,0,0,14,19,0,0,19,19,0,0,19
83758,86,"CASA DE CULTURĂ ""BARTÓK BÉLA"", VLĂHIŢA",VLĂHIŢA,HR,1197,1,0,0,1,4,0,0,4,5,0,0,5,7,0,0,7,7,0,0,7
83794,87,"CÃMINUL CULTURAL ATID",ATID,HR,1046,5,0,0,5,13,0,0,13,15,0,0,15,18,5,0,23,20,5,0,25
83801,88,"CÃMINUL CULTURAL CRISENI",CRIŞENI,HR,565,0,0,0,0,0,3,0,3,0,4,0,4,4,5,0,9,4,5,0,9
83810,89,"CÃMINUL CULTURAL CUSMED",CUŞMED,HR,345,0,0,0,0,0,0,0,0,0,0,0,0,1,1,0,2,3,1,0,4
83838,90,"CÃMINUL CULTURAL SICLOD",ŞICLOD,HR,155,1,0,0,1,4,2,0,6,6,3,0,9,7,3,0,10,7,5,0,12
83829,91,"SEDIU COMPOSESORAT INLÃCENI",INLĂCENI,HR,127,2,1,0,3,4,2,0,6,5,2,0,7,5,3,0,8,7,3,0,10
83856,92,"SEDIUL PRIMĂRIEI AVRĂMEŞTI",AVRĂMEŞTI,HR,850,0,0,0,0,0,0,0,0,0,0,0,0,0,0,0,0,2,0,0,2
83874,93,"ŞCOALA PRIMARĂ CECHEŞTI",CECHEŞTI,HR,482,0,0,0,0,0,0,0,0,1,0,0,1,1,0,0,1,1,0,0,1
83883,94,"ŞCOALA GIMNAZIALĂ ,,MÓRA FERENC'' GOAGIU",GOAGIU,HR,546,0,0,0,0,0,0,0,0,0,0,0,0,2,0,0,2,2,0,0,2
83892,95,"ŞCOALA PRIMARĂ FIRTĂNUŞ",FIRTĂNUŞ,HR,267,0,0,0,0,0,0,0,0,0,0,0,0,0,0,0,0,0,0,0,0
83945,96,"CĂMINUL CULTURAL",BILBOR,HR,867,5,0,0,5,12,0,0,12,12,1,0,13,14,2,0,16,15,2,0,17
83945,97,"CĂMINUL CULTURAL",BILBOR,HR,1385,4,3,0,7,9,3,0,12,20,3,0,23,23,3,0,26,25,3,0,28
83160,98,"ŞCOALA GIMNAZIALĂ MARTON ARON BRĂDEŞTI",BRĂDEŞTI,HR,1011,6,1,0,7,12,1,0,13,24,1,0,25,30,3,0,33,32,4,0,36
83179,99,"SCOALA PRIMARA TIRNOVITA",TÎRNOVIŢA,HR,608,6,0,0,6,8,0,0,8,8,0,0,8,8,0,0,8,10,2,0,12
83972,100,"CĂMINUL CULTURAL ""SÜTŐ ANDRÁS""",CĂPÎLNIŢA,HR,825,7,3,0,10,13,3,0,16,16,3,0,19,22,5,0,27,25,5,0,30
83972,101,"CĂMINUL CULTURAL ""SÜTŐ ANDRÁS""",CĂPÎLNIŢA,HR,824,2,0,0,2,4,0,0,4,8,0,0,8,11,1,0,12,15,1,0,16
84111,102,"PRIMĂRIA CÎRŢA",CÎRŢA,HR,844,3,0,0,3,12,1,0,13,13,1,0,14,24,1,0,25,26,1,0,27
84120,103,COMPOSESORAT,INEU,HR,1422,6,0,0,6,16,1,0,17,20,1,0,21,30,1,0,31,30,1,0,31
85653,104,"PAROHIA ROM.CAT.",CICEU,HR,1507,3,0,0,3,13,0,0,13,21,0,0,21,26,1,0,27,32,1,0,33
85653,105,"PAROHIA ROM.CAT.",CICEU,HR,770,0,0,0,0,1,0,0,1,1,2,0,3,3,3,0,6,3,5,0,8
83990,106,"ŞCOALA GIMNAZIALĂ ""GAL SANDOR"" CIUCSÂNGEORGIU",CIUCSÎNGEORGIU,HR,868,0,0,0,0,7,1,0,8,8,1,0,9,9,1,0,10,9,1,0,10
83990,107,"ŞCOALA GIMNAZIALĂ ""GAL SANDOR"" CIUCSÂNGEORGIU",CIUCSÎNGEORGIU,HR,747,0,0,0,0,4,0,0,4,4,0,0,4,7,0,0,7,8,0,0,8
84013,108,"CĂMINUL CULTURAL ARMĂŞENI-NOI","ARMĂŞENII NOI",HR,241,0,0,0,0,1,0,0,1,4,0,0,4,8,0,0,8,8,0,0,8
84004,109,"CĂMINUL CULTURAL ARMĂŞENI",ARMĂŞENI,HR,709,1,1,0,2,3,1,0,4,9,1,0,10,11,1,0,12,12,3,0,15
84022,110,"ŞCOALA GIMNAZIALĂ ""MARTON FERENC"" BANCU",BANCU,HR,1098,1,0,0,1,1,2,0,3,3,2,0,5,5,3,0,8,5,3,0,8
84059,111,"CĂMINUL CULTURAL EGHERSEC-CINOD",EGHERSEC,HR,136,0,2,0,2,5,2,0,7,6,2,0,8,9,2,0,11,9,2,0,11
84059,112,"CĂMINUL CULTURAL EGHERSEC",EGHERSEC,HR,90,7,0,0,7,8,0,0,8,8,0,0,8,8,0,0,8,8,0,0,8
84095,113,"ȘCOALA PRIMARĂ KÖLLŐ MIKLÓS",CIUMANI,HR,1369,11,3,0,14,18,3,0,21,36,3,0,39,39,3,0,42,40,3,0,43
84095,114,"ȘCOALA PRIMARĂ KÖLLŐ MIKLÓS",CIUMANI,HR,1135,2,0,0,2,10,3,0,13,13,3,0,16,17,3,0,20,17,3,0,20
84095,115,"ȘCOALA PRIMARA SZILÁGYI",CIUMANI,HR,1149,0,0,0,0,6,0,0,6,9,0,0,9,15,0,0,15,16,0,0,16
84157,116,"LICEUL TEHNOLOGIC CORBU CORP A",CORBU,HR,749,0,0,0,0,0,0,0,0,2,0,0,2,3,0,0,3,5,0,0,5
84166,117,"LICEUL TEHNOLOGIC CORP D","CAPU CORBULUI",HR,409,3,1,0,4,5,2,0,7,6,2,0,8,8,2,0,10,8,2,0,10
84184,118,"LICEUL TEHNOLOGIC CORUND",CORUND,HR,1350,1,0,0,1,4,1,0,5,8,1,0,9,8,2,0,10,8,2,0,10
84184,119,"ŞCOALA GIMNAZIALĂ CORUND",CORUND,HR,1288,2,0,0,2,7,0,0,7,14,0,0,14,17,7,0,24,18,7,0,25
84184,120,"ȘCOALA GIMNAZIALĂ CORUND",CORUND,HR,1585,1,0,0,1,2,0,0,2,2,0,0,2,5,1,0,6,5,1,0,6
84193,121,"CĂMINUL CULTURAL ATIA",ATIA,HR,176,1,0,0,1,1,0,0,1,4,0,0,4,4,0,0,4,4,1,0,5
84219,122,"ŞCOALA GIMNAZIALĂ FÂNTÂNA BRAZILOR","FÎNTÎNA BRAZILOR",HR,249,4,0,0,4,6,0,0,6,6,0,0,6,6,0,0,6,6,0,0,6
84228,123,"ŞCOALA GIMNAZIALĂ VALEA LUI PAVEL","VALEA LUI PAVEL",HR,308,5,1,0,6,7,1,0,8,11,1,0,12,12,1,0,13,14,1,0,15
85813,124,"COMUNA COZMENI",COZMENI,HR,1162,0,0,0,0,2,0,0,2,3,0,0,3,4,0,0,4,4,0,0,4
85822,125,"COMUNA COZMENI",LĂZĂREŞTI,HR,476,0,0,0,0,2,0,0,2,5,0,0,5,5,0,0,5,5,0,0,5
84246,126,"CĂMINUL CULTURAL DĂNEȘTI",DĂNEŞTI,HR,893,0,0,0,0,4,0,0,4,6,0,0,6,11,3,0,14,13,3,0,16
84246,127,"CĂMINUL CULTURAL DĂNEȘTI",DĂNEŞTI,HR,963,3,1,0,4,6,1,0,7,11,1,0,12,14,1,0,15,14,1,0,15
84273,128,"CASA SOCIALĂ",DEALU,HR,1560,2,0,0,2,3,0,0,3,8,0,0,8,10,0,0,10,12,0,0,12
84291,129,"CAMIN CULTURAL",SÎNCRAI,HR,1064,2,1,0,3,2,21,0,23,2,24,0,26,3,30,0,33,3,32,0,35
84326,130,"CASĂ COMUNALĂ",ULCANI,HR,547,0,0,0,0,0,0,0,0,0,1,0,1,2,1,0,3,2,1,0,3
84353,131,"ȘCOALA GIMNAZIALĂ „SIKLODY LORINC” DITRĂU",DITRĂU,HR,1592,0,0,0,0,1,0,0,1,4,0,0,4,4,0,0,4,5,0,0,5
84353,132,"GRADINITA CU PROGRAM NORMAL ”CSIGABIGA” DITRĂU",DITRĂU,HR,878,0,0,0,0,0,1,0,1,4,1,0,5,7,5,0,12,7,6,0,13
84353,133,"ȘCOALA GIMNAZIALĂ „CSIBY ANDOR” DITRĂU „KOHID”",DITRĂU,HR,959,0,0,0,0,4,0,0,4,6,0,0,6,7,0,0,7,8,0,0,8
84353,134,"ȘCOALA GIMNAZIALĂ „DR. CSIBY ANDOR” DITRĂU",DITRĂU,HR,899,0,0,0,0,0,0,0,0,1,0,0,1,5,0,0,5,7,0,0,7
84362,135,"ȘCOALA GIMNAZIALĂ JOLOTCA",JOLOTCA,HR,518,0,0,0,0,1,0,0,1,2,0,0,2,2,1,0,3,2,1,0,3
84399,136,"ȘCOALA GENERALÂ DÂRJIU JÁNOS ZSIGMOND",DÎRJIU,HR,541,0,0,0,0,1,0,0,1,1,0,0,1,1,0,0,1,1,0,0,1
84406,137,"ȘCOALA GENERALĂ DIN MUJNA",MUJNA,HR,291,2,1,0,3,2,1,0,3,4,1,0,5,8,1,0,9,8,1,0,9
83204,138,"ŞCOALA GIMNAZIALĂ ""FULOP ARON"" FELICENI",FELICENI,HR,1031,0,0,0,0,5,0,0,5,7,0,0,7,7,0,0,7,11,0,0,11
83286,139,"ŞCOALA GENERALĂ TĂURENI",TĂURENI,HR,584,0,0,0,0,2,1,0,3,3,1,0,4,3,1,0,4,3,2,0,5
83259,140,"ŞCOALA GENERALĂ HOGHIA",HOGHIA,HR,235,3,0,0,3,3,0,0,3,3,0,0,3,3,0,0,3,3,0,0,3
83240,141,"ŞCOALA GENERALĂ FORŢENI",FORŢENI,HR,440,0,0,0,0,0,0,0,0,0,0,0,0,0,0,0,0,0,0,0,0
83277,142,"ŞCOALA GENERALĂ POLONIŢA",POLONIŢA,HR,287,0,0,0,0,0,0,0,0,0,0,0,0,1,0,0,1,1,0,0,1
83295,143,"ŞCOALA GENERALĂ TELEAC",TELEAC,HR,180,0,0,0,0,6,0,0,6,8,0,0,8,11,0,0,11,11,0,0,11
84433,144,"ȘCOALA GIMNAZIALĂ BÎRZAVA",BÎRZAVA,HR,533,4,0,0,4,7,0,0,7,9,0,0,9,9,0,0,9,9,0,0,9
84424,145,"PRIMĂRIA COMUNEI FRUMOASA",FRUMOASA,HR,1542,1,0,0,1,9,4,0,13,10,4,0,14,12,4,0,16,13,4,0,17
84451,146,"ȘCOALA PRIMARĂ",NICOLEŞTI,HR,923,1,0,0,1,2,0,0,2,5,2,0,7,7,2,0,9,7,2,0,9
84479,147,"ŞCOALA GIMNAZIALĂ""DUMITRU GAFTON"" GĂLĂUȚAȘ",GĂLĂUŢAŞ,HR,984,5,0,0,5,18,0,0,18,22,0,0,22,33,1,0,34,33,1,0,34
84479,148,"ŞCOALA GIMNAZIALĂ ""DUMITRU GAFTON"" GĂLĂUȚAȘ",GĂLĂUŢAŞ,HR,719,1,2,0,3,3,2,0,5,3,2,0,5,3,2,0,5,3,2,0,5
84479,149,"ȘCOALA GIMNAZIALĂ ”DUMITRU GAFTON” GĂLĂUȚAȘ",GĂLĂUŢAŞ,HR,316,2,1,0,3,3,2,0,5,3,2,0,5,4,2,0,6,4,2,0,6
84567,150,"LICEUL TEHNOLOGIC SOVER ELEK",JOSENI,HR,1247,1,0,0,1,6,0,0,6,8,0,0,8,19,0,0,19,19,0,0,19
84567,151,"LICEUL TEHNOLOGIC SOVER ELEK",JOSENI,HR,1442,0,0,0,0,5,0,0,5,10,2,0,12,17,2,0,19,19,2,0,21
84567,152,"LICEUL TEHNOLOGIC SOVER ELEK",JOSENI,HR,1393,1,0,0,1,4,0,0,4,7,0,0,7,10,0,0,10,13,0,0,13
84576,153,"SCOALA PRIMARA GAÁL TAMÁS, BORZONT",BORZONT,HR,696,1,0,0,1,1,0,0,1,3,0,0,3,6,0,0,6,6,0,0,6
84601,154,"ŞCOALA GIMNAZIALĂ ""BETHLEN GÁBOR"" LĂZAREA",LĂZAREA,HR,1672,1,2,0,3,5,2,0,7,9,2,0,11,18,2,0,20,18,2,0,20
84601,155,"ŞCOALA GIMNAZIALĂ ""BETHLEN GÁBOR"" LĂZAREA",LĂZAREA,HR,1116,2,0,0,2,3,0,0,3,7,0,0,7,9,0,0,9,16,0,0,16
84610,156,"ŞCOALA GIMNAZIALĂ ""BETHLEN GÁBOR"" GHIDUŢ",GHIDUŢ,HR,152,0,0,0,0,0,0,0,0,0,0,0,0,0,0,0,0,0,0,0,0
85724,157,"CAMINUL CULTURAL",LELICENI,HR,443,0,0,0,0,5,0,0,5,10,0,0,10,12,0,0,12,16,0,0,16
85706,158,"CAMINUL CULTURAL",FITOD,HR,397,0,0,0,0,3,1,0,4,3,1,0,4,4,1,0,5,4,1,0,5
85733,159,"SEDIU ADMINISTRATIV",MISENTEA,HR,879,1,0,0,1,4,2,0,6,7,3,0,10,10,3,0,13,13,4,0,17
84638,160,"SEDIUL PRIMĂRIEI",LUETA,HR,1493,6,0,0,6,14,2,0,16,18,2,0,20,19,2,0,21,21,2,0,23
84638,161,"FOSTA AGENTIE CEC LUETA",LUETA,HR,1553,5,0,0,5,18,0,0,18,21,0,0,21,24,0,0,24,27,0,0,27
84745,162,"ȘCOALA PRIMARĂ POIANA FAGULUI","VALEA RECE",HR,1229,0,0,0,0,8,0,0,8,9,0,0,9,13,0,0,13,19,0,0,19
84665,163,"CLĂDIREA PRIMĂRIEI","LUNCA DE JOS",HR,631,0,0,0,0,2,0,0,2,4,0,0,4,8,0,0,8,8,0,0,8
84665,164,"ŞCOALA GIMNAZIALA ,, MAJLATH GUSZTAV KAROLY,,","LUNCA DE JOS",HR,1446,0,0,0,0,2,0,0,2,2,0,0,2,4,2,0,6,5,3,0,8
84745,165,"ŞCOALAPRIMARA GURA VAII RECE","VALEA RECE",HR,887,0,0,0,0,0,0,0,0,3,0,0,3,12,0,0,12,13,0,0,13
84692,166,"ŞCOALA PRIMARA PUNTEA LUPULUI II","PUNTEA LUPULUI",HR,109,0,0,0,0,2,0,0,2,4,0,0,4,4,0,0,4,4,0,0,4
84772,167,"ŞCOALA PRIMARĂ COMIAT",COMIAT,HR,309,0,0,0,0,0,0,0,0,0,1,0,1,0,4,0,4,0,6,0,6
84781,168,"ŞCOALA GIMNAZIALĂ IZVORUL TROTUŞULUI","IZVORUL TROTUŞULUI",HR,590,0,6,0,6,0,6,0,6,0,8,0,8,0,8,0,8,0,9,0,9
84763,169,"PRIMĂRIA LUNCA DE SUS","LUNCA DE SUS",HR,1358,3,0,0,3,13,0,0,13,20,1,0,21,28,3,0,31,30,5,0,35
84790,170,"ŞCOALA PRIMARĂ PĂLTINIŞ-CIUC",PĂLTINIŞ-CIUC,HR,438,3,4,0,7,7,4,0,11,9,4,0,13,12,4,0,16,12,4,0,16
84870,171,"ŞCOALA PRIMARĂ MORĂRENI",MORĂRENI,HR,643,2,0,0,2,5,0,0,5,9,1,0,10,12,2,0,14,12,2,0,14
84889,172,"CASA DE CULTURĂ PĂLTINIŞ",PĂLTINIŞ,HR,428,0,0,0,0,1,0,0,1,4,0,0,4,5,0,0,5,5,0,0,5
84834,173,"ŞCOALA GIMNAZIALĂ ""TAMASI ARON"" LUPENI",LUPENI,HR,1594,1,0,0,1,1,0,0,1,7,0,0,7,9,0,0,9,9,0,0,9
84843,174,"SCOALA GIMNAZIALĂ ""BENEDEK FIDEL"" BISERICANI",BISERICANI,HR,595,1,3,0,4,4,3,0,7,9,4,0,13,12,4,0,16,13,5,0,18
84852,175,"SCOALA PRIMARĂ BULGĂRENI",BULGĂRENI,HR,230,0,0,0,0,0,0,0,0,1,0,0,1,3,0,0,3,4,0,0,4
84898,176,"SCOALA PRIMARĂ PĂULENI",PĂULENI,HR,297,3,0,0,3,4,0,0,4,6,0,0,6,7,0,0,7,7,0,0,7
84255,177,"ŞCOALA GIMNAZIALĂ ''KISS FERENC''",MĂDĂRAŞ,HR,1028,1,0,0,1,3,0,0,3,4,0,0,4,6,0,0,6,7,3,0,10
84255,178,"ŞCOALA GIMNAZIALĂ ''KISS FERENC''",MĂDĂRAŞ,HR,807,0,0,0,0,1,0,0,1,2,0,0,2,8,0,0,8,11,1,0,12
84932,179,"CĂMINUL CULTURAL MĂRTINIȘ",MĂRTINIŞ,HR,536,7,2,0,9,11,3,0,14,12,5,0,17,22,5,0,27,23,5,0,28
84978,180,"CĂMINUL CULTURAL CHINUȘU",CHINUŞU,HR,113,0,0,0,0,1,0,0,1,1,0,0,1,1,0,0,1,1,0,0,1
84941,181,"ȘCOALA PRIMARĂ ALDEA",ALDEA,HR,322,0,0,0,0,0,0,0,0,0,0,0,0,0,5,0,5,0,5,0,5
84950,182,"ȘCOALA PRIMARĂ BĂDENI",BĂDENI,HR,163,0,0,0,0,2,0,0,2,2,0,0,2,2,2,0,4,4,2,0,6
85047,183,"ȘCOALA GIMNAZIALĂ ”LÁSZLÓ GYULA"" SÎNPAUL",SÎNPAUL,HR,409,0,0,0,0,0,0,0,0,2,0,0,2,9,0,0,9,10,1,0,11
84996,184,"ȘCOALA PRIMARĂ GHIPEȘ",GHIPEŞ,HR,171,1,0,0,1,1,0,0,1,1,0,0,1,3,0,0,3,3,0,0,3
84987,185,"ȘCOALA PRIMARĂ COMĂNEȘTI",COMĂNEŞTI,HR,177,0,0,0,0,0,2,0,2,0,2,0,2,0,4,0,4,0,4,0,4
85038,186,"ȘCOALA PRIMARĂ RAREȘ",RAREŞ,HR,109,3,0,0,3,5,0,0,5,5,0,0,5,6,0,0,6,6,0,0,6
85010,187,"GRĂDINIȚA CU PROGRAM NORMAL ORĂȘENI",ORĂŞENI,HR,199,3,0,0,3,4,0,0,4,4,0,0,4,7,2,0,9,7,3,0,10
85029,188,"ȘCOALA PRIMARĂ PETRENI",PETRENI,HR,145,1,0,0,1,1,0,0,1,1,0,0,1,4,0,0,4,4,0,0,4
85065,189,"PRIMĂRIA MEREŞTI",MEREŞTI,HR,1106,8,2,0,10,13,4,0,17,22,4,0,26,22,4,0,26,22,4,0,26
85083,190,"SC.GIM. ARANY JANOS",MIHĂILENI,HR,795,0,0,0,0,0,0,0,0,1,2,0,3,6,2,0,8,7,2,0,9
85118,191,"SCOALA PRIMARA",VĂCĂREŞTI,HR,488,2,2,0,4,3,4,0,7,5,4,0,9,6,4,0,10,6,4,0,10
85109,192,"SCOALA PRIMARA",NĂDEJDEA,HR,502,0,0,0,0,2,0,0,2,3,2,0,5,6,3,0,9,6,3,0,9
85092,193,"SCOALA GIMNAZIALA",LIVEZI,HR,422,5,1,0,6,6,4,0,10,6,4,0,10,8,5,0,13,9,5,0,14
85136,194,"PRIMĂRIA COMUNEI MUGENI",MUGENI,HR,930,1,0,0,1,3,0,0,3,4,1,0,5,8,1,0,9,8,1,0,9
85190,195,"CĂMINUL CULTURAL LUTIŢA",LUTIŢA,HR,601,2,0,0,2,3,0,0,3,6,0,0,6,7,0,0,7,7,0,0,7
85207,196,"CĂMINUL CULTURAL MĂTIŞENI",MĂTIŞENI,HR,110,0,0,0,0,1,0,0,1,1,0,0,1,2,1,0,3,2,1,0,3
85172,197,"CĂMINUL CULTURAL DEJUŢIU",DEJUŢIU,HR,158,0,0,0,0,0,0,0,0,0,0,0,0,0,3,0,3,1,3,0,4
85145,198,"CĂMINUL CULTURAL ALUNIŞ",ALUNIŞ,HR,131,1,0,0,1,1,0,0,1,2,0,0,2,3,0,0,3,3,0,0,3
85154,199,"CĂMINUL CULTURAL BETA",BETA,HR,267,0,0,0,0,0,0,0,0,4,0,0,4,5,0,0,5,5,0,0,5
85181,200,"CĂMINUL CULTURAL DOBENI",DOBENI,HR,480,1,0,0,1,2,1,0,3,4,1,0,5,8,1,0,9,8,2,0,10
85234,201,"CĂMINUL CULTURAL TĂIETURA",TĂIETURA,HR,227,2,1,0,3,2,1,0,3,3,5,0,8,4,6,0,10,4,6,0,10
85261,202,"CĂMINUL CULTURAL",CRĂCIUNEL,HR,396,9,1,0,10,14,2,0,16,16,2,0,18,28,2,0,30,28,5,0,33
85252,203,"CAMINUL CULTURALOCLAND",OCLAND,HR,590,0,0,0,0,3,0,0,3,6,0,0,6,9,0,0,9,10,0,0,10
83384,204,"ȘCOALA GIMNAZIALĂ ”MARTON FERENC”",PĂULENI-CIUC,HR,527,0,0,0,0,3,1,0,4,4,2,0,6,6,5,0,11,6,5,0,11
83393,205,"SCOALA PRIMARĂ DELNIŢA",DELNIŢA,HR,538,2,0,0,2,4,0,0,4,10,0,0,10,13,1,0,14,13,1,0,14
83400,206,"SCOALA PRIMARĂ ŞOIMENI",ŞOIMENI,HR,485,1,0,0,1,4,1,0,5,10,1,0,11,13,1,0,14,15,2,0,17
85298,207,"CASA DE CULTURĂ PLĂIEȘII DE JOS","PLĂIEŞII DE JOS",HR,650,0,0,0,0,2,1,0,3,4,3,0,7,4,4,0,8,6,4,0,10
85332,208,"ȘCOALA GIMNAZIALĂ NR.4 PLĂIEȘII DE SUS","PLĂIEŞII DE SUS",HR,606,0,0,0,0,4,0,0,4,6,0,0,6,10,1,0,11,10,1,0,11
85314,209,"ȘCOALA PRIMARĂ DR.PATAKI JÓZSEF NR.3 IACOBENI",IACOBENI,HR,295,0,0,0,0,1,0,0,1,2,0,0,2,3,0,0,3,4,0,0,4
85305,210,"ȘCOALA GIMNAZIALĂ TUZSON JÁNOS NR.2 CASINU NOU","CASINU NOU",HR,561,2,0,0,2,5,0,0,5,6,2,0,8,13,4,0,17,13,4,0,17
85216,211,"CAMIN CULTURAL","PORUMBENII MARI",HR,1011,1,0,0,1,8,1,0,9,13,1,0,14,17,2,0,19,18,2,0,20
85225,212,"SALA DE MANIFESTATII","PORUMBENII MICI",HR,388,2,0,0,2,5,0,0,5,6,0,0,6,6,0,0,6,6,0,0,6
85350,213,"PRIMARIA COMUNEI PRAID- SALA DE SEDINTE AL CONS.LOCAL",PRAID,HR,1449,1,0,0,1,11,5,0,16,14,7,0,21,17,19,0,36,20,27,0,47
85350,214,"CAMINUL CULTURAL PRAID",PRAID,HR,1532,4,0,0,4,8,0,0,8,15,0,0,15,30,7,0,37,33,8,0,41
85387,215,"ŞCOALA GIMNAZIALĂ""SUKOSD FERENC"" OCNA DE JOS","OCNA DE JOS",HR,1303,2,0,0,2,6,0,0,6,7,0,0,7,8,0,0,8,8,0,0,8
85396,216,"ŞCOALA GIMNAZIALĂ""SZEKELY MOZES"" OCNA DE SUS","OCNA DE SUS",HR,1165,1,0,0,1,1,0,0,1,3,0,0,3,4,0,0,4,4,0,0,4
85369,217,"ŞCOALA GIMNAZIALĂBECAŞ",BECAŞ,HR,104,0,0,0,0,1,1,0,2,2,1,0,3,2,1,0,3,2,1,0,3
85662,218,"CASA DE CULTURĂ RACU",RACU,HR,911,7,0,4,11,11,4,0,15,16,5,0,21,20,5,0,25,22,5,0,27
85671,219,"GRĂDINIŢA DE COPII",GÂRCIU,HR,394,2,4,0,6,2,4,0,6,4,4,0,8,4,4,0,8,5,4,0,9
85421,220,"ȘCOALA GENERALA ""BALÁS JENŐ""",REMETEA,HR,1140,2,0,0,2,7,0,0,7,15,0,0,15,16,0,0,16,16,0,0,16
85421,221,"GRĂDINITA DE COPII ALSZEG",REMETEA,HR,1379,1,0,0,1,9,0,0,9,13,0,0,13,19,0,0,19,19,0,0,19
85421,222,"SCOLA GIMNAZIALA FRÁTER GYÖRGY",REMETEA,HR,1412,9,0,0,9,16,0,0,16,27,2,0,29,34,2,0,36,36,2,0,38
85421,223,"GRADINIȚA DE COPII TULAMAROS",REMETEA,HR,1249,3,0,0,3,21,0,0,21,26,1,0,27,32,5,0,37,32,8,0,40
83188,224,"CAMINUL CULTURAL SATU MARE","SATU MARE",HR,785,1,0,0,1,8,1,0,9,10,1,0,11,12,1,0,13,12,1,0,13
83188,225,"CAMINUL CULTURAL SATU MARE","SATU MARE",HR,840,1,0,0,1,1,0,0,1,4,1,0,5,4,1,0,5,4,1,0,5
85476,226,"ŞCOALA GIMNAZIALĂ SACEL",SĂCEL,HR,93,0,0,0,0,0,0,0,0,1,2,0,3,1,2,0,3,2,2,0,4
85519,227,"CĂMIN CULTURAL VIDACUT",VIDACUT,HR,243,0,0,0,0,0,0,0,0,0,0,0,0,2,1,0,3,2,1,0,3
85494,228,"CĂMIN CULTURAL ȘOIMUȘU MIC","ŞOIMUŞU MIC",HR,342,5,0,0,5,5,0,0,5,5,1,0,6,5,1,0,6,5,3,0,8
85485,229,"CĂMIN CULTURAL ȘOIMUȘU MARE","ŞOIMUŞU MARE",HR,252,2,0,0,2,5,0,0,5,7,0,0,7,9,0,0,9,9,0,0,9
85555,230,"ȘCOALA GIMNAZIALĂ HODOȘA GARĂ",HODOŞA,HR,1221,8,1,0,9,14,1,0,15,22,1,0,23,22,2,0,24,22,2,0,24
85564,231,"ȘCOALA PRIMARĂ PLATONEȘTI",PLATONEŞTI,HR,388,1,4,0,5,7,4,0,11,10,4,0,14,11,4,0,15,12,5,0,17
85546,232,"ȘCOALA PRIMARĂ FUNDOAIA",FUNDOAIA,HR,477,3,6,0,9,6,6,0,12,6,6,0,12,7,8,0,15,7,8,0,15
85537,233,"ȘCOALA GIMNAZIALĂ ,,SFÂNTU ANDREI ,,SĂRMAȘ",SĂRMAŞ,HR,1193,5,0,0,5,22,0,0,22,34,0,0,34,36,0,0,36,36,0,0,36
85699,234,"ŞCOALA GIMNAZIALĂSÂNCRĂIENI",SÂNCRĂIENI,HR,1151,0,0,0,0,5,0,0,5,6,0,0,6,9,0,0,9,10,0,0,10
85699,235,"ŞCOALA GIMNAZIALĂSÂNCRĂIENI",SÂNCRĂIENI,HR,966,3,0,0,3,5,0,0,5,10,0,0,10,14,0,0,14,14,0,0,14
85797,236,"PRIMARIA SÎNMARTIN",SÂNMARTIN,HR,956,2,0,0,2,5,0,0,5,9,0,0,9,11,1,0,12,12,1,0,13
85797,237,"PRIMARIA SÎNMARTIN",SÂNMARTIN,HR,864,8,0,0,8,13,0,0,13,18,0,0,18,19,0,0,19,21,0,0,21
85742,238,"ŞCOALA GIMNAZIALĂ ""ARANY JÁNOS"" SÂNTIMBRU",SÂNTIMBRU,HR,959,7,0,0,7,15,2,0,17,16,2,0,18,24,2,0,26,32,2,0,34
85742,239,"ŞCOALA PRIMARĂ PÁLSZEG SÂNTIMBRU",SÂNTIMBRU,HR,750,0,5,0,5,1,5,0,6,2,5,0,7,9,5,0,14,9,5,0,14
85591,240,"CAMIN CULTURAL",SECUIENI,HR,623,4,0,0,4,4,0,0,4,5,0,0,5,6,0,0,6,6,0,0,6
85617,241,"CAMIN CULTURAL",ELISENI,HR,942,4,0,0,4,5,0,0,5,8,0,0,8,10,0,0,10,11,0,0,11
85608,242,"BIROU ADMINISTRATIV",BODOGAIA,HR,717,1,0,0,1,5,0,0,5,5,0,0,5,6,0,0,6,8,0,0,8
85635,243,"PRIMĂRIA COMUNEI SICULENI",SICULENI,HR,873,4,2,0,6,8,2,0,10,12,2,0,14,14,2,0,16,14,2,0,16
85635,244,"ȘCOALA GIMNAZIALĂZOLD PETER SICULENI",SICULENI,HR,1403,2,0,0,2,4,0,0,4,6,0,0,6,14,2,0,16,16,3,0,19
85779,245,"PRIMĂRIA SÎNDOMINIC",SÎNDOMINIC,HR,1523,2,0,0,2,8,0,0,8,18,0,0,18,35,0,0,35,40,0,0,40
85779,246,"PRIMĂRIA SÎNDOMINIC",SÎNDOMINIC,HR,1497,2,0,0,2,8,0,0,8,13,0,0,13,17,0,0,17,17,0,0,17
85779,247,"ŞCOALA GIMNAZIALĂ MARTON ARON SÎNDOMINIC",SÎNDOMINIC,HR,1083,4,0,0,4,8,0,0,8,11,0,0,11,13,1,0,14,15,1,0,16
85779,248,"ȘCOALAGIMNAZIALĂMARTON ARONSÎNDOMINIC",SÎNDOMINIC,HR,1090,0,0,0,0,3,0,0,3,4,0,0,4,6,0,0,6,7,0,0,7
85859,249,"CĂMINUL CULTURAL",SÎNSIMION,HR,750,2,0,0,2,4,0,0,4,6,1,0,7,8,1,0,9,9,1,0,10
85859,250,"CĂMINUL CULTURAL",SÎNSIMION,HR,1203,1,0,0,1,3,0,0,3,7,0,0,7,8,0,0,8,13,0,0,13
85868,251,"CĂMIN CULTURAL",CETĂŢUIA,HR,840,5,3,0,8,6,3,0,9,8,3,0,11,12,3,0,15,15,3,0,18
85886,252,"LICEUL MIRON CRISTEA SUBCETATE",SUBCETATE,HR,1505,8,0,0,8,18,1,0,19,23,3,0,26,25,3,0,28,26,5,0,31
85939,253,"PRIMĂRIA COMUNEI SUSENI",SUSENI,HR,866,1,1,0,2,4,2,0,6,5,3,0,8,11,4,0,15,13,4,0,17
85939,254,"PRIMĂRIA COMUNEI SUSENI",SUSENI,HR,829,1,6,0,7,3,6,0,9,9,6,0,15,12,6,0,18,12,6,0,18
85939,255,"ŞCOALA PRIMARĂ - MUREŞ SAT",SUSENI,HR,740,0,1,0,1,0,1,0,1,0,1,0,1,3,3,0,6,3,3,0,6
85948,256,"ŞCOALA PRIMARĂ CHILENI",CHILENI,HR,660,0,0,0,0,7,0,0,7,10,1,0,11,23,1,0,24,30,1,0,31
85975,257,"ŞCOALA GIMNAZIALĂ ""TARISZNYÁS MÁRTON"" VALEA STRÎMBĂ","VALEA STRÎMBĂ",HR,1113,0,0,0,0,0,0,0,0,0,2,0,2,4,2,0,6,5,5,0,10
85957,258,"ŞCOALA PRIMARĂ LIBAN",LIBAN,HR,56,0,0,0,0,0,0,0,0,0,0,0,0,0,3,0,3,0,3,0,3
86106,259,"CÃMINUL CULTURAL RUGĂNEŞTI",RUGĂNEŞTI,HR,709,1,3,0,4,3,3,0,6,7,4,0,11,9,4,0,13,10,5,0,15
86062,260,"CÃMINUL CULTURAL COBĂTEŞTI",COBĂTEŞTI,HR,446,7,0,0,7,10,2,0,12,11,7,0,18,18,8,0,26,21,8,0,29
86035,261,"CÃMINUL CULTURAL CEHEŢEL",CEHEŢEL,HR,105,2,0,0,2,2,0,0,2,7,0,0,7,7,0,0,7,7,0,0,7
86124,262,"CÃMINUL CULTURAL TURDENI",TURDENI,HR,75,1,0,0,1,5,0,0,5,5,1,0,6,7,1,0,8,7,1,0,8
86115,263,"CÃMINUL CULTURAL TĂRCEŞTI",TĂRCEŞTI,HR,174,0,0,0,0,1,2,0,3,1,2,0,3,1,2,0,3,1,2,0,3
86080,264,"CÃMINUL CULTURAL MIHĂILENI",MIHĂILENI,HR,435,2,0,0,2,9,2,0,11,16,2,0,18,26,3,0,29,31,3,0,34
85993,265,"CLÃDIREA PRIMÃRIEI ŞIMONEŞTI",ŞIMONEŞTI,HR,1101,8,1,0,9,10,2,0,12,17,2,0,19,23,3,0,26,23,3,0,26
86071,266,"ŞCOALĂ PRIMARĂ MEDIŞORU MARE","MEDIŞORU MARE",HR,81,0,0,0,0,9,3,0,12,12,3,0,15,12,3,0,15,12,3,0,15
84139,267,"CLĂDIREA CĂMINULUI CULTURAL TOMEȘTI",TOMEŞTI,HR,1155,3,0,0,3,11,0,0,11,16,0,0,16,19,0,0,19,21,0,0,21
84139,268,"CLĂDIREA PRIMĂRIEI COMUNEI TOMEȘTI",TOMEŞTI,HR,1011,3,0,0,3,10,1,0,11,13,1,0,14,20,1,0,21,20,1,0,21
86142,269,"ŞCOALA GIMNAZIALĂ TULGHEŞ",TULGHEŞ,HR,1413,3,0,0,3,4,9,0,13,15,9,0,24,20,12,0,32,21,13,0,34
86142,270,"ŞCOALA PRIMARĂ PUTNA",TULGHEŞ,HR,462,2,4,0,6,2,6,0,8,3,6,0,9,4,6,0,10,5,6,0,11
86179,271,"ŞCOALA PRIMARĂ RECEA",RECEA,HR,194,1,0,0,1,1,1,0,2,3,1,0,4,4,1,0,5,4,1,0,5
86142,272,"ŞCOALA PRIMARĂ VALEA FRUMOASĂ",TULGHEŞ,HR,582,2,4,0,6,2,4,0,6,3,4,0,7,3,4,0,7,3,4,0,7
86197,273,"CLĂDIREA PRIMRIEI",TUŞNAD,HR,726,0,0,0,0,4,0,0,4,7,0,0,7,12,2,0,14,16,4,0,20
86204,274,"CĂMINUL CULTURAL","TUŞNADU NOU",HR,829,1,1,0,2,2,1,0,3,2,1,0,3,8,1,0,9,9,1,0,10
86213,275,"CĂMINUL CULTURAL",VRABIA,HR,166,2,0,0,2,2,0,0,2,5,1,0,6,5,2,0,7,7,2,0,9
86231,276,"CĂMINUL CULTURAL ULIEȘ",ULIEŞ,HR,280,1,0,0,1,4,1,0,5,6,2,0,8,7,2,0,9,7,2,0,9
86277,277,"CĂMINUL CULTURAL NICOLEȘTI",NICOLEŞTI,HR,176,0,0,0,0,0,0,0,0,2,0,0,2,3,0,0,3,4,0,0,4
86240,278,"ȘCOALA PRIMARĂ DAIA",DAIA,HR,216,1,2,0,3,2,2,0,4,2,2,0,4,3,2,0,5,3,3,0,6
86268,279,"CĂMINUL CULTURAL IGHIU",IGHIU,HR,48,0,0,0,0,0,0,0,0,3,1,0,4,3,2,0,5,3,2,0,5
86295,280,"CĂMINUL CULTURAL PETECU",PETECU,HR,184,2,0,0,2,4,3,0,7,6,3,0,9,8,3,0,11,8,3,0,11
86320,281,"PRIMĂRIA COMUNEI VĂRȘAG",VĂRŞAG,HR,1067,0,0,0,0,5,0,0,5,7,0,0,7,7,1,0,8,7,1,0,8
86320,282,"ȘCOALĂ PRIMARĂ SOLYOMKO",VĂRŞAG,HR,257,5,0,0,5,10,0,0,10,12,0,0,12,25,0,0,25,25,0,0,25
86348,283,"ȘCOALA GIMNAZIALĂ ,,TEODOR CHINDEA"" VOȘLĂBENI",VOŞLĂBENI,HR,991,2,0,0,2,17,4,0,21,24,6,0,30,29,23,0,52,31,25,0,56
86357,284,"CĂMINUL CULTURAL IZVORU MUREȘULUI","IZVORU MUREŞULUI",HR,663,2,3,0,5,15,7,0,22,38,12,0,50,38,12,0,50,38,13,0,51
86375,285,"GRĂDINIŢA CU PROGRAM NORMAL ALSZEG ZETEA",ZETEA,HR,1221,2,0,0,2,8,0,0,8,10,0,0,10,12,0,0,12,12,0,0,12
86375,286,"PRIMĂRIA ZETEA",ZETEA,HR,1277,2,0,0,2,3,0,0,3,6,1,0,7,13,1,0,14,13,1,0,14
86375,287,"ŞCOALA PRIMARĂ TOFĂLĂU ZETEA",ZETEA,HR,1193,0,0,0,0,6,0,0,6,14,0,0,14,15,0,0,15,17,0,0,17
86428,288,"ŞCOALA GIMNAZIALĂ ""JÓKAI MÓR"" SUB CETATE","SUB CETATE",HR,658,0,0,0,0,2,0,0,2,2,0,0,2,2,0,0,2,2,0,0,2
86419,289,"CĂMIN CULTURAL ŞICASĂU",ŞICASĂU,HR,139,0,0,0,0,0,0,0,0,0,0,0,0,0,0,0,0,0,0,0,0
86393,290,"ŞCOALA PRIMARĂ ""SZÉKELY JÁNOS"" IZVOARE",IZVOARE,HR,315,0,0,0,0,2,0,0,2,2,0,0,2,2,3,0,5,2,7,0,9
179230,1,"SCOALA GIMNAZIALA NR. 1 BRAGADIRU",BRAGADIRU,IF,1749,15,12,0,27,41,24,0,65,67,36,0,103,82,45,0,127,89,51,0,140
179230,2,"SCOALA GIMNAZIALA NR. 1 BRAGADIRU",BRAGADIRU,IF,1820,8,0,0,8,34,0,0,34,56,1,0,57,83,3,0,86,87,4,0,91
179230,3,"SCOALA GIMNAZIALA NR. 1 BRAGADIRU",BRAGADIRU,IF,1555,21,1,0,22,49,1,0,50,60,2,0,62,77,2,0,79,87,3,0,90
179230,4,"SCOALA GIMNAZIALA NR. 1 BRAGADIRU",BRAGADIRU,IF,1152,8,0,0,8,29,0,0,29,36,1,0,37,47,5,0,52,57,5,0,62
179230,5,"SCOALA GIMNAZIALA NR. 1 BRAGADIRU",BRAGADIRU,IF,1813,6,1,0,7,22,3,0,25,35,3,0,38,53,6,0,59,57,8,0,65
179230,6,"SC GAD SPECIAL CONSTRUCT SRL",BRAGADIRU,IF,1926,12,8,0,20,29,21,0,50,54,33,0,87,67,45,0,112,80,53,0,133
179230,7,"SC GAD SPECIAL CONSTRUCT SRL",BRAGADIRU,IF,1563,9,4,0,13,22,11,0,33,36,16,0,52,64,30,0,94,73,36,0,109
179230,8,"S.C. BANDKOPP FASTENERS IMPORT EXPORT SRL",BRAGADIRU,IF,1888,10,3,0,13,34,8,0,42,60,19,0,79,74,28,0,102,78,30,0,108
179230,9,"GRADINITA PITICII NOSTRI",BRAGADIRU,IF,1703,3,4,0,7,18,9,0,27,43,18,0,61,62,25,0,87,74,33,0,107
179230,10,"SPAȚIU COMERCIAL",BRAGADIRU,IF,1476,2,1,0,3,10,3,0,13,23,6,0,29,38,8,0,46,43,9,0,52
179230,11,"SPAȚIU COMERCIAL",BRAGADIRU,IF,1149,6,2,0,8,16,7,0,23,18,12,0,30,27,13,0,40,31,13,0,44
100585,12,"ȘCOALA GIMNAZIALĂ NR. 1 BUFTEA",BUFTEA,IF,1674,14,2,0,16,35,5,0,40,59,5,0,64,80,6,0,86,86,7,0,93
100585,13,"ȘCOALA GIMNAZIALĂ NR. 1 BUFTEA",BUFTEA,IF,1797,9,2,0,11,45,5,0,50,74,5,0,79,107,6,0,113,118,6,0,124
100585,14,"ȘCOALA GIMNAZIALĂ NR. 1 BUFTEA",BUFTEA,IF,1793,22,3,0,25,46,7,0,53,77,13,0,90,108,17,0,125,119,18,0,137
100585,15,"LICEUL TEHNOLOGIC ""DUMITRU DUMITRESCU"" BUFTEA",BUFTEA,IF,1135,9,0,0,9,26,2,0,28,37,3,0,40,51,3,0,54,52,3,0,55
100585,16,"ȘCOALA GIMNAZIALĂ NR. 2 BUFTEA",BUFTEA,IF,1266,18,0,0,18,46,1,0,47,57,8,0,65,68,12,0,80,77,12,0,89
100585,17,"ȘCOALA GIMNAZIALĂ NR. 2 BUFTEA",BUFTEA,IF,1570,24,4,0,28,48,7,0,55,73,11,0,84,108,13,0,121,111,16,0,127
100585,18,"ȘCOALA GIMNAZIALĂ NR. 2 BUFTEA",BUFTEA,IF,1645,11,1,0,12,34,2,0,36,58,5,1,64,71,5,1,77,79,5,1,85
100585,19,"ȘCOALA GIMNAZIALĂ NR. 2 BUFTEA",BUFTEA,IF,1597,12,0,0,12,44,3,0,47,57,3,0,60,77,3,0,80,77,5,0,82
100585,20,"ȘCOALA GIMNAZIALĂ NR. 4 BUFTEA",BUFTEA,IF,954,5,0,0,5,16,0,0,16,22,2,0,24,28,3,0,31,30,3,0,33
100585,21,"SEDIU TÂRG - PRIMĂRIA BUFTEA",BUFTEA,IF,1320,6,0,0,6,20,0,0,20,23,1,0,24,41,5,0,46,43,5,0,48
100585,22,"ȘCOALA GIMNAZIALĂ NR. 3 BUFTEA",BUFTEA,IF,1880,24,6,0,30,49,7,0,56,66,11,0,77,99,12,0,111,107,14,0,121
100585,23,"LICEUL TEHNOLOGIC ”DUMITRU DUMITRESCU” BUFTEA",BUFTEA,IF,1396,6,1,0,7,18,1,0,19,30,3,0,33,46,6,0,52,61,6,0,67
100585,24,"PROPRIETATE PRIVATĂ: TUTUNARU GHEORGHE",BUFTEA,IF,448,0,0,0,0,7,0,0,7,11,2,0,13,19,2,0,21,21,3,0,24
179294,25,"GRĂDINIŢA CU PROGRAM PRELUNGIT ""VOINICEL""",CHITILA,IF,1266,10,0,0,10,19,1,0,20,38,6,0,44,53,6,0,59,71,6,0,77
179294,26,"ŞCOALA GIMNAZIALĂ CU CLASELE I-VIII NR.1 ""PROF.ION VIŞOIU""",CHITILA,IF,1630,13,2,0,15,45,7,0,52,65,13,0,78,83,22,0,105,93,26,0,119
179294,27,"ŞCOALA GIMNAZIALĂ CU CLASELE I-VIII NR.1 ""PROF. ION VIŞOIU""",CHITILA,IF,1593,11,1,0,12,36,10,0,46,60,14,0,74,86,16,0,102,99,19,0,118
179301,28,"ŞCOALA GIMNAZIALĂ CU CLASELE I-VIII NR.1 ""PROF. ION VIŞOIU""",RUDENI,IF,1113,12,0,0,12,16,1,0,17,18,1,0,19,23,3,0,26,25,3,0,28
179294,29,"CASA DE CULTURĂ ""TUDOR ARGHEZI""",CHITILA,IF,1823,13,2,0,15,38,8,0,46,59,12,0,71,77,16,0,93,82,16,0,98
179294,30,"ŞCOALA GIMNAZIALĂ CU CLASELE I- VIII NR.1 ""PROF. ION VIŞOIU"" -",CHITILA,IF,1590,12,2,0,14,24,5,0,29,35,6,0,41,46,8,0,54,50,8,0,58
179294,31,"SCOALA GIMNAZIALA CU CLASELE I-VIII NR. 1 PROF. ION VISOIU, STRUCTURA CU CLASELE I-IV SI GRUPE DE PRESCOLARI ION OLTEANU-CHITILA",CHITILA,IF,1126,9,1,0,10,31,2,0,33,38,3,0,41,48,6,0,54,52,9,0,61
179294,32,"ŞCOALA GIMNAZIALĂ CU CLASELE I- VIII NR.1 ""PROF. ION VIŞOIU""",CHITILA,IF,1105,16,3,0,19,37,7,0,44,45,9,0,54,59,9,0,68,65,10,0,75
179294,33,"GRĂDINIŢA ""PRICHINDEL""",CHITILA,IF,1104,11,0,0,11,25,2,0,27,44,4,0,48,51,4,0,55,62,6,0,68
179418,34,"GRADINITA NR 2 MAGURELE",MĂGURELE,IF,1332,17,1,0,18,36,3,0,39,46,9,0,55,59,12,0,71,67,13,0,80
179418,35,"LICEUL TEORETIC ""HORIA HULUBEI""",MĂGURELE,IF,900,6,3,0,9,28,6,0,34,41,8,0,49,62,13,0,75,68,14,0,82
179418,36,"PRIMĂRIA ORAŞULUI MĂGURELE",MĂGURELE,IF,1700,15,8,0,23,43,16,0,59,60,28,0,88,80,41,0,121,85,48,0,133
179418,37,"PRIMĂRIA ORAŞULUI MĂGURELE",MĂGURELE,IF,936,3,2,0,5,18,7,0,25,22,9,0,31,35,10,0,45,37,11,0,48
179427,38,"CLĂDIRE PARC ALUNIŞ",ALUNIŞU,IF,1196,3,0,0,3,14,1,0,15,15,1,0,16,25,2,0,27,27,4,0,31
179454,39,"SCOALA PRIMARA NR 1 VARTEJU",VÂRTEJU,IF,942,3,1,0,4,6,1,0,7,6,1,0,7,12,3,0,15,15,3,0,18
179454,40,"GRADINITA NR 3 VARTEJU",VÂRTEJU,IF,1274,4,3,0,7,13,8,0,21,26,15,0,41,54,19,0,73,57,19,0,76
179436,41,"SCOALA PRIMARA NR 2 DUMITRANA",DUMITRANA,IF,873,11,0,0,11,18,2,0,20,27,2,0,29,28,4,0,32,34,4,0,38
179506,42,"GRĂDINIŢIA CU PROGRAM PRELUNGIT NR. 2",ODĂILE,IF,939,5,0,0,5,21,5,0,26,31,14,0,45,40,12,0,52,43,13,0,56
179490,43,"LICEUL TEORETIC ""IOAN PETRUŞ""",OTOPENI,IF,1336,8,3,0,11,27,16,0,43,48,26,0,74,62,30,0,92,64,34,0,98
179490,44,"LICEUL TEORETIC ""IOAN PETRUŞ""",OTOPENI,IF,980,15,2,0,17,34,4,0,38,53,5,0,58,63,7,0,70,67,8,0,75
179490,45,"LICEUL TEORETIC ""IOAN PETRUŞ""",OTOPENI,IF,1111,10,0,0,10,27,4,0,31,41,8,0,49,58,8,0,66,66,9,0,75
179490,46,"LICEUL TEORETIC ""IOAN PETRUŞ""",OTOPENI,IF,1018,18,4,0,22,33,25,0,58,51,40,0,91,70,53,0,123,73,56,0,129
179490,47,"PRIMĂRIA ORAŞULUI OTOPENI",OTOPENI,IF,1268,9,3,0,12,34,12,0,46,56,17,0,73,73,19,0,92,78,21,0,99
179490,48,"PRIMĂRIA ORAŞULUI OTOPENI",OTOPENI,IF,1168,17,6,0,23,32,8,0,40,51,10,0,61,67,11,0,78,73,13,0,86
179490,49,"SALA DE SPORT OTOPENI",OTOPENI,IF,1532,23,3,0,26,49,6,0,55,84,13,0,97,104,14,0,118,113,20,0,133
179490,50,"GRĂDINIŢA CU PROGRAM NORMAL NR. 2",OTOPENI,IF,1135,18,6,0,24,42,10,0,52,68,14,0,82,79,17,0,96,87,18,0,105
179490,51,"PROPRIETATE PRIVATĂ: FARR MIHAELA DANA",OTOPENI,IF,926,9,3,0,12,18,12,0,30,21,13,0,34,44,16,0,60,50,17,0,67
179524,52,"ŞCOALA GENERALĂ NR.1",PANTELIMON,IF,1469,17,0,0,17,42,2,0,44,49,6,0,55,60,10,0,70,66,11,0,77
179524,53,"ŞCOALA GENERALĂ NR.1",PANTELIMON,IF,1564,10,0,0,10,24,3,0,27,30,4,0,34,45,7,0,52,46,7,0,53
179524,54,"ŞCOALA GENERALĂ NR.1",PANTELIMON,IF,1422,6,1,0,7,35,1,0,36,40,2,0,42,55,3,0,58,59,5,0,64
179524,55,"ŞCOALA GENERALĂ NR.1",PANTELIMON,IF,1866,4,0,0,4,24,3,0,27,36,3,0,39,48,5,0,53,49,5,0,54
179524,56,"ŞCOALA GENERALĂ NR.1",PANTELIMON,IF,1710,16,2,0,18,25,5,0,30,46,6,0,52,61,6,0,67,63,6,0,69
179524,57,"ŞCOALA GENERALĂ NR.1",PANTELIMON,IF,1365,11,3,0,14,26,4,0,30,44,6,0,50,54,7,0,61,57,7,0,64
179524,58,"ŞCOALA GENERALĂ NR.1",PANTELIMON,IF,1359,9,0,0,9,15,0,0,15,22,0,0,22,23,0,0,23,33,0,0,33
179524,59,"ŞCOALA GENERALĂ NR.1",PANTELIMON,IF,1786,13,4,0,17,32,5,0,37,44,8,0,52,62,8,0,70,77,8,0,85
179524,60,"ŞCOALA GENERALĂ NR.1",PANTELIMON,IF,1886,11,5,0,16,37,14,0,51,65,26,0,91,89,31,0,120,94,33,0,127
179524,61,"ŞCOALA GENERALĂ NR.1",PANTELIMON,IF,1799,14,3,0,17,33,7,0,40,58,16,0,74,70,19,0,89,74,20,0,94
179524,62,"GRĂDINIŢA DE COPII NR.1",PANTELIMON,IF,1415,11,0,0,11,36,2,0,38,50,5,0,55,57,6,0,63,58,6,0,64
179524,63,"GRĂDINIŢA DE COPII NR.1",PANTELIMON,IF,1205,11,3,0,14,28,4,0,32,42,9,0,51,60,11,0,71,68,14,0,82
179524,64,"GRĂDINIŢA DE COPII NR.1",PANTELIMON,IF,1169,10,0,0,10,25,0,0,25,31,0,0,31,41,0,0,41,44,0,0,44
179524,65,"GRĂDINIŢA DE COPII NR.1",PANTELIMON,IF,1904,5,4,0,9,22,4,0,26,37,4,0,41,45,4,0,49,50,5,0,55
179524,66,"GRĂDINIŢA DE COPII NR.1",PANTELIMON,IF,1594,10,1,0,11,26,1,0,27,43,1,0,44,65,1,0,66,73,4,0,77
179542,67,"FUNDAŢIA LEONARDO MURIALDO","POPEŞTI LEORDENI",IF,1424,4,5,0,9,14,13,0,27,30,17,0,47,51,26,0,77,56,33,0,89
179542,68,"FUNDAŢIA LEONARDO MURIALDO","POPEŞTI LEORDENI",IF,1601,8,3,0,11,17,6,0,23,21,12,0,33,27,16,0,43,33,22,0,55
179542,69,"FUNDATIA LEONARDO MURIALDO","POPEŞTI LEORDENI",IF,850,3,1,0,4,10,2,0,12,18,3,0,21,25,4,0,29,29,7,0,36
179542,70,"FUNDATIA LEORNARDO MURIALDO","POPEŞTI LEORDENI",IF,1523,2,0,0,2,18,3,0,21,26,7,0,33,30,10,0,40,38,13,0,51
179542,71,"ŞCOALA GIMNAZIALĂ IOAN BĂDESCU","POPEŞTI LEORDENI",IF,1203,6,1,0,7,14,2,0,16,23,5,0,28,34,12,0,46,39,12,0,51
179542,72,"ŞCOALA GIMNAZIALĂ IOAN BĂDESCU","POPEŞTI LEORDENI",IF,1784,19,3,0,22,36,7,0,43,51,23,0,74,71,25,0,96,82,27,0,109
179542,73,"CĂMINUL CULTURAL","POPEŞTI LEORDENI",IF,1815,12,0,0,12,29,8,0,37,43,10,0,53,62,15,0,77,67,21,0,88
179542,74,"LICEUL TEORETIC RADU POPESCU","POPEŞTI LEORDENI",IF,1667,13,3,0,16,26,5,0,31,33,6,0,39,62,10,0,72,69,10,0,79
179542,75,"LICEUL TEORETIC RADU POPESCU","POPEŞTI LEORDENI",IF,1677,12,3,0,15,32,5,0,37,57,7,0,64,74,9,0,83,87,12,0,99
179542,76,"ŞCOALA GENERALĂ NR. 4","POPEŞTI LEORDENI",IF,1603,18,3,0,21,41,10,0,51,59,12,0,71,83,15,0,98,90,15,0,105
179542,77,"ŞCOALA GENERALĂ NR. 3","POPEŞTI LEORDENI",IF,1380,1,2,0,3,26,4,0,30,38,11,0,49,60,17,0,77,65,20,0,85
179542,78,"ŞCOALA GENERALĂ NR. 3","POPEŞTI LEORDENI",IF,1479,6,0,0,6,18,0,0,18,29,0,0,29,35,0,0,35,47,1,0,48
179542,79,"SC MIKY&JASMIN SRL","POPEŞTI LEORDENI",IF,1798,15,2,0,17,49,6,0,55,64,8,0,72,93,12,0,105,104,17,0,121
179542,80,"S.C. AGROPOLS.A.","POPEŞTI LEORDENI",IF,444,4,0,0,4,7,0,0,7,8,1,0,9,13,1,0,14,13,1,0,14
179542,81,"GRADINITA NR.3","POPEŞTI LEORDENI",IF,1157,3,0,0,3,10,3,0,13,17,4,0,21,26,6,0,32,28,6,0,34
179542,82,"GRADINITA CU PROGRAM PRELUNGIT NR.4","POPEŞTI LEORDENI",IF,1791,1,0,0,1,16,2,0,18,24,2,0,26,34,4,0,38,37,4,0,41
179560,83,"ŞCOALA GENERALĂ NR. 3",VOLUNTARI,IF,1993,4,2,0,6,24,12,0,36,57,17,0,74,74,18,0,92,84,25,0,109
179560,84,"ŞCOALA GENERALĂ NR. 3",VOLUNTARI,IF,1873,4,3,0,7,34,10,0,44,48,18,0,66,72,21,0,93,79,25,0,104
179560,85,"ŞCOALA GENERALĂ NR. 3",VOLUNTARI,IF,1795,7,2,0,9,35,8,0,43,59,9,0,68,77,11,0,88,88,13,0,101
179560,86,"ŞCOALA GENERALĂ NR. 3",VOLUNTARI,IF,1806,12,1,0,13,46,4,0,50,68,8,0,76,96,11,0,107,106,11,0,117
179560,87,"SALA DE SPORT ""ANDREEA ISĂRESCU""",VOLUNTARI,IF,1751,9,5,0,14,30,6,0,36,58,10,0,68,82,11,0,93,86,12,0,98
179560,88,"ŞCOALA GENERALĂ NR. 1",VOLUNTARI,IF,1982,9,2,0,11,29,10,0,39,54,21,0,75,73,30,0,103,88,31,0,119
179560,89,"ŞCOALA GENERALĂ NR. 1",VOLUNTARI,IF,1983,19,1,0,20,43,3,0,46,68,3,0,71,83,5,0,88,98,7,0,105
179560,90,"ŞCOALA GENERALĂ NR. 1",VOLUNTARI,IF,1832,19,4,0,23,37,6,0,43,53,10,0,63,73,14,0,87,81,16,0,97
179560,91,"ŞCOALA GENERALĂ NR. 1",VOLUNTARI,IF,1748,18,1,0,19,37,3,0,40,54,6,0,60,78,9,0,87,90,13,0,103
179560,92,"ŞCOALA GENERALĂ NR. 1",VOLUNTARI,IF,1658,13,4,0,17,38,6,0,44,53,6,0,59,73,8,0,81,84,9,0,93
179560,93,"ŞCOALA GENERALĂ NR. 1",VOLUNTARI,IF,1937,11,5,0,16,30,13,0,43,39,13,0,52,64,19,0,83,69,22,0,91
179560,94,"ŞCOALA GENERALĂ NR. 1",VOLUNTARI,IF,1798,14,1,0,15,33,3,0,36,61,3,0,64,78,4,0,82,98,6,0,104
179560,95,"CASA DE CULTURĂ",VOLUNTARI,IF,1928,30,6,0,36,55,9,0,64,76,16,0,92,92,21,0,113,100,26,0,126
179560,96,"ŞCOALA GENERALĂ NR. 2",VOLUNTARI,IF,1848,11,8,0,19,35,12,0,47,60,23,0,83,89,25,0,114,102,25,0,127
179560,97,"ŞCOALA GENERALĂ NR. 2",VOLUNTARI,IF,1742,8,1,0,9,40,1,0,41,76,1,0,77,111,3,0,114,128,3,0,131
179560,98,"ŞCOALA GENERALĂ NR. 2",VOLUNTARI,IF,1827,22,1,0,23,47,2,0,49,66,2,0,68,83,2,0,85,91,6,0,97
179560,99,"FOSTUL SEDIU AL PRIMĂRIEI",VOLUNTARI,IF,1711,14,1,0,15,46,3,0,49,80,6,0,86,114,11,0,125,137,21,0,158
179560,100,"PRIMĂRIA ORAŞULUI VOLUNTARI",VOLUNTARI,IF,1567,10,1,0,11,33,13,0,46,49,19,0,68,58,23,0,81,66,23,0,89
179560,101,"SCOALA GENERALA NR. 3",VOLUNTARI,IF,1266,3,2,0,5,13,9,0,22,29,14,0,43,39,25,0,64,43,26,0,69
102552,102,"ŞCOALA GIMNAZIALA NR. 1, CORP A","1 DECEMBRIE",IF,1955,12,1,0,13,30,5,0,35,44,10,0,54,53,16,0,69,68,21,0,89
102552,103,"ŞCOALA GIMNAZIALA NR. 1, CORP A","1 DECEMBRIE",IF,1527,9,3,0,12,26,5,0,31,29,6,0,35,41,9,0,50,44,11,0,55
102552,104,"ŞCOALA GIMNAZIALA NR. 1, CORP B","1 DECEMBRIE",IF,1638,7,2,0,9,19,6,0,25,27,9,0,36,45,10,0,55,65,11,0,76
102552,105,"ŞCOALA GIMNAZIALA NR. 1, CORP B","1 DECEMBRIE",IF,1528,4,1,0,5,18,1,0,19,24,6,0,30,28,7,0,35,32,8,0,40
100843,106,"ȘCOALA GENERALĂ NR.1",AFUMAŢI,IF,785,6,4,0,10,22,5,0,27,30,5,0,35,43,6,0,49,47,11,0,58
100843,107,"ŞCOALA GENERALĂ NR. 1 CU CLASELE V - VIII",AFUMAŢI,IF,1142,10,1,0,11,19,5,0,24,37,14,0,51,55,37,0,92,61,37,0,98
100843,108,"ŞCOALA GENERALĂ NR. 3 CU CLASELE I - IV",AFUMAŢI,IF,1646,17,0,0,17,36,0,0,36,50,1,0,51,69,4,0,73,75,4,0,79
100843,109,"ŞCOALA GENERALĂ NR. 2 CU CLASELE I - IV",AFUMAŢI,IF,1610,22,1,0,23,40,1,0,41,63,4,0,67,70,5,0,75,80,7,0,87
100843,110,"SCOALA CU CLASELE I-IV",AFUMAŢI,IF,1239,6,0,0,6,19,3,0,22,31,3,0,34,38,3,0,41,39,3,0,42
100978,111,"CLĂDIRE POLICLINICĂ",BALOTEŞTI,IF,1517,10,0,0,10,33,4,0,37,49,5,0,54,67,7,38,112,70,7,38,115
100978,112,"ŞCOALA NR. 1 BALOTEŞTI",BALOTEŞTI,IF,1223,6,2,0,8,24,9,0,33,43,10,0,53,58,13,0,71,62,21,0,83
100978,113,"ŞCOALA NR. 1 BALOTEŞTI",BALOTEŞTI,IF,944,4,3,0,7,14,4,0,18,23,5,0,28,32,5,0,37,34,6,0,40
100978,114,"ŞCOALA NR. 3 BALOTEŞTI",BALOTEŞTI,IF,2166,14,1,0,15,45,9,1,55,57,11,1,69,80,18,1,99,95,23,1,119
100996,115,"ŞCOALA NR. 2 SĂFTICA",SĂFTICA,IF,1135,16,2,0,18,42,11,0,53,55,16,0,71,71,17,0,88,76,18,0,94
101154,116,"SCOALA PRIMARA NR. 2",BERCENI,IF,1738,4,4,0,8,18,13,0,31,28,22,0,50,49,24,0,73,64,33,0,97
101154,117,"SCOALA PRIMARA NR. 2",BERCENI,IF,1314,6,1,0,7,23,7,0,30,42,10,0,52,59,16,0,75,60,17,0,77
101154,118,"ŞCOALA GIMNAZIALA NR. 1",BERCENI,IF,1364,5,7,0,12,26,28,0,54,48,35,0,83,66,36,0,102,76,39,0,115
101305,119,"ŞCOALA GIMNAZIALA NR.1",BRĂNEŞTI,IF,784,9,3,0,12,15,4,0,19,23,9,0,32,30,14,0,44,34,15,0,49
101305,120,"ŞCOALA GENERALĂ DIN CARTIERUL BĂJENARI",BRĂNEŞTI,IF,1779,13,3,0,16,29,5,0,34,42,5,0,47,76,10,0,86,81,11,0,92
101305,121,"SCOALA GIMNAZIALA NR.1 BRANESTI",BRĂNEŞTI,IF,1342,17,2,0,19,35,3,0,38,45,4,0,49,68,4,0,72,71,7,0,78
101305,122,"LICEUL TEORETIC ""TRAIAN LALESCU""",BRĂNEŞTI,IF,1799,16,7,0,23,49,20,0,69,76,24,0,100,106,31,0,137,115,32,0,147
101323,123,"GRADINITA NR.2",PASĂREA,IF,870,15,5,0,20,57,13,0,70,86,17,0,103,91,28,13,132,101,33,13,147
101314,124,"GRĂDINIŢA NR.1",ISLAZ,IF,1197,13,4,0,17,27,10,0,37,40,15,0,55,61,18,0,79,72,23,0,95
101751,125,"ŞCOALA GIMNAZIALĂ NR.1",CERNICA,IF,804,12,4,0,16,31,6,0,37,45,8,0,53,63,11,0,74,70,18,0,88
101751,126,"ŞCOALA GIMNAZIALĂ NR.1",CERNICA,IF,839,21,1,0,22,42,1,0,43,58,2,0,60,71,2,0,73,77,9,0,86
101751,127,"ŞCOALA GIMNAZIALĂ NR.1",CERNICA,IF,894,12,0,0,12,33,1,0,34,43,2,0,45,56,3,0,59,59,8,0,67
101760,128,"ŞCOALA GIMNAZIALĂ NR.3",BĂLĂCEANCA,IF,1347,3,0,0,3,13,0,0,13,21,4,0,25,37,4,0,41,40,4,0,44
101760,129,"ŞCOALA GIMNAZIALĂ NR.3",BĂLĂCEANCA,IF,1163,9,3,0,12,18,4,15,37,26,5,15,46,41,6,15,62,44,8,15,67
101779,130,"GRĂDINIŢA NR.5",CĂLDĂRARU,IF,916,7,4,0,11,7,4,0,11,24,6,0,30,42,11,0,53,43,11,0,54
101797,131,"ŞCOALA GIMNAZIALĂ NR.2",TÎNGANU,IF,1265,12,2,0,14,21,2,0,23,30,3,0,33,40,4,0,44,47,4,0,51
101797,132,"ŞCOALA GIMNAZIALĂ NR.2",TÎNGANU,IF,1282,17,0,0,17,30,2,0,32,32,2,0,34,56,2,0,58,61,4,0,65
179258,133,"SCOALA GIMNAZIALA"""" ALEXANDRU ODOBESCU""",CHIAJNA,IF,1955,17,2,0,19,34,7,0,41,50,10,0,60,73,12,0,85,74,12,0,86
179258,134,"SCOALA GIMNAZIALA""ALEXANDRU ODOBESCU""",CHIAJNA,IF,1785,12,4,0,16,30,6,0,36,56,7,0,63,74,7,0,81,87,7,0,94
179258,135,"SCOALA GIMNAZIALA """"ALEXANDRU ODOBESCU""",CHIAJNA,IF,1882,14,0,0,14,44,4,0,48,64,7,0,71,70,12,0,82,75,16,0,91
179276,136,"LICEUL TEHNOLOGIC ""DOAMNA CHIAJNA""",ROŞU,IF,1927,7,0,0,7,34,11,0,45,55,19,0,74,74,21,0,95,89,21,0,110
179276,137,"LICEUL TEHNOLOGIC ""DOAMNA CHIAJNA""",ROŞU,IF,1958,6,1,0,7,22,12,0,34,32,17,0,49,57,29,0,86,64,30,0,94
179276,138,"LICEUL TEHNOLOGIC ""DOAMNA CHIAJNA""",ROŞU,IF,1977,4,0,0,4,27,0,0,27,35,0,0,35,52,0,0,52,63,0,0,63
179276,139,"LICEUL TEHNOLOGIC""'DOAMNA CHIAJNA""",ROŞU,IF,1693,1,0,0,1,14,8,0,22,24,13,0,37,29,23,0,52,40,27,0,67
179276,140,"LICEUL TEHNOLOGIC""""DOAMNA CHIAJNA""",ROŞU,IF,2073,2,0,0,2,17,0,0,17,33,1,0,34,43,8,0,51,45,8,0,53
179276,141,"LICEUL TEHNOLOGIC""DOAMNA CHIAJNA""",ROŞU,IF,1554,0,0,0,0,4,0,0,4,11,0,0,11,21,9,0,30,27,13,0,40
101911,142,"CĂMINUL CULTURAL CIOLPANI",CIOLPANI,IF,1907,19,4,0,23,42,14,0,56,62,24,0,86,95,33,0,128,102,33,0,135
101948,143,"SCOALA GENERALĂ CU CLASELE I-IV",PISCU,IF,794,7,3,0,10,12,8,0,20,22,19,0,41,47,24,0,71,48,28,0,76
101939,144,"SCOALA GENERALA CU CLASELE I-IV CIOLPANI",LUPĂRIA,IF,1158,7,0,0,7,12,9,0,21,17,15,0,32,20,20,0,40,20,22,0,42
101920,145,"SCOALA GENERALĂCU CLASELE I-IV",IZVORANI,IF,636,1,4,0,5,12,14,0,26,22,18,0,40,33,24,0,57,33,27,0,60
101966,146,"ŞCOALA NR. 1 CIOROGÎRLA",CIOROGÎRLA,IF,1303,7,0,0,7,21,7,0,28,35,10,0,45,51,15,0,66,54,19,0,73
101966,147,"ŞCOALA NR. 1 CIOROGÂRLA",CIOROGÎRLA,IF,1766,9,1,0,10,29,8,0,37,44,11,0,55,71,18,0,89,72,18,0,90
101975,148,"ŞCOALA NR.2 DÂRVARI",DÎRVARI,IF,1681,4,6,0,10,9,12,0,21,19,14,0,33,29,15,0,44,31,15,0,46
102044,149,"LICEUL SPORTIV CLINCENI",CLINCENI,IF,1535,6,4,0,10,31,10,0,41,43,13,0,56,55,15,0,70,63,18,0,81
102044,150,"LICEUL SPORTIV CLINCENI",CLINCENI,IF,1078,5,4,0,9,15,16,0,31,18,23,0,41,29,32,0,61,33,36,0,69
102053,151,"LICEUL SPORTIV CLINCENI",OLTENI,IF,1674,10,2,0,12,34,9,0,43,52,17,0,69,61,22,0,83,66,24,0,90
102044,152,"LLICEUL SPORTIV CLINCENI",CLINCENI,IF,1274,1,2,0,3,18,4,0,22,27,6,0,33,29,10,0,39,31,11,0,42
102561,153,"AȘEZĂMÂNTUL SOCIAL AL BISERICII SF. DUMITRU",COPĂCENI,IF,1435,14,3,0,17,30,9,0,39,36,15,0,51,51,20,0,71,57,21,0,78
102561,154,"SCOALA GIMNAZIALA NR. 1",COPĂCENI,IF,1016,5,0,0,5,11,4,0,15,19,7,0,26,47,9,0,56,63,10,0,73
102179,155,"ŞCOALA GIMNAZIALĂ NR. 1",CORBEANCA,IF,995,1,6,0,7,9,8,0,17,12,16,0,28,20,29,0,49,23,31,0,54
102179,156,"ŞCOALA GIMNAZIALĂ NR. 1",CORBEANCA,IF,1231,9,1,0,10,30,6,0,36,43,9,0,52,51,9,0,60,58,9,0,67
102204,157,"ŞCOALA GIMNAZIALĂ NR. 2",TAMAŞI,IF,1861,11,2,0,13,42,23,0,65,56,27,0,83,77,32,0,109,83,32,0,115
102188,158,"CLĂDIREA AFTER SCHOOL",OSTRATU,IF,1142,6,4,0,10,26,13,0,39,41,24,0,65,53,29,0,82,56,32,0,88
102197,159,"GRĂDINIŢA NR. 1",PETREŞTI,IF,728,9,6,0,15,21,11,0,32,31,12,0,43,38,16,0,54,44,17,0,61
102222,160,"ŞCOALA GIMNAZIALĂ NR.1",CORNETU,IF,1047,9,0,0,9,27,4,0,31,31,6,0,37,43,12,0,55,46,14,0,60
102222,161,"ŞCOALA GIMNAZIALĂ NR.1",CORNETU,IF,880,12,3,0,15,22,6,0,28,27,10,0,37,35,15,0,50,38,15,0,53
102222,162,"ŞCOALA GIMNAZIALĂ NR.1",CORNETU,IF,921,12,1,0,13,17,4,0,21,40,10,0,50,42,10,0,52,44,11,0,55
102222,163,"ŞCOALA GIMNAZIALĂ NR.1",CORNETU,IF,924,16,7,0,23,20,10,0,30,35,12,0,47,53,14,0,67,55,14,0,69
102222,164,"ŞCOALA GIMNAZIALĂ NR.1",CORNETU,IF,1099,12,0,0,12,32,0,0,32,40,0,0,40,51,1,0,52,55,4,0,59
102482,165,ŞCOALAGIMNAZIALĂDASCĂLU,DASCĂLU,IF,1719,12,4,0,16,33,17,0,50,45,22,0,67,52,24,0,76,56,24,0,80
102507,166,"GRĂDINIŢA NR. 2 GAGU",GAGU,IF,624,1,4,0,5,10,8,0,18,16,12,0,28,26,14,0,40,26,14,0,40
102534,167,"ŞCOALA GENERALĂ NR. 1",DĂRĂŞTI-ILFOV,IF,1083,4,2,0,6,12,3,0,15,19,4,0,23,20,5,0,25,20,5,0,25
102534,168,"ŞCOALA GENERALĂ NR. 1",DĂRĂŞTI-ILFOV,IF,1216,10,0,0,10,16,2,0,18,24,4,0,28,32,4,0,36,32,4,0,36
179329,169,"ŞCOALA NR.1 DOBROEŞTI",DOBROEŞTI,IF,1839,17,1,0,18,44,8,0,52,61,14,0,75,83,28,0,111,91,31,0,122
179329,170,"ŞCOALA NR.1 DOBROEŞTI",DOBROEŞTI,IF,1637,13,0,0,13,41,1,0,42,56,1,0,57,82,5,0,87,93,15,0,108
179329,171,"ŞCOALA NR.1 DOBROEŞTI",DOBROEŞTI,IF,1403,15,0,0,15,36,0,0,36,43,0,0,43,53,2,0,55,59,5,0,64
179338,172,"ŞCOALA NR.2 FUNDENI",FUNDENI,IF,1876,13,1,0,14,39,5,0,44,55,9,0,64,79,12,0,91,86,12,0,98
179338,173,"ŞCOALA NR.2 FUNDENI",FUNDENI,IF,1823,9,0,0,9,30,3,0,33,45,6,0,51,60,10,0,70,64,14,0,78
102589,174,"CĂMINUL CULTURAL DOMNEȘTI",DOMNEŞTI,IF,1985,12,2,0,14,27,4,0,31,35,4,0,39,52,7,0,59,60,8,0,68
102589,175,"CĂMINUL CULTURAL DOMNEȘTI",DOMNEŞTI,IF,1527,14,5,0,19,36,17,0,53,48,19,0,67,71,20,0,91,71,20,0,91
102589,176,"ȘCOALA GIMNAZIALĂ NR. 1 - ȘCOALA MARE",DOMNEŞTI,IF,1434,15,10,0,25,36,22,0,58,51,28,0,79,68,32,0,100,72,37,0,109
102589,177,"ȘCOALA PRIMARĂ NR. 1 - ȘCOALA BĂLEANU",DOMNEŞTI,IF,1869,20,0,0,20,44,2,0,46,60,2,0,62,67,6,0,73,74,6,0,80
102598,178,"ȘCOALA PRIMARĂ NR. 2 - ȘCOALA ȚEGHEȘ",ŢEGHEŞ,IF,764,6,5,0,11,12,10,0,22,17,10,0,27,26,12,0,38,26,13,0,39
102623,179,"ȘCOALA GENERALĂ NR. 2",DRAGOMIREŞTI-DEAL,IF,1298,6,6,0,12,14,6,0,20,18,10,0,28,30,11,0,41,35,11,0,46
102632,180,"ȘCOALA GENERALĂ NR. 3",ZURBAUA,IF,809,7,1,0,8,19,4,0,23,28,5,0,33,40,7,0,47,42,7,0,49
102614,181,"GRUPUL ȘCOLAR ""VINTILĂ BRĂTIANU""",DRAGOMIREŞTI-VALE,IF,1285,11,5,0,16,33,14,0,47,51,19,0,70,69,24,0,93,72,26,0,98
102623,182,"ȘCOALA VECHE",DRAGOMIREŞTI-DEAL,IF,996,13,6,0,19,28,8,0,36,35,8,0,43,42,8,0,50,43,11,0,54
103149,183,"ŞCOALA GĂNEASA",GĂNEASA,IF,784,5,0,0,5,7,2,0,9,7,4,0,11,12,4,0,16,13,7,0,20
103167,184,"ŞCOALA MOARA DOMNEASCĂ","MOARA DOMNEASCĂ",IF,537,5,1,0,6,8,3,0,11,16,3,0,19,20,4,0,24,22,4,0,26
103158,185,"ŞCOALA COZIENI",COZIENI,IF,645,2,0,0,2,3,1,0,4,6,1,0,7,7,1,0,8,11,2,0,13
103185,186,"GRĂDINIŢA ŞINDRILIŢA",ŞINDRILIŢA,IF,1042,9,0,0,9,28,1,0,29,42,3,0,45,65,5,0,70,68,5,0,73
103176,187,"ŞCOALA PITEASCA",PITEASCA,IF,1026,2,1,0,3,4,1,0,5,10,2,0,12,14,5,0,19,15,5,0,20
179356,188,"ŞCOALA NR. 1",GLINA,IF,1649,7,0,0,7,15,3,0,18,27,4,0,31,35,5,0,40,40,5,0,45
179356,189,"ŞCOALA NR. 1",GLINA,IF,1350,10,5,0,15,17,5,0,22,31,7,0,38,38,8,0,46,40,9,0,49
179356,190,"ŞCOALA NR. 3",GLINA,IF,1543,4,2,0,6,8,5,0,13,16,7,0,23,28,8,0,36,31,10,0,41
179365,191,"ŞCOALA NR. 2",CĂŢELU,IF,1256,10,0,0,10,26,2,0,28,35,2,0,37,59,8,0,67,75,10,0,85
179365,192,"ŞCOALA NR. 2",CĂŢELU,IF,942,10,1,0,11,21,5,0,26,28,8,0,36,39,13,0,52,44,15,0,59
103452,193,"CĂMINUL CULTURAL MULTIFUNCŢIONAL",GRĂDIŞTEA,IF,1675,25,0,0,25,51,5,0,56,70,19,0,89,87,28,0,115,95,29,0,124
103461,194,"ŞCOALA PRIMARĂ NR. 1 SITARU",SITARU,IF,855,6,1,0,7,12,3,0,15,15,15,0,30,21,16,0,37,22,17,0,39
103531,195,"GRĂDINIŢA DE COPII",LIPIA,IF,1785,13,4,0,17,22,9,0,31,30,12,0,42,45,13,0,58,46,13,0,59
103522,196,"ŞCOALA DE 4 ANI",GRUIU,IF,1574,11,5,0,16,30,18,0,48,42,22,0,64,62,29,0,91,63,30,0,93
103540,197,"ŞCOALA DE 4 ANI","ŞANŢU FLOREŞTI",IF,572,3,4,0,7,8,6,0,14,19,13,0,32,29,16,0,45,33,20,0,53
103559,198,"ŞCOALA DE 8 ANI","SILIŞTEA SNAGOVULUI",IF,1795,22,5,0,27,48,14,0,62,78,24,0,102,108,36,0,144,114,45,0,159
179392,199,"S.C. PROGRESU S.A.",JILAVA,IF,1585,5,0,0,5,11,2,0,13,13,2,0,15,23,241,0,264,24,243,0,267
179392,200,"ȘCOALA NR.2",JILAVA,IF,1449,4,0,0,4,8,0,0,8,18,1,0,19,32,2,235,269,35,2,235,272
179392,201,"ȘCOALA NR.1",JILAVA,IF,1990,14,4,0,18,29,12,0,41,52,13,0,65,74,13,220,307,84,13,220,317
179392,202,"ȘCOALA NR.3",JILAVA,IF,2051,13,0,0,13,34,4,0,38,53,6,0,59,82,8,165,255,82,8,165,255
179392,203,"INCINTA FOSTULUI CAP",JILAVA,IF,1571,2,2,0,4,13,3,0,16,21,4,0,25,31,4,0,35,33,5,293,331
104252,204,"ŞCOALA GIMNAZIALA NR. 2 MOARA VLASIEI","MOARA VLĂSIEI",IF,1783,16,0,0,16,38,11,0,49,59,18,0,77,83,25,0,108,95,25,0,120
104252,205,"ŞCOALA GIMNAZIALA NR. 1 MOARA VLASIEI","MOARA VLĂSIEI",IF,1768,12,1,0,13,25,1,0,26,48,2,0,50,64,2,0,66,69,2,0,71
104261,206,"ŞCOALA GIMNAZIALA NR. 3""AL. DIMITRIE GHICA """,CĂCIULAŢI,IF,1548,8,2,0,10,15,4,0,19,26,5,0,31,32,8,0,40,38,8,0,46
179472,207,"ŞCOALA GENERALĂ NR. 1",MOGOŞOAIA,IF,1180,13,5,0,18,47,14,0,61,55,17,0,72,69,26,0,95,74,26,0,100
179472,208,"ŞCOALA GENERALĂ NR. 1",MOGOŞOAIA,IF,1136,19,0,0,19,29,3,0,32,41,7,0,48,50,15,0,65,55,18,0,73
179472,209,"ŞCOALA GENERALĂ NR. 1",MOGOŞOAIA,IF,918,25,3,0,28,36,5,0,41,42,10,0,52,50,13,0,63,58,15,0,73
179472,210,"SCOALA GIMNAZIALA NR.1 MOGOSOAIA",MOGOŞOAIA,IF,1537,8,0,0,8,16,1,0,17,23,1,0,24,31,2,0,33,32,2,0,34
179472,211,"SCOALA GIMNAZIALA NR.1 MOGOSOAIA",MOGOŞOAIA,IF,1792,20,0,0,20,40,0,0,40,53,0,0,53,76,0,0,76,90,0,0,90
104476,212,"ŞCOALA DIN SATUL MICŞUNEŞTII-MOARĂ",MICŞUNEŞTII-MOARĂ,IF,1322,4,0,0,4,17,9,0,26,46,13,0,59,64,27,0,91,71,30,0,101
104458,213,"ŞCOALA DIN SATUL MERII PETCHII","MERII PETCHII",IF,913,8,0,0,8,20,0,0,20,27,5,0,32,31,7,0,38,33,7,0,40
104555,214,"LICEUL PERIŞ",PERIŞ,IF,1933,28,3,0,31,45,17,0,62,67,20,0,87,95,27,0,122,108,27,0,135
104555,215,"ŞCOALA NR. 2 PERIS",PERIŞ,IF,1961,14,4,0,18,37,7,0,44,46,8,0,54,59,15,0,74,75,16,0,91
104555,216,"FOSTA ŞCOALA NR. 3 PERIS",PERIŞ,IF,615,5,4,0,9,13,5,0,18,18,8,0,26,27,9,0,36,27,12,0,39
104573,217,"ŞCOALA NR. 4 BURIAŞ",BURIAŞ,IF,1106,16,3,0,19,29,6,0,35,41,11,0,52,58,17,0,75,61,17,0,78
104564,218,"ŞCOALA NR. 5 BĂLTENI",BĂLTENI,IF,401,4,3,0,7,8,7,0,15,13,10,0,23,23,17,0,40,33,19,0,52
104591,219,"STRUCTURA CU GRUPE DE PREŞCOLARI",PETRĂCHIOAIA,IF,1645,16,5,0,21,34,13,0,47,42,15,0,57,62,25,0,87,71,27,0,98
104608,220,"STRUCTURA CU CLASELE I-IV ŞI GRUPE DE PREŞCOLARI",MĂINEASCA,IF,284,0,1,0,1,6,2,0,8,13,6,0,19,14,13,0,27,15,13,0,28
104626,221,"STRUCTURA CU CLASELE I-IV ŞI GRUPE DE PREŞCOLARI",VÎNĂTORI,IF,371,5,11,0,16,10,13,0,23,10,14,0,24,28,17,0,45,35,18,0,53
104617,222,"STRUCTURA CU CLASELE I-IV ŞI GRUPE DE PREŞCOLARI",SURLARI,IF,456,3,2,0,5,9,4,0,13,17,7,0,24,26,8,0,34,26,8,0,34
105179,223,"ŞCOALA GENERALĂ SNAGOV",SNAGOV,IF,1739,20,6,0,26,44,27,0,71,66,38,0,104,88,48,0,136,94,53,0,147
105197,224,"CASA DE CULTURĂ GHERMĂNEŞTI",GHERMĂNEŞTI,IF,1292,13,1,0,14,35,11,0,46,51,19,0,70,62,28,0,90,81,36,0,117
105197,225,"CASA DE CULTURĂ GHERMĂNEŞTI",GHERMĂNEŞTI,IF,1130,14,2,0,16,29,9,0,38,31,13,0,44,41,20,0,61,43,22,0,65
105188,226,"GRĂDINIŢA NR. 1 CIOFLICENI",CIOFLICENI,IF,1011,7,2,0,9,17,8,0,25,33,13,0,46,49,14,0,63,50,15,0,65
105204,227,"ŞCOALA GIMNAZIALĂ ""CONSTANTIN I.BĂICOIANU""",TÎNCĂBEŞTI,IF,1468,3,1,0,4,14,6,0,20,35,9,0,44,50,13,0,63,57,13,0,70
105428,228,"ŞCOALA NR.1 CU CLASELEI-VIII","ŞTEFĂNEŞTII DE JOS",IF,1200,2,0,0,2,9,1,0,10,16,2,0,18,22,2,0,24,25,3,0,28
105428,229,"ŞCOALA NR.1 CU CLASELEI-VIII","ŞTEFĂNEŞTII DE JOS",IF,1360,4,0,0,4,11,5,0,16,28,7,0,35,49,7,0,56,52,9,0,61
105437,230,"ŞCOALA NR.1 CU CLASELEI-VIII",CREŢULEASCA,IF,1781,3,2,0,5,11,6,0,17,24,8,0,32,37,10,0,47,38,10,0,48
105446,231,"ŞCOALA NR.1 CU CLASELEI-VIII","ŞTEFĂNEŞTII DE SUS",IF,810,8,0,0,8,13,2,0,15,22,2,0,24,35,3,0,38,36,3,0,39
105428,232,"COMPLEX COSMOPOLIS","ŞTEFĂNEŞTII DE JOS",IF,1090,3,5,0,8,15,20,0,35,20,32,0,52,33,43,0,76,40,60,0,100
105589,233,"SCOALA NR. 1 TUNARI - CORP A",TUNARI,IF,1496,8,2,0,10,22,4,0,26,38,14,0,52,53,17,0,70,58,23,0,81
105589,234,"ŞCOALA NR. 1 TUNARI - CORP C",TUNARI,IF,1481,8,2,0,10,25,7,0,32,36,8,0,44,38,8,0,46,48,10,0,58
105589,235,"SCOALA NR. 1 TUNARI - CORP B",TUNARI,IF,1894,15,0,0,15,32,2,0,34,47,6,0,53,59,9,0,68,62,11,0,73
105945,236,"ŞCOALA GENERALĂ NR. 304 VIDRA",VIDRA,IF,753,3,1,0,4,4,2,0,6,5,7,0,12,10,7,0,17,10,8,0,18
105945,237,"ŞCOALA GENERALĂ NR. 304 VIDRA",VIDRA,IF,1123,4,1,0,5,6,1,0,7,8,2,0,10,15,5,0,20,19,5,0,24
105945,238,"ŞCOALA GENERALĂ NR. 301 VIDRA",VIDRA,IF,1263,7,0,0,7,16,4,0,20,16,6,0,22,20,8,0,28,23,15,0,38
105954,239,"ŞCOALA GENERALĂ NR. 302 CREŢEŞTI",CREŢEŞTI,IF,1171,3,0,0,3,4,0,0,4,10,0,0,10,14,3,0,17,23,3,0,26
105954,240,"ŞCOALA GENERALĂ NR. 302 CREŢEŞTI",CREŢEŞTI,IF,840,7,1,0,8,18,3,0,21,30,3,0,33,37,5,0,42,44,5,0,49
105963,241,"ŞCOALA GENERALĂ NR. 303 SINTEŞTI",SINTEŞTI,IF,839,11,5,0,16,22,9,0,31,28,9,0,37,34,11,0,45,38,12,0,50
105963,242,"ŞCOALA GENERALĂ NR. 303 SINTEŞTI",SINTEŞTI,IF,1078,2,0,0,2,6,1,0,7,9,1,0,10,10,1,0,11,13,1,0,14
179506,243,"GRĂDINIȚA CU PROGRAM PRELUNGIT NR.2",ODĂILE,IF,975,6,3,0,9,22,5,0,27,41,8,0,49,51,10,0,61,55,10,0,65
179490,244,"GRĂDINIȚA CU PROGRAM NORMAL NR.2",OTOPENI,IF,1112,10,0,0,10,20,6,0,26,38,8,0,46,48,14,0,62,53,14,0,67
179542,245,"SC RAFFAELLO SHOES FACTORY SRL","POPEŞTI LEORDENI",IF,2021,2,8,0,10,15,13,0,28,26,24,0,50,34,24,0,58,38,25,0,63
179542,246,"DIRECȚIA IMPOZITE ȘI TAXE LOCALE","POPEŞTI LEORDENI",IF,1978,3,1,0,4,20,2,0,22,26,7,0,33,35,9,0,44,39,18,0,57
179542,247,"SERVICIUL ACHIZIȚII PUBLICE","POPEŞTI LEORDENI",IF,1848,7,2,0,9,24,6,0,30,35,9,0,44,45,11,0,56,51,13,0,64
179542,248,"ȘCOALA GIMNAZIALĂ ,,IOAN BĂDESCU""","POPEŞTI LEORDENI",IF,849,1,0,0,1,4,0,0,4,14,0,0,14,15,0,0,15,15,0,0,15
179258,249,"SCOALA GIMNAZIALA""ALEXANDRU ODOBESCU""",CHIAJNA,IF,1566,4,0,0,4,29,12,0,41,42,17,0,59,48,32,0,80,56,38,0,94
179276,250,"LICEUL TEHNOLOGIC ""DOAMNA CHIAJNA'",ROŞU,IF,1295,2,0,0,2,11,0,0,11,17,0,0,17,24,0,0,24,28,0,0,28
101154,251,"SCOALA GIMNAZIALA NR. 1",BERCENI,IF,1540,15,4,0,19,29,7,0,36,55,8,0,63,72,9,0,81,79,9,0,88
92667,1,"GRUPUL ŞCOLAR “ALEXANDRU IOAN CUZA”(LICEUL DE CONSTRUCŢII),",SLOBOZIA,IL,1543,8,1,0,9,22,2,251,275,28,2,251,281,38,3,251,292,39,3,251,293
92667,2,"GRUPUL ŞCOLAR “ALEXANDRU IOAN CUZA”(LICEUL DE CONSTRUCŢII),",SLOBOZIA,IL,1404,9,2,0,11,32,2,0,34,44,2,0,46,58,7,0,65,67,7,0,74
92667,3,"ŞCOALA GENERALÃ NR.3,",SLOBOZIA,IL,1152,18,5,0,23,40,9,0,49,60,14,0,74,76,14,0,90,85,14,0,99
92667,4,"ŞCOALA GENERALÃ NR.3,",SLOBOZIA,IL,961,18,2,0,20,47,4,0,51,66,4,0,70,77,9,0,86,81,10,0,91
92667,5,"COLEGIUL NAŢIONAL ,,MIHAI VITEAZU” (LICEUL DE MATEMATICÃ - FIZICÃ)",SLOBOZIA,IL,1209,20,0,0,20,51,0,0,51,63,2,0,65,80,2,0,82,90,3,0,93
92667,6,"LICEUL PEDAGOGIC ,,MATEI BASARAB” (ŞCOALA NORMALÃ)",SLOBOZIA,IL,1538,18,2,0,20,58,3,0,61,75,3,0,78,109,3,0,112,117,5,0,122
92667,7,"MUZEUL AGRICULTURII",SLOBOZIA,IL,1613,15,1,0,16,32,3,0,35,47,4,0,51,77,5,0,82,79,7,0,86
92667,8,"ŞCOALA GENERALÃ NR.6",SLOBOZIA,IL,1596,25,0,0,25,55,2,0,57,66,2,0,68,96,2,0,98,98,3,0,101
92667,9,"ŞCOALA GENERALÃ NR.6",SLOBOZIA,IL,1374,17,0,0,17,47,0,0,47,65,3,0,68,84,4,0,88,90,7,0,97
92667,10,"LICEU TEHNOLOGIC",SLOBOZIA,IL,1496,27,0,0,27,87,1,0,88,106,1,0,107,134,1,0,135,134,1,0,135
92667,11,"CLUBUL TINERETULUI",SLOBOZIA,IL,1061,12,0,0,12,33,2,0,35,45,2,0,47,56,4,0,60,76,5,0,81
92667,12,"SEMINARUL TEOLOGIC,",SLOBOZIA,IL,1003,11,5,0,16,40,11,0,51,57,13,0,70,78,14,0,92,80,14,0,94
92667,13,"CASA DE CULTURĂ MUNICIPALĂ (FOSTUL CINEMA “GALAX”)",SLOBOZIA,IL,1442,14,0,0,14,42,2,0,44,47,2,0,49,74,3,0,77,76,3,0,79
92667,14,"LICEUL ,,MIHAI EMINESCU” (LICEUL DE CHIMIE)",SLOBOZIA,IL,1141,9,2,0,11,30,2,0,32,36,14,0,50,49,14,0,63,60,14,0,74
92667,15,"ŞCOALA GENERALÃ NR.4",SLOBOZIA,IL,1591,19,3,0,22,56,8,0,64,72,9,0,81,89,10,0,99,93,10,0,103
92667,16,"ŞCOALA GENERALÃ NR.4",SLOBOZIA,IL,1542,9,2,10,21,25,2,26,53,42,2,26,70,63,4,26,93,68,4,26,98
92667,17,"GRĂDINIŢA CU PROGRAM PRELUNGIT",SLOBOZIA,IL,1523,13,1,0,14,41,4,0,45,52,6,0,58,79,7,0,86,92,8,0,100
92667,18,SCELIF,SLOBOZIA,IL,1475,22,3,0,25,67,8,0,75,90,11,0,101,106,11,0,117,112,11,0,123
92667,19,"ŞCOALA GENERALÃ NR.2",SLOBOZIA,IL,1592,14,0,0,14,60,2,0,62,77,3,0,80,119,4,0,123,128,6,0,134
92667,20,"ŞCOALA GENERALÃ NR.2",SLOBOZIA,IL,1479,22,0,0,22,76,1,0,77,92,1,0,93,116,4,0,120,124,5,0,129
92667,21,"S.C. DRUMURI ŞI PODURI IALOMIŢA",SLOBOZIA,IL,1695,28,2,0,30,68,3,0,71,84,3,0,87,100,3,0,103,109,3,0,112
92667,22,"PALATUL COPIILOR ŞI ELEVILOR SLOBOZIA",SLOBOZIA,IL,1500,11,0,0,11,51,0,0,51,64,0,0,64,97,0,0,97,110,1,0,111
92667,23,"PALATUL COPIILOR ŞI ELEVILOR SLOBOZIA",SLOBOZIA,IL,1264,17,0,0,17,46,1,0,47,67,2,0,69,82,9,0,91,88,9,0,97
92667,24,"ŞCOALA GENERALÃ NR.1",SLOBOZIA,IL,934,8,4,0,12,33,4,0,37,48,6,0,54,65,7,0,72,65,7,0,72
92667,25,"ŞCOALA GENERALÃ NR.1",SLOBOZIA,IL,907,12,0,0,12,33,11,0,44,35,14,0,49,45,15,0,60,51,15,0,66
92667,26,"LICEUL DE ARTÃ",SLOBOZIA,IL,1123,8,2,0,10,37,2,0,39,44,3,0,47,55,4,0,59,60,4,0,64
92667,27,"LICEUL DE ARTÃ",SLOBOZIA,IL,1518,12,0,0,12,27,3,0,30,36,3,0,39,52,3,0,55,60,4,0,64
92667,28,"GRÃDINIŢA CU PROGRAM PRELUNGIT NR.3",SLOBOZIA,IL,1420,12,3,0,15,39,4,0,43,45,5,0,50,66,5,1,72,69,6,1,76
92667,29,"ATELIERELE DE CREAŢIE ALE LICEULUI DE ARTĂ",SLOBOZIA,IL,1935,11,0,0,11,45,0,0,45,53,0,0,53,68,1,0,69,82,1,0,83
92676,30,"ŞCOALA GENERALÃ BORA",BORA,IL,734,1,0,0,1,8,0,0,8,11,0,0,11,14,0,0,14,14,2,0,16
92676,31,"ŞCOALA GENERALÃ BORA",BORA,IL,978,1,0,0,1,7,0,0,7,15,1,0,16,18,5,0,23,20,5,0,25
92685,32,"ŞCOALA GENERALÃ NR.5 SLOBOZIA NOUÃ","SLOBOZIA NOUĂ",IL,1071,5,0,0,5,15,0,0,15,18,0,0,18,29,1,0,30,31,1,0,32
92685,33,"ŞCOALA GENERALÃ NR.5 SLOBOZIA NOUÃ","SLOBOZIA NOUĂ",IL,992,7,0,0,7,15,3,0,18,19,3,0,22,38,3,0,41,38,3,0,41
92710,34,"ŞCOALA GIMNAZIALĂ "" MIHAI VITEAZUL""- LOCALUL BULIGA",FETEŞTI,IL,886,13,0,0,13,26,3,0,29,39,4,0,43,58,4,0,62,60,4,0,64
92710,35,"ŞCOALA GIMNAZIALĂ ""MIHAI VITEAZUL""- LOCALUL A",FETEŞTI,IL,1513,6,1,0,7,26,1,0,27,39,1,0,40,55,1,0,56,65,1,0,66
92710,36,"SC COCOLINO SRL",FETEŞTI,IL,1039,15,5,0,20,24,5,0,29,35,5,0,40,49,5,0,54,50,5,0,55
92710,37,"SCOALA GIMNAZIALA ""MIHAI VITEAZUL"" - LOCALUL B",FETEŞTI,IL,1031,6,0,0,6,21,6,0,27,28,6,0,34,39,6,0,45,40,6,0,46
92710,38,"SCOALA GIMNAZIALA ""MIHAI VITEAZUL"" - LOCALUL C",FETEŞTI,IL,952,4,4,0,8,20,6,0,26,31,6,0,37,36,6,0,42,39,6,0,45
92710,39,"PROTOPOPIATUL FETESTI",FETEŞTI,IL,1126,7,1,0,8,18,4,0,22,31,4,0,35,48,6,0,54,50,6,0,56
92710,40,"SCOALA GIMNAZIALA ""RADU VODA""",FETEŞTI,IL,993,5,3,0,8,18,3,0,21,26,3,0,29,39,3,0,42,41,3,0,44
92710,41,"GRADINIŢA ŞCOLII GIMNAZIALE NR.4",FETEŞTI,IL,820,8,0,0,8,12,2,0,14,23,2,0,25,34,2,0,36,34,2,0,36
92710,42,"GRADINIŢA ŞCOLII GIMNAZIALE NR.4",FETEŞTI,IL,970,11,0,0,11,12,0,0,12,20,3,0,23,31,4,0,35,32,4,0,36
92710,43,"LICEU TEHNOLOGIC ""ANGHEL SALIGNY""",FETEŞTI,IL,1060,20,1,0,21,38,4,0,42,45,4,0,49,60,6,0,66,63,7,29,99
92710,44,"LICEUL TEORETIC ""CAROL I""",FETEŞTI,IL,1333,15,5,0,20,35,5,0,40,49,5,0,54,63,5,0,68,68,5,0,73
92710,45,"ŞCOALA GIMNAZIALA ""AUREL VLAICU""",FETEŞTI,IL,1185,20,6,0,26,51,10,0,61,69,11,0,80,93,17,0,110,97,19,0,116
92710,46,"LICEUL TEHNOLOGIC DE INDUSTRIE ALIMENTARA",FETEŞTI,IL,1486,18,6,0,24,41,7,0,48,51,9,0,60,62,11,0,73,62,11,0,73
92710,47,"GRĂDINIŢA CU PROGRAM PRELUNGIT ""ALBA CA ZAPADA""",FETEŞTI,IL,1208,14,4,0,18,40,5,0,45,58,6,0,64,77,6,1,84,80,8,1,89
92710,48,"SALA DE SPORT",FETEŞTI,IL,1096,1,6,0,7,21,6,0,27,34,1,0,35,38,7,0,45,43,7,0,50
92710,49,"LICEUL TEHNOLOGIC DE INDUSTRIE ALIMENTARA (FOSTA SCOALA NR. 8)",FETEŞTI,IL,919,15,0,0,15,40,1,0,41,57,1,0,58,70,2,0,72,76,2,0,78
92710,50,"LICEUL TEHNOLOGIC DE INDUSTRIE ALIMENTARA (FOSTA SCOALA NR. 8)",FETEŞTI,IL,1000,8,2,0,10,17,3,0,20,35,5,0,40,41,8,0,49,45,9,0,54
92710,51,"GRĂDINIŢA NR.1",FETEŞTI,IL,1208,24,4,0,28,57,13,1,71,71,16,1,88,90,16,1,107,97,16,1,114
92710,52,"ŞCOALA GIMNAZIALA ""DIMITRIE CANTEMIR""",FETEŞTI,IL,1301,10,0,0,10,42,0,0,42,59,0,0,59,83,0,0,83,91,0,0,91
92710,53,"ŞCOALA GIMNAZIALA ""DIMITRIE CANTEMIR""",FETEŞTI,IL,972,2,0,0,2,25,0,0,25,40,0,0,40,59,0,0,59,65,0,0,65
92710,54,"ŞCOALA GIMNAZIALA ""DIMITRIE CANTEMIR""",FETEŞTI,IL,972,5,3,0,8,28,4,0,32,40,7,0,47,57,8,0,65,64,9,0,73
92710,55,"CENTRUL SOCIAL AL PAROHIEI FETESTI GARA II",FETEŞTI,IL,1346,10,0,0,10,23,2,0,25,37,2,0,39,56,4,0,60,63,4,0,67
92710,56,AGROSEM,FETEŞTI,IL,1325,9,2,0,11,32,2,0,34,47,2,0,49,54,2,0,56,59,3,0,62
92710,57,"LICEUL TEHNOLOGIC ""ANGHEL SALIGNY"" (FOSTA SCOALA NR. 5)",FETEŞTI,IL,1364,15,1,0,16,37,4,0,41,52,7,0,59,71,7,0,78,75,7,0,82
92710,58,"LICEUL TEHNOLOGIC ""ANGHEL SALIGNY"" (FOSTA SCOALA NR. 5)",FETEŞTI,IL,1118,12,5,0,17,22,5,0,27,37,5,0,42,49,5,0,54,54,5,0,59
100692,59,"GRĂDINIŢA CU PROGRAM PRELUNGIT",URZICENI,IL,749,14,6,2,22,20,7,2,29,30,7,2,39,35,7,2,44,38,7,2,47
100692,60,"ŞCOALA CU CLASELE I-VIII NR.3 DIN URZICENI",URZICENI,IL,1365,13,0,0,13,26,0,0,26,35,0,0,35,52,1,0,53,60,1,0,61
100692,61,"GRĂDINIŢA DE COPII",URZICENI,IL,1070,10,1,0,11,25,3,0,28,28,4,0,32,35,5,0,40,39,5,0,44
100692,62,"CASA DE CULTURĂ",URZICENI,IL,1223,10,0,0,10,24,9,0,33,33,9,0,42,55,10,0,65,63,10,0,73
100692,63,"GRUPUL ŞCOLAR ’’SF. ECATERINA’’",URZICENI,IL,1377,15,0,0,15,31,1,0,32,43,2,0,45,47,3,0,50,56,4,0,60
100692,64,"SCOALA GENERALA ALEXANDRU ODOBESCU",URZICENI,IL,1188,14,5,0,19,47,6,0,53,61,7,0,68,75,10,0,85,81,11,0,92
100692,65,"CLUBUL SINDICATELOR",URZICENI,IL,1703,19,0,0,19,55,3,0,58,73,5,0,78,97,7,0,104,109,7,0,116
100692,66,"ŞCOALA GENERALĂ ION HELIADE RADULESCU",URZICENI,IL,1546,18,1,0,19,40,4,0,44,60,6,0,66,75,8,2,85,85,8,2,95
100692,67,"ŞCOALA GENERALĂ ION HELIADE RADULESCU",URZICENI,IL,1284,14,0,0,14,48,1,0,49,60,5,0,65,72,8,0,80,78,8,0,86
100692,68,"INTERNATUL COLEGIULUI NATIONAL GRIGORE MOISIL",URZICENI,IL,1151,18,2,0,20,37,3,0,40,53,3,0,56,67,3,0,70,76,3,0,79
100692,69,"LICEUL TEHNOLOGIC URZICENI",URZICENI,IL,1609,3,3,0,6,17,4,0,21,21,4,0,25,31,5,0,36,40,5,0,45
92845,70,"GRADINITA CU PROGRAM NORMAL AMARA",AMARA,IL,1296,5,1,0,6,17,1,0,18,28,2,0,30,39,2,0,41,40,2,0,42
92845,71,"GRADINITACU PROGRAM NORMALAMARA",AMARA,IL,1073,4,0,0,4,15,0,0,15,23,2,0,25,32,4,0,36,32,4,0,36
92845,72,"SCOALA GIMNAZIALA GEORGE VALSAN",AMARA,IL,1374,9,4,0,13,26,12,0,38,39,18,0,57,45,20,0,65,47,27,0,74
92845,73,"SCOALA GIMNAZIALA GEORGE VALSAN",AMARA,IL,1415,12,5,0,17,18,15,0,33,26,18,0,44,45,19,0,64,49,19,0,68
92845,74,"CASA DE CULTURA JAN CACIULA",AMARA,IL,1429,19,5,0,24,21,14,0,35,31,30,0,61,51,38,0,89,53,38,0,91
93076,75,"LICEUL TEHNOLOGIC- CORP B",CĂZĂNEŞTI,IL,1492,20,0,0,20,40,4,0,44,57,7,11,75,83,9,11,103,86,9,11,106
93076,76,"LICEUL TEHNOLOGIC",CĂZĂNEŞTI,IL,1393,4,0,0,4,15,1,0,16,23,1,4,28,34,3,4,41,37,3,4,44
102758,77,"CĂMINUL CULTURAL",FIERBINŢI-TÂRG,IL,1342,12,0,0,12,16,10,0,26,28,11,0,39,35,13,6,54,44,16,6,66
102776,78,"ŞCOALA GENERALĂ CU CLASELE I-IV FIRBINŢI DE SUS","FIERBINŢII DE SUS",IL,1552,10,0,0,10,12,16,0,28,17,18,0,35,26,21,0,47,30,21,0,51
102767,79,"ŞCOALA GENERALĂ CU CLASELE I-IV FIRBINŢI DE JOS","FIERBINŢII DE JOS",IL,912,11,0,0,11,18,3,0,21,25,6,0,31,35,8,0,43,40,10,0,50
92774,80,"GRUPUL SCOLAR AGRICOL",ŢĂNDĂREI,IL,1428,4,0,0,4,15,0,0,15,20,0,0,20,31,0,0,31,35,0,0,35
92774,81,"LICEUL TEORETIC ’’PAUL GEORGESCU’’",ŢĂNDĂREI,IL,1148,3,2,0,5,10,4,0,14,13,5,0,18,23,7,4,34,24,7,4,35
92774,82,"LICEUL TEORETIC ’’PAUL GEORGESCU’’",ŢĂNDĂREI,IL,902,2,0,0,2,8,0,0,8,11,0,0,11,18,2,0,20,18,2,0,20
92774,83,"ŞCOALA NR. 2",ŢĂNDĂREI,IL,1616,8,0,0,8,21,0,0,21,26,6,0,32,44,8,0,52,50,8,0,58
92774,84,"ŞCOALA NR. 2",ŢĂNDĂREI,IL,1505,9,0,0,9,27,0,0,27,38,0,0,38,59,0,0,59,61,0,0,61
92774,85,"ŞCOALA NR. 1 ŢĂNDĂREI",ŢĂNDĂREI,IL,1483,6,4,0,10,17,4,0,21,44,4,0,48,63,5,0,68,63,5,0,68
92774,86,"FOST SEDIU PRIMĂRIE",ŢĂNDĂREI,IL,1536,9,1,0,10,21,7,0,28,35,7,0,42,42,7,0,49,44,7,0,51
92774,87,"ŞCOALA NR. 1",ŢĂNDĂREI,IL,1015,3,2,0,5,4,4,0,8,8,4,0,12,24,4,0,28,26,4,0,30
92774,88,"BIBLIOTECA/DOMENIUL PUBLIC AL UAT TANDAREI",ŢĂNDĂREI,IL,848,1,0,0,1,13,3,0,16,15,3,0,18,21,3,0,24,24,3,0,27
100763,89,"SALA DE SPORT DE LÂNGĂ PRIMARIA COMUNEIADÂNCATA",ADÂNCATA,IL,1394,12,1,0,13,18,5,0,23,29,9,0,38,57,14,26,97,61,14,26,101
100772,90,"ŞCOALA GENERALĂ ADÂNCATA","PATRU FRAŢI",IL,633,3,2,0,5,5,5,0,10,7,7,0,14,9,11,0,20,15,11,0,26
92792,91,"SCOALA GIMNAZIALA""CONSTANTIN STEFAN""",ALBEŞTI,IL,538,6,0,0,6,7,1,0,8,14,3,0,17,23,12,0,35,25,12,0,37
92827,92,"SCOALA PRIMARA MARSILIENI",MARSILIENI,IL,440,5,3,0,8,15,6,0,21,19,6,0,25,21,7,0,28,29,9,0,38
100861,93,"ŞCOALA VECHE",ALEXENI,IL,891,15,0,0,15,28,0,0,28,38,1,0,39,56,2,0,58,62,2,0,64
100861,94,"ŞCOALA VECHE",ALEXENI,IL,993,13,3,0,16,32,8,0,40,41,11,0,52,60,13,0,73,69,14,0,83
92881,95,"ŞCOALA GENERALA ANDRĂŞEŞTI",ANDRĂŞEŞTI,IL,1462,8,5,0,13,21,6,0,27,23,6,0,29,37,6,0,43,41,6,0,47
92890,96,"ŞCOALA ORBOEŞTI",ORBOEŞTI,IL,280,2,0,0,2,5,1,0,6,11,1,0,12,15,3,0,18,15,3,0,18
100889,97,"ȘCOALA GENERALĂ ARMĂȘEȘTI",ARMĂŞEŞTI,IL,648,8,0,0,8,13,0,0,13,18,0,0,18,31,0,5,36,34,0,5,39
100905,98,"ŞCOALA GENERALĂ MALU ROȘU","MALU ROŞU",IL,1206,7,0,0,7,14,1,0,15,21,4,0,25,32,15,0,47,36,18,0,54
100932,99,PRIMARIE,AXINTELE,IL,552,9,4,0,13,19,8,0,27,30,17,0,47,47,17,0,64,51,17,0,68
100932,100,SCOALAFRUMUȘICA,AXINTELE,IL,799,4,6,0,10,6,14,0,20,11,15,0,26,16,18,0,34,18,19,0,37
100950,101,"ȘCOALA HORIA",HORIA,IL,493,3,3,0,6,10,6,0,16,11,7,0,18,13,7,0,20,14,7,0,21
92916,102,CAMINCULTURAL,BALACIU,IL,395,8,2,0,10,18,13,0,31,20,15,0,35,28,16,0,44,29,16,0,45
92916,103,"ŞCOALA GIMNAZIALĂ ,,ARHIMANDRIT TEOFIL,, BALACIU",BALACIU,IL,359,2,5,0,7,9,5,0,14,10,5,0,15,25,5,0,30,25,7,0,32
92934,104,"SALĂ FESTIVITĂŢI","CRĂSANII DE JOS",IL,272,9,2,0,11,24,11,0,35,34,16,0,50,35,20,0,55,37,20,0,57
92925,105,"GRADINITA COPUZU",COPUZU,IL,260,1,2,0,3,7,5,0,12,10,8,0,18,14,9,0,23,14,9,0,23
100898,106,"ŞCOALA GIMNAZIALĂ BĂRBULEŞTI",BĂRBULEŞTI,IL,842,1,0,0,1,11,0,0,11,28,0,0,28,44,0,0,44,48,0,0,48
100898,107,"ŞCOALA GIMNAZIALĂ BĂRBULEŞTI",BĂRBULEŞTI,IL,955,6,0,0,6,17,0,0,17,31,0,0,31,40,0,0,40,46,0,0,46
100898,108,"ŞCOALA GIMNAZIALĂ BĂRBULEŞTI",BĂRBULEŞTI,IL,950,2,0,0,2,9,0,0,9,37,0,0,37,61,0,0,61,69,0,0,69
100898,109,"ŞCOALA GIMNAZIALĂ BĂRBULEŞTI",BĂRBULEŞTI,IL,1035,10,2,0,12,20,2,0,22,28,2,0,30,38,3,0,41,45,3,0,48
101065,110,"ŞCOALA GIMNAZIALA BĂRCĂNEŞTI",BĂRCĂNEŞTI,IL,1331,5,0,0,5,20,0,7,27,20,0,7,27,32,13,0,45,39,13,0,52
101074,111,"ŞCOALA GIMNAZIALĂ CONDEEŞTI",CONDEEŞTI,IL,1385,3,0,0,3,21,0,0,21,31,0,0,31,31,5,5,41,35,8,5,48
102268,112,"ŞCOALA GIMNAZIALĂ",BORĂNEŞTI,IL,967,6,2,0,8,7,2,0,9,8,2,0,10,10,4,0,14,14,4,0,18
102268,113,"ŞCOALA GIMNAZIALĂ",BORĂNEŞTI,IL,569,1,0,0,1,4,1,0,5,5,1,0,6,12,3,0,15,12,3,0,15
102277,114,"FOSTA ŞCOALĂ SINTEŞTI",SINTEŞTI,IL,322,1,0,0,1,2,0,0,2,9,0,2,11,22,0,4,26,24,0,8,32
92998,115,"LOCALUL ŞCOLII VECHI DIN CENTRUL SATULUI",BORDUŞANI,IL,1402,9,0,0,9,15,0,0,15,23,3,0,26,37,4,0,41,40,4,0,44
92998,116,"LOCALUL GRUPULUI ŞCOLAR BORDUŞANI (ZONA „MOARĂ”)",BORDUŞANI,IL,1452,4,1,0,5,8,2,0,10,14,7,0,21,32,7,0,39,32,7,0,39
93003,117,"LOCALUL ŞCOLII CU CLASELE I- VIII CEGANI",CEGANI,IL,1107,7,2,0,9,14,2,0,16,20,2,0,22,24,2,0,26,24,2,0,26
93030,118,"CĂMINUL CULTURAL",BUCU,IL,1017,8,2,0,10,11,3,0,14,20,5,0,25,23,5,0,28,23,5,0,28
93030,119,"CĂMINUL CULTURAL",BUCU,IL,1052,10,0,0,10,18,0,0,18,20,1,0,21,27,4,0,31,29,4,0,33
92818,120,"ŞCOALA CU CLASELE I – IV BUEŞTI",BUEŞTI,IL,862,6,1,0,7,16,3,0,19,23,8,0,31,36,8,0,44,39,8,0,47
100718,121,"ŞCOALA GENERALĂ CIOCÂRLIA",CIOCÂRLIA,IL,625,9,0,0,9,13,0,0,13,14,0,0,14,20,1,0,21,23,6,0,29
93110,122,"CĂMINUL CULTURAL DIN SATUL CIOCHINA",CIOCHINA,IL,1257,12,0,0,12,24,7,0,31,27,9,0,36,39,12,0,51,40,12,0,52
93129,123,"CĂMINUL CULTURAL DIN SATUL BORDUŞELU",BORDUŞELU,IL,603,5,0,0,5,10,5,0,15,15,5,0,20,26,14,0,40,26,14,0,40
93138,124,"CĂMINUL CULTURAL DIN SATUL OREZU",OREZU,IL,652,4,2,0,6,11,3,0,14,16,3,0,19,21,4,0,25,21,4,0,25
93165,125,"CĂMIN CULTURAL CIULNIŢA",CIULNIŢA,IL,917,9,2,0,11,18,4,0,22,35,16,0,51,48,17,0,65,56,17,0,73
93174,126,"CĂMIN CULTURAL ION GHICA","ION GHICA",IL,453,8,1,0,9,14,1,0,15,22,3,0,25,28,6,0,34,29,6,0,35
93192,127,"ŞCOALA POIANA",POIANA,IL,407,6,1,0,7,15,2,0,17,15,2,0,17,44,6,0,50,50,6,0,56
93192,128,"CĂMIN CULTURAL GHIMPAŢI",POIANA,IL,203,4,3,0,7,6,3,0,9,8,8,0,16,21,9,0,30,26,10,0,36
93218,129,"ŞCOALA VECHE",COCORA,IL,808,9,4,0,13,15,5,0,20,25,6,0,31,41,7,0,48,41,7,0,48
93218,130,"PRIMARIA COCORA",COCORA,IL,849,6,1,0,7,19,2,0,21,37,2,0,39,50,4,0,54,52,5,0,57
93227,131,"ŞCOALA CU CLASELE I-VIII COLELIA",COLELIA,IL,940,4,0,0,4,12,1,0,13,23,1,0,24,34,30,5,69,41,5,30,76
93245,132,"CAMINUL CULTURAL DIN SATUL COSÂMBEŞTI",COSÂMBEŞTI,IL,785,12,0,0,12,28,0,0,28,42,3,11,56,56,4,11,71,59,4,11,74
93254,133,"ŞCOALA GIMBĂŞANI",GIMBĂŞANI,IL,761,4,1,0,5,10,7,0,17,24,10,0,34,27,10,0,37,28,10,0,38
102259,134,"CAMINUL CULTURAL COSERENI",COŞERENI,IL,1344,11,3,0,14,25,8,0,33,31,8,0,39,46,11,0,57,52,11,0,63
102259,135,"ŞCOALA GENERALĂ COSERENI",COŞERENI,IL,1281,7,0,0,7,19,0,0,19,25,0,0,25,41,0,0,41,41,3,1,45
102259,136,"GRADINIŢA PĂTRIME",COŞERENI,IL,1045,3,1,0,4,5,3,0,8,10,3,0,13,12,3,0,15,20,3,0,23
102650,137,"CĂMINUL CULTURAL DRĂGOEŞTI",DRĂGOEŞTI,IL,754,9,10,0,19,13,11,0,24,17,23,0,40,42,23,0,65,45,25,0,70
102712,138,"ŞCOALA GIMNAZIALĂ DRIDU",DRIDU,IL,958,7,2,0,9,19,10,0,29,29,17,0,46,51,27,0,78,53,28,0,81
102712,139,"GRĂDINIŢA DRIDU – MOARĂ",DRIDU,IL,794,12,0,0,12,17,1,0,18,22,2,0,24,41,6,0,47,46,6,0,52
102712,140,"GRĂDINIŢA DRIDU – MOVILA",DRIDU,IL,620,8,6,0,14,16,11,0,27,19,18,0,37,27,24,0,51,30,24,0,54
102721,141,"GRĂDINIŢA DRIDU –SNAGOV",DRIDU-SNAGOV,IL,340,1,2,0,3,3,5,0,8,7,8,0,15,11,10,0,21,13,10,0,23
93584,142,"SAM FACAENI",FĂCĂENI,IL,1230,9,2,0,11,18,3,0,21,25,3,0,28,29,8,0,37,32,8,0,40
93584,143,"SCOALA GENERALA FACAENI - CORP B",FĂCĂENI,IL,1675,10,4,0,14,29,4,0,33,49,4,0,53,65,7,0,72,71,7,0,78
93584,144,"SCOALA GENERALA FACAENI - CORP C",FĂCĂENI,IL,991,8,0,0,8,19,0,0,19,29,0,0,29,34,1,0,35,39,7,0,46
93593,145,"SEDIUL ADMINISTRATIV PRIMARIA FACAENI",PROGRESU,IL,511,8,5,0,13,18,6,0,24,20,6,0,26,28,6,0,34,36,6,0,42
103292,146,"ŞCOALA CU CLASELE I-VIII GÂRBOVI,",GÂRBOVI,IL,1016,10,5,0,15,16,7,0,23,26,8,0,34,42,9,4,55,60,12,4,76
103292,147,"ŞCOALA CU CLASELE I-VIII GÂRBOVI,",GÂRBOVI,IL,1039,9,3,0,12,24,5,0,29,31,8,1,40,43,13,1,57,48,14,1,63
103292,148,"SCOALA CU CLASELE I-VIII GARBOVI",GÂRBOVI,IL,1102,15,1,0,16,19,1,0,20,31,1,0,32,55,2,0,57,57,2,0,59
93619,149,"ŞCOALA GIMNAZIALĂ GHEORGHE DOJASITUATĂ ÎN GHEORGHE DOJA","GHEORGHE DOJA",IL,1098,2,1,0,3,6,2,0,8,9,2,0,11,13,2,0,15,14,3,0,17
93619,150,"ŞCOALA GIMNAZIALĂ GHEORGHE DOJASITUATĂ ÎN GHEORGHE DOJA","GHEORGHE DOJA",IL,1118,4,0,0,4,11,0,0,11,14,0,0,14,16,0,0,16,17,0,0,17
93637,151,"ŞCOALA GENERALĂ GHEORGHE LAZĂR","GHEORGHE LAZĂR",IL,1088,27,3,0,30,75,12,0,87,109,18,31,158,149,20,31,200,160,20,31,211
93637,152,"ŞCOALA GENERALĂ GHEORGHE LAZĂR","GHEORGHE LAZĂR",IL,781,32,2,0,34,66,6,6,78,89,11,8,108,115,12,8,135,134,12,8,154
93655,153,"ŞCOALA GIMNAZIALĂ GIURGENI",GIURGENI,IL,1170,8,2,0,10,17,3,0,20,43,3,0,46,69,3,0,72,73,3,0,76
93726,154,"CĂMINUL CULTURAL",GRINDU,IL,827,14,1,0,15,35,5,0,40,53,8,0,61,83,9,0,92,86,9,0,95
93726,155,"CĂMINUL CULTURAL",GRINDU,IL,825,4,2,0,6,15,5,0,20,24,9,0,33,33,16,0,49,35,17,0,52
93744,156,"LICEUL TEHNOLOGIC ARETA TEODORESCU",GRIVIŢA,IL,1002,3,0,0,3,8,0,0,8,17,0,0,17,21,0,0,21,24,2,0,26
93744,157,"LICEUL TEHNOLOGIC ARETA TEODORESCU",GRIVIŢA,IL,980,4,2,0,6,7,3,0,10,10,4,0,14,16,5,0,21,17,5,0,22
93753,158,"ŞCOALA CU CLASELE I-IV",SMIRNA,IL,787,5,1,0,6,11,6,0,17,19,8,0,27,26,9,0,35,28,9,0,37
94018,159,"SCOALA GIMNAZIALA CONSTANTIN GURGU NR. 1","GURA IALOMIŢEI",IL,979,10,0,0,10,18,0,0,18,20,2,0,22,25,4,0,29,26,4,0,30
94036,160,"ŞCOALA GENERALA LUCIU",LUCIU,IL,1106,7,0,0,7,16,0,0,16,18,3,0,21,52,3,0,55,54,3,0,57
103871,161,"ŞCOALA GIMNAZIALA ION ROATA","ION ROATĂ",IL,919,10,2,0,12,29,3,0,32,42,6,0,48,48,6,0,54,52,6,0,58
103871,162,"GRADINITA ION ROATA(LOCALUL VECHI COLINELE)","ION ROATĂ",IL,777,11,1,0,12,17,5,0,22,24,7,0,31,38,8,0,46,42,9,0,51
103880,163,"ŞCOALA GIMNAZIALA ION ROATA(STRUCTURA BROSTENI)",BROŞTENI,IL,1182,2,3,0,5,9,5,0,14,12,5,0,17,25,5,0,30,27,5,0,32
103979,164,"ŞCOALA NR.1 JILAVELE",JILAVELE,IL,1205,21,0,0,21,31,0,0,31,72,0,0,72,102,0,0,102,111,0,0,111
103979,165,"ŞCOALA NR.2 JILAVELE",JILAVELE,IL,1263,16,0,0,16,30,8,0,38,46,8,0,54,69,11,0,80,81,11,0,92
103988,166,"ŞCOALA DIN SATUL SLĂTIOARELE",SLĂTIOARELE,IL,312,5,3,0,8,7,4,0,11,19,8,0,27,27,9,0,36,30,9,0,39
101261,167,"ŞCOALA CU CLASELE I-VIII, ""BARBU CATARGIU"", MAIA",MAIA,IL,1379,12,0,0,12,22,5,0,27,27,7,0,34,39,18,0,57,43,18,0,61
100745,168,"ŞCOALA NOUĂ",MANASIA,IL,1329,11,0,0,11,27,3,0,30,36,8,0,44,45,8,0,53,51,9,0,60
100745,169,"ŞCOALA NOUĂ",MANASIA,IL,1295,15,2,0,17,19,5,0,24,23,5,0,28,33,5,0,38,37,7,0,44
100745,170,"ŞCOALA NOUĂ",MANASIA,IL,1181,12,0,0,12,22,1,0,23,28,3,0,31,36,3,0,39,45,3,0,48
93263,171,"LOCALUL ŞCOLII GIMNAZIALE DIN COMUNA MĂRCULEŞTI",MĂRCULEŞTI,IL,1342,7,3,0,10,18,3,0,21,20,4,0,24,32,4,0,36,34,4,0,38
94009,172,"CĂMIN CULTURAL MIHAIL KOGĂLNICEANU","MIHAIL KOGĂLNICEANU",IL,1384,1,0,0,1,4,4,0,8,12,4,0,16,17,4,0,21,25,4,0,29
94009,173,"LICEUL TEHNOLOGIC MIHAIL KOGĂLNICEANU","MIHAIL KOGĂLNICEANU",IL,1279,8,0,0,8,12,4,0,16,14,7,0,21,18,9,0,27,19,9,0,28
94054,174,"ŞCOALA GIMNAZIALA MILOŞEŞTI",MILOŞEŞTI,IL,1472,16,1,0,17,36,3,0,39,61,6,0,67,77,7,0,84,82,8,0,90
94063,175,"ŞCOALA GENERALĂ NICOLEŞTI",NICOLEŞTI,IL,336,3,0,0,3,7,0,0,7,10,1,0,11,14,2,0,16,15,2,0,17
94072,176,"ŞCOALA GENERALA TOVĂRĂŞIA",TOVĂRĂŞIA,IL,299,4,3,0,7,7,7,0,14,13,9,0,22,16,9,0,25,16,9,0,25
102730,177,"ŞCOALA CU CLASELE I-VIII MOLDOVENI",MOLDOVENI,IL,905,10,0,0,10,22,1,0,23,30,11,0,41,48,18,0,66,54,18,0,72
94090,178,"ŞCOALA CU CLASELE I-VIII, MOVILA",MOVILA,IL,1593,24,1,0,25,55,5,0,60,75,12,0,87,98,17,0,115,114,17,45,176
104289,179,"SCOALA GIMNAZIALA MOVILITA",MOVILIŢA,IL,1151,5,1,0,6,9,4,0,13,21,4,0,25,30,6,0,36,31,9,0,40
104289,180,"SCOALA GIMNAZIALA MOVILITA",MOVILIŢA,IL,821,4,0,0,4,7,7,0,14,17,9,0,26,27,11,0,38,28,11,0,39
94116,181,"ŞCOALA GENERALĂ NR. 1",MUNTENI-BUZĂU,IL,1536,12,6,0,18,22,6,0,28,26,10,0,36,42,13,0,55,45,13,0,58
94116,182,"ŞCOALA GENERALĂ NR. 2",MUNTENI-BUZĂU,IL,1282,3,0,0,3,4,0,0,4,14,0,0,14,30,5,0,35,32,10,0,42
93058,183,"IMOBILUL ŞCOLII CU CLASELE I-VIII ,, IONEL PERLEA “",OGRADA,IL,1254,10,0,0,10,17,1,0,18,26,1,0,27,42,2,0,44,48,2,0,50
93058,184,"IMOBILUL SCOLII CU CLASELE I-VIII ,, IONEL PERLEA “",OGRADA,IL,1111,11,1,0,12,23,3,0,26,37,4,0,41,59,8,26,93,67,10,26,103
94170,185,"SCOALA GIMNAZIALA PERIETI",PERIEŢI,IL,1066,8,0,0,8,11,6,0,17,22,7,0,29,32,8,0,40,32,8,0,40
94205,186,"SCOALA PRIMARA PALTINISU",PĂLTINIŞU,IL,910,3,1,0,4,11,3,0,14,17,3,0,20,20,3,0,23,23,4,0,27
94189,187,"GRADINITA CU PROGRAM NORMAL FUNDATA",FUNDATA,IL,381,1,0,0,1,10,2,0,12,12,4,0,16,21,6,0,27,22,6,0,28
94198,188,"SCOALA PRIMARA MISLEANU",MISLEANU,IL,676,7,0,0,7,9,0,0,9,13,1,0,14,16,4,0,20,16,4,0,20
94410,189,"GRĂDINIŢA CU PROGRAM NORMAL PLATONEŞTI",PLATONEŞTI,IL,753,11,0,0,11,31,4,0,35,45,5,0,50,53,11,0,64,53,11,0,64
94401,190,"GRĂDINIŢA CU PROGRAM NORMAL",LĂCUSTENI,IL,810,5,1,0,6,15,2,0,17,17,3,0,20,70,8,0,78,96,11,0,107
101252,191,"SCOALA GIMNAZIALA RADULESTI",BRAZII,IL,734,10,3,0,13,13,4,0,17,18,5,0,23,25,6,0,31,29,6,0,35
101289,192,"ŞCOALA GENERALĂ CU CLASELE I-IV RĂSIMNICEA",RĂSIMNICEA,IL,217,3,3,0,6,6,6,0,12,13,6,0,19,21,9,0,30,21,9,0,30
94278,193,"ŞCOALA REVIGA",REVIGA,IL,1121,5,6,0,11,15,7,0,22,22,8,0,30,36,8,0,44,47,9,0,56
94303,194,"ŞCOALA ROVINE",ROVINE,IL,737,4,1,0,5,8,1,0,9,11,3,0,14,14,5,0,19,15,5,0,20
94287,195,"ŞCOALA CRUNŢI",CRUNŢI,IL,381,3,0,0,3,5,1,0,6,13,1,0,14,21,3,0,24,22,3,0,25
104314,196,"SCOALA CU CLASELE I-VIIIROŞIORI",ROŞIORI,IL,922,13,2,0,15,25,2,0,27,33,3,0,36,59,9,3,71,63,9,3,75
104314,197,"ŞCOALA CU CLASELE I-VIIIROŞIORI",ROŞIORI,IL,638,9,2,0,11,12,2,0,14,17,4,0,21,30,5,2,37,36,6,2,44
94349,198,"ŞCOALA GIMNAZIALĂ",SĂLCIOARA,IL,911,8,1,0,9,12,2,0,14,15,2,0,17,21,4,0,25,23,5,0,28
94367,199,ŞCOALAPRIMARĂ,RAŞI,IL,877,8,5,0,13,27,15,0,42,45,21,0,66,68,30,0,98,73,31,0,104
92952,200,"SCOALA PRIMARA SARATENI",SĂRĂŢENI,IL,973,10,1,0,11,16,3,0,19,21,7,0,28,38,11,0,49,39,11,0,50
94385,201,"ŞCOALA ŞĂVENI",SĂVENI,IL,1261,7,6,0,13,17,9,0,26,32,10,0,42,44,10,0,54,51,11,0,62
94385,202,"GRADINIŢA SĂVENI",SĂVENI,IL,1253,9,4,0,13,24,5,0,29,39,5,0,44,56,6,0,62,61,6,0,67
94394,203,"ŞCOALA FRĂŢILEŞTI",FRĂŢILEŞTI,IL,340,9,4,0,13,21,5,0,26,30,6,0,36,35,7,0,42,37,7,0,44
94438,204,"GRADINIŢA SCÂNTEIA",SCÂNTEIA,IL,1169,16,2,0,18,41,2,0,43,48,6,0,54,64,7,0,71,68,9,0,77
94438,205,"ŞCOALA GENERALĂ SCÂNTEIA",SCÂNTEIA,IL,1081,19,7,0,26,39,8,0,47,48,9,0,57,59,12,0,71,62,14,0,76
94447,206,"SCOALA CU CLASELEI-IV IAZU",IAZU,IL,857,9,2,0,11,25,4,21,50,37,4,21,62,48,5,21,74,50,5,21,76
94465,207,"SCOALA PRIMARASFÂNTU GHEORGHE","SFÂNTU GHEORGHE",IL,667,4,1,0,5,11,4,0,15,20,7,0,27,25,7,0,32,25,7,0,32
94483,208,"CĂMINUL CULTURAL MALU,SALONUL DE NUNŢI SITUATĂ ÎN MALU",MALU,IL,879,2,2,0,4,15,5,0,20,18,7,0,25,32,8,0,40,35,9,0,44
105035,209,"CĂMINUL CULTURAL SITUATĂ ÎN SATUL SINEŞTI, SINEŞTI",SINEŞTI,IL,1211,7,2,0,9,14,12,0,26,26,21,0,47,29,26,0,55,30,27,0,57
105071,210,"ŞCOALA CU CL.I-IVSITUATĂ ÎN SATUL LILIECI, SINEŞTI",LILIECI,IL,864,12,0,0,12,33,0,0,33,59,0,0,59,59,21,0,80,59,22,0,81
94508,211,"PRIMĂRIA STELNICA",STELNICA,IL,1526,28,3,0,31,59,7,0,66,80,9,0,89,109,11,0,120,116,12,0,128
94544,212,"SCOALA GIMNAZIALĂ “APOSTOL D CULEA”",SUDIŢI,IL,844,11,0,0,11,25,0,0,25,38,0,0,38,53,0,0,53,60,0,0,60
94544,213,"SCOALA GIMNAZIALĂ “APOSTOL D CULEA”",SUDIŢI,IL,867,7,4,0,11,18,4,0,22,35,5,0,40,46,5,0,51,54,5,0,59
93762,214,"GRĂDINIŢA CU PROGRAM NORMAL TRAIAN",TRAIAN,IL,1249,12,1,0,13,20,2,0,22,31,2,0,33,69,3,0,72,90,3,0,93
93762,215,"ŞCOLA PROFESIONALĂ TRAIAN",TRAIAN,IL,1269,8,2,0,10,20,2,0,22,28,2,0,30,66,3,0,69,73,3,0,76
94697,216,PRIMARIAVALEACIORII,"VALEA CIORII",IL,1466,13,0,0,13,26,1,0,27,40,1,0,41,47,2,31,80,53,3,31,87
105801,217,"CĂMIN CULTURAL","VALEA MĂCRIŞULUI",IL,984,11,3,0,14,32,6,0,38,35,6,0,41,70,11,0,81,76,15,0,91
105810,218,"CĂMIN CULTURAL",GRINDAŞI,IL,396,1,0,0,1,4,0,0,4,9,2,0,11,13,3,0,16,18,3,0,21
94802,219,"CĂMINUL CULTURAL",VLĂDENI,IL,886,7,0,0,7,35,0,0,35,44,0,0,44,54,0,0,54,54,0,0,54
94802,220,"CĂMINUL CULTURAL",VLĂDENI,IL,791,4,3,0,7,17,4,0,21,28,5,0,33,32,6,0,38,36,7,0,43
95079,1,"GRĂDINIŢA CU PROGRAM NORMAL NR. 15",IAŞI,IS,1562,4,4,0,8,31,8,0,39,48,8,0,56,61,11,0,72,66,12,0,78
95079,2,"GRĂDINIŢA CU PROGRAM NORMAL NR. 15",IAŞI,IS,1346,4,0,0,4,33,4,0,37,47,11,0,58,58,14,0,72,69,17,0,86
95079,3,"ŞCOALA GIMNAZIALĂ ""ELENA CUZA""",IAŞI,IS,1423,11,1,0,12,48,6,0,54,71,6,0,77,90,8,0,98,102,8,0,110
95079,4,"ŞCOALA GIMNAZIALĂ ""ELENA CUZA""",IAŞI,IS,1167,6,0,0,6,22,2,0,24,44,2,0,46,57,7,0,64,60,8,0,68
95079,5,"ŞCOALA GIMNAZIALĂ ""ELENA CUZA""",IAŞI,IS,1574,15,0,0,15,51,10,0,61,76,20,0,96,102,30,0,132,114,35,0,149
95079,6,"ŞCOALA GIMNAZIALĂ ""ELENA CUZA""",IAŞI,IS,1465,16,0,0,16,51,5,0,56,71,6,0,77,80,7,0,87,84,8,0,92
95079,7,"ŞCOALA GIMNAZIALĂ ""ELENA CUZA""",IAŞI,IS,1330,17,2,0,19,45,2,0,47,83,5,0,88,83,10,0,93,87,10,0,97
95079,8,"ŞCOALA GIMNAZIALĂ ""ELENA CUZA""",IAŞI,IS,1455,15,4,0,19,52,4,0,56,82,5,0,87,100,5,0,105,115,6,0,121
95079,9,"ŞCOALA GIMNAZIALĂ ""ELENA CUZA""",IAŞI,IS,1627,11,4,0,15,46,4,0,50,75,4,0,79,93,5,0,98,100,5,0,105
95079,10,"ŞCOALA GIMNAZIALĂ ""ELENA CUZA""",IAŞI,IS,1671,8,2,0,10,47,3,0,50,74,3,0,77,86,5,0,91,97,5,0,102
95079,11,"ŞCOALAGIMNAZIALĂ ""ION CREANGĂ""",IAŞI,IS,1620,13,1,0,14,42,1,0,43,54,1,0,55,74,2,0,76,79,2,0,81
95079,12,"ŞCOALAGIMNAZIALĂ ""ION CREANGĂ""",IAŞI,IS,1132,14,2,0,16,30,3,0,33,61,4,0,65,80,8,0,88,92,8,0,100
95079,13,"ŞCOALAGIMNAZIALĂ ""ION CREANGĂ""",IAŞI,IS,1168,12,6,0,18,31,13,0,44,43,16,0,59,64,23,0,87,72,28,0,100
95079,14,"ŞCOALAGIMNAZIALĂ ""ION CREANGĂ""",IAŞI,IS,1049,12,0,0,12,26,3,0,29,41,4,0,45,53,6,0,59,53,8,0,61
95079,15,"ŞCOALA GIMNAZIALĂ ""PETRU PONI""",IAŞI,IS,1502,16,4,0,20,47,7,0,54,68,10,0,78,82,15,0,97,91,19,0,110
95079,16,"ŞCOALA GIMNAZIALĂ ""PETRU PONI""",IAŞI,IS,1018,8,0,0,8,19,1,0,20,28,1,0,29,48,3,0,51,52,8,0,60
95079,17,"ŞCOALA GIMNAZIALĂ ""PETRU PONI""",IAŞI,IS,1401,23,2,0,25,46,4,0,50,73,4,0,77,95,5,0,100,102,8,0,110
95079,18,"ŞCOALA GIMNAZIALĂ ""PETRU PONI""",IAŞI,IS,1078,4,4,0,8,29,5,0,34,46,5,0,51,60,5,0,65,71,8,0,79
95079,19,"ŞCOALAGIMNAZIALĂ ""ŞTEFAN BÂRSĂNESCU""",IAŞI,IS,1225,11,7,0,18,45,14,0,59,68,25,0,93,93,30,0,123,108,32,0,140
95079,20,"ŞCOALAGIMNAZIALĂ ""ŞTEFAN BÂRSĂNESCU""",IAŞI,IS,1156,3,4,0,7,25,5,0,30,40,7,0,47,54,8,0,62,62,8,0,70
95079,21,"ŞCOALAGIMNAZIALĂ ""ŞTEFAN BÂRSĂNESCU""",IAŞI,IS,835,5,5,0,10,33,7,0,40,46,8,0,54,64,8,0,72,66,8,0,74
95079,22,"ŞCOALAGIMNAZIALĂ ""ŞTEFAN BÂRSĂNESCU""",IAŞI,IS,983,17,1,0,18,41,1,0,42,65,2,0,67,79,2,0,81,83,2,0,85
95079,23,"ŞCOALAGIMNAZIALĂ ""ŞTEFAN BÂRSĂNESCU""",IAŞI,IS,1287,1,4,0,5,6,8,0,14,12,15,0,27,22,16,0,38,22,19,0,41
95079,24,"BIBLIOTECA DE FILOSOFIE",IAŞI,IS,1325,4,4,0,8,42,24,0,66,62,46,0,108,70,66,0,136,81,76,0,157
95079,25,"COLEGIUL NAŢIONAL",IAŞI,IS,1007,9,3,0,12,41,3,0,44,66,6,0,72,80,7,0,87,87,7,0,94
95079,26,"COLEGIUL NAŢIONAL",IAŞI,IS,899,19,5,0,24,69,39,0,108,83,74,0,157,100,96,0,196,104,117,0,221
95079,27,"COLEGIUL NAŢIONAL",IAŞI,IS,1730,14,6,0,20,38,9,0,47,62,12,0,74,74,16,0,90,76,18,0,94
95079,28,"COLEGIUL NAŢIONAL",IAŞI,IS,1103,12,5,0,17,41,14,0,55,61,20,0,81,91,30,0,121,98,35,0,133
95079,29,"GRĂDINIŢA CU PROGRAM PRELUNGIT NR.4",IAŞI,IS,1542,10,17,0,27,35,19,0,54,49,20,0,69,74,20,0,94,90,21,0,111
95079,30,"ŞCOALAPRIMARĂ""GHEORGHE ASACHI""",IAŞI,IS,1077,7,88,0,95,25,254,0,279,32,440,0,472,45,556,0,601,52,622,0,674
95079,31,"COLEGIUL NATIONAL ""COSTACHE NEGRUZZI’’",IAŞI,IS,972,11,18,0,29,22,23,30,75,44,41,30,115,54,50,31,135,65,57,31,153
95079,32,"COLEGIUL NATIONAL ""COSTACHE NEGRUZZI’’",IAŞI,IS,901,15,35,0,50,49,54,0,103,87,61,0,148,87,100,0,187,88,102,0,190
95079,33,"COLEGIUL NATIONAL ""GARABET IBRĂILEANU""",IAŞI,IS,852,24,5,0,29,51,12,0,63,66,26,0,92,90,35,0,125,97,36,0,133
95079,34,"COLEGIUL NATIONAL ""GARABET IBRĂILEANU""",IAŞI,IS,973,7,0,0,7,40,0,0,40,55,7,0,62,70,13,28,111,78,15,28,121
95079,35,"COLEGIUL NATIONAL ""GARABET IBRĂILEANU""",IAŞI,IS,903,45,4,0,49,77,18,0,95,99,29,45,173,127,38,45,210,138,43,45,226
95079,36,"COLEGIUL NATIONAL ""GARABET IBRĂILEANU""",IAŞI,IS,2187,5,0,0,5,14,2,0,16,22,4,0,26,38,9,62,109,48,9,62,119
95079,37,"UNIVERSITATEA DE STIINTE AGRICOLE SI MEDICINA VETERINARĂ ""ION IONESCU DE LA BRAD""",IAŞI,IS,1797,27,14,0,41,83,29,0,112,126,48,0,174,143,59,0,202,158,62,0,220
95079,38,"LICEUL TEORETIC DE INFORMATICĂ ""GRIGORE MOISIL""",IAŞI,IS,1639,12,5,0,17,22,16,0,38,47,32,0,79,61,54,0,115,74,56,0,130
95079,39,"COLEGIUL NAŢIONAL ""MIHAI EMINESCU""",IAŞI,IS,1014,16,0,0,16,30,0,24,54,56,7,24,87,69,7,24,100,73,8,24,105
95079,40,"COLEGIUL NAŢIONAL ""MIHAI EMINESCU""",IAŞI,IS,946,14,0,0,14,27,0,0,27,40,0,35,75,56,0,35,91,63,1,35,99
95079,41,"ŞCOALA GIMNAZIALĂ""MIHAI CODREANU""",IAŞI,IS,462,2,0,0,2,9,0,0,9,17,1,80,98,21,3,138,162,22,5,138,165
95079,42,"ŞCOALA GIMNAZIALĂ""MIHAI CODREANU""",IAŞI,IS,530,9,4,0,13,27,4,0,31,34,4,0,38,41,4,0,45,43,7,0,50
95079,43,"LICEUL TEHNOLOGIC UCECOM ""SPIRU HARET""",IAŞI,IS,1320,8,0,0,8,24,2,0,26,35,3,0,38,44,5,0,49,48,5,0,53
95079,44,"LICEUL TEHNOLOGIC UCECOM ""SPIRU HARET""",IAŞI,IS,1009,7,1,0,8,19,1,0,20,26,1,0,27,35,4,2,41,38,5,2,45
95079,45,"LICEUL TEHNOLOGIC UCECOM ""SPIRU HARET""",IAŞI,IS,1161,8,4,0,12,16,5,0,21,28,9,0,37,41,12,0,53,41,13,0,54
95079,46,"COLEGIUL ECONOMIC ADMINISTRATIV",IAŞI,IS,934,9,0,0,9,28,6,0,34,40,24,0,64,47,24,0,71,48,24,0,72
95079,47,"COLEGIUL ECONOMIC ADMINISTRATIV",IAŞI,IS,930,14,0,0,14,27,0,0,27,41,0,0,41,52,0,0,52,64,0,0,64
95079,48,"LICEUL TEORETIC ‘’VASILE ALECSANDRI’’",IAŞI,IS,1138,19,3,0,22,56,14,0,70,70,26,0,96,95,43,0,138,103,46,0,149
95079,49,"LICEUL TEORETIC ‘’VASILE ALECSANDRI’’",IAŞI,IS,582,8,1,0,9,27,2,0,29,40,22,0,62,51,34,0,85,53,47,0,100
95079,50,"LICEUL TEORETIC ‘’VASILE ALECSANDRI’’",IAŞI,IS,1272,27,4,0,31,65,8,0,73,98,18,0,116,126,28,0,154,136,28,0,164
95079,51,"LICEUL TEHNOLOGIC SPECIAL ""VASILE PAVELCU""",IAŞI,IS,769,8,6,0,14,32,9,0,41,45,11,0,56,64,17,0,81,64,20,0,84
95079,52,"LICEUL TEHNOLOGIC SPECIAL ""VASILE PAVELCU""",IAŞI,IS,667,7,3,0,10,19,4,0,23,30,4,0,34,36,5,0,41,38,6,0,44
95079,53,"COLEGIUL NATIONAL DE ARTĂ ""OCTACV BĂNCILĂ""",IAŞI,IS,719,18,6,0,24,32,7,0,39,43,10,0,53,61,14,0,75,63,15,0,78
95079,54,"COLEGIUL NATIONAL DE ARTĂ ""OCTAV BĂNCILĂ""",IAŞI,IS,766,11,5,0,16,28,24,0,52,38,30,0,68,63,36,0,99,65,38,0,103
95079,55,"ŞCOALAGIMNAZIALĂ""ION SIMIONESCU""",IAŞI,IS,946,13,2,0,15,22,7,0,29,45,17,0,62,64,28,0,92,70,28,0,98
95079,56,"ŞCOALAGIMNAZIALĂ""ION SIMIONESCU""",IAŞI,IS,995,7,0,0,7,24,7,0,31,28,10,0,38,45,11,0,56,47,11,0,58
95079,57,"ŞCOALAGIMNAZIALĂ""ION SIMIONESCU""",IAŞI,IS,1222,12,3,0,15,43,7,0,50,59,10,0,69,79,11,0,90,87,13,0,100
95079,58,"ŞCOALAGIMNAZIALĂ""ION SIMIONESCU""",IAŞI,IS,1073,9,0,0,9,30,0,0,30,42,2,0,44,58,2,0,60,68,2,0,70
95079,59,"ŞCOALAGIMNAZIALĂ""ION SIMIONESCU""",IAŞI,IS,982,8,2,0,10,20,5,0,25,40,7,0,47,56,7,0,63,60,7,0,67
95079,60,"ŞCOALAGIMNAZIALĂ""ION SIMIONESCU""",IAŞI,IS,1403,21,0,0,21,38,0,0,38,48,1,0,49,67,3,0,70,78,3,0,81
95079,61,"ŞCOALAGIMNAZIALĂ""ION SIMIONESCU""",IAŞI,IS,1226,13,1,0,14,34,1,0,35,42,2,0,44,67,3,0,70,71,3,0,74
95079,62,"ŞCOALAGIMNAZIALĂ""ION SIMIONESCU""",IAŞI,IS,1992,10,1,0,11,30,3,0,33,46,3,0,49,59,3,0,62,66,3,0,69
95079,63,"ŞCOALAGIMNAZIALĂ""ION SIMIONESCU""",IAŞI,IS,2115,3,6,0,9,25,7,0,32,49,7,0,56,68,8,0,76,81,8,0,89
95079,64,"GRĂDINIŢA CU PROGRAM PRELUNGIT NR. 25",IAŞI,IS,1475,18,6,0,24,51,6,0,57,70,7,0,77,104,8,0,112,106,10,0,116
95079,65,"GRĂDINIŢA CU PROGRAM PRELUNGIT NR. 25",IAŞI,IS,1250,9,6,0,15,34,10,0,44,50,15,0,65,64,15,0,79,65,15,0,80
95079,66,"GRĂDINIŢA CU PROGRAM NORMALNR.21",IAŞI,IS,884,4,4,0,8,18,12,0,30,31,16,0,47,50,18,0,68,57,18,0,75
95079,67,"GRĂDINIŢA CU PROGRAM NORMALNR.21",IAŞI,IS,790,8,0,0,8,24,1,0,25,37,4,0,41,48,4,0,52,48,4,0,52
95079,68,"GRĂDINIŢA CU PROGRAM NORMALNR.21",IAŞI,IS,887,9,0,0,9,26,0,0,26,46,5,0,51,52,11,0,63,55,11,0,66
95079,69,"GRĂDINIŢA CU PROGRAM NORMALNR.21",IAŞI,IS,875,6,0,0,6,23,3,0,26,44,5,0,49,52,7,0,59,54,7,0,61
95079,70,"GRĂDINIŢA CU PROGRAM PRELUNGITNR.21",IAŞI,IS,998,6,5,0,11,23,7,0,30,33,9,0,42,52,13,0,65,59,14,0,73
95079,71,"GRĂDINIŢA CU PROGRAM PRELUNGITNR.21",IAŞI,IS,908,7,0,0,7,21,1,0,22,30,2,0,32,45,4,0,49,54,5,0,59
95079,72,"GRĂDINIŢA CU PROGRAM NORMAL NR. 7",IAŞI,IS,654,5,4,0,9,11,5,0,16,22,5,0,27,37,5,0,42,37,5,0,42
95079,73,"GRĂDINIŢA CU PROGRAM NORMAL NR. 7",IAŞI,IS,735,3,7,0,10,15,8,0,23,23,10,0,33,29,12,0,41,31,12,0,43
95079,74,"LICEUL TEHNOLOGICECONOMIC ""VIRGIL MADGEARU"" - CORP B",IAŞI,IS,1166,14,0,0,14,33,1,0,34,57,2,0,59,77,4,0,81,82,4,0,86
95079,75,"LICEUL TEHNOLOGICECONOMIC ""VIRGIL MADGEARU"" - CORP B",IAŞI,IS,1188,6,0,0,6,19,3,0,22,32,3,0,35,39,5,0,44,42,5,0,47
95079,76,"LICEUL TEHNOLOGICECONOMIC ""VIRGIL MADGEARU"" - CORP B",IAŞI,IS,1379,12,5,0,17,48,9,0,57,56,11,0,67,77,14,0,91,82,14,0,96
95079,77,"LICEUL TEHNOLOGICECONOMIC ""VIRGIL MADGEARU"" - CORP B",IAŞI,IS,1210,3,0,0,3,14,4,0,18,29,4,0,33,37,4,0,41,41,4,0,45
95079,78,"LICEUL TEHNOLOGICECONOMIC ""VIRGIL MADGEARU"" - CORP B",IAŞI,IS,1250,9,0,0,9,49,0,0,49,64,0,0,64,89,0,0,89,96,0,0,96
95079,79,"ŞCOALAGIMNAZIALĂ ""ALEXANDRU CEL BUN""",IAŞI,IS,1146,4,2,0,6,30,4,0,34,46,8,0,54,64,15,0,79,64,16,0,80
95079,80,"ŞCOALAGIMNAZIALĂ ""ALEXANDRU CEL BUN""",IAŞI,IS,1296,20,3,0,23,59,5,0,64,89,6,0,95,120,7,0,127,127,8,0,135
95079,81,"ŞCOALAGIMNAZIALĂ ""ALEXANDRU CEL BUN""",IAŞI,IS,1369,23,0,0,23,58,0,0,58,86,1,0,87,117,1,0,118,121,1,0,122
95079,82,"ŞCOALAGIMNAZIALĂ ""ALEXANDRU CEL BUN""",IAŞI,IS,1364,8,0,0,8,25,7,0,32,40,11,0,51,44,11,0,55,44,11,0,55
95079,83,"ŞCOALAGIMNAZIALĂ ""ALEXANDRU CEL BUN""",IAŞI,IS,1095,9,0,0,9,25,0,0,25,44,3,0,47,49,4,0,53,53,4,0,57
95079,84,"LICEUL TEHNOLOGIC ECONOMIC DE TURISM - CORP A",IAŞI,IS,1004,16,6,0,22,54,6,0,60,74,6,0,80,91,7,0,98,94,10,0,104
95079,85,"LICEUL TEHNOLOGIC ECONOMIC DE TURISM - CORP A",IAŞI,IS,1356,9,6,0,15,33,9,0,42,51,12,0,63,74,15,0,89,77,15,0,92
95079,86,"LICEUL TEHNOLOGIC ECONOMIC DE TURISM - CORP A",IAŞI,IS,1116,14,0,0,14,29,0,0,29,45,0,0,45,56,2,0,58,66,2,0,68
95079,87,"LICEUL TEHNOLOGIC ECONOMIC DE TURISM - CORP A",IAŞI,IS,1067,7,0,0,7,35,0,0,35,55,1,0,56,65,4,0,69,70,4,0,74
95079,88,"ŞCOALAGIMNAZIALĂ ""GEORGE COŞBUC""",IAŞI,IS,1107,10,0,0,10,22,2,0,24,33,3,0,36,52,7,0,59,57,9,0,66
95079,89,"ŞCOALAGIMNAZIALĂ ""GEORGE COŞBUC""",IAŞI,IS,1132,9,1,0,10,22,2,0,24,38,4,0,42,48,6,0,54,51,6,0,57
95079,90,"ŞCOALAGIMNAZIALĂ ""GEORGE COŞBUC""",IAŞI,IS,1117,10,0,0,10,29,2,0,31,49,2,0,51,56,2,0,58,58,7,0,65
95079,91,"ŞCOALAGIMNAZIALĂ ""GEORGE COŞBUC""",IAŞI,IS,1116,10,0,0,10,31,0,0,31,42,0,0,42,50,0,0,50,51,0,0,51
95079,92,"ŞCOALAGIMNAZIALĂ ""GEORGE COŞBUC""",IAŞI,IS,1139,10,2,0,12,30,3,0,33,44,3,0,47,57,3,0,60,66,3,0,69
95079,93,"ŞCOALAGIMNAZIALĂ ""GEORGE COŞBUC""",IAŞI,IS,1199,10,0,0,10,37,0,0,37,43,0,0,43,53,0,0,53,59,0,0,59
95079,94,"ŞCOALAGIMNAZIALĂ ""GEORGE COŞBUC""",IAŞI,IS,1182,7,5,0,12,20,5,0,25,33,5,0,38,47,5,0,52,54,5,0,59
95079,95,"ŞCOALAGIMNAZIALĂ ""GEORGE COŞBUC""",IAŞI,IS,1001,6,2,0,8,20,3,0,23,29,3,0,32,40,4,0,44,50,5,0,55
95079,96,"ŞCOALAGIMNAZIALĂ ""GEORGE COŞBUC""",IAŞI,IS,1035,10,0,0,10,22,0,0,22,30,0,0,30,31,0,0,31,31,0,0,31
95079,97,"ŞCOALAGIMNAZIALĂ ""ALEXANDRU VLAHUŢĂ""",IAŞI,IS,1022,11,2,0,13,39,7,0,46,56,8,0,64,74,10,0,84,81,10,0,91
95079,98,"ŞCOALAGIMNAZIALĂ ""ALEXANDRU VLAHUŢĂ""",IAŞI,IS,809,5,4,0,9,14,4,0,18,19,4,0,23,25,4,0,29,28,4,0,32
95079,99,"ŞCOALAGIMNAZIALĂ ""ALEXANDRU VLAHUŢĂ""",IAŞI,IS,886,11,1,0,12,33,2,0,35,60,3,0,63,60,5,0,65,69,5,0,74
95079,100,"ŞCOALAGIMNAZIALĂ ""ALEXANDRU VLAHUŢĂ""",IAŞI,IS,1050,8,1,0,9,25,1,0,26,39,1,0,40,51,1,0,52,51,1,0,52
95079,101,"ŞCOALAGIMNAZIALĂ ""ALEXANDRU VLAHUŢĂ""",IAŞI,IS,754,1,3,0,4,10,3,0,13,19,3,0,22,27,3,0,30,30,3,0,33
95079,102,"ŞCOALAGIMNAZIALĂ ""GEORGE CĂLINESCU""",IAŞI,IS,1108,6,0,0,6,18,0,0,18,34,0,0,34,51,0,0,51,59,0,0,59
95079,103,"ŞCOALAGIMNAZIALĂ ""GEORGE CĂLINESCU""",IAŞI,IS,1398,15,2,0,17,53,6,0,59,72,8,0,80,87,12,0,99,95,13,0,108
95079,104,"ŞCOALAGIMNAZIALĂ ""GEORGE CĂLINESCU""",IAŞI,IS,1477,15,5,0,20,44,14,0,58,70,16,0,86,84,23,0,107,87,27,0,114
95079,105,"ŞCOALAGIMNAZIALĂ ""GEORGE CĂLINESCU""",IAŞI,IS,1225,12,0,0,12,32,0,0,32,47,0,0,47,63,0,0,63,64,0,0,64
95079,106,"ŞCOALAGIMNAZIALĂ ""GEORGE CĂLINESCU""",IAŞI,IS,1355,8,1,0,9,28,1,0,29,38,1,0,39,54,1,0,55,65,1,0,66
95079,107,"ŞCOALAGIMNAZIALĂ ""GEORGE CĂLINESCU""",IAŞI,IS,1194,11,5,0,16,23,5,0,28,42,5,0,47,51,6,0,57,54,6,0,60
95079,108,"LICEUL TEHNOLOGIC ECONOMIC DE TURISM - CORP B",IAŞI,IS,1394,15,0,0,15,33,0,0,33,49,4,0,53,62,12,0,74,64,12,0,76
95079,109,"LICEUL TEHNOLOGIC ECONOMIC DE TURISM - CORP B",IAŞI,IS,1321,18,0,0,18,52,1,0,53,65,2,0,67,82,3,0,85,84,3,0,87
95079,110,"LICEUL TEHNOLOGIC ECONOMIC DE TURISM - CORP B",IAŞI,IS,1359,16,5,0,21,41,6,0,47,65,7,0,72,97,7,0,104,105,7,0,112
95079,111,"LICEUL TEHNOLOGIC ECONOMIC DE TURISM - CORP B",IAŞI,IS,1196,13,0,0,13,32,0,0,32,52,0,0,52,73,0,0,73,76,0,0,76
95079,112,"LICEUL TEHNOLOGIC ECONOMIC DE TURISM - CORP B",IAŞI,IS,1371,11,6,0,17,32,8,0,40,56,8,0,64,67,8,0,75,74,9,0,83
95079,113,"LICEUL TEHNOLOGIC ECONOMIC DE TURISM - CORP B",IAŞI,IS,1508,10,5,0,15,24,5,2,31,29,5,3,37,34,8,3,45,38,8,3,49
95079,114,"LICEUL TEHNOLOGIC ECONOMIC DE TURISM - CORP B",IAŞI,IS,1306,5,0,0,5,25,0,0,25,31,1,0,32,45,2,0,47,45,2,0,47
95079,115,"ŞCOALAGIMNAZIALĂ ""CARMEN SYLVA""",IAŞI,IS,1340,13,2,0,15,43,7,0,50,71,17,0,88,95,20,0,115,99,22,0,121
95079,116,"ŞCOALAGIMNAZIALĂ ""CARMEN SYLVA""",IAŞI,IS,1033,7,0,0,7,37,1,0,38,56,1,0,57,74,9,0,83,79,10,0,89
95079,117,"ŞCOALA GIMNAZIALĂ ""CALISTRAT HOGAŞ""",IAŞI,IS,1603,16,5,0,21,44,6,0,50,65,8,0,73,89,11,0,100,107,11,0,118
95079,118,"ŞCOALA GIMNAZIALĂ ""CALISTRAT HOGAŞ""",IAŞI,IS,2181,9,6,0,15,31,6,0,37,42,7,0,49,53,8,0,61,58,9,0,67
95079,119,"ŞCOALA GIMNAZIALĂ ""CALISTRAT HOGAŞ""",IAŞI,IS,1850,7,3,0,10,34,4,0,38,48,4,0,52,63,6,0,69,68,7,0,75
95079,120,"ŞCOALA PRIMARĂ ""COSTACHE NEGRI""",IAŞI,IS,1477,8,0,0,8,33,1,0,34,40,1,0,41,81,2,23,106,85,2,23,110
95079,121,"ŞCOALA PRIMARĂ ""COSTACHE NEGRI""",IAŞI,IS,1312,10,5,0,15,29,5,0,34,48,5,0,53,57,6,0,63,62,7,0,69
95079,122,"ŞCOALAGIMNAZIALĂ ""BOGDAN PETRICEICU HAŞDEU""",IAŞI,IS,1404,12,2,0,14,40,2,0,42,58,5,0,63,73,5,0,78,80,5,65,150
95079,123,"ŞCOALAGIMNAZIALĂ ""BOGDAN PETRICEICU HAŞDEU""",IAŞI,IS,1013,2,1,0,3,15,7,0,22,15,8,0,23,15,20,0,35,15,22,0,37
95079,124,"ŞCOALAGIMNAZIALĂ ""BOGDAN PETRICEICU HAŞDEU""",IAŞI,IS,1502,16,8,0,24,56,17,0,73,64,21,23,108,77,28,23,128,78,29,23,130
95079,125,"ŞCOALAGIMNAZIALĂ ""BOGDAN PETRICEICU HAŞDEU""",IAŞI,IS,1326,11,2,0,13,28,3,0,31,46,5,0,51,55,5,0,60,56,5,0,61
95079,126,"LICEUL TEORETIC ""ALEXANDRU IOAN CUZA""",IAŞI,IS,2233,14,0,0,14,44,0,0,44,59,3,0,62,79,9,0,88,90,16,0,106
95079,127,"LICEUL TEORETIC ""ALEXANDRU IOAN CUZA""",IAŞI,IS,2652,7,2,0,9,33,2,0,35,56,2,0,58,84,4,0,88,93,4,0,97
95079,128,"LICEUL TEORETIC ""ALEXANDRU IOAN CUZA""",IAŞI,IS,1992,16,5,0,21,36,6,0,42,51,8,0,59,64,9,0,73,67,12,0,79
95079,129,"LICEUL TEORETIC ""ALEXANDRU IOAN CUZA""",IAŞI,IS,2134,15,1,0,16,44,1,0,45,69,1,0,70,96,1,0,97,109,1,0,110
95079,130,"ŞCOALA PRIMARA ""COSTACHE CONACHI""",IAŞI,IS,1315,7,1,0,8,34,2,0,36,58,3,0,61,76,6,0,82,86,6,0,92
95079,131,"ŞCOALA PRIMARA ""COSTACHE CONACHI""",IAŞI,IS,1621,10,0,0,10,31,4,0,35,48,11,0,59,60,14,0,74,67,17,0,84
95079,132,"ŞCOALA PRIMARA ""COSTACHE CONACHI""",IAŞI,IS,1370,12,3,0,15,23,6,0,29,38,8,0,46,55,8,0,63,56,9,0,65
95079,133,"ŞCOALA PRIMARA ""COSTACHE CONACHI""",IAŞI,IS,1352,9,0,0,9,29,0,0,29,44,0,0,44,67,0,0,67,75,0,0,75
95079,134,"ŞCOALA PRIMARA ""COSTACHE CONACHI""",IAŞI,IS,1489,8,0,0,8,22,4,0,26,36,4,0,40,45,8,0,53,53,10,0,63
95079,135,"DIRECTIA JUDETEANA PENTRU SPORT SI TINERET - COMPLEX SPORTIV GRADINARI",IAŞI,IS,1088,7,2,0,9,23,8,0,31,35,18,0,53,46,22,0,68,47,25,0,72
95079,136,"DIRECTIA JUDETEANA PENTRU SPORT SI TINERET - COMPLEX SPORTIV GRADINARI",IAŞI,IS,1372,5,7,0,12,21,7,0,28,39,11,0,50,45,12,0,57,55,13,0,68
95079,137,"DIRECTIA JUDETEANA PENTRU SPORT SI TINERET - COMPLEX SPORTIV GRADINARI",IAŞI,IS,1675,3,0,0,3,16,0,0,16,25,0,0,25,38,0,0,38,45,0,0,45
95079,138,"DIRECTIA JUDETEANA PENTRU SPORT SI TINERET - COMPLEX SPORTIV GRADINARI",IAŞI,IS,1423,15,5,0,20,31,5,0,36,57,5,0,62,83,6,0,89,89,6,0,95
95079,139,"DIRECTIA JUDETEANA PENTRU SPORT SI TINERET - COMPLEX SPORTIV GRADINARI",IAŞI,IS,1467,13,2,0,15,29,2,0,31,44,2,0,46,62,2,0,64,69,2,0,71
95079,140,"DIRECTIA JUDETEANA PENTRU SPORT SI TINERET - COMPLEX SPORTIV GRADINARI",IAŞI,IS,1400,13,4,0,17,19,5,12,36,43,5,12,60,57,5,12,74,61,7,12,80
95079,141,"ŞCOALAGIMNAZIALĂ ""IONEL TEODOREANU""",IAŞI,IS,1597,15,1,0,16,42,3,0,45,67,4,0,71,84,4,0,88,88,4,0,92
95079,142,"ŞCOALAGIMNAZIALĂ ""IONEL TEODOREANU""",IAŞI,IS,1171,8,1,0,9,39,6,0,45,58,6,0,64,68,12,0,80,75,12,0,87
95079,143,"ŞCOALAGIMNAZIALĂ ""IONEL TEODOREANU""",IAŞI,IS,1344,9,0,0,9,33,4,0,37,51,7,0,58,72,8,0,80,82,9,0,91
95079,144,"ŞCOALAGIMNAZIALĂ ""IONEL TEODOREANU""",IAŞI,IS,1687,14,0,0,14,44,1,0,45,50,4,0,54,76,5,0,81,80,6,0,86
95079,145,"ŞCOALAGIMNAZIALĂ ""IONEL TEODOREANU""",IAŞI,IS,1968,10,1,0,11,30,2,0,32,51,2,0,53,70,2,0,72,71,3,0,74
95079,146,"ŞCOALAGIMNAZIALĂ ""GHEORGHE I. BRĂTIANU""",IAŞI,IS,1499,8,5,0,13,38,6,0,44,57,7,0,64,77,9,0,86,92,10,0,102
95079,147,"ŞCOALAGIMNAZIALĂ ""GHEORGHE I. BRĂTIANU""",IAŞI,IS,1314,10,1,0,11,51,1,0,52,62,6,0,68,79,6,0,85,95,6,0,101
95079,148,"ŞCOALAGIMNAZIALĂ ""GHEORGHE I. BRĂTIANU""",IAŞI,IS,2607,0,2,0,2,0,2,0,2,0,4,0,4,0,5,0,5,0,5,0,5
95079,149,"ŞCOALAGIMNAZIALĂ ""GHEORGHE I. BRĂTIANU""",IAŞI,IS,2726,0,1,0,1,0,1,0,1,1,2,0,3,2,2,0,4,2,2,0,4
95079,150,"ŞCOALAGIMNAZIALĂ ""GHEORGHE I. BRĂTIANU""",IAŞI,IS,1566,12,4,0,16,45,5,0,50,67,6,0,73,85,8,1,94,87,9,1,97
95079,151,"ŞCOALAGIMNAZIALĂ ""GHEORGHE I. BRĂTIANU""",IAŞI,IS,1719,6,3,0,9,30,4,0,34,37,5,0,42,42,5,0,47,57,6,0,63
95079,152,"ŞCOALAGIMNAZIALĂ ""GHEORGHE I. BRĂTIANU""",IAŞI,IS,1890,16,0,0,16,39,2,0,41,56,5,0,61,68,6,0,74,84,7,0,91
95079,153,"UNIVERSITATEA TEHNICĂ ""GHEORGHE ASACHI""",IAŞI,IS,1475,10,5,0,15,19,30,0,49,35,83,0,118,50,97,0,147,52,109,0,161
95079,154,"UNIVERSITATEA TEHNICĂ ""GHEORGHE ASACHI""",IAŞI,IS,776,5,5,0,10,25,6,0,31,41,7,0,48,49,9,0,58,52,9,0,61
95079,155,"UNIVERSITATEA TEHNICĂ ""GHEORGHE ASACHI""",IAŞI,IS,805,14,1,0,15,32,4,0,36,44,4,0,48,51,4,0,55,59,4,0,63
95079,156,"UNIVERSITATEA TEHNICĂ ""GHEORGHE ASACHI""",IAŞI,IS,1180,20,4,0,24,51,5,0,56,69,6,0,75,74,12,0,86,95,13,0,108
95079,157,"ŞCOALAGIMNAZIALĂ ""ION GHICA""",IAŞI,IS,1491,16,4,0,20,51,5,0,56,63,6,0,69,96,7,0,103,108,7,0,115
95079,158,"ŞCOALAGIMNAZIALĂ ""ION GHICA""",IAŞI,IS,590,8,7,0,15,27,8,0,35,34,10,0,44,42,17,0,59,45,17,0,62
95079,159,"ŞCOALAGIMNAZIALĂ ""ION GHICA""",IAŞI,IS,585,6,0,0,6,17,2,0,19,26,2,0,28,33,3,0,36,35,3,0,38
95079,160,"LICEUL TEHNOLOGIC DE MECATRONICA SI AUTOMATIZARI",IAŞI,IS,1751,2,1,0,3,4,3,0,7,9,3,0,12,16,3,0,19,18,3,0,21
95079,161,"LICEUL TEHNOLOGIC DE MECATRONICA SI AUTOMATIZARI",IAŞI,IS,2284,2,0,0,2,3,4,0,7,3,6,0,9,4,8,0,12,4,8,0,12
95079,162,"LICEUL TEHNOLOGIC DE MECATRONICA SI AUTOMATIZARI",IAŞI,IS,1113,10,6,0,16,22,7,0,29,33,12,0,45,48,13,0,61,50,13,0,63
95079,163,"LICEUL TEHNOLOGIC DE MECATRONICA SI AUTOMATIZARI",IAŞI,IS,1313,5,3,0,8,30,3,0,33,47,4,0,51,59,4,0,63,66,5,0,71
95079,164,"COLEGIUL TEHNIC ""IOAN C.ŞTEFĂNESCU""",IAŞI,IS,1445,4,6,0,10,18,6,0,24,29,6,0,35,40,6,0,46,40,6,0,46
95079,165,"COLEGIUL TEHNIC ""IOAN C.ŞTEFĂNESCU""",IAŞI,IS,1938,5,6,0,11,11,6,0,17,15,7,0,22,22,7,0,29,25,7,0,32
95079,166,"COLEGIUL TEHNIC ""IOAN C.ŞTEFĂNESCU""",IAŞI,IS,1078,2,3,0,5,13,7,0,20,15,11,0,26,28,12,0,40,36,15,0,51
95079,167,"LICEUL TEHNOLOGIC ""PETRU PONI""",IAŞI,IS,988,9,5,0,14,24,9,0,33,35,12,0,47,48,18,0,66,53,20,0,73
95079,168,"LICEUL TEHNOLOGIC ""PETRU PONI""",IAŞI,IS,979,7,0,0,7,22,1,0,23,30,2,0,32,41,5,0,46,43,5,0,48
95079,169,"LICEUL TEHNOLOGIC ""PETRU PONI""",IAŞI,IS,807,3,0,0,3,13,0,0,13,20,2,0,22,27,2,0,29,30,2,0,32
95079,170,"LICEUL TEHNOLOGIC ""PETRU PONI""",IAŞI,IS,893,7,0,0,7,16,0,0,16,24,0,0,24,35,0,0,35,36,0,0,36
95079,171,"COLEGIUL TEHNIC ELECTRONICĂ ŞI TELECOMUNICAŢII ""GHEORGHE MÂRZESCU""",IAŞI,IS,1426,12,0,0,12,36,1,0,37,47,2,0,49,59,2,0,61,73,3,0,76
95079,172,"COLEGIUL TEHNIC ELECTRONICĂ ŞI TELECOMUNICAŢII ""GHEORGHE MÂRZESCU""",IAŞI,IS,1400,7,2,0,9,17,5,0,22,24,7,0,31,33,14,0,47,36,14,0,50
95079,173,"ŞCOALAGIMNAZIALĂ ""NICOLAE IORGA""",IAŞI,IS,1867,3,7,0,10,7,8,0,15,10,9,0,19,24,9,0,33,26,12,0,38
95079,174,"ŞCOALAGIMNAZIALĂ ""NICOLAE IORGA""",IAŞI,IS,1571,9,3,0,12,33,6,0,39,45,22,0,67,64,26,0,90,68,29,0,97
95079,175,"ŞCOALAGIMNAZIALĂ ""NICOLAE IORGA""",IAŞI,IS,1656,9,1,0,10,21,1,0,22,39,2,0,41,52,4,0,56,54,4,0,58
95079,176,"ŞCOALAGIMNAZIALĂ ""NICOLAE IORGA""",IAŞI,IS,1750,5,7,0,12,17,8,0,25,33,8,0,41,50,9,0,59,61,11,0,72
95079,177,"ŞCOALAGIMNAZIALĂ ""NICOLAE IORGA""",IAŞI,IS,4126,14,2,0,16,34,5,0,39,43,7,0,50,62,10,0,72,71,10,0,81
95079,178,"ŞCOALAGIMNAZIALĂ ""NICOLAE IORGA""",IAŞI,IS,1613,14,5,0,19,32,7,0,39,56,8,0,64,74,8,0,82,86,9,0,95
95079,179,"ŞCOALAGIMNAZIALĂ ""NICOLAE IORGA""",IAŞI,IS,1922,11,4,0,15,29,5,0,34,56,5,0,61,85,5,0,90,90,5,0,95
95079,180,"ŞCOALAGIMNAZIALĂ ""VERONICA MICLE""",IAŞI,IS,2094,21,3,0,24,46,10,2,58,59,16,2,77,93,19,2,114,102,20,2,124
95079,181,"ŞCOALAGIMNAZIALĂ ""VERONICA MICLE""",IAŞI,IS,1895,16,5,0,21,42,11,0,53,71,17,0,88,93,22,0,115,113,28,0,141
95079,182,"ŞCOALAGIMNAZIALĂ ""VERONICA MICLE""",IAŞI,IS,1984,9,1,0,10,36,1,0,37,58,2,0,60,72,2,0,74,83,2,0,85
95079,183,"LICEUL TEHNOLOGIC DE MECATRONICA SI AUTOMATIZĂRI",IAŞI,IS,1235,7,3,0,10,24,5,0,29,35,7,0,42,49,7,0,56,49,7,0,56
95079,184,"LICEUL TEHNOLOGIC DE MECATRONICA SI AUTOMATIZĂRI",IAŞI,IS,939,2,3,0,5,11,3,0,14,15,5,0,20,23,6,0,29,25,6,0,31
95079,185,"LICEUL TEHNOLOGIC DE MECATRONICA SI AUTOMATIZĂRI",IAŞI,IS,920,3,0,0,3,9,1,0,10,20,1,0,21,29,1,0,30,34,1,0,35
95079,186,"LICEUL TEHNOLOGIC DE MECATRONICA SI AUTOMATIZĂRI",IAŞI,IS,759,6,0,0,6,11,0,0,11,15,1,0,16,18,1,0,19,19,1,0,20
95079,187,"LICEUL TEHNOLOGIC DE MECATRONICA SI AUTOMATIZĂRI",IAŞI,IS,1310,2,1,0,3,13,2,0,15,14,2,0,16,26,2,0,28,29,2,0,31
95079,188,"LICEUL TEHNOLOGIC DE MECATRONICA SI AUTOMATIZĂRI",IAŞI,IS,1153,1,3,0,4,5,3,0,8,5,4,0,9,12,5,0,17,12,5,0,17
95079,189,"ŞCOALA GIMNAZIALĂ""DIMITRIE A.STURDZA""",IAŞI,IS,877,4,0,0,4,17,1,0,18,27,20,0,47,42,23,0,65,45,23,0,68
95079,190,"ŞCOALA GIMNAZIALĂ""DIMITRIE A.STURDZA""",IAŞI,IS,1180,14,2,0,16,37,8,0,45,46,23,0,69,56,24,0,80,59,24,0,83
95079,191,"ŞCOALA GIMNAZIALĂ""DIMITRIE A.STURDZA""",IAŞI,IS,1263,6,5,0,11,19,5,0,24,36,17,0,53,55,18,0,73,63,18,0,81
95079,192,"ŞCOALA GIMNAZIALĂ""DIMITRIE A.STURDZA""",IAŞI,IS,1495,6,0,0,6,37,2,0,39,51,20,0,71,69,20,0,89,77,21,0,98
95079,193,"ŞCOALA GIMNAZIALĂ ""ALECU RUSSO""",IAŞI,IS,1131,5,0,0,5,20,1,0,21,30,1,0,31,39,1,0,40,40,1,0,41
95079,194,"ŞCOALA GIMNAZIALĂ ""ALECU RUSSO""",IAŞI,IS,1261,14,1,0,15,29,1,0,30,40,1,0,41,51,1,0,52,57,1,0,58
95079,195,"ŞCOALA GIMNAZIALĂ ""ALECU RUSSO""",IAŞI,IS,1363,15,0,0,15,40,1,0,41,46,1,0,47,60,3,0,63,70,6,0,76
95079,196,"ŞCOALA GIMNAZIALĂ ""ALECU RUSSO""",IAŞI,IS,1382,14,3,0,17,29,4,0,33,43,8,0,51,64,10,0,74,70,10,0,80
95079,197,"ŞCOALA GIMNAZIALĂ ""ALECU RUSSO""",IAŞI,IS,1554,12,0,0,12,21,2,0,23,27,5,0,32,42,7,0,49,47,10,0,57
95079,198,"ŞCOALA GIMNAZIALĂ "" ALECU RUSSO""",IAŞI,IS,1061,6,2,0,8,17,2,0,19,21,2,0,23,40,2,0,42,47,4,0,51
95079,199,"ŞCOALA PRIMARA""GHEORGHE GHIBANESCU""",IAŞI,IS,1167,9,5,0,14,26,12,0,38,35,20,0,55,45,24,0,69,46,26,0,72
95079,200,"ŞCOALA PRIMARA""GHEORGHE GHIBANESCU""",IAŞI,IS,1170,5,0,0,5,29,2,0,31,40,2,0,42,52,2,0,54,57,2,0,59
95079,201,"ŞCOALA PRIMARA""GHEORGHE GHIBANESCU""",IAŞI,IS,1131,8,4,0,12,35,5,0,40,51,6,0,57,69,8,0,77,76,8,0,84
95079,202,"ŞCOALA PRIMARA""GHEORGHE GHIBANESCU""",IAŞI,IS,1307,11,2,0,13,23,4,0,27,47,5,0,52,60,8,0,68,69,8,0,77
95079,203,"ŞCOALA PRIMARA""GHEORGHE GHIBANESCU""",IAŞI,IS,1210,12,0,0,12,26,1,0,27,43,1,0,44,59,1,0,60,67,2,0,69
95079,204,"GRĂDINIŢA CU PROGRAM PRELUNGIT NR.1",IAŞI,IS,823,9,1,0,10,28,7,0,35,42,10,0,52,53,14,0,67,59,19,0,78
95079,205,"GRĂDINIŢA CU PROGRAM PRELUNGIT NR.1",IAŞI,IS,1016,10,0,0,10,32,4,0,36,47,7,0,54,61,11,0,72,68,11,0,79
95079,206,"PARCUL ŞTIINŢIFIC ŞI TEHNOLOGIC ""TEHNOPOLIS""",IAŞI,IS,1193,7,1,0,8,24,1,0,25,35,1,0,36,50,2,0,52,58,3,0,61
95079,207,"PARCUL ŞTIINŢIFIC ŞI TEHNOLOGIC ""TEHNOPOLIS""",IAŞI,IS,1219,6,0,0,6,12,4,0,16,25,7,0,32,28,8,0,36,37,8,0,45
95079,208,"ŞCOALAGIMNAZIALĂ ""OTILIA CAZIMIR""",IAŞI,IS,1170,9,2,0,11,49,2,0,51,66,6,0,72,88,8,0,96,97,8,0,105
95079,209,"ŞCOALAGIMNAZIALĂ ""OTILIA CAZIMIR""",IAŞI,IS,1093,7,2,0,9,37,7,0,44,51,13,0,64,74,20,0,94,81,21,0,102
95079,210,"ŞCOALAGIMNAZIALĂ ""OTILIA CAZIMIR""",IAŞI,IS,1206,20,3,0,23,49,5,0,54,59,16,0,75,73,17,1,91,73,17,1,91
95079,211,"ŞCOALAGIMNAZIALĂ ""OTILIA CAZIMIR""",IAŞI,IS,1297,16,0,0,16,56,0,0,56,82,2,0,84,118,3,0,121,122,3,0,125
95079,212,"COLEGIULNATIONAL ""EMIL RACOVIŢĂ""",IAŞI,IS,3932,8,0,0,8,24,7,0,31,39,10,0,49,46,10,1,57,49,10,1,60
95079,213,"COLEGIULNATIONAL ""EMIL RACOVIŢĂ""",IAŞI,IS,1153,10,4,0,14,32,7,0,39,61,11,0,72,86,11,0,97,96,12,0,108
95079,214,"COLEGIULNATIONAL ""EMIL RACOVIŢĂ""",IAŞI,IS,1349,20,2,0,22,52,2,0,54,89,3,0,92,105,3,0,108,110,3,0,113
95079,215,"COLEGIULNATIONAL ""EMIL RACOVIŢĂ""",IAŞI,IS,1079,19,4,0,23,36,4,0,40,57,5,0,62,72,6,0,78,73,6,0,79
95079,216,"LICEUL TEORETIC ""DIMITRIE CANTEMIR""",IAŞI,IS,1363,8,0,0,8,39,5,0,44,63,8,0,71,84,8,0,92,89,8,0,97
95079,217,"LICEUL TEORETIC ""DIMITRIE CANTEMIR""",IAŞI,IS,1313,11,0,0,11,54,1,0,55,77,8,0,85,95,14,0,109,103,16,0,119
95079,218,"LICEUL TEORETIC ""DIMITRIE CANTEMIR""",IAŞI,IS,1257,11,0,0,11,35,2,0,37,49,3,0,52,70,4,0,74,74,4,0,78
95079,219,"LICEUL TEORETIC ""DIMITRIE CANTEMIR""",IAŞI,IS,1388,14,2,0,16,37,2,0,39,65,2,0,67,86,4,0,90,96,4,0,100
95079,220,"ŞCOALAGIMNAZIALĂ""TITU MAIORESCU""",IAŞI,IS,791,3,5,0,8,24,7,0,31,44,8,0,52,52,13,0,65,57,16,0,73
95079,221,"ŞCOALAGIMNAZIALĂ""TITU MAIORESCU""",IAŞI,IS,785,6,0,0,6,20,2,0,22,31,6,0,37,40,12,0,52,41,13,0,54
95079,222,"ŞCOALAGIMNAZIALĂ""TITU MAIORESCU""",IAŞI,IS,1223,7,4,0,11,41,6,0,47,58,8,0,66,61,8,0,69,64,8,0,72
95079,223,"GRĂDINIŢA CU PROGRAM PRELUNGIT ""CUV. PARASCHEVA""",IAŞI,IS,841,11,7,0,18,27,12,0,39,44,16,0,60,54,20,0,74,54,26,0,80
95079,224,"ŞCOALAGIMNAZIALĂ ""ION NECULCE""",IAŞI,IS,1273,14,2,0,16,34,5,0,39,59,9,0,68,81,10,0,91,88,11,0,99
95079,225,"ŞCOALAGIMNAZIALĂ ""ION NECULCE""",IAŞI,IS,1042,17,0,0,17,35,0,0,35,52,0,0,52,75,2,0,77,76,2,0,78
95079,226,"ŞCOALAGIMNAZIALĂ ""ION NECULCE""",IAŞI,IS,1117,19,6,0,25,41,6,0,47,62,6,0,68,80,7,0,87,84,7,0,91
95079,227,"ŞCOALAGIMNAZIALĂ ""ION NECULCE""",IAŞI,IS,1108,16,1,0,17,26,2,0,28,38,3,0,41,46,3,0,49,47,3,0,50
95079,228,"ŞCOALAPRIMARA NR.1 ""VASILE CONTA""",IAŞI,IS,784,5,1,0,6,11,3,0,14,14,6,0,20,31,6,0,37,32,6,0,38
95079,229,"ŞCOALAPRIMARA NR.1 ""VASILE CONTA""",IAŞI,IS,1196,6,2,0,8,22,3,0,25,41,5,0,46,64,6,0,70,71,6,0,77
95079,230,"ŞCOALAPRIMARA NR.1 ""VASILE CONTA""",IAŞI,IS,1744,12,0,0,12,30,3,0,33,58,5,0,63,81,9,0,90,88,9,0,97
95079,231,"ŞCOALAGIMNAZIALĂ ""VASILE CONTA""",IAŞI,IS,1397,13,3,0,16,38,11,0,49,57,14,0,71,79,19,0,98,87,23,0,110
95079,232,"ŞCOALAGIMNAZIALĂ ""VASILE CONTA""",IAŞI,IS,1401,14,1,0,15,36,2,0,38,52,3,0,55,76,4,0,80,82,4,0,86
95079,233,"ŞCOALAGIMNAZIALĂ ""VASILE CONTA""",IAŞI,IS,1505,10,1,0,11,29,1,0,30,47,2,0,49,71,3,0,74,76,3,0,79
95079,234,"ŞCOALAGIMNAZIALĂ ""VASILE CONTA""",IAŞI,IS,1477,21,3,0,24,41,3,0,44,66,5,0,71,87,5,0,92,93,5,0,98
95079,235,"COLEGIUL TEHNIC ""ION HOLBAN""",IAŞI,IS,1612,7,7,0,14,32,15,0,47,44,25,0,69,60,29,0,89,66,30,0,96
95079,236,"COLEGIUL TEHNIC ""ION HOLBAN""",IAŞI,IS,1285,3,3,0,6,29,9,0,38,52,17,0,69,71,17,0,88,73,17,0,90
95079,237,"COLEGIUL TEHNIC ""ION HOLBAN""",IAŞI,IS,1493,8,3,0,11,36,8,0,44,55,11,142,208,73,11,142,226,77,11,111,199
95079,238,"LICEUL TEORETIC ""MIRON COSTIN""",IAŞI,IS,1403,10,1,0,11,35,5,0,40,60,12,0,72,79,22,0,101,82,26,0,108
95079,239,"LICEUL TEORETIC ""MIRON COSTIN""",IAŞI,IS,1252,22,3,0,25,76,4,0,80,82,4,0,86,89,4,0,93,96,5,0,101
95079,240,"LICEUL TEORETIC ""MIRON COSTIN""",IAŞI,IS,1467,12,3,0,15,43,4,0,47,119,8,0,127,119,8,0,127,119,9,0,128
95079,241,"LICEUL TEORETIC ""MIRON COSTIN""",IAŞI,IS,1514,14,1,0,15,44,3,0,47,73,3,0,76,95,6,0,101,110,6,0,116
95408,242,"CASA DE CULTURAMIHAIL SADOVEANU",PAŞCANI,IS,1248,18,0,0,18,65,0,0,65,85,2,0,87,101,3,0,104,103,3,0,106
95408,243,"CASA DE CULTURAMIHAIL SADOVEANU",PAŞCANI,IS,1367,11,0,0,11,46,2,0,48,65,2,0,67,88,2,0,90,98,2,0,100
95408,244,"SCOALA ION CREANGA",PAŞCANI,IS,1389,14,1,0,15,32,1,0,33,53,6,0,59,62,6,0,68,72,6,0,78
95408,245,"GRADINITA NR. 1",PAŞCANI,IS,1183,12,0,0,12,54,6,0,60,66,8,0,74,93,8,1,102,98,8,1,107
95408,246,"SCOALANR.3 IORDACHI CANTACUZINO",PAŞCANI,IS,1503,24,5,0,29,89,12,0,101,107,13,0,120,130,13,0,143,144,13,0,157
95408,247,"SCOALA NR.3 IORDACHI CANTACUZINO",PAŞCANI,IS,1228,16,0,0,16,30,3,0,33,34,4,0,38,50,4,0,54,60,4,0,64
95408,248,"GRADINITA VATRA",PAŞCANI,IS,1375,9,0,0,9,28,0,0,28,53,2,0,55,67,4,0,71,75,4,0,79
95408,249,"COLEGIUL NATIONAL MIHAIL SADOVEANU",PAŞCANI,IS,1332,17,1,0,18,50,1,0,51,61,1,0,62,79,3,0,82,81,3,0,84
95408,250,"COLEGIUL NATIONAL MIHAIL SADOVEANU",PAŞCANI,IS,1434,11,2,0,13,47,4,0,51,68,7,0,75,83,7,0,90,91,7,0,98
95408,251,GRADINITASIIRETUL,PAŞCANI,IS,3175,14,0,0,14,39,1,0,40,61,2,0,63,85,2,0,87,97,2,0,99
95408,252,"SCOALA DE ARTE SI MESERII NICOLAE IORGA",PAŞCANI,IS,1697,22,3,0,25,44,6,0,50,65,10,0,75,92,11,0,103,102,12,0,114
95408,253,"SCOALA SPECIALA",PAŞCANI,IS,1715,18,0,0,18,52,2,0,54,69,2,0,71,92,4,0,96,120,4,0,124
95408,254,"COLEGIU TEHNIC DE CAI FERATE UNIREA",PAŞCANI,IS,1583,14,5,0,19,26,7,0,33,34,8,0,42,60,12,0,72,70,14,0,84
95408,255,"COLEGIU TEHNIC DE CAI FERATE UNIREA",PAŞCANI,IS,1136,12,4,0,16,34,4,0,38,58,4,0,62,66,4,0,70,71,4,0,75
95408,256,"GRADINITA CU PROGRAM PRELUNGIT NR. 3",PAŞCANI,IS,1094,6,0,0,6,28,0,0,28,40,2,0,42,70,5,0,75,73,5,0,78
95408,257,"GRADINITA CU PROGRAM PRELUNGIT NR. 3",PAŞCANI,IS,1345,15,1,0,16,46,2,0,48,66,2,0,68,83,2,0,85,96,4,0,100
95408,258,"LICEULMIRON COSTIN",PAŞCANI,IS,1322,23,3,0,26,51,4,0,55,80,6,0,86,94,7,0,101,98,8,0,106
95408,259,"LICEULMIRON COSTIN",PAŞCANI,IS,1271,23,2,0,25,53,4,0,57,65,7,0,72,90,7,0,97,96,7,0,103
95408,260,"GRUP SCOLAR MIHAI BUSUIOC",PAŞCANI,IS,1287,15,3,0,18,50,3,0,53,66,4,0,70,85,4,0,89,90,4,0,94
95408,261,"GRUP SCOLAR MIHAI BUSUIOC",PAŞCANI,IS,1117,12,3,0,15,30,6,0,36,50,6,0,56,67,6,0,73,69,9,0,78
95417,262,"SCOALA BLAGESTI",BLĂGEŞTI,IS,1159,16,4,0,20,46,6,0,52,78,8,0,86,99,8,0,107,106,8,0,114
95435,263,"SCOALA GISTESTI",GÂŞTEŞTI,IS,1047,6,0,0,6,10,1,0,11,16,1,0,17,23,1,0,24,26,1,0,27
95435,264,"GRADINITA GISTESTI",GÂŞTEŞTI,IS,1486,19,1,0,20,30,1,0,31,43,2,0,45,60,2,0,62,63,2,0,65
95444,265,"SCOALA LUNCA",LUNCA,IS,1118,3,4,0,7,14,4,0,18,24,6,0,30,34,9,0,43,35,9,0,44
95444,266,"SCOALA LUNCA",LUNCA,IS,1025,5,3,0,8,17,3,0,20,22,4,0,26,33,4,0,37,38,5,0,43
95453,267,"SCOALA SODOMENI",SODOMENI,IS,996,4,2,0,6,6,3,0,9,10,7,0,17,12,7,0,19,13,7,0,20
95426,268,"SCOALA BOSTENI",BOŞTENI,IS,1231,16,0,0,16,27,0,0,27,61,4,0,65,70,4,0,74,75,4,0,79
95364,269,"LICEUL TEHNOLOGIC HÎRLĂU",HÎRLĂU,IS,1350,19,3,0,22,35,3,0,38,48,4,0,52,82,7,0,89,96,9,0,105
95364,270,"COLEGIUL NAŢIONAL ŞTEFAN CEL MARE HÎRLĂU",HÎRLĂU,IS,1190,12,4,0,16,29,6,0,35,40,6,0,46,62,7,5,74,67,9,5,81
95364,271,"ŞCOALA GIMNAZIALĂ PETRU RAREŞ - CORP VECHI",HÎRLĂU,IS,1931,28,1,0,29,56,4,0,60,73,7,0,80,91,8,0,99,98,8,0,106
95364,272,"ŞCOALA GIMNAZIALĂ PETRU RAREŞ-CORP GRĂDINIŢĂ CU PROGRAM PRELUNGIT",HÎRLĂU,IS,1952,13,1,0,14,43,3,0,46,57,10,0,67,67,13,0,80,75,13,0,88
95364,273,"ŞCOALA GIMNAZIALĂ PETRU RAREŞ - CORP NOU",HÎRLĂU,IS,1501,10,0,0,10,42,5,0,47,58,5,0,63,71,5,0,76,75,7,0,82
95373,274,"ŞCOALA GIMNAZIALĂ PÎRCOVACI - CORP GRADINIŢĂ",PÎRCOVACI,IS,1477,34,0,0,34,47,0,0,47,59,2,0,61,71,2,0,73,76,2,0,78
95373,275,"ŞCOALA GIMNAZIALĂ PÎRCOVACI - CORP ŞCOALĂ",PÎRCOVACI,IS,1314,14,3,0,17,26,4,0,30,36,4,0,40,43,4,0,47,46,5,0,51
98382,276,"ŞCOALA AL. I. CUZA","PODU ILOAIEI",IS,614,12,3,0,15,14,3,0,17,19,5,0,24,24,6,0,30,24,6,0,30
98382,277,"ŞCOALA AL. I. CUZA","PODU ILOAIEI",IS,1281,12,0,0,12,22,0,0,22,33,1,0,34,46,2,0,48,50,2,0,52
98382,278,"ŞCOALA AL. I. CUZA","PODU ILOAIEI",IS,956,5,2,0,7,18,4,0,22,19,8,0,27,27,10,0,37,27,12,0,39
98382,279,"ŞCOALA AL. I. CUZA","PODU ILOAIEI",IS,894,8,0,0,8,13,0,0,13,13,0,0,13,22,0,0,22,22,0,0,22
98382,280,"ŞCOALA AL. I. CUZA","PODU ILOAIEI",IS,901,4,1,0,5,14,2,0,16,17,3,0,20,19,3,0,22,24,3,0,27
98382,281,"ŞCOALA AL. I. CUZA","PODU ILOAIEI",IS,1135,10,2,0,12,19,2,0,21,25,4,0,29,31,4,0,35,32,5,0,37
98382,282,"ŞCOALA HENCI","PODU ILOAIEI",IS,444,4,0,0,4,6,0,0,6,12,0,0,12,15,0,0,15,15,0,0,15
98417,283,"ŞCOALA HOLM",HOLM,IS,241,4,2,0,6,6,2,0,8,18,3,0,21,21,3,0,24,21,3,0,24
98426,284,"IMOBIL PRIVAT SAMSON NECULAI",SCOBÂLŢENI,IS,984,4,0,0,4,21,1,0,22,32,2,0,34,36,2,0,38,41,3,0,44
98391,285,"ŞCOALA BUDĂI",BUDĂI,IS,779,4,0,0,4,8,0,0,8,11,0,23,34,11,0,23,34,14,0,23,37
98408,286,"ŞCOALA COSIŢENI",COSIŢENI,IS,253,2,1,0,3,12,2,0,14,15,2,0,17,18,4,0,22,26,5,0,31
95480,287,"SCOALA GENERALA ION CREANGA","TÂRGU FRUMOS",IS,1669,8,0,0,8,28,1,0,29,36,2,0,38,46,3,0,49,53,6,0,59
95480,288,"SCOALA GENERALA ION CREANGA","TÂRGU FRUMOS",IS,880,5,7,0,12,11,7,0,18,13,7,0,20,20,7,0,27,23,7,0,30
95480,289,"SCOALA GENERALA GARABET IBRAILEANU","TÂRGU FRUMOS",IS,1422,11,0,0,11,30,6,0,36,40,6,0,46,56,6,0,62,61,6,0,67
95480,290,"SCOALA GENERALA GARABET IBRAILEANU","TÂRGU FRUMOS",IS,1188,8,1,0,9,24,2,0,26,39,6,0,45,49,7,0,56,50,7,0,57
95480,291,"COMPLEX SERVICII SOCIALEPENTRU COPII - TARGU FRUMOS","TÂRGU FRUMOS",IS,1580,7,2,0,9,25,3,0,28,36,3,0,39,51,3,0,54,52,3,0,55
95480,292,"CASA DE CULTURA ""GARABET IBRAILEANU""","TÂRGU FRUMOS",IS,1598,19,2,0,21,38,2,0,40,50,2,0,52,69,5,0,74,78,7,0,85
95480,293,"CASA DE CULTURA ""GARABET IBRAILEANU""","TÂRGU FRUMOS",IS,1919,12,5,0,17,28,5,0,33,40,7,0,47,56,8,0,64,61,8,0,69
95480,294,"LICEUL TEORETIC ""ION NECULCE""","TÂRGU FRUMOS",IS,1487,2,4,0,6,13,4,0,17,18,5,0,23,38,5,0,43,41,5,0,46
95621,295,"FOST SEDIU BIBLIOTECĂ COMUNALĂ","ALEXANDRU I. CUZA",IS,627,4,0,0,4,24,3,0,27,35,3,0,38,44,3,0,47,56,3,0,59
95649,296,"SCOALA GIMNAZIALA SCHEIA",SCHEIA,IS,1075,8,2,0,10,12,5,0,17,18,11,0,29,24,15,0,39,30,15,0,45
95658,297,"SCOALA PRIMARA VOLINTIRESTI",VOLINTIREŞTI,IS,602,13,2,0,15,23,5,0,28,26,5,0,31,33,5,0,38,39,5,0,44
95676,298,"SCOALAGIMNAZIALA GH. CIOBANU ANDRIESENI",ANDRIEŞENI,IS,1342,7,4,0,11,32,6,0,38,37,6,0,43,42,8,0,50,44,10,0,54
95685,299,"SCOALA PRIMARA BUHAENI",BUHĂENI,IS,523,0,0,0,0,3,1,0,4,13,4,0,17,19,4,0,23,22,4,0,26
95738,300,"SCOALA GIMNAZIALA SPINENI",SPINENI,IS,804,2,0,0,2,3,1,0,4,4,1,0,5,6,1,0,7,6,1,0,7
95710,301,"SCOALA GIMNAZIALA GLAVANESTI",GLĂVĂNEŞTI,IS,568,1,2,0,3,9,4,0,13,15,4,0,19,16,4,0,20,16,4,0,20
95756,302,"ȘCOALA GIMNAZIALĂARON-VODA DIN SAT ARONEANU",ARONEANU,IS,1363,14,7,0,21,32,10,0,42,63,21,0,84,73,24,0,97,90,25,0,115
95765,303,"ȘCOALA GIMNAZIALĂ ARON-VODĂ DIN SAT DOROBANȚ",DOROBANŢ,IS,1147,11,0,0,11,15,0,0,15,30,6,0,36,59,11,0,70,69,11,0,80
95774,304,"ȘCOALA GIMNAZIALĂARON-VODĂ DIN SAT REDIUALDEI","REDIU ALDEI",IS,346,2,1,0,3,2,3,0,5,3,8,0,11,5,8,0,13,5,12,0,17
95783,305,"BAZA SPORTIVĂ MULTIFUNCȚIONALĂ - ȘOROGARI",ŞOROGARI,IS,339,7,3,0,10,8,4,0,12,14,7,0,21,15,7,0,22,18,7,0,25
95505,306,"SCOALA GIMNAZIALA CLASELE I-VIII BALS",BALŞ,IS,1193,9,1,0,10,28,2,0,30,37,2,0,39,47,3,0,50,47,3,0,50
95514,307,"SCOALA GIMNAZIALA CLASELE I-VIII BOURENI",BOURENI,IS,1370,7,0,0,7,12,0,0,12,19,0,0,19,46,2,0,48,49,2,0,51
95532,308,"SCOALA PRIMARA CLASELE I-IV COASTA MAGURII","COASTA MĂGURII",IS,179,4,3,0,7,6,4,0,10,7,4,0,11,7,4,0,11,8,4,0,12
95809,309,"CENTRU DE ZI BĂLȚAȚI",BĂLŢAŢI,IS,1594,8,0,0,8,13,1,0,14,16,1,0,17,21,1,0,22,21,1,0,22
95836,310,"ȘCOALA PRIMARĂ - SAT MĂDÎRJEȘTI",MĂDÎRJEŞTI,IS,957,2,0,0,2,7,0,0,7,16,0,0,16,26,0,0,26,29,0,0,29
95845,311,"ȘCOALA PRIMARĂ - SAT PODIȘU",PODIŞU,IS,497,6,2,0,8,8,5,0,13,11,5,0,16,14,5,0,19,17,6,0,23
95854,312,"ȘCOALA GIMNAZIALĂ - SAT SÎRCA",SÎRCA,IS,873,7,0,0,7,9,1,0,10,12,1,0,13,17,3,0,20,17,4,0,21
95863,313,"ȘCOALA GIMNAZIALĂ - SAT VALEA OILOR","VALEA OILOR",IS,532,3,0,0,3,4,0,0,4,14,2,0,16,18,2,0,20,20,2,0,22
95881,314,"SCOALA BELCEŞTI",BELCEŞTI,IS,1145,9,1,0,10,22,6,0,28,29,9,0,38,31,10,0,41,33,11,0,44
95881,315,"SCOALA BELCEŞTI",BELCEŞTI,IS,1204,13,3,0,16,21,4,0,25,31,5,0,36,39,5,0,44,41,5,0,46
95881,316,"SCOALA RUSI",BELCEŞTI,IS,1230,7,0,0,7,13,4,0,17,22,4,0,26,29,6,0,35,38,7,0,45
95916,317,"ŞCOALA SATU – NOU","SATU NOU",IS,1562,8,4,0,12,9,5,0,14,11,5,0,16,14,5,0,19,18,5,0,23
95907,318,"ŞCOALA MUNTENI",MUNTENI,IS,855,4,0,0,4,8,1,0,9,13,1,0,14,25,4,0,29,26,5,0,31
95925,319,"MAGAZIN CONSUMCOOP",TANSA,IS,829,5,0,0,5,20,0,0,20,45,0,0,45,51,2,0,53,58,3,0,61
95890,320,"ŞCOALA LITENI",LITENI,IS,1101,1,0,0,1,8,0,0,8,15,1,0,16,19,5,0,24,22,5,0,27
95934,321,"SCOALA ULMI",ULMI,IS,499,20,5,0,25,46,6,0,52,67,6,0,73,87,7,0,94,94,7,0,101
95952,322,"ŞCOALA GIMNAZIALĂ CU CLASELE I-VIII BIVOLARI",BIVOLARI,IS,913,13,2,0,15,22,4,0,26,29,8,9,46,32,8,9,49,34,8,9,51
95952,323,"ŞCOALA GIMNAZIALĂ CU CLASELE I-VIII BIVOLARI",BIVOLARI,IS,941,12,0,0,12,21,0,0,21,35,3,3,41,36,3,3,42,36,3,3,42
95989,324,"ŞCOALA GIMNAZIALĂ CU CLASELE I-VIII TABĂRA",TABĂRA,IS,887,4,1,0,5,7,3,0,10,9,5,0,14,14,5,0,19,18,5,0,23
95970,325,"ŞCOALA CU CLASELE I - IV SOLONEŢ",SOLONEŢ,IS,603,1,1,0,2,10,2,0,12,12,4,0,16,13,4,0,17,15,5,0,20
95097,326,"CAMINCULTURAL BIRNOVA",BÎRNOVA,IS,1115,6,2,0,8,22,7,0,29,30,11,0,41,39,18,0,57,41,22,0,63
95104,327,"SCOALA PRIMARA CERCU",CERCU,IS,555,4,0,0,4,6,7,0,13,13,7,0,20,19,7,0,26,23,8,0,31
95113,328,"CAMIN CULTURAL PAUN",PĂUN,IS,1073,5,1,0,6,10,6,0,16,27,6,0,33,34,12,0,46,36,12,0,48
95122,329,"SCOALA PRIMARA PIETRARIA",PIETRĂRIA,IS,796,9,1,0,10,21,3,0,24,35,9,0,44,46,12,0,58,47,13,0,60
95131,330,"SCOALA PRIMARA TODIREL",TODIREL,IS,455,0,0,0,0,6,1,0,7,11,2,0,13,14,2,0,16,19,3,0,22
95140,331,"SCOALA PRIMARA VISAN",VIŞAN,IS,1309,4,1,0,5,13,1,0,14,17,3,0,20,26,6,0,32,26,6,0,32
96067,332,"LICEUL TEHNOLOGIC BRAESTI",BRĂEŞTI,IS,886,11,1,0,12,22,3,0,25,34,3,0,37,39,3,0,42,42,3,0,45
96085,333,"SCOALA CU CLASELE I-IV",BUDA,IS,197,5,0,0,5,9,0,0,9,17,1,0,18,20,1,0,21,20,3,0,23
96094,334,"ŞCOALA GENERALĂ CRISTEŞTI",CRISTEŞTI,IS,766,8,2,0,10,12,4,0,16,14,4,0,18,33,4,0,37,37,5,0,42
96076,335,"ŞCOALA CU CL. I-IV ALBEŞTI",ALBEŞTI,IS,561,7,4,0,11,9,4,0,13,16,6,0,22,21,6,0,27,21,7,0,28
96129,336,"CAMIN CULTURAL BUTEA",BUTEA,IS,1636,17,4,0,21,22,4,0,26,27,4,0,31,35,7,0,42,36,7,0,43
96129,337,"GRADINITA BUTEA",BUTEA,IS,1560,19,3,0,22,28,3,0,31,31,6,0,37,39,6,0,45,39,6,0,45
96138,338,"SCOALA PRIMARA MICLAUSENI",MICLĂUŞENI,IS,344,4,1,0,5,7,13,0,20,13,17,0,30,24,17,0,41,25,21,0,46
96156,339,"SCOALA GIMNAZIALA ""GRIGORE URECHE"" CEPLENITA",CEPLENIŢA,IS,1184,5,1,0,6,15,6,0,21,17,6,0,23,23,6,0,29,24,6,0,30
96165,340,"SCOALA GIMNAZIALA ""NICOLAE IORGA"" BUHALNITA",BUHALNIŢA,IS,1181,14,3,0,17,41,5,0,46,51,7,0,58,60,8,0,68,63,8,0,71
96174,341,"SCOALA GIMNAZIALA POIANA MARULUI","POIANA MĂRULUI",IS,797,6,4,0,10,6,4,0,10,10,5,0,15,12,5,0,17,14,5,0,19
96183,342,"GRADINITA CU PROGRAM NORMAL ZLODICA",ZLODICA,IS,244,3,2,0,5,7,2,0,9,10,2,0,12,13,5,0,18,16,5,0,21
98079,343,"CĂMINUL CULTURAL CIOHORĂNI",CIOHORĂNI,IS,1508,19,4,0,23,38,11,0,49,54,13,0,67,69,14,0,83,71,14,0,85
96209,344,"CAMINUL CULTURAL CIORTEŞTI",CIORTEŞTI,IS,889,8,0,0,8,12,1,0,13,18,1,0,19,23,1,0,24,29,1,0,30
96218,345,"ŞCOALAGIMNAZIALĂ COROPCENI",COROPCENI,IS,897,8,1,0,9,11,3,0,14,14,4,0,18,16,5,0,21,20,5,0,25
96227,346,ŞCOALAPRIMARĂDELENI,DELENI,IS,411,4,0,0,4,5,2,0,7,7,5,0,12,7,5,0,12,8,5,0,13
96236,347,ŞCOALAPRIMARĂROTĂRIA,ROTĂRIA,IS,307,10,5,0,15,16,6,0,22,20,6,0,26,33,7,0,40,33,7,0,40
96245,348,"ŞCOALAGIMANAZIALĂ ŞERBEŞTI",ŞERBEŞTI,IS,646,5,2,0,7,12,3,0,15,23,5,0,28,37,5,0,42,48,5,0,53
96263,349,SCOALAGIMNAZIALACIUREA,CIUREA,IS,1049,3,4,0,7,3,4,0,7,4,5,0,9,7,5,0,12,7,5,0,12
96263,350,"SCOALAGIMNAZIALA CIUREA",CIUREA,IS,1052,5,3,0,8,14,3,0,17,17,3,0,20,22,3,0,25,25,3,0,28
96272,351,"GRADINITACUPROGRAMNORMALNR. 3CURATURI",CURĂTURI,IS,210,3,2,0,5,3,3,0,6,3,4,0,7,5,5,0,10,6,5,0,11
96281,352,"CORP C SCOALAGIMNAZIALA DUMBRAVA",DUMBRAVA,IS,1186,0,0,0,0,1,0,0,1,8,0,0,8,39,8,0,47,51,12,0,63
96290,353,PROPRMACOVEI,HLINCEA,IS,652,5,0,0,5,10,0,0,10,12,4,0,16,17,4,0,21,17,7,0,24
96307,354,"SCOALAGIMNAZIALANR.1 LUNCACETATUII","LUNCA CETĂŢUII",IS,1599,15,2,0,17,28,6,0,34,28,18,0,46,67,24,0,91,74,26,0,100
96307,355,"SCOALAGIMNAZIALANR.1 LUNCACETATUII","LUNCA CETĂŢUII",IS,1802,9,1,0,10,20,1,0,21,38,2,0,40,58,2,0,60,63,2,0,65
96307,356,"SCOALAGIMNAZIALANR.1 LUNCACETATUII","LUNCA CETĂŢUII",IS,1923,18,0,0,18,38,0,0,38,50,1,0,51,83,1,0,84,98,2,1,101
96307,357,"SCOALA GIMNAZIALANR.1 LUNCACETATUII","LUNCA CETĂŢUII",IS,1760,11,3,0,14,29,4,0,33,56,4,0,60,77,4,0,81,85,5,0,90
96307,358,"SCOALAPRIMARANR.2 LUNCA CETAŢUII(ZANEA)","LUNCA CETĂŢUII",IS,470,5,1,0,6,9,1,0,10,24,2,0,26,30,2,0,32,44,2,0,46
96316,359,"CENTRUL DE ZI PENTRU COPIIIAFLAȚI ÎN SITUAȚIEDERISC,, SCUFIȚAROȘIE""","PICIORU LUPULUI",IS,501,7,1,0,8,17,4,0,21,24,4,0,28,39,4,0,43,41,6,0,47
96325,360,"SCOALAPRIMARANR. 2SLOBOZIA",SLOBOZIA,IS,368,3,4,0,7,10,8,0,18,12,9,0,21,15,11,0,26,15,11,0,26
96343,361,"SCOALA GENERALA NR.1. SAT.COARNELE CAPREI","COARNELE CAPREI",IS,905,12,1,0,13,17,2,0,19,26,2,0,28,28,2,0,30,33,2,0,35
96343,362,"SCOALA GENERALA NR. 1. SAT.COARNELE CAPREI","COARNELE CAPREI",IS,830,11,0,0,11,16,2,0,18,19,2,0,21,23,2,0,25,27,2,0,29
96352,363,"ŞCOALA GENERALA SAT. ARAMA",ARAMA,IS,403,0,0,0,0,2,0,0,2,6,0,0,6,7,0,0,7,11,0,0,11
96361,364,"ŞCOALA GENERALA SAT. PETROSICA",PETROŞICA,IS,69,1,0,0,1,3,0,0,3,3,0,0,3,6,1,0,7,6,1,0,7
96389,365,"ŞCOALA OSOI",OSOI,IS,1570,7,0,0,7,19,4,0,23,31,5,0,36,36,5,0,41,42,5,0,47
96414,366,"ŞCOALA STÂNCA",STÎNCA,IS,187,1,0,0,1,6,2,0,8,8,2,0,10,12,6,0,18,13,6,0,19
96398,367,"SCOALA CLASELE I-VII COMARNA I",COMARNA,IS,979,2,1,0,3,5,3,0,8,7,3,0,10,9,3,0,12,9,3,0,12
96398,368,"SCOALA CLASELE I-IV COMARNA II",COMARNA,IS,1168,3,0,0,3,4,1,0,5,10,3,0,13,13,3,0,16,13,3,0,16
96405,369,"ŞCOALA CURAGĂU",CURAGĂU,IS,121,3,0,0,3,4,0,0,4,4,0,0,4,7,0,0,7,10,2,0,12
96398,370,"GRĂDINIȚA CU PROGRAM NORMAL COMARNA NR.1",COMARNA,IS,1834,2,2,0,4,8,2,0,10,17,4,0,21,19,4,0,23,24,4,0,28
95541,371,"SCOALA GIMNAZIALA NR.1 COSTESTI",COSTEŞTI,IS,1050,7,3,0,10,12,3,0,15,19,3,0,22,40,4,0,44,44,4,0,48
95578,372,"CASA SOCIALA DIN PAROHIA ORTODOXA TAIEREA CAPULUI SFANTUL IOAN BOTEZATORUL",GIURGEŞTI,IS,365,3,2,0,5,6,2,0,8,10,3,0,13,20,4,0,24,21,5,0,26
96432,373,"SCOALA GIMNAZIALĂ COSTULENI",COSTULENI,IS,1314,14,0,0,14,22,1,0,23,29,1,0,30,38,2,0,40,39,2,0,41
96441,374,"SCOALA GIMNAZIALĂ COVASNA",COVASNA,IS,883,10,0,0,10,27,3,0,30,36,8,0,44,50,15,0,65,58,16,0,74
96450,375,"SCOALA GIMNAZIALĂ COZIA",COZIA,IS,1737,3,3,0,6,6,3,0,9,7,3,0,10,12,6,0,18,13,7,0,20
96469,376,"SCOALA PRIMARĂHILIȚA",HILIŢA,IS,584,3,2,0,5,6,2,0,8,13,3,0,16,20,3,0,23,23,3,0,26
96450,377,"ȘCOALA GIMNAZIALĂ COZIA",COZIA,IS,1668,4,0,0,4,11,0,0,11,15,0,0,15,23,0,0,23,24,0,0,24
96487,378,"CAMIN CULTURAL COTNARI",COTNARI,IS,1461,13,0,0,13,20,0,1,21,25,1,1,27,33,1,1,35,36,1,1,38
96496,379,"CASA DE PRAZNUIRE BAHLUI",BAHLUIU,IS,269,0,0,0,0,4,1,0,5,10,1,0,11,14,2,0,16,14,2,0,16
96539,380,"SCOALA HODORA",HODORA,IS,1303,3,0,0,3,22,1,0,23,31,1,0,32,37,2,0,39,37,4,0,41
96548,381,"SCOALA HORODISTEA",HORODIŞTEA,IS,470,3,3,0,6,3,3,0,6,5,3,0,8,7,5,0,12,7,5,0,12
96511,382,"SCOALA CIRJOAIA",CÎRJOAIA,IS,1377,4,1,0,5,5,2,0,7,10,4,0,14,14,5,0,19,14,6,0,20
96575,383,"SCOALA VALEA RACULUI","VALEA RACULUI",IS,268,4,0,0,4,11,3,0,14,11,3,0,14,16,3,0,19,16,4,0,20
96584,384,"SCOALA ZBERENI",ZBERENI,IS,631,1,0,0,1,8,2,0,10,8,3,0,11,10,6,0,16,10,7,0,17
96566,385,"SCOALA LUPARIA",LUPĂRIA,IS,277,1,3,0,4,1,3,0,4,4,3,0,7,5,3,0,8,5,3,0,8
96600,386,"GRUP ŞCOLARCOZMESTI",COZMEŞTI,IS,1189,6,0,0,6,28,5,0,33,45,6,0,51,63,10,0,73,72,12,0,84
96628,387,"SCOALA NOUĂ PODOLENII DE SUS","PODOLENII DE SUS",IS,751,1,0,0,1,4,0,0,4,12,0,0,12,23,3,0,26,23,3,0,26
96619,388,"SCOALAPODOLENII DE JOS","PODOLENII DE JOS",IS,260,4,0,0,4,8,3,0,11,11,3,0,14,12,4,0,16,12,4,0,16
96646,389,"SCOALA PROFESIONALA CRISTEŞTI",CRISTEŞTI,IS,1299,6,1,0,7,10,4,0,14,19,4,0,23,27,5,0,32,31,5,0,36
96646,390,"SCOALA PROFESIONALA CRISTEŞTI",CRISTEŞTI,IS,1046,3,1,0,4,8,1,0,9,11,2,0,13,18,4,0,22,23,4,0,27
96646,391,"ŞCOALA PRIMARA HEREŞTI",CRISTEŞTI,IS,613,13,2,0,15,22,7,0,29,39,10,0,49,40,10,0,50,48,11,0,59
96655,392,"ŞCOALA HOMIŢA",HOMIŢA,IS,282,1,3,0,4,2,5,0,7,7,5,0,12,8,7,0,15,10,7,0,17
96673,393,"GRĂDINIŢA CUCUTENI",CUCUTENI,IS,717,6,1,0,7,19,6,0,25,30,8,0,38,35,8,0,43,36,11,0,47
96708,394,"ŞCOALA SĂCĂREŞTI",SĂCĂREŞTI,IS,339,13,4,0,17,17,5,0,22,31,5,0,36,54,6,0,60,54,6,0,60
96726,395,"ȘCOALA PROFESIONALA DAGÎȚA - CORP NOU",DAGÎŢA,IS,1336,7,0,0,7,13,3,0,16,22,3,0,25,25,3,0,28,31,3,0,34
96762,396,"SCOALA GENERALĂ MĂNĂSTIREA",MĂNĂSTIREA,IS,904,5,0,0,5,8,0,0,8,11,0,0,11,12,0,0,12,15,0,0,15
96735,397,"LOCUINȚĂ PROPRIETATE MARDARE ELENA",BĂLUŞEŞTI,IS,149,1,1,0,2,2,4,0,6,3,4,0,7,5,4,0,9,5,4,0,9
96744,398,"SCOALA PRIMARĂ BOATCA",BOATCA,IS,216,4,1,0,5,6,3,0,9,6,3,0,9,11,3,0,14,11,4,0,15
96771,399,"SCOALAPRIMARĂ PISCU RUSULUI","PISCU RUSULUI",IS,397,1,4,0,5,4,4,0,8,12,4,0,16,12,4,0,16,16,4,0,20
96780,400,"CENTRU DE ORGANIZARE PENTRU INTEGRARE SI INFORMARE - C.O.P.I.I. PENTRU COMUNITATEA POIENILE",POIENILE,IS,226,1,0,0,1,1,0,0,1,2,3,0,5,5,3,0,8,7,3,0,10
96806,401,"SCOALA PRIMARĂZECE PRAJINI","ZECE PRĂJINI",IS,390,2,0,0,2,4,0,0,4,5,0,0,5,20,1,0,21,25,1,0,26
96824,402,"SCOALA GIMNAZIALADELENI",DELENI,IS,1620,11,1,0,12,30,3,0,33,39,4,0,43,42,7,0,49,48,7,0,55
96824,403,"GRADINITACU PROGRAM NORMAL DELENI( SEDIUL NOU)",DELENI,IS,1866,15,2,0,17,26,3,0,29,38,5,0,43,45,5,0,50,49,6,0,55
96851,404,"SCOALA GIMNAZIALAMAXUT",MAXUT,IS,1084,9,1,0,10,22,1,0,23,28,4,0,32,42,8,0,50,42,8,0,50
96851,405,"GRADINITA CU PROGRAM NORMALMAXUT",MAXUT,IS,790,1,7,0,8,12,7,0,19,13,8,0,21,22,8,0,30,26,8,0,34
96879,406,"SCOALA GIMNAZIALA SLOBOZIA",SLOBOZIA,IS,962,6,2,0,8,13,2,0,15,17,2,0,19,20,3,0,23,22,4,0,26
96833,407,"SCOALA GIMNAZIALA FEREDENI",FEREDENI,IS,647,2,0,0,2,5,0,0,5,10,0,0,10,12,0,0,12,16,1,0,17
96860,408,"GRADINITACU PROGRAM NORMAL POIANA",POIANA,IS,908,6,3,0,9,17,4,0,21,25,4,0,29,29,4,0,33,33,4,0,37
96897,409,"ŞCOALA GENERALĂ NR.1 MOLDOVENI",DOBROVĂŢ,IS,1090,10,1,0,11,14,1,0,15,19,3,0,22,22,3,0,25,22,3,0,25
96897,410,"CENTRU DE ZI AFTER SCHOOL RUSI",DOBROVĂŢ,IS,793,0,0,0,0,6,2,0,8,8,3,0,11,17,7,0,24,19,11,0,30
96913,411,"ŞCOALA DOLHEŞTI",DOLHEŞTI,IS,561,6,1,0,7,19,5,0,24,38,7,0,45,44,7,6,57,55,7,6,68
96922,412,"ŞCOALA BRĂDICEŞTI",BRĂDICEŞTI,IS,779,1,3,0,4,1,3,0,4,4,5,0,9,8,6,0,14,10,6,0,16
96931,413,"ŞCOALA PIETRIŞ",PIETRIŞ,IS,763,3,3,0,6,6,3,0,9,11,3,0,14,16,3,0,19,16,4,0,20
99334,414,"GRĂDINIŢĂ DRĂGUŞENI",DRĂGUŞENI,IS,754,8,2,0,10,15,4,0,19,19,4,0,23,25,5,16,46,25,5,16,46
99343,415,"ŞCOLA FRENCIUGI",FRENCIUGI,IS,416,11,3,0,14,15,5,0,20,25,5,11,41,38,7,11,56,42,7,11,60
96959,416,"LICEUL TEHNOLOGIC DUMESTI",DUMEŞTI,IS,1380,10,1,0,11,31,1,0,32,44,1,0,45,60,2,0,62,63,2,0,65
96995,417,"SCOALA GIMNAZIALA PAUSESTI",PĂUŞEŞTI,IS,1368,6,0,0,6,18,2,0,20,23,2,0,25,24,2,0,26,24,2,0,26
96977,418,"GRADINITA CU PROGRAM NORMAL CHILISOAIA",CHILIŞOAIA,IS,154,1,0,0,1,4,1,0,5,6,1,0,7,6,1,0,7,6,1,0,7
96986,419,"SCOALA PRIMARA HOISESTI",HOISEŞTI,IS,627,2,1,0,3,5,2,0,7,8,2,0,10,10,4,0,14,11,4,0,15
96968,420,"CLADIREA FOSTEI SCOLI PRIMARE BANU",BANU,IS,322,5,2,0,7,7,3,0,10,13,3,0,16,19,4,0,23,20,4,0,24
97018,421,"SCOALA GENERALA ERBICENI CORP CLADIRE",ERBICENI,IS,885,9,0,0,9,24,3,0,27,30,4,0,34,45,4,0,49,46,4,0,50
97018,422,"SCOALA GENERALA ERBICENI CORP CLADIRE",ERBICENI,IS,1054,12,3,0,15,30,3,0,33,38,4,0,42,43,5,0,48,46,5,0,51
97027,423,"SCOALA GENERALA BIRLESTI",BÎRLEŞTI,IS,571,4,4,0,8,11,5,0,16,13,5,0,18,14,9,0,23,14,9,0,23
97054,424,"SCOALA GENERALATOTOESTI",TOTOEŞTI,IS,1303,8,5,0,13,20,5,0,25,31,6,0,37,39,9,0,48,42,11,0,53
97036,425,"SCOALA GENERALA ERBICENI CLS. I-IVCONSTANTIN ERBICEANU",SPINOASA,IS,244,0,0,0,0,1,2,0,3,2,3,0,5,2,6,0,8,2,6,0,8
97045,426,"SCOALA GENERALAERBICENI CORP CLADIRE CLS. I-IV CONSTANTIN ERBICEANU",SPRÎNCEANA,IS,314,2,2,0,4,5,2,0,7,8,2,0,10,12,3,0,15,12,3,0,15
97081,427,"GRĂDINIŢA NR.1 FÂNTÂNELE",FÂNTÂNELE,IS,1528,11,1,0,12,24,2,0,26,32,5,0,37,39,5,0,44,39,5,0,44
97072,428,"CĂMINUL CULTURAL",FOCURI,IS,1547,11,0,0,11,18,3,0,21,24,3,0,27,31,3,0,34,33,3,0,36
97072,429,"GRĂDINIŢA NR. 2, PĂŞCĂNENI",FOCURI,IS,1447,11,0,0,11,17,0,0,17,19,0,0,19,21,1,0,22,28,1,0,29
97107,430,"SCOALA GIMNAZIALA GOLAIESTI",GOLĂIEŞTI,IS,1558,6,1,0,7,15,4,0,19,20,6,0,26,32,7,0,39,35,7,0,42
97143,431,"SCOALA PRIMARA GRADINARI",GRĂDINARI,IS,312,3,0,0,3,7,1,0,8,16,2,0,18,22,4,0,26,22,4,0,26
97134,432,"SCOALA PRIMARA COTU LUI IVAN","COTU LUI IVAN",IS,319,2,0,0,2,4,1,0,5,4,1,0,5,6,1,0,7,6,1,0,7
97161,433,"SCOALA PRIMARA PETRESTI",PETREŞTI,IS,239,2,1,0,3,2,1,0,3,9,3,0,12,17,6,0,23,17,6,0,23
97170,434,"SCOALA PRIMARA PODU JIJIEI","PODU JIJIEI",IS,205,2,5,0,7,11,9,0,20,14,9,0,23,16,10,0,26,18,10,0,28
97125,435,"SCOALA PRIMARA CILIBIU",CILIBIU,IS,393,1,1,0,2,5,2,0,7,7,3,0,10,8,3,0,11,13,3,0,16
97198,436,"SCOALA GIMNAZIALA",GORBAN,IS,596,4,1,0,5,7,1,0,8,12,2,0,14,19,5,0,24,20,5,0,25
97214,437,"ȘCOALA PRIMARĂ","PODU HAGIULUI",IS,502,7,0,0,7,11,1,0,12,16,1,0,17,19,2,0,21,21,2,0,23
97223,438,"ȘCOALA PRIMARĂ",SCOPOSENI,IS,599,6,0,0,6,7,0,0,7,14,0,0,14,14,0,0,14,16,0,0,16
97232,439,"ȘCOALA PRIMARĂ",ZBEROAIA,IS,286,1,0,0,1,3,0,0,3,11,0,0,11,13,0,0,13,14,0,0,14
97205,440,"ȘCOALA GIMNAZIALĂ","GURA BOHOTIN",IS,400,2,2,0,4,5,2,0,7,18,2,0,20,24,2,0,26,25,3,0,28
97250,441,"SCOALA GIMNAZIALA GRAJDURI",GRAJDURI,IS,1312,9,2,0,11,12,2,0,14,15,3,0,18,16,3,0,19,22,3,0,25
97250,442,"SCOALA GIMNAZIALA GRAJDURI",GRAJDURI,IS,1035,6,1,0,7,9,1,0,10,12,1,0,13,17,2,0,19,18,2,0,20
97312,443,"SCOALA PRIMARA VALEA SATULUI","VALEA SATULUI",IS,1611,3,3,0,6,6,3,0,9,7,3,0,10,10,3,0,13,11,3,0,14
97312,444,"SCOALA PRIMARA VALEA SATULUI","VALEA SATULUI",IS,1672,6,0,0,6,9,0,0,9,12,2,0,14,15,2,0,17,15,2,0,17
97269,445,"SCOALA PRIMARA CARBUNARI",CĂRBUNARI,IS,910,1,1,0,2,5,1,0,6,9,1,0,10,10,1,0,11,12,3,0,15
97296,446,"SCOALAPRIMARA PADURENI",PĂDURENI,IS,1201,0,2,0,2,2,2,0,4,2,3,0,5,2,4,0,6,2,4,0,6
97303,447,"SCOALA PRIMARA POIANA CU CETATE","POIANA CU CETATE",IS,136,0,0,0,0,2,1,0,3,4,3,0,7,4,4,0,8,5,4,0,9
97296,448,"SCOALA PRIMARA PADURENI",PĂDURENI,IS,818,1,3,0,4,4,3,0,7,4,3,0,7,4,3,0,7,4,3,0,7
97330,449,"ȘCOALA GROPNIŢA",GROPNIŢA,IS,334,5,0,0,5,6,0,0,6,7,1,0,8,12,1,0,13,13,3,0,16
97349,450,"SEDIUL PRIMĂRIEI",BULBUCANI,IS,532,7,3,0,10,13,4,0,17,15,4,0,19,17,4,0,21,24,4,0,28
97358,451,"CĂMIN CULTURAL FORĂŞTI",FORĂŞTI,IS,421,2,0,0,2,4,0,0,4,7,0,0,7,9,0,0,9,10,0,0,10
97367,452,GRĂDINIȚAMĂLĂEŞTI,MĂLĂEŞTI,IS,331,3,1,0,4,12,4,0,16,19,4,0,23,20,4,0,24,20,5,0,25
97376,453,"ŞCOALA SĂVENI",SĂVENI,IS,602,0,0,0,0,1,2,0,3,1,2,0,3,3,3,0,6,4,3,0,7
97385,454,"ŞCOALA SÎNGERI",SÎNGERI,IS,312,7,0,0,7,21,5,0,26,26,8,0,34,28,8,0,36,29,8,0,37
97401,455,"SC. GIMNAZIALA GROZESTI",GROZEŞTI,IS,925,10,2,0,12,13,2,0,15,16,4,0,20,18,5,0,23,19,5,0,24
97410,456,"GRADINITA COLTU-CORNII","COLŢU CORNII",IS,455,1,0,0,1,3,1,0,4,9,1,0,10,10,1,0,11,10,1,0,11
97447,457,"SCOALA GENERALA HALAUCESTI",HĂLĂUCEŞTI,IS,1446,8,0,0,8,12,0,0,12,13,0,0,13,21,1,0,22,24,2,0,26
97447,458,"CAMIN CULTURAL HALAUCESTI",HĂLĂUCEŞTI,IS,1355,7,2,0,9,11,2,0,13,14,2,0,16,19,4,0,23,19,6,0,25
97447,459,"CAMIN CULTURAL HALAUCESTI",HĂLĂUCEŞTI,IS,1215,2,0,0,2,12,0,0,12,17,1,0,18,19,1,0,20,21,2,0,23
97456,460,"SCOALA GENERALA LUNCASI",LUNCAŞI,IS,782,7,0,0,7,13,0,0,13,17,3,0,20,32,6,0,38,34,7,0,41
99584,461,"GRĂDINIȚA CU PROGRAM NORMAL HĂRMĂNEȘTII VECHI","HĂRMĂNEŞTII VECHI",IS,1288,6,2,0,8,13,2,0,15,21,3,0,24,25,3,0,28,29,4,0,33
99575,462,"ŞCOALA HĂRMĂNEŞTII NOI","HĂRMĂNEŞTII NOI",IS,703,4,2,0,6,27,4,0,31,37,5,0,42,41,6,0,47,43,7,0,50
97474,463,"SCOALA GIMNAZIALA HELESTENI",HELEŞTENI,IS,648,5,1,0,6,13,2,0,15,13,2,0,15,19,3,0,22,26,6,0,32
97483,464,"CENTRUL EDUCATIV PENTRU COPII SARACI HARMANEASA",HĂRMĂNEASA,IS,589,9,0,0,9,11,1,0,12,12,1,0,13,20,8,0,28,23,9,0,32
97508,465,"SCOALA GIMNAZIALA OBOROCENI",OBOROCENI,IS,625,9,1,0,10,14,2,0,16,16,3,0,19,22,3,0,25,22,3,0,25
97492,466,"SCOALA GENERALA MOVILENI",MOVILENI,IS,163,5,0,0,5,11,1,0,12,13,1,0,14,14,2,0,16,14,2,0,16
95211,467,"SCOALA CU CLASELE I-VIII","RUSENII VECHI",IS,534,1,6,0,7,5,6,0,11,9,6,0,15,9,6,0,15,9,6,0,15
95168,468,"SCOALA HOLBOCA",HOLBOCA,IS,1463,3,0,0,3,9,2,0,11,16,5,0,21,26,5,0,31,26,5,0,31
95168,469,"SCOALA HOLBOCA",HOLBOCA,IS,1433,4,4,0,8,8,4,0,12,21,6,0,27,31,6,0,37,32,6,0,38
95186,470,"GRADINITA CU PROGRAM NORMAL DANCU",DANCU,IS,1332,9,3,0,12,22,3,0,25,36,5,0,41,46,9,0,55,52,9,0,61
95186,471,"GRADINITA CU PROGRAM NORMAL DANCU",DANCU,IS,1442,9,6,0,15,26,7,0,33,36,7,0,43,49,8,0,57,51,10,0,61
95186,472,"SCOALA STEFAN CEL MARE",DANCU,IS,1261,7,1,0,8,31,1,0,32,43,2,0,45,58,3,0,61,62,4,0,66
95186,473,"SCOALA STEFAN CEL MARE",DANCU,IS,1507,11,0,0,11,24,2,0,26,33,2,0,35,43,6,0,49,48,6,0,54
95186,474,"SCOALA STEFAN CEL MARE",DANCU,IS,1414,6,4,0,10,29,4,0,33,37,4,0,41,52,4,0,56,52,4,0,56
95202,475,"SCOALA CU CLASELE I-IV","RUSENII NOI",IS,348,1,6,0,7,2,6,0,8,4,6,0,10,6,7,0,13,8,8,0,16
95195,476,"SPAȚIUCOMERCIAL PROPRIETATEGOLĂESCUMARIA",ORZENI,IS,629,5,1,0,6,11,1,0,12,21,1,0,22,27,2,0,29,29,2,0,31
95177,477,"SCOALA CU CLASELE I-IV",CRISTEŞTI,IS,611,7,0,0,7,14,0,0,14,20,0,0,20,34,2,0,36,34,2,0,36
95220,478,"SCAOALA VALEA LUNGA","VALEA LUNGĂ",IS,272,2,4,0,6,10,7,0,17,23,16,0,39,29,17,0,46,29,17,0,46
97526,479,"CAMIN CULTURAL SATUL HORLEŞTI",HORLEŞTI,IS,1151,9,1,0,10,18,3,0,21,26,4,0,30,35,5,0,40,39,5,0,44
97526,480,"BIBLIOTECA COMUNALA SATUL HORLEŞTI",HORLEŞTI,IS,404,4,2,0,6,9,2,0,11,14,5,0,19,15,5,0,20,17,8,0,25
97535,481,"ŞCOALA BOGDĂNEŞTI",BOGDĂNEŞTI,IS,529,10,9,0,19,22,10,0,32,31,12,0,43,36,12,0,48,36,12,0,48
97544,482,"FOSTA ŞCOALĂ SATUL SCOPOSENI",SCOPOSENI,IS,228,5,0,0,5,5,2,0,7,5,2,0,7,5,3,0,8,7,4,0,11
95603,483,"SCOALA GIMNAZIALĂ ""CONSTANTIN TEODORESCU""RAZBOIENI",RĂZBOIENI,IS,1683,19,1,0,20,30,2,0,32,43,3,0,46,50,3,0,53,57,3,0,60
95523,484,"SCOALA GIMNAZIALABUZNEA",BUZNEA,IS,1396,10,2,0,12,11,2,0,13,19,2,0,21,25,3,0,28,31,3,0,34
95550,485,"SCOALA PRIMARADADESTI",DĂDEŞTI,IS,222,1,0,0,1,4,1,0,5,4,2,0,6,9,2,0,11,9,7,0,16
95569,486,"CENTRUL DE ÎNGRIJIRE DE ZI PENTRU COPII-GĂNEŞTI",GĂNEŞTI,IS,618,5,5,0,10,5,5,0,10,5,5,0,10,7,5,0,12,9,5,0,14
95587,487,"CASA SOCIALA ION NECULCE","ION NECULCE",IS,149,0,0,0,0,1,4,0,5,3,4,0,7,3,5,0,8,3,5,0,8
95596,488,"SCOALA PRIMARA PRIGORENI",PRIGORENI,IS,530,5,6,0,11,8,8,0,16,9,8,0,17,13,8,0,21,13,8,0,21
97562,489,"SCOLA GIMNAZIALA”ION HAULICA”IPATELE",IPATELE,IS,514,8,1,0,9,9,3,0,12,12,3,0,15,15,3,0,18,16,3,0,19
97599,490,"PUNCT SANITAR CUZA-VODĂ","CUZA VODĂ",IS,378,7,2,0,9,10,3,0,13,13,3,0,16,19,5,0,24,20,6,0,26
97580,491,"CĂMIN CULTURAL BÎCU",BÎCU,IS,434,1,0,0,1,3,0,0,3,6,0,0,6,9,3,0,12,10,4,0,14
97615,492,"LICEUL TEHNOLOGIC LESPEZI",LESPEZI,IS,815,3,2,0,5,8,2,0,10,12,2,0,14,16,2,0,18,18,2,0,20
97660,493,"SCOALA GIMNAZIALA HECI",HECI,IS,930,3,0,0,3,6,3,0,9,12,3,0,15,14,3,0,17,16,3,0,19
97660,494,"SCOALA GIMNAZIALA HECI",HECI,IS,843,8,0,0,8,14,0,0,14,17,2,0,19,20,2,0,22,20,2,0,22
97624,495,"ȘCOALA GIMNAZIALĂ BUDA",BUDA,IS,870,4,0,0,4,9,7,0,16,10,9,0,19,12,9,0,21,13,10,0,23
97633,496,"SCOALA PRIMARĂ BERSUC DEAL",BURSUC-DEAL,IS,678,5,1,0,6,16,4,0,20,27,5,0,32,40,9,0,49,41,9,0,50
97651,497,"SCOALA PRIMARĂ DUMBRAVA",DUMBRAVA,IS,567,7,0,0,7,22,6,0,28,29,7,0,36,39,7,0,46,41,7,0,48
97688,498,"SCOALA GIMNAZIALA LETCANI",LEŢCANI,IS,1883,21,0,0,21,40,5,0,45,53,5,0,58,68,6,0,74,81,6,0,87
97688,499,"SCOALA GIMNAZIALA LETCANI",LEŢCANI,IS,1670,6,2,0,8,18,2,0,20,27,4,0,31,31,6,0,37,38,6,0,44
97697,500,"SCOALA PRIMARA BOGONOS",BOGONOS,IS,645,10,0,0,10,18,3,0,21,24,3,0,27,39,7,0,46,44,7,0,51
97704,501,"SCOALA GIMNAZIALA COGEASCA",COGEASCA,IS,1588,10,3,0,13,14,3,0,17,20,3,0,23,31,3,0,34,34,4,0,38
97713,502,"SCOALA PRIMARA CUCUTENI",CUCUTENI,IS,381,9,0,0,9,22,0,0,22,29,1,0,30,33,2,0,35,34,2,0,36
97731,503,"LICEUL TEHNOLOGIC LUNGANI",LUNGANI,IS,862,12,1,0,13,28,2,0,30,33,2,0,35,41,2,0,43,52,2,0,54
97740,504,"GRADINITA DIN CADRUL SCOLII GIMNAZIALE CRUCEA",CRUCEA,IS,1194,3,3,0,6,13,3,0,16,28,4,0,32,34,4,0,38,37,4,0,41
97759,505,"GRADINITA DIN CADRUL SCOLII GIMNAZIALE GOESTI",GOEŞTI,IS,699,8,2,0,10,15,2,0,17,20,2,0,22,24,5,0,29,24,5,0,29
97768,506,"GRADINITA DIN CADRUL SCOLII GIMNAZIALE ZMEU",ZMEU,IS,1297,8,1,0,9,68,3,0,71,184,6,0,190,301,7,0,308,315,7,0,322
97786,507,"CAMINUL CULTURAL MADIRJAC",MĂDÎRJAC,IS,1148,4,3,0,7,6,3,0,9,9,4,0,13,14,4,0,18,19,7,0,26
97820,508,"ŞCOALAGIMNAZIALA VASILE ALECSANDRI MIRCESTI",MIRCEŞTI,IS,1274,8,7,0,15,28,7,0,35,30,7,0,37,39,12,0,51,44,12,0,56
97839,509,"SCOALA GIMNAZIALA IUGANI",IUGANI,IS,1314,5,0,0,5,8,2,0,10,12,2,0,14,19,3,0,22,24,3,0,27
97839,510,"GRADINITA CU PROGRAM NORMAL IUGANI",IUGANI,IS,503,0,0,0,0,0,0,0,0,1,0,0,1,2,2,0,4,4,2,0,6
97884,511,"SCOALA GIMNAZIALA MIRONEASA",MIRONEASA,IS,1476,15,2,0,17,24,2,0,26,28,4,0,32,33,4,0,37,33,5,0,38
97884,512,"SCOALA GIMNAZIALA MIRONEASA",MIRONEASA,IS,1321,11,1,0,12,17,1,0,18,24,1,0,25,37,1,0,38,38,1,0,39
97884,513,"SCOALA GIMNAZIALA MIRONEASA",MIRONEASA,IS,1151,17,1,0,18,22,1,0,23,27,1,0,28,36,3,0,39,39,3,0,42
97900,514,"SCOALA GIMNAZIALA URSITA",URŞIŢA,IS,462,6,0,0,6,12,3,0,15,16,3,0,19,27,3,0,30,32,3,0,35
97928,515,"SCOALA GIMNAZIALA ” COLONEL CONSTANTIN LANGA ”-MIROSLAVA",MIROSLAVA,IS,1711,4,1,0,5,19,4,0,23,28,4,0,32,39,4,0,43,47,6,0,53
97928,516,"SCOALA GIMNAZIALA ”COLONEL CONSTANTIN LANGA”-MIROSLAVA",MIROSLAVA,IS,1630,6,0,0,6,19,5,0,24,29,8,0,37,39,9,0,48,45,10,0,55
97937,517,"SALA DE SPORT -MIROSLAVA",BALCIU,IS,1053,7,2,0,9,24,9,0,33,33,15,0,48,45,16,0,61,47,18,0,65
97946,518,"SCOALA CU CLASELE I-IV BRĂTULENI",BRĂTULENI,IS,322,4,0,0,4,5,0,0,5,6,0,0,6,8,0,0,8,12,0,0,12
97955,519,"SCOALA CU CLASELE I-IV CIURBESTI",CIURBEŞTI,IS,958,6,2,0,8,15,2,0,17,23,3,0,26,34,8,0,42,37,9,0,46
97964,520,"SCOALA GIMNAZIALĂ ”DIMITRIE ANGHEL”- CORNESTI",CORNEŞTI,IS,1025,10,1,0,11,16,2,0,18,26,3,0,29,32,4,0,36,36,4,0,40
97991,521,"GRADINITA CU PROGRAM NORMAL -HORPAZ",HORPAZ,IS,2077,8,0,0,8,27,3,0,30,43,3,0,46,55,13,0,68,68,16,0,84
98015,522,"SCOALA GIMNAZIALA ”MIRON BARNOVSCHI”-URICANI",URICANI,IS,935,20,3,0,23,43,3,0,46,52,3,0,55,64,9,0,73,66,9,0,75
98024,523,"GRADINITA CU PROGRAM NORMAL-VALEA ADINCA","VALEA ADÎNCĂ",IS,2001,16,1,0,17,35,3,0,38,51,3,0,54,63,3,0,66,71,3,0,74
98024,524,"MAGAZIN MOBILA TOFAN","VALEA ADÎNCĂ",IS,2651,29,3,0,32,62,14,0,76,97,21,0,118,120,35,0,155,132,40,0,172
98042,525,"SCOALA PRIMARA-VOROVESTI",VOROVEŞTI,IS,762,2,0,0,2,18,1,0,19,28,1,0,29,36,3,0,39,37,3,0,40
98060,526,"SCOALA GIMNAZIALAMIROSLOVESTI",MIROSLOVEŞTI,IS,1533,10,0,0,10,21,3,0,24,28,5,0,33,45,5,0,50,54,8,0,62
98097,527,"SCOALA GIMNAZIALASOCI",SOCI,IS,1073,23,2,0,25,29,3,0,32,40,3,0,43,42,3,0,45,84,6,0,90
98104,528,"SCOALA GIMNAZIALA VERSENI",VERŞENI,IS,968,3,1,0,4,9,2,0,11,17,4,0,21,28,4,0,32,32,6,0,38
98122,529,"LICEUL TEHNOLOGIC DUMITRU POPA - MOGOȘEȘTI",MOGOŞEŞTI,IS,1322,4,0,0,4,13,0,0,13,29,0,0,29,35,0,0,35,35,3,0,38
98122,530,"LICEUL TEHNOLOGIC DUMITRU POPA - MOGOȘEȘTI",MOGOŞEŞTI,IS,1025,7,3,0,10,15,5,0,20,28,9,0,37,37,12,0,49,38,13,0,51
98159,531,"ŞCOALA GIMNAZIALĂ MÎNJEȘTI, CORP CLĂDIRE NR. 2",MÎNJEŞTI,IS,494,5,3,0,8,18,4,0,22,20,6,0,26,33,7,0,40,34,7,0,41
98140,532,"CENTRUL DE ZI AFTER SCHOOL SAT HADÎMBU",HADÎMBU,IS,818,1,0,0,1,5,4,0,9,6,9,0,15,8,9,0,17,8,11,0,19
98131,533,"CASA SOCIALA BISERICA SF.PARASCHEVA BUDESTI",BUDEŞTI,IS,296,8,1,0,9,15,1,0,16,20,4,0,24,21,5,0,26,22,6,0,28
98177,534,"SCOALA GIMNAZIALAMOGOSESTI-SIRET",MOGOŞEŞTI-SIRET,IS,1379,16,4,0,20,46,4,0,50,58,5,0,63,76,6,0,82,84,8,0,92
98186,535,"SCOALA GIMNAZIALA MUNCELU DE SUS","MUNCELU DE SUS",IS,911,6,2,0,8,23,2,0,25,29,2,0,31,31,4,0,35,35,4,0,39
98186,536,"SCOALA GIMNAZIALA MUNCELU DE SUS","MUNCELU DE SUS",IS,851,5,1,0,6,14,1,0,15,21,1,0,22,25,2,0,27,29,2,0,31
98211,537,"ŞCOALA GIMNAZIALĂ MOŞNA",MOŞNA,IS,1285,3,0,0,3,8,1,0,9,9,1,0,10,18,1,0,19,20,1,0,21
98211,538,"ȘCOALA GIMNAZIALĂ MOȘNA",MOŞNA,IS,1732,5,0,0,5,10,0,0,10,13,0,0,13,29,1,0,30,35,1,0,36
98211,539,"ȘCOALA GIMNAZIALĂ MOȘNA",MOŞNA,IS,1558,10,1,0,11,12,1,0,13,15,1,0,16,20,2,0,22,25,2,0,27
98211,540,"ȘCOALA GIMNAZIALĂ MOȘNA",MOŞNA,IS,1555,0,0,0,0,0,0,0,0,0,0,0,0,0,0,0,0,0,0,0,0
98211,541,"ȘCOALA GIMNAZIALĂ MOȘNA",MOŞNA,IS,1809,0,0,0,0,0,0,0,0,0,1,0,1,0,1,0,1,0,1,0,1
98239,542,"CĂMIN CULTURAL",MOŢCA,IS,1586,22,0,0,22,40,0,0,40,59,4,0,63,75,5,0,80,83,6,0,89
98239,543,"CĂMIN CULTURAL",MOŢCA,IS,1456,6,0,0,6,20,0,0,20,23,1,0,24,40,2,0,42,54,3,0,57
98248,544,"GRADINITA CU PROGRAM NORMAL BOURENI",BOURENI,IS,1178,5,1,0,6,8,3,0,11,21,4,0,25,26,4,0,30,36,4,0,40
98266,545,"GRADINITA CUPROGRAM NORMALMOVILENI",MOVILENI,IS,433,6,2,0,8,10,2,0,12,12,4,0,16,19,5,0,24,23,6,0,29
98275,546,"SCOALA PRIMARA IEPURENI",IEPURENI,IS,695,4,3,0,7,11,5,0,16,14,6,0,20,18,6,0,24,21,6,0,27
98284,547,"SCOALA GIMNAZIALA LARGA JIJIA",LARGA-JIJIA,IS,613,3,0,0,3,3,0,0,3,7,0,0,7,10,0,0,10,10,0,0,10
98293,548,"SCOALA PRIMARA POTINGENI",POTÎNGENI,IS,734,3,0,0,3,8,0,0,8,14,0,0,14,19,0,0,19,19,0,0,19
98319,549,"CĂMIN CULTURAL - SALA I OTELENI",OŢELENI,IS,1008,12,0,0,12,20,0,0,20,22,0,0,22,29,0,0,29,29,4,0,33
98319,550,"CĂMIN CULTURAL - SALA II OTELENI",OŢELENI,IS,1060,8,0,0,8,18,0,0,18,18,2,0,20,26,4,0,30,33,5,0,38
98328,551,"SCOALA GIMNAZIALA HINDRESTI",HÎNDREŞTI,IS,874,5,3,0,8,11,3,0,14,18,4,0,22,21,4,13,38,22,4,13,39
98346,552,"LICEUL TEHNOLOGIC PLUGARI",PLUGARI,IS,1497,15,1,0,16,24,2,0,26,29,3,0,32,33,3,0,36,34,3,0,37
98355,553,"SCOALA GIMNAZIALA BOROSOAIA",BOROSOAIA,IS,1214,7,5,0,12,13,6,0,19,22,7,0,29,34,8,0,42,35,8,0,43
98444,554,"SCOALA GENERALA,, DIMITRIE STURDZA ''POPESTI",POPEŞTI,IS,879,6,2,0,8,12,4,0,16,19,4,0,23,21,4,0,25,25,4,0,29
98444,555,"SCOALA GENERALA ,,DIMITRIE STURDZA''POPESTI",POPEŞTI,IS,898,10,2,0,12,20,4,0,24,25,4,0,29,38,6,0,44,40,7,0,47
98471,556,"ŞCOALA PRIMARA""NICOLAIEBUTESCU"" OBRIJENI",OBRIJENI,IS,1373,4,1,0,5,7,1,0,8,8,2,0,10,10,4,0,14,10,4,0,14
98453,557,"ŞCOALA PRIMARADOROSCANI",DOROŞCANI,IS,480,3,2,0,5,5,2,0,7,10,2,0,12,14,2,0,16,18,2,0,20
98462,558,"ŞCOALA GIMNAZIALAHARPASESTI",HĂRPĂŞEŞTI,IS,751,13,5,0,18,14,6,0,20,23,8,0,31,25,8,0,33,25,9,0,34
98471,559,"ŞCOALA PRIMARA ,,NICOLAIE BUTESCU''OBRIJENI",OBRIJENI,IS,1184,1,1,0,2,1,2,0,3,1,2,0,3,3,3,0,6,3,5,0,8
98514,560,SCOALAGIMNAZIALAPOPRICANI,POPRICANI,IS,1238,2,0,0,2,7,0,0,7,14,0,0,14,21,1,0,22,22,2,0,24
98514,561,SCOALAGIMNAZIALAPOPRICANI,POPRICANI,IS,1167,7,0,0,7,10,1,0,11,13,1,0,14,16,2,0,18,24,2,0,26
98550,562,"SCOALAGIMNAZIALA POPRICANI",MOIMEŞTI,IS,379,1,0,0,1,8,1,0,9,8,1,0,9,9,1,0,10,9,1,0,10
98578,563,"SCOALAPRIMARA TIPILESTI",ŢIPILEŞTI,IS,311,4,1,0,5,6,1,0,7,14,4,0,18,17,5,0,22,20,7,0,27
98532,564,"SCOALAPRIMARA COTU MORII","COTU MORII",IS,226,1,0,0,1,6,0,0,6,8,0,0,8,9,2,0,11,11,4,0,15
98587,565,"SCOALA GIMNAZIALA VINATORI",VÎNĂTORI,IS,1275,5,5,0,10,15,6,0,21,20,8,0,28,28,13,0,41,28,13,0,41
98596,566,"SCOALA GIMNAZIALA VINATORI",VULTURI,IS,837,5,6,0,11,11,10,0,21,20,12,0,32,36,18,0,54,41,18,0,59
98523,567,"SCOALA PRIMARACIRLIG",CÎRLIG,IS,692,5,3,0,8,11,4,0,15,13,4,0,17,22,4,0,26,24,7,0,31
98541,568,"SCOALA PRIMARACUZA- VODA","CUZA VODĂ",IS,507,6,0,0,6,9,0,0,9,13,1,0,14,18,1,0,19,22,3,0,25
98612,569,"GRADINITA CU PROGRAM NORMAL PRISĂCANI",PRISĂCANI,IS,1412,11,0,0,11,19,1,0,20,24,1,0,25,39,2,0,41,43,2,0,45
98621,570,"SCOALA GIMNAZIALA MACARESTI",MĂCĂREŞTI,IS,956,1,3,0,4,5,6,0,11,11,8,0,19,16,8,0,24,16,8,0,24
98630,571,"SCOALA PRIMARA MORENI",MORENI,IS,794,10,1,0,11,13,1,0,14,17,4,0,21,26,4,0,30,27,5,0,32
98658,572,"SCOLA GIMNAZIALA'PETRUANGHEL'PROBOTA",PROBOTA,IS,976,3,1,0,4,4,3,0,7,8,3,0,11,9,5,0,14,9,5,0,14
98667,573,"PAROHIA BĂLTENI",BĂLTENI,IS,629,2,0,0,2,5,0,0,5,8,3,0,11,11,3,0,14,11,3,0,14
98676,574,"SCOLA GIMNAZIALA PERIENI",PERIENI,IS,1259,3,0,0,3,8,0,0,8,12,0,0,12,17,0,0,17,22,0,0,22
97857,575,"SCOALA NOUA RACHITENI",RĂCHITENI,IS,1544,4,0,0,4,8,0,0,8,11,2,0,13,13,2,0,15,13,2,0,15
97848,576,"SCOALA IZVOARELE",IZVOARELE,IS,1171,8,6,0,14,13,6,0,19,16,6,0,22,21,6,0,27,25,6,0,31
98694,577,"LICEUL TEORETIC LASCAR ROSETTI",RĂDUCĂNENI,IS,1262,3,3,0,6,7,5,0,12,8,5,0,13,8,9,0,17,10,9,0,19
98694,578,"LICEUL TEORETIC LASCAR ROSETTI",RĂDUCĂNENI,IS,1228,4,2,0,6,7,3,0,10,13,3,23,39,18,4,23,45,19,4,23,46
98694,579,"ŞCOALA GENERALA RADUCANENI",RĂDUCĂNENI,IS,1203,6,1,0,7,8,1,0,9,12,1,0,13,15,2,0,17,19,2,0,21
98694,580,"ŞCOALA GENERALA BAZGA",RĂDUCĂNENI,IS,1229,16,2,0,18,29,3,0,32,42,3,0,45,62,5,0,67,71,5,0,76
98701,581,"SCOALA GENERALA BOHOTIN",BOHOTIN,IS,1306,13,7,0,20,17,7,0,24,18,7,0,25,28,10,0,38,30,10,0,40
98729,582,"ŞCOALA GENERALA ROŞU",ROŞU,IS,579,1,3,0,4,1,3,0,4,4,4,0,8,5,4,0,9,5,4,0,9
98710,583,"ŞCOALA GENERALĂ ISAIIA",ISAIIA,IS,262,2,0,0,2,2,0,0,2,3,1,0,4,5,2,0,7,10,2,0,12
95248,584,"SCOALA GIMNAZIALA REDIU",REDIU,IS,1637,8,1,0,9,19,1,0,20,21,2,0,23,38,4,0,42,43,4,0,47
95248,585,"SCOALA GIMNAZIALA REDIU",REDIU,IS,1191,6,1,0,7,12,2,0,14,13,2,0,15,21,2,0,23,26,2,0,28
95257,586,"GRADINITA CU PROGRAM NORMAL BREAZU",BREAZU,IS,1565,3,2,0,5,19,4,0,23,40,4,0,44,58,6,0,64,64,7,0,71
95266,587,"SCOALA GIMNAZIALA HORLESTI",HORLEŞTI,IS,1054,2,2,0,4,8,3,0,11,18,3,0,21,23,5,0,28,23,5,0,28
98747,588,"SCOALA GIMNAZIALA ""IOANID ROMANESCU"" ROMANESTI",ROMÂNEŞTI,IS,724,9,3,0,12,15,7,0,22,19,8,0,27,22,12,0,34,22,12,0,34
98756,589,"SCOALA PRIMARA AVINTU",AVÎNTU,IS,390,4,0,0,4,9,1,0,10,14,7,0,21,20,8,0,28,24,8,0,32
98765,590,"SCOALA GIMNAZIALA URSOAIA",URSOAIA,IS,350,0,3,0,3,15,5,0,20,15,6,0,21,15,7,0,22,15,9,0,24
99637,591,"GRĂDINITA CU PROGRAM NORMALRADENI",RĂDENI,IS,565,3,2,0,5,5,3,0,8,7,5,0,12,12,9,0,21,12,11,0,23
99646,592,"ȘCOALA PRIMARĂ ROȘCANI, NR. 1",ROŞCANI,IS,553,1,6,0,7,2,6,0,8,4,7,0,11,9,7,0,16,11,9,0,20
98783,593,"ŞCOALA GIMNAZIALĂ RUGINOASA",RUGINOASA,IS,871,5,0,0,5,9,1,0,10,9,4,0,13,12,4,0,16,15,30,0,45
98783,594,"ŞCOALA GIMNAZIALĂ RUGINOASA",RUGINOASA,IS,695,0,0,0,0,9,0,0,9,11,0,0,11,20,3,0,23,22,29,0,51
98792,595,"ŞCOALA GIMNAZIALĂ DUMBRĂVIŢA",DUMBRĂVIŢA,IS,1161,6,3,0,9,12,3,0,15,17,3,0,20,21,4,0,25,24,5,0,29
98792,596,"ŞCOALA GIMNAZIALĂ DUMBRĂVIŢA",DUMBRĂVIŢA,IS,907,3,1,0,4,8,1,0,9,9,1,0,10,12,1,0,13,12,2,0,14
98809,597,"ŞCOALA GIMNAZIALĂ REDIU",REDIU,IS,983,4,2,0,6,9,2,0,11,13,3,0,16,17,4,0,21,17,4,0,21
98818,598,"ŞCOALA VASCANI",VASCANI,IS,401,4,0,0,4,6,0,0,6,8,1,0,9,9,4,0,13,9,4,0,13
98925,599,"ŞCOALA GIMNAZIALĂ ""AXINTE URICARIUL""",SCÂNTEIA,IS,1080,11,0,0,11,17,3,0,20,25,4,0,29,31,4,0,35,40,4,0,44
98925,600,"GRĂDINIȚA CU PROGRAM NORMAL SCÂNTEIA",SCÂNTEIA,IS,2005,1,0,0,1,4,0,0,4,14,0,0,14,14,1,0,15,15,5,0,20
98934,601,"ŞCOALA GIMNAZIALĂ BODEŞTI",BODEŞTI,IS,413,1,2,0,3,11,5,0,16,22,8,0,30,31,8,0,39,33,8,0,41
98943,602,"GRĂDINIŢA CU PROGRAM NORMAL BOROSEŞTI",BOROŞEŞTI,IS,728,6,2,0,8,14,3,0,17,20,5,0,25,24,7,0,31,25,7,0,32
98952,603,"ŞCOALA PRIMARĂ CIOCÂRLEŞTI",CIOCÎRLEŞTI,IS,244,8,1,0,9,11,5,0,16,15,7,0,22,17,7,0,24,22,10,0,32
98961,604,"ŞCOALA PRIMARĂ LUNCA RATEŞ","LUNCA RATEŞ",IS,329,2,3,0,5,3,3,0,6,7,3,0,10,15,5,0,20,15,6,0,21
98970,605,"ŞCOALA PRIMARĂ REDIU",REDIU,IS,168,4,0,0,4,5,1,0,6,7,1,0,8,10,3,0,13,10,5,0,15
98989,606,"ŞCOALA PRIMARĂ TUFEŞTII DE SUS","TUFEŞTII DE SUS",IS,220,0,0,0,0,5,0,0,5,6,0,0,6,8,0,0,8,8,0,0,8
98925,607,"CĂMINUL CULTURAL SCÂNTEIA",SCÂNTEIA,IS,1733,0,0,0,0,0,0,0,0,0,7,0,7,1,7,0,8,1,7,0,8
98836,608,"SCOALA PRIMARA SCHITU DUCA","SCHITU DUCA",IS,479,1,1,0,2,1,3,0,4,5,3,0,8,6,7,0,13,6,7,0,13
98872,609,"SCOALA GIMNAZIALA POIENI",POIENI,IS,661,0,0,0,0,1,1,0,2,4,1,0,5,18,1,0,19,29,1,0,30
98854,610,"SCOALA GIMNAZIALA DUMITRESTII GALATII","DUMITREŞTII GĂLĂŢII",IS,542,9,0,0,9,13,0,0,13,13,0,0,13,25,3,0,28,30,4,0,34
98863,611,"SCOALA GIMNAZIALA POCREACA",POCREACA,IS,331,3,1,0,4,14,2,0,16,21,5,0,26,37,10,0,47,37,12,0,49
98881,612,"SCOALA PRIMARA POIANA",POIANA,IS,364,5,0,0,5,7,0,0,7,11,0,0,11,23,7,0,30,28,7,0,35
98890,613,"SCOALA GIMNAZIALA SATU NOU","SATU NOU",IS,439,8,2,0,10,12,2,0,14,13,3,0,16,24,3,0,27,26,3,0,29
98907,614,"SCOALA PRIMARA SLOBOZIA",SLOBOZIA,IS,334,7,2,0,9,19,9,0,28,31,9,0,40,45,9,0,54,47,9,0,56
99003,615,"SAT SCOBINTI, SEDIU SCOALA VECHE SCOBINTI",SCOBINŢI,IS,1221,10,2,0,12,32,10,0,42,45,10,0,55,57,10,0,67,62,10,0,72
99003,616,"SAT SCOBINTI, SEDIU SCOALA ZVARICI- SCOBINTI",SCOBINŢI,IS,283,5,5,0,10,15,11,0,26,15,11,0,26,21,11,0,32,21,11,0,32
99012,617,"SAT BADENI, SEDIU SCOALA BADENI",BĂDENI,IS,1038,6,0,0,6,21,0,0,21,29,4,0,33,35,6,0,41,39,6,0,45
99021,618,"SAT FETESTI, SEDIU SCOALA COORD.",FETEŞTI,IS,1052,2,0,0,2,9,1,0,10,14,1,0,15,17,1,0,18,23,2,0,25
99030,619,"SAT STICLARIA, SEDIU SCOALA STICLARIA",STICLĂRIA,IS,1183,5,2,0,7,13,3,0,16,15,3,0,18,18,3,0,21,18,3,0,21
99030,620,"SAT STICLARIA, SEDIU SCOALA REDIU",STICLĂRIA,IS,257,4,7,0,11,10,16,0,26,18,21,0,39,22,21,0,43,22,23,0,45
99049,621,"SAT .ZAGAVIA ,CU SEDIUL LA SCOALA ZAGAVIA",ZAGAVIA,IS,945,5,7,0,12,15,9,0,24,21,9,0,30,26,10,0,36,27,11,0,38
99085,622,"ŞCOALA GIMNAZIALA OSOI",OSOI,IS,810,2,0,0,2,11,0,0,11,20,0,0,20,25,3,0,28,27,4,0,31
99067,623,"SALA DE SPORT SINEŞTI",SINEŞTI,IS,1295,5,1,0,6,18,1,0,19,29,4,0,33,41,4,0,45,51,4,0,55
99076,624,"ŞCOALA PRIMARA BOCNIŢA",BOCNIŢA,IS,263,5,0,0,5,6,0,0,6,8,3,0,11,12,4,0,16,12,4,0,16
99094,625,"ŞCOALAGIMNAZIALA STORNEŞTI",STORNEŞTI,IS,803,6,3,0,9,15,5,0,20,25,8,0,33,42,11,0,53,48,11,0,59
99110,626,"ŞCOALA GENERALĂ",SIREŢEL,IS,898,9,0,0,9,18,0,0,18,28,0,0,28,33,0,0,33,34,0,0,34
99110,627,"ŞCOALA GENERALĂ",SIREŢEL,IS,987,11,2,0,13,18,2,0,20,27,3,0,30,30,3,0,33,33,4,0,37
99156,628,"ŞCOALA GENERALĂ SLOBOZIA",SLOBOZIA,IS,653,8,1,0,9,16,1,0,17,18,2,0,20,21,2,0,23,23,2,0,25
99138,629,"ŞCOALA GENERALĂ HUMOSU",HUMOSU,IS,588,4,1,0,5,11,1,0,12,16,1,0,17,19,1,0,20,19,2,0,21
99174,630,"BIBLIOTECA MATEIMILLO",STOLNICENI-PRĂJESCU,IS,1267,25,0,0,25,30,0,0,30,37,0,0,37,54,1,0,55,59,1,0,60
99183,631,"SCOALA CU CLASELE I-IV SALA 1",BRĂTEŞTI,IS,835,6,3,0,9,7,3,0,10,11,3,0,14,12,3,0,15,13,3,0,16
99183,632,"SCOALA CU CLASELE I-VIII SALANR.1",BRĂTEŞTI,IS,550,6,1,0,7,7,1,0,8,11,1,0,12,12,2,0,14,18,2,0,20
99192,633,SCOALAGIMNAZIALACOZMESTI,COZMEŞTI,IS,943,6,0,0,6,11,1,0,12,16,3,0,19,36,3,0,39,43,3,0,46
99192,634,SCOALAGIMNAZIALACOZMESTI,COZMEŞTI,IS,784,7,0,0,7,21,0,0,21,31,0,0,31,43,0,0,43,46,0,0,46
99218,635,"SCOALA GIMNAZIALA STRUNGA",STRUNGA,IS,509,7,1,0,8,10,2,0,12,21,2,0,23,37,3,0,40,42,3,0,45
99227,636,"SCOALA PRIMARA BRATULESTI",BRĂTULEŞTI,IS,580,7,2,0,9,9,4,0,13,11,6,0,17,19,10,0,29,21,10,0,31
99236,637,"MAGAZIN CRIVESTI",CRIVEŞTI,IS,259,5,3,0,8,9,3,0,12,12,3,0,15,13,3,0,16,15,4,0,19
99281,638,"GRADINITA CU PROGRAM NORMAL HABASESTI",HĂBĂŞEŞTI,IS,325,1,2,0,3,4,2,0,6,5,2,0,7,11,3,0,14,11,3,0,14
99245,639,"SCOALA CUCOVA",CUCOVA,IS,123,3,6,0,9,3,6,0,9,3,6,0,9,6,6,0,12,6,6,0,12
99254,640,"SCOALA GIMNAZIALAFARCASENI",FĂRCĂŞENI,IS,811,3,0,0,3,5,0,0,5,5,0,0,5,9,0,0,9,12,2,0,14
99254,641,"SCOALA GIMNAZIALAFARCASENI",FĂRCĂŞENI,IS,821,1,0,0,1,2,2,0,4,8,2,0,10,12,4,0,16,13,5,0,18
99307,642,"GRUP SCOLAR SCHEIA",ŞCHEIA,IS,913,11,3,0,14,28,6,0,34,39,7,0,46,45,7,0,52,46,7,0,53
99316,643,"SCOALA GENERALĂ CĂUESTI",CĂUEŞTI,IS,432,5,0,0,5,7,1,0,8,8,4,0,12,12,5,0,17,13,6,0,19
99325,644,"SCOALA GENERALĂ CIOCA-BOCA",CIOCA-BOCA,IS,374,3,3,0,6,7,3,0,10,12,3,0,15,14,3,0,17,15,3,0,18
99352,645,"SCOALA GENERALĂ POIANA-SCHEII","POIANA ŞCHEII",IS,393,0,0,0,0,1,0,0,1,3,0,0,3,6,4,0,10,8,4,0,12
99361,646,"SCOALA GENERALĂ SATU-NOU","SATU NOU",IS,292,3,5,0,8,7,13,0,20,8,13,0,21,14,7,0,21,15,7,0,22
99389,647,"SCOALA GIMNAZIALA SIPOTE",ŞIPOTE,IS,727,2,0,0,2,4,0,0,4,8,1,0,9,10,3,0,13,11,3,0,14
99414,648,"SCOALA GIMNAZIALA IAZU NOU","IAZU NOU",IS,815,1,0,0,1,9,0,0,9,13,0,0,13,15,1,0,16,16,1,0,17
99398,649,"SCOALAGIMNAZIALA CHISCARENI",CHIŞCĂRENI,IS,1242,4,0,0,4,13,4,0,17,27,5,0,32,32,7,0,39,32,7,0,39
99405,650,"SCOALAGIMNAZIALA HALCENI",HĂLCENI,IS,1186,3,0,0,3,4,1,0,5,9,2,0,11,20,5,0,25,21,8,0,29
99450,651,"GRĂDINIŢA CU PROGRAM NORMALTANSA",TANSA,IS,1385,3,1,0,4,15,1,0,16,17,3,0,20,27,4,0,31,37,7,0,44
99469,652,"ŞCOALA GIMNAZIALĂ CL.I-VIII SUHULEŢ",SUHULEŢ,IS,927,2,0,0,2,5,1,0,6,7,1,0,8,10,1,0,11,19,5,0,24
99487,653,"LICEUL TEHNOLOGIC TATARUSI",TĂTĂRUŞI,IS,1384,7,2,0,9,15,2,0,17,25,5,0,30,39,10,0,49,42,10,0,52
99511,654,"PAROHIA ORTODOXA ''SF. MARIA'' - UDA",UDA,IS,1265,7,3,0,10,20,3,0,23,38,6,0,44,44,9,0,53,47,10,0,57
99502,655,"SCOALA GIMNAZIALAPIETROSU",PIETROSU,IS,1143,7,4,0,11,29,5,0,34,32,5,0,37,34,5,0,39,39,5,0,44
99496,656,"SCOALA PRIMARA IORCANI",IORCANI,IS,690,14,5,0,19,24,5,0,29,29,5,0,34,34,5,0,39,35,5,0,40
99548,657,"SCOALA CU CLASELE I-VIIINR.1 TODIRESTI CORP A",TODIREŞTI,IS,1868,13,2,0,15,20,2,0,22,26,4,0,30,33,4,0,37,44,4,0,48
99548,658,"SCOALA CU CLASELE I-VIII NR.1 TODIRESTI CORP A",TODIREŞTI,IS,1291,4,1,0,5,10,1,0,11,16,7,0,23,25,7,0,32,27,7,0,34
99557,659,"SCOALA PRIMARA BAICENI",BĂICENI,IS,279,4,7,0,11,6,7,0,13,11,9,0,20,13,10,0,23,17,10,0,27
99593,660,"CAMIN CULTURAL STROESTI",STROEŞTI,IS,354,7,2,0,9,13,2,0,15,21,2,0,23,25,3,0,28,27,3,0,30
95300,661,"PRIMARIA COMUNEI TOMESTI",TOMEŞTI,IS,1133,4,4,0,8,13,5,0,18,26,8,0,34,36,8,0,44,38,8,0,46
95300,662,"SEDIUL SC.D.D.PATRASCANU",TOMEŞTI,IS,1680,8,3,0,11,17,5,5,27,30,6,5,41,39,8,5,52,45,8,5,58
95300,663,"SEDIUL SC.D.D.PATRASCANU",TOMEŞTI,IS,1585,7,0,0,7,25,0,0,25,34,2,0,36,38,5,0,43,49,5,0,54
95300,664,"SEDIUL SC.D.D.PATRASCANU",TOMEŞTI,IS,1253,5,0,0,5,16,0,0,16,25,0,0,25,45,0,0,45,46,0,0,46
95300,665,"SEDIUL SC.D.D.PATRASCANU",TOMEŞTI,IS,1714,15,1,0,16,32,3,0,35,39,3,0,42,62,4,0,66,67,4,0,71
95300,666,"SEDIUL SC.D.D.PATRASCANU",TOMEŞTI,IS,1347,10,0,0,10,30,1,0,31,34,1,0,35,55,1,0,56,58,1,0,59
95319,667,"SEDIUL SCOALA GIMNAZIALA CHICEREA, SAT.CHICEREA, COM.TOMEŞTI",CHICEREA,IS,1169,6,1,0,7,12,1,0,13,17,1,0,18,25,1,0,26,25,5,0,30
95328,668,"SEDIUL SCOALA GIMNAZIALAGORUNI, SATUL GORUNI, COM.TOMEŞTI",GORUNI,IS,1024,3,0,0,3,12,0,0,12,17,0,0,17,24,2,0,26,31,3,0,34
95337,669,"SEDIUL SCOALAPRIMARA VLĂDICENI, SAT. VLĂDICENI, COM.TOMEŞTI",VLĂDICENI,IS,580,16,2,0,18,34,4,0,38,46,23,0,69,57,28,0,85,60,29,0,89
99619,670,"GRĂDINIȚA CU PROGRAM NORMAL TRIFEȘTI",TRIFEŞTI,IS,1369,3,1,0,4,4,5,0,9,10,6,0,16,10,6,0,16,12,6,0,18
99664,671,"ȘCOALA PRIMARĂ ZABOLOTENI",ZABOLOTENI,IS,592,3,0,0,3,5,0,0,5,8,0,0,8,9,0,0,9,10,0,0,10
99628,672,"ŞCOALA GIMNAZIALĂHERMEZIU",HERMEZIU,IS,746,4,1,0,5,9,2,0,11,15,2,0,17,20,3,0,23,23,4,0,27
99655,673,"ŞCOALA PRIMARĂ VLADOMIRA",VLADOMIRA,IS,192,2,2,0,4,6,2,0,8,7,2,0,9,16,2,0,18,22,3,0,25
99682,674,"LICEUL TEHNOLOGIC DE INDUSTRIE ALIMENTARĂ ŢIBANA",ŢIBANA,IS,719,9,0,0,9,18,0,0,18,28,0,0,28,32,3,0,35,37,4,0,41
99753,675,"SCOALA GIMNAZIALĂ POIANA MĂNĂSTIRII","POIANA MĂNĂSTIRII",IS,367,2,0,0,2,3,0,0,3,5,0,0,5,8,2,0,10,8,3,0,11
99691,676,"ŞCOALA GIMNAZIALĂALEXENI",ALEXENI,IS,614,3,0,0,3,6,0,0,6,12,0,0,12,12,0,0,12,13,4,0,17
99744,677,"ŞCOALA PRIMARĂPOIANA DE SUS","POIANA DE SUS",IS,447,5,0,0,5,10,0,0,10,17,1,0,18,20,1,0,21,21,2,0,23
99708,678,"ŞCOALA GIMNAZIALĂDOMNIŢA",DOMNIŢA,IS,1052,7,0,0,7,12,2,0,14,19,4,0,23,19,4,0,23,21,4,0,25
99762,679,"ŞCOALA GIMNAZIALĂRUNCU",RUNCU,IS,407,2,2,0,4,7,3,0,10,8,3,0,11,8,3,0,11,9,3,0,12
99717,680,"ŞCOALA GIMNAZIALĂGÎRBEŞTI",GÎRBEŞTI,IS,931,8,0,0,8,11,3,0,14,11,5,0,16,12,6,0,18,12,6,0,18
99717,681,"ŞCOALA PRIMARĂGÎRBEŞTI",GÎRBEŞTI,IS,841,2,3,0,5,5,3,0,8,7,3,0,10,9,3,0,12,10,3,0,13
99771,682,"ŞCOALA PRIMARĂVADU VEJEI","VADU VEJEI",IS,267,3,0,0,3,3,1,0,4,7,1,0,8,8,1,0,9,9,2,0,11
99799,683,"GRĂDINIȚA CU PROGRAM NORMAL ȚIBĂNEȘTI",ŢIBĂNEŞTI,IS,903,7,2,0,9,11,2,0,13,17,2,0,19,19,3,0,22,19,3,0,22
99799,684,"GRĂDINIȚA CU PROGRAM NORMAL ȚIBĂNEȘTI",ŢIBĂNEŞTI,IS,959,8,0,0,8,10,0,0,10,12,0,0,12,16,0,0,16,18,0,0,18
99833,685,"ȘCOALA GIMNAZIALĂ RĂSBOIENI",RĂSBOIENI,IS,753,1,0,0,1,3,0,0,3,7,0,0,7,7,0,0,7,18,0,0,18
99806,686,"ȘCOALA GIMNAZIALĂ GLODENII GÎNDULUI","GLODENII GÎNDULUI",IS,1042,1,0,0,1,4,0,0,4,7,0,0,7,8,0,0,8,8,0,0,8
99806,687,"ȘCOALA GIMNAZIALĂ GLODENII GÎNDULUI","GLODENII GÎNDULUI",IS,1006,4,1,0,5,8,1,0,9,12,1,0,13,17,2,0,19,17,2,0,19
99824,688,"ȘCOALA GIMNAZIALĂ ,,DR. PETRU BRÂNZEI,, JIGORENI",JIGORENI,IS,569,4,0,0,4,6,0,0,6,8,0,0,8,10,2,0,12,10,2,0,12
99860,689,"GRĂDINIȚA CU PROGRAM NORMAL VĂLENII",VĂLENII,IS,223,3,1,0,4,3,1,0,4,5,1,0,6,5,1,0,6,5,1,0,6
99851,690,"GRĂDINIȚA CU PROGRAM NORMAL TUNGUJEI",TUNGUJEI,IS,468,11,3,0,14,12,4,0,16,17,4,0,21,23,4,0,27,25,5,0,30
99842,691,"GRĂDINIȚA CU PROGRAM NORMAL RECEA",RECEA,IS,119,0,0,0,0,0,0,0,0,0,0,0,0,0,0,0,0,0,0,0,0
99815,692,"GRĂDINIȚA CU PROGRAM NORMALGRIEȘTI",GRIEŞTI,IS,198,3,0,0,3,7,1,0,8,10,2,0,12,12,2,0,14,12,2,0,14
99897,693,"SCOALA GENERALA CIRNICENI",CÎRNICENI,IS,1243,2,0,0,2,6,0,0,6,16,0,0,16,21,2,0,23,25,2,0,27
99904,694,"SCOALA GENERALAMIHAIL KOGALNICEANU","MIHAIL KOGĂLNICEANU",IS,1085,4,0,0,4,7,1,0,8,24,1,0,25,37,1,0,38,51,2,0,53
99913,695,"SCOALA PRIMARA STEJARII",STEJARII,IS,241,2,1,0,3,4,2,0,6,6,4,0,10,10,5,0,15,13,5,0,18
99888,696,"SCOALA GIMNAZIALA ""COSTACHE ANTONIU""TIGANASI",ŢIGĂNĂŞI,IS,1151,6,0,0,6,15,0,0,15,26,0,0,26,34,2,0,36,43,2,0,45
99931,697,"SCOALA GIMNAZIALĂ ȚUȚORA",ŢUŢORA,IS,959,13,1,0,14,29,8,0,37,47,11,0,58,68,16,0,84,70,19,0,89
99932,698,"SCOALA GIMNAZIALA CHIPEREȘTI",CHIPEREŞTI,IS,301,6,4,0,10,13,14,0,27,25,18,0,43,34,20,0,54,34,20,0,54
99933,699,"ȘCOALA GIMNAZIALĂ OPRIȘENI",OPRIŞENI,IS,544,4,6,0,10,7,8,0,15,7,8,0,15,9,8,0,17,12,8,0,20
96012,700,"SCOALA GIMNAZIALA BOSIA",BOSIA,IS,854,5,0,0,5,8,1,0,9,13,1,0,14,17,1,0,18,19,1,0,20
96012,701,"SCOALA GIMNAZIALA BOSIA",BOSIA,IS,713,4,0,0,4,8,1,0,9,8,1,0,9,12,1,0,13,13,1,0,14
96021,702,"SCOALA PRIMARA COADA STÎNCII","COADA STÎNCII",IS,544,6,2,0,8,22,3,0,25,23,3,0,26,37,4,0,41,37,4,0,41
96030,703,"SCOALA PRIMARA MÎNZĂTEŞTI",MÎNZĂTEŞTI,IS,837,8,3,0,11,12,4,0,16,16,4,0,20,23,4,0,27,24,4,0,28
96049,704,"SCOALA PRIMARA UNGHENI",UNGHENI,IS,527,4,2,0,6,8,2,0,10,8,2,0,10,13,4,0,17,15,5,0,20
95284,705,"ȘCOALA GIMNAZIALĂ”PROF.MIHAI DUMITRIU”","VALEA LUPULUI",IS,1734,12,1,0,13,25,5,0,30,48,6,0,54,74,9,0,83,88,10,0,98
95284,706,"ȘCOALA GIMNAZIALĂ”PROF.MIHAI DUMITRIU”","VALEA LUPULUI",IS,1722,13,2,0,15,33,4,0,37,49,9,0,58,66,10,0,76,81,10,0,91
95284,707,"ȘCOALA GIMNAZIALĂ”PROF.MIHAI DUMITRIU”","VALEA LUPULUI",IS,1698,4,1,0,5,29,3,0,32,72,9,0,81,99,11,0,110,99,11,0,110
99977,708,"SCOALA GIMNAZIALAVALEA SEACA","VALEA SEACĂ",IS,1648,5,1,0,6,14,1,0,15,23,2,0,25,27,2,0,29,36,2,0,38
99986,709,"SCOALA GIMNAZIALA CONTESTI",CONŢEŞTI,IS,1476,8,0,0,8,18,1,0,19,24,1,0,25,31,2,0,33,35,3,0,38
99995,710,"SCOALA GIMNAZIALATOPILE",TOPILE,IS,1834,17,1,0,18,41,2,0,43,48,2,0,50,69,2,0,71,71,2,0,73
100068,711,"ŞCOALA STÂNCA",STÎNCA,IS,439,4,0,0,4,6,2,0,8,13,2,0,15,21,2,0,23,27,2,0,29
100013,712,"ȘCOALA VICTORIA",VICTORIA,IS,1268,6,0,0,6,14,2,0,16,15,2,0,17,22,4,0,26,29,5,0,34
100022,713,"ŞCOALA FRĂSULENI",FRĂSULENI,IS,315,0,0,0,0,1,1,0,2,1,1,0,2,2,1,0,3,2,1,0,3
100031,714,"ŞCOALA ICUŞENI",ICUŞENI,IS,396,3,0,0,3,3,0,0,3,5,0,0,5,7,0,0,7,7,1,0,8
100031,715,"ŞCOALA ICUȘENI",ICUŞENI,IS,431,1,0,0,1,1,0,0,1,1,0,0,1,2,0,0,2,3,0,0,3
100059,716,"ŞCOALA SCULENI",SCULENI,IS,327,1,0,0,1,9,0,0,9,18,1,0,19,25,3,0,28,26,3,0,29
100077,717,"ŞCOALA ŞENDRENI",ŞENDRENI,IS,248,5,5,0,10,10,7,0,17,16,7,0,23,22,8,0,30,24,8,0,32
100095,718,"CAMINUL CULTURAL VINATORI",VÎNĂTORI,IS,1016,7,2,0,9,15,2,0,17,16,2,0,18,19,2,0,21,19,2,0,21
100102,719,"GRADINIȚACU PROGRAM NORMAL",CRIVEŞTI,IS,1205,5,1,0,6,8,1,0,9,9,1,0,10,10,1,0,11,20,1,0,21
100111,720,"SCOALA CU CLASELE I-IVGURA-BIDILITEI","GURA BÎDILIŢEI",IS,507,14,2,0,16,34,8,0,42,42,13,0,55,52,14,0,66,56,14,0,70
100120,721,"ȘCOALA GIMNAZIALĂ HÎRTOAPE",HÎRTOAPE,IS,923,3,1,0,4,6,3,0,9,13,4,0,17,35,11,0,46,35,11,0,46
100157,722,"LICEUL TEHNOLOGIC VLADENI",VLĂDENI,IS,1427,11,2,0,13,20,2,0,22,25,2,0,27,42,2,0,44,44,2,0,46
100175,723,"SCOALA CU CLASELE I-VIII BORSA",BORŞA,IS,673,4,2,0,6,13,4,0,17,16,4,0,20,18,4,0,22,18,4,0,22
100193,724,"SCOALA CU CLASELE I-IV IACOBENI",IACOBENI,IS,179,1,6,0,7,4,6,0,10,6,6,0,12,8,7,0,15,10,7,0,17
100166,725,"SCOALA CU CLASELE I-IV ALEXANDRU CEL BUN","ALEXANDRU CEL BUN",IS,405,6,0,0,6,12,3,0,15,29,5,0,34,35,5,0,40,40,5,0,45
100184,726,"SCOALA CU CLASELE I-IV BROSTENI",BROŞTENI,IS,333,6,0,0,6,7,0,0,7,9,0,0,9,10,0,0,10,11,0,0,11
100200,727,"SCOALA PRIMARA VILCELELE",VÎLCELELE,IS,339,7,1,0,8,15,1,0,16,20,1,0,21,24,2,0,26,28,2,0,30
100228,728,"ŞCOALA GIMNAZIALĂ ""IOANID ROAMANESCU"" VOINEŞTI",VOINEŞTI,IS,1125,11,0,0,11,16,0,0,16,27,1,0,28,30,1,0,31,30,5,0,35
100228,729,"ŞCOALA GIMNAZIALĂ ""IOANID ROAMANESCU"" VOINEŞTI",VOINEŞTI,IS,796,6,0,0,6,13,1,0,14,14,1,0,15,18,3,0,21,19,3,0,22
100228,730,"ŞCOALA GIMNAZIALĂ ""IOANID ROAMANESCU"" VOINEŞTI",VOINEŞTI,IS,957,3,0,0,3,6,0,0,6,12,1,0,13,18,1,0,19,18,1,0,19
100255,731,"ŞCOALA GIMNAZIALĂ SLOBOZIA DEAL",SLOBOZIA,IS,791,7,0,0,7,10,0,0,10,17,0,0,17,21,0,0,21,22,0,0,22
100255,732,"ŞCOALA GIMNAZIALĂ SLOBOZIA DEAL",SLOBOZIA,IS,777,5,0,0,5,11,6,0,17,19,6,0,25,32,6,0,38,36,6,0,42
100237,733,"ŞCOALA PRIMARĂ LUNGANI",LUNGANI,IS,472,3,2,0,5,6,3,0,9,7,5,0,12,10,5,0,15,10,5,0,15
100246,734,"ŞCOALA PRIMARĂ SCHITU-STAVNIC","SCHITU STAVNIC",IS,433,5,1,0,6,5,3,0,8,10,6,0,16,14,8,0,22,14,8,0,22
100264,735,"A.F. GHEORGHIŢĂ",VOCOTEŞTI,IS,106,4,1,0,5,5,2,0,7,15,10,0,25,17,16,0,33,18,16,0,34
95284,736,"ȘCOALA GIMNAZIALA ""PROF.MIHAI DUMITRIU""","VALEA LUPULUI",IS,1666,4,0,0,4,14,0,0,14,29,7,0,36,43,10,0,53,48,10,0,58
109782,1,"CONSILIUL LOCAL DROBETA-TURNU SEVERIN - PALATUL CULTURII ""TEODOR COSTESCU""","DROBETA-TURNU SEVERIN",MH,1411,15,6,0,21,69,12,0,81,83,16,0,99,101,17,0,118,109,17,0,126
109782,2,"COLEGIUL NAȚIONAL ”TRAIAN”","DROBETA-TURNU SEVERIN",MH,1420,12,0,0,12,33,8,3,44,50,8,3,61,67,9,3,79,73,9,3,85
109782,3,"ȘCOALA GIMNAZIALĂ ”DUMITRU I.TOTIR” (ȘCOALA GENERALĂ NR.10)","DROBETA-TURNU SEVERIN",MH,1453,15,0,0,15,46,2,0,48,65,2,0,67,97,3,0,100,108,5,0,113
109782,4,"ȘCOALA GIMNAZIALĂ ”DUMITRU I.TOTIR”(ȘCOALA GENERALĂ NR.10)","DROBETA-TURNU SEVERIN",MH,1356,11,0,0,11,38,2,0,40,48,3,0,51,64,6,0,70,73,9,0,82
109782,5,"ASOCIAȚIA DE PROPRIETARI NR.90","DROBETA-TURNU SEVERIN",MH,992,17,0,0,17,31,2,0,33,45,3,0,48,56,4,0,60,62,9,0,71
109782,6,"LICEUL TEHNOLOGIC SPECIAL ”DROBETA” (ȘCOALA ENERGETICĂ)","DROBETA-TURNU SEVERIN",MH,1413,18,5,0,23,39,6,0,45,48,8,0,56,72,8,0,80,79,8,0,87
109782,7,"LICEUL TEHNOLOGIC SPECIAL ”DROBETA” (ȘCOALA ENERGETICĂ)","DROBETA-TURNU SEVERIN",MH,1033,12,4,0,16,20,4,0,24,29,5,0,34,40,6,0,46,41,6,0,47
109782,8,"S.C. TRANSPORT PUBLIC URBAN ''DROBETA'' S.A. (AUTOGARĂ)","DROBETA-TURNU SEVERIN",MH,1427,7,3,0,10,27,6,0,33,29,6,0,35,39,7,0,46,48,7,0,55
109782,9,"ȘCOALA GIMNAZIALĂ ”CONSTANTIN NEGREANU” (ȘCOALA GENERALĂ NR.9)","DROBETA-TURNU SEVERIN",MH,1467,13,3,0,16,31,5,0,36,45,5,0,50,69,6,0,75,86,7,0,93
109782,10,"ȘCOALA GIMNAZIALĂ ”CONSTANTIN NEGREANU” (ȘCOALA GENERALĂ NR.9)","DROBETA-TURNU SEVERIN",MH,1357,11,0,0,11,33,1,0,34,50,1,0,51,72,4,0,76,73,4,0,77
109782,11,"ȘCOALA GIMNAZIALĂ ”CONSTANTIN NEGREANU” (ȘCOALA GENERALĂ NR.9)","DROBETA-TURNU SEVERIN",MH,1716,10,4,0,14,32,4,0,36,35,4,0,39,48,4,0,52,53,5,0,58
109782,12,"OFICIUL JUDEȚEAN PENTRU FINANȚAREA INVESTIȚIILOR RURALE","DROBETA-TURNU SEVERIN",MH,1671,12,1,0,13,25,1,0,26,27,12,0,39,35,13,0,48,47,17,0,64
109782,13,"OFICIUL JUDEȚEAN PENTRU FINANȚAREA INVESTIȚIILOR RURALE MEHEDINȚI","DROBETA-TURNU SEVERIN",MH,1559,6,0,0,6,20,1,0,21,32,1,0,33,46,3,0,49,56,3,0,59
109782,14,"COLEGIUL NAȚIONAL ”GHEORGHE ȚIȚEICA”","DROBETA-TURNU SEVERIN",MH,1256,9,0,0,9,40,0,0,40,60,1,0,61,73,1,0,74,79,1,0,80
109782,15,"COLEGIUL NAȚIONAL ”GHEORGHE ȚIȚEICA”","DROBETA-TURNU SEVERIN",MH,1201,11,0,0,11,42,0,0,42,56,0,0,56,68,1,0,69,75,1,0,76
109782,16,"COLEGIUL NAȚIONAL ECONOMIC ”THEODOR COSTESCU”","DROBETA-TURNU SEVERIN",MH,1085,13,0,0,13,41,1,0,42,52,2,0,54,67,8,0,75,81,8,0,89
109782,17,"GRĂDINIȚA CU PROGRAM PRELUNGIT NR. 22","DROBETA-TURNU SEVERIN",MH,1121,11,0,0,11,24,0,0,24,30,2,0,32,43,3,0,46,48,4,0,52
109782,18,"ȘCOALA GIMNAZIALĂ NR. 14","DROBETA-TURNU SEVERIN",MH,1064,10,1,0,11,30,1,0,31,38,1,0,39,43,2,0,45,45,2,0,47
109782,19,"ȘCOALA GIMNAZIALĂ NR. 14","DROBETA-TURNU SEVERIN",MH,1395,14,2,0,16,31,2,0,33,44,4,0,48,55,4,0,59,65,6,0,71
109782,20,"ASOCIATIA LIGA ''SOLIDARITATEA'' A PENSIONARILOR","DROBETA-TURNU SEVERIN",MH,1197,15,0,0,15,30,0,0,30,44,0,0,44,55,2,0,57,63,3,0,66
109782,21,"ȘCOALA GIMNAZIALĂ NR. 11","DROBETA-TURNU SEVERIN",MH,1646,16,0,0,16,44,4,0,48,62,4,0,66,81,5,0,86,89,6,0,95
109782,22,"ȘCOALA GIMNAZIALĂ NR. 11","DROBETA-TURNU SEVERIN",MH,1325,21,4,0,25,44,5,0,49,57,5,0,62,96,8,0,104,96,10,0,106
109782,23,"MINISTERUL SĂNĂTĂȚII - SERVICIUL JUDEȚEAN DE AMBULANȚĂ - SPAȚIU ADMINISTRATIV","DROBETA-TURNU SEVERIN",MH,1530,16,0,0,16,35,0,0,35,51,0,0,51,62,3,0,65,66,9,0,75
109782,24,"DIRECȚIA DE SĂNĂTATE PUBLICĂ MEHEDINȚI - SPITALUL JUDEŢEAN DE URGENŢĂ - SPAȚIU ADMINISTRATIV","DROBETA-TURNU SEVERIN",MH,1710,19,4,0,23,41,8,0,49,55,14,42,111,62,14,42,118,65,15,42,122
109782,25,"DIRECȚIA DE SĂNĂTATE PUBLICĂ MEHEDINȚI - SPITALUL JUDEŢEAN DE URGENŢĂ - SPAȚIU ADMINISTRATIV","DROBETA-TURNU SEVERIN",MH,1490,15,2,0,17,32,3,0,35,46,10,0,56,62,13,41,116,68,14,41,123
109782,26,"GRĂDINIȚA CU PROGRAM PRELUNGIT NR.20","DROBETA-TURNU SEVERIN",MH,1656,13,2,0,15,37,3,0,40,46,4,0,50,55,4,0,59,59,5,0,64
109782,27,"COLEGIUL TEHNIC ”DOMNUL TUDOR”","DROBETA-TURNU SEVERIN",MH,905,8,2,0,10,25,9,0,34,39,14,0,53,46,15,0,61,54,15,0,69
109782,28,"COLEGIUL TEHNIC ”DOMNUL TUDOR”","DROBETA-TURNU SEVERIN",MH,1183,15,5,0,20,28,12,0,40,46,14,0,60,71,17,0,88,73,19,0,92
109782,29,"COLEGIUL TEHNIC ”DOMNUL TUDOR”","DROBETA-TURNU SEVERIN",MH,1295,13,6,0,19,29,7,0,36,34,7,0,41,44,7,0,51,50,7,0,57
109782,30,"COLEGIUL TEHNIC ”DOMNUL TUDOR”","DROBETA-TURNU SEVERIN",MH,1321,11,0,0,11,24,0,0,24,29,0,0,29,41,0,0,41,46,0,0,46
109782,31,"PRIMĂRIA MUNICIPIULUI DROBETA-TURNU SEVERIN (STADIONUL MUNICIPAL)","DROBETA-TURNU SEVERIN",MH,1482,11,0,0,11,37,0,0,37,59,0,0,59,71,0,0,71,78,0,0,78
109782,32,"COLEGIUL TEHNIC ”LORIN SĂLĂGEAN” (LICEUL INDUSTRIAL NR.4)","DROBETA-TURNU SEVERIN",MH,1131,11,0,0,11,21,0,0,21,31,0,0,31,41,0,0,41,47,0,0,47
109782,33,"GRĂDINIȚA CU PROGRAM PRELUNGIT NR. 3","DROBETA-TURNU SEVERIN",MH,1350,6,5,0,11,18,5,0,23,31,5,0,36,56,5,0,61,60,6,0,66
109782,34,"ȘCOALA GIMNAZIALĂ NR. 6","DROBETA-TURNU SEVERIN",MH,1279,14,2,0,16,35,3,0,38,45,5,0,50,72,5,0,77,73,5,0,78
109782,35,"ȘCOALA GIMNAZIALĂ NR. 6","DROBETA-TURNU SEVERIN",MH,1574,9,0,0,9,24,0,0,24,34,0,0,34,62,0,0,62,71,0,0,71
109782,36,"ȘCOALA GIMNAZIALĂ NR. 6","DROBETA-TURNU SEVERIN",MH,1266,8,0,0,8,26,0,0,26,30,0,0,30,40,0,0,40,53,0,0,53
109782,37,"ȘCOALA GIMNAZIALĂ NR. 6","DROBETA-TURNU SEVERIN",MH,1267,13,0,0,13,27,0,0,27,55,6,0,61,66,6,0,72,66,6,0,72
109782,38,"DIRECȚIA REGIONALĂ DE DRUMURI ȘI PODURI CRAIOVA","DROBETA-TURNU SEVERIN",MH,1400,7,2,0,9,21,2,0,23,30,6,0,36,36,7,0,43,42,8,0,50
109782,39,"ȘCOALA GIMNAZIALĂ ”PETRE SERGESCU”","DROBETA-TURNU SEVERIN",MH,1222,8,4,0,12,23,5,0,28,31,5,0,36,45,7,0,52,51,7,0,58
109782,40,"PRIMARIA MUNICIPIULUI DROBETA-TURNU SEVERIN - SPATIU ADMINISTRATIV","DROBETA-TURNU SEVERIN",MH,1022,9,0,0,9,30,0,0,30,43,1,0,44,51,2,0,53,51,2,0,53
109782,41,"GRĂDINIȚA CU PROGRAM PRELUNGIT NR. 21","DROBETA-TURNU SEVERIN",MH,1343,7,6,0,13,23,6,0,29,26,6,0,32,38,6,0,44,39,6,0,45
109782,42,"ȘCOALA GIMNAZIALĂ ”PETRE SERGESCU” (ȘCOALA GENERALĂ NR.4)","DROBETA-TURNU SEVERIN",MH,1263,13,8,0,21,21,17,0,38,31,20,0,51,43,22,0,65,48,25,0,73
109782,43,"ȘCOALA GIMNAZIALĂ ”PETRE SERGESCU” (ȘCOALA GENERALĂ NR.4)","DROBETA-TURNU SEVERIN",MH,1281,0,5,0,5,7,5,0,12,15,8,0,23,33,10,0,43,39,10,0,49
109782,44,"ȘCOALA GIMNAZIALĂ ”PETRE SERGESCU” (ȘCOALA GENERALĂ NR.4)","DROBETA-TURNU SEVERIN",MH,1306,10,0,0,10,27,6,0,33,32,7,0,39,42,8,0,50,48,8,0,56
109782,45,"PRIMĂRIA MUNICIPIULUI DROBETA-TURNU SEVERIN (SALA POLIVALENTĂ)","DROBETA-TURNU SEVERIN",MH,1963,14,0,0,14,44,2,0,46,63,4,0,67,75,4,0,79,84,4,0,88
109782,46,"PRIMĂRIA MUNICIPIULUI DROBETA-TURNU SEVERIN (SALA POLIVALENTĂ)","DROBETA-TURNU SEVERIN",MH,1604,11,0,0,11,38,0,0,38,59,0,0,59,69,0,0,69,80,1,0,81
109782,47,"ȘCOALA GIMNAZIALĂ ”DIMITRIE GRECESCU” (ȘCOALA GENERALĂ NR.1)","DROBETA-TURNU SEVERIN",MH,1531,17,0,0,17,66,2,175,243,91,8,175,274,124,8,175,307,135,9,175,319
109782,48,"COLEGIUL TEHNIC ”DECEBAL”","DROBETA-TURNU SEVERIN",MH,1382,15,1,0,16,42,4,0,46,65,4,0,69,77,6,0,83,81,6,0,87
109782,49,"ȘCOALA GIMNAZIALĂ NR.3","DROBETA-TURNU SEVERIN",MH,1414,10,2,0,12,35,3,0,38,59,5,0,64,82,8,0,90,94,15,0,109
109782,50,"ȘCOALA GIMNAZIALĂ ”ALICE VOINESCU” (ȘCOALA GENERALĂ NR.2)","DROBETA-TURNU SEVERIN",MH,1349,10,0,0,10,35,1,0,36,47,1,0,48,72,3,0,75,77,3,0,80
109782,51,"ȘCOALA GIMNAZIALĂ NR.15 (FOSTA ȘCOALĂ GENERALĂ NR.8)","DROBETA-TURNU SEVERIN",MH,1059,14,1,0,15,27,4,0,31,36,4,0,40,49,5,0,54,49,5,0,54
109782,52,"ȘCOALA GIMNAZIALĂ NR.15 (FOSTA ȘCOALĂ GENERALĂ NR.8)","DROBETA-TURNU SEVERIN",MH,1789,20,0,0,20,59,1,0,60,81,1,0,82,108,2,0,110,116,3,0,119
109782,53,"ȘCOALA GIMNAZIALĂ ”TEODOR COSTESCU” ( ȘCOALA GENERALĂ NR.7)","DROBETA-TURNU SEVERIN",MH,1892,16,2,0,18,34,5,0,39,41,6,0,47,61,7,0,68,66,7,0,73
109782,54,"ȘCOALA GIMNAZIALĂ ”TEODOR COSTESCU” ( ȘCOALA GENERALĂ NR.7)","DROBETA-TURNU SEVERIN",MH,1542,12,0,0,12,31,0,0,31,40,0,0,40,51,0,0,51,56,0,0,56
109782,55,"ȘCOALA GIMNAZIALĂ ”TEODOR COSTESCU” ( ȘCOALA GENERALĂ NR.7)","DROBETA-TURNU SEVERIN",MH,1854,7,0,0,7,28,0,0,28,47,0,0,47,58,0,0,58,63,0,0,63
109782,56,"ȘCOALA GIMNAZIALĂ ”TEODOR COSTESCU” (ȘCOALA GENERALĂ NR.7)","DROBETA-TURNU SEVERIN",MH,1707,11,4,0,15,21,4,0,25,35,4,0,39,52,4,0,56,58,5,0,63
109782,57,"ȘCOALA GIMNAZIALĂ NR.15","DROBETA-TURNU SEVERIN",MH,1380,12,5,0,17,21,5,0,26,28,5,0,33,39,6,0,45,47,7,0,54
109782,58,"ȘCOALA GIMNAZIALĂ NR.15","DROBETA-TURNU SEVERIN",MH,1026,13,4,0,17,29,4,0,33,49,5,0,54,64,6,0,70,77,6,0,83
109782,59,"ȘCOALA GIMNAZIALĂ NR.15","DROBETA-TURNU SEVERIN",MH,1354,7,0,0,7,30,0,0,30,42,4,0,46,49,4,0,53,57,4,0,61
109782,60,"ȘCOALA GIMNAZIALĂ NR.15","DROBETA-TURNU SEVERIN",MH,1818,11,4,0,15,32,5,0,37,45,5,0,50,67,5,0,72,72,5,0,77
109782,61,"GRĂDINIȚA CU PROGRAM PRELUNGIT NR.15","DROBETA-TURNU SEVERIN",MH,1164,11,3,0,14,26,4,0,30,44,5,0,49,55,5,0,60,67,5,0,72
109782,62,"GRĂDINIȚA CU PROGRAM PRELUNGIT NR.15","DROBETA-TURNU SEVERIN",MH,1422,5,0,0,5,23,2,0,25,34,2,0,36,51,7,0,58,51,9,0,60
109782,63,"GRĂDINIȚA CU PROGRAM PRELUNGIT NR.15","DROBETA-TURNU SEVERIN",MH,1760,3,0,0,3,10,0,0,10,12,0,0,12,15,0,0,15,19,0,0,19
109782,64,"ȘCOALA GIMNAZIALĂ NR.5","DROBETA-TURNU SEVERIN",MH,1552,16,2,0,18,28,6,0,34,42,6,1,49,73,7,1,81,87,7,1,95
109782,65,"ȘCOALA GIMNAZIALĂ ”DIMITRIE GRECESCU” (ȘCOALA GENERALĂ NR.15 GURA VĂII)","DROBETA-TURNU SEVERIN",MH,1543,12,0,0,12,35,19,0,54,64,34,0,98,100,42,0,142,115,47,0,162
110072,66,"ȘCOALA CU CLASELE I-VIII PETRU DUMITRIU SUD",ORŞOVA,MH,1543,12,8,0,20,26,8,0,34,37,8,0,45,59,13,0,72,64,16,0,80
110072,67,"LICEUL TRAIAN LALESCU",ORŞOVA,MH,1050,7,4,0,11,24,5,0,29,40,5,0,45,46,6,0,52,47,6,0,53
110072,68,"LICEUL TRAIAN LALESCU",ORŞOVA,MH,1308,10,6,0,16,27,7,0,34,43,8,0,51,48,8,8,64,54,10,8,72
110072,69,"CLUBUL COPIILOR",ORŞOVA,MH,968,13,0,0,13,37,11,0,48,52,12,0,64,65,12,0,77,69,12,0,81
110072,70,"CLUBUL COPIILOR",ORŞOVA,MH,1236,9,1,0,10,23,9,0,32,31,10,0,41,37,11,0,48,40,11,0,51
110072,71,"COLEGIUL TEHNIC DIERNA",ORŞOVA,MH,1446,11,0,0,11,26,4,0,30,42,6,0,48,57,6,0,63,60,9,0,69
110072,72,"ȘCOALA GENERALĂ I-VIII NUMĂRUL 1 NORD",ORŞOVA,MH,1325,8,0,0,8,30,8,0,38,37,17,0,54,51,21,0,72,68,21,0,89
110072,73,"GRĂDINIŢA NUMĂRUL 3",ORŞOVA,MH,1484,15,2,0,17,53,5,0,58,61,5,0,66,74,12,0,86,78,12,0,90
110072,74,"GRĂDINIŢA CORAMNIC",ORŞOVA,MH,332,3,4,0,7,8,4,0,12,13,5,0,18,15,5,0,20,17,5,0,22
109933,75,"ȘCOALA GENERALĂ BAIA DE ARAMĂ","BAIA DE ARAMĂ",MH,1213,11,0,0,11,21,0,0,21,24,7,0,31,39,7,0,46,44,7,0,51
109933,76,"GRUPUL ŞCOLAR CONSTANTIN BRÂNCOVEANU","BAIA DE ARAMĂ",MH,1168,6,0,0,6,15,2,0,17,24,17,0,41,31,21,0,52,36,21,0,57
109979,77,"ŞCOALA GENERALĂ MĂRĂŞEŞTI",MĂRĂŞEŞTI,MH,1098,7,0,0,7,10,2,0,12,21,2,0,23,24,2,0,26,27,2,0,29
110018,78,"ŞCOALA GENERALĂ TITERLEŞTI",TITERLEŞTI,MH,410,1,0,0,1,1,0,0,1,2,0,0,2,3,0,0,3,5,3,0,8
109988,79,"ŞCOALA GENERALĂ NEGOEŞTI",NEGOEŞTI,MH,694,0,0,0,0,1,0,0,1,2,3,0,5,4,7,0,11,5,7,0,12
110125,80,"LICEUL TEHNOLOGIC MATEI BASARAB",STREHAIA,MH,1669,12,5,0,17,33,8,0,41,49,13,0,62,70,15,0,85,80,15,0,95
110125,81,"GRĂDINIŢA 2",STREHAIA,MH,1518,37,2,0,39,74,2,0,76,87,2,0,89,97,3,0,100,106,4,0,110
110125,82,"ŞCOALA GENERALĂ STREHAIA",STREHAIA,MH,1387,18,8,0,26,52,12,0,64,59,14,0,73,72,16,0,88,79,18,0,97
110125,83,"GRĂDINIŢA VEST STREHAIA",STREHAIA,MH,1414,30,3,0,33,78,4,0,82,100,5,0,105,110,6,19,135,120,6,19,145
110134,84,"ŞCOALA GENERALĂ CIOCHIUŢA",CIOCHIUŢA,MH,789,8,4,0,12,17,8,0,25,25,8,0,33,38,8,0,46,42,8,0,50
110170,85,"ŞCOALA GENERALĂ SLĂTINICUL MARE","SLĂTINICU MARE",MH,288,1,0,0,1,5,3,0,8,8,0,0,8,8,3,0,11,14,3,0,17
110143,86,"ŞCOALA GENERALĂ COMANDA",COMANDA,MH,1275,11,0,0,11,28,3,0,31,40,5,0,45,67,7,2,76,71,7,2,80
110161,87,"ŞCOALA GENERALĂ LUNCA BANULUI","LUNCA BANULUI",MH,380,4,2,0,6,8,3,0,11,11,5,0,16,18,11,0,29,23,12,0,35
110152,88,"ŞCOALA GENERALĂ HURDUCEŞTI",HURDUCEŞTI,MH,216,4,3,0,7,9,3,0,12,13,4,0,17,17,9,0,26,18,10,0,28
110214,89,"ŞCOALA GENERALĂ STĂNCEŞTI",STĂNCEŞTI,MH,153,1,3,0,4,4,3,0,7,6,3,0,9,9,5,0,14,9,6,0,15
110241,90,"LICEUL TEORETICVÎNJU MARE","VÎNJU MARE",MH,1236,6,0,0,6,16,1,0,17,23,4,0,27,35,6,0,41,40,9,0,49
110241,91,"ŞCOALA GENERALĂ I-VIII VÎNJU MARE","VÎNJU MARE",MH,1670,9,2,0,11,27,5,0,32,42,8,0,50,60,8,0,68,65,8,0,73
110250,92,"GRADINIŢA BUCURA",BUCURA,MH,280,7,0,0,7,9,3,0,12,10,6,0,16,13,6,0,19,14,6,0,20
110269,93,"ŞCOALA GENERALĂ I-IV NICOLAE BĂLCESCU","NICOLAE BĂLCESCU",MH,643,5,0,0,5,6,0,0,6,10,1,0,11,12,1,0,13,12,1,0,13
110278,94,"ŞCOALA GENERALĂ I-IV OREVIŢA MARE","OREVIŢA MARE",MH,626,0,0,0,0,3,0,0,3,7,0,0,7,10,5,0,15,10,5,0,15
110287,95,"ŞCOALA GENERALĂ I-IV TRAIAN",TRAIAN,MH,493,1,0,0,1,9,3,0,12,12,4,0,16,20,5,0,25,20,5,0,25
110367,96,"ŞCOALA GENERALĂ I-IV COMĂNEŞTI",COMĂNEŞTI,MH,325,3,0,0,3,7,0,0,7,11,0,0,11,13,0,0,13,13,0,0,13
110376,97,"ȘCOALA GENERALĂ I-VIII CRAINICI",CRAINICI,MH,272,2,0,0,2,3,0,0,3,3,0,0,3,6,2,0,8,15,5,0,20
110438,98,"ȘCOALA GENERALĂ I-IV SĂRDĂNEŞTI",SĂRDĂNEŞTI,MH,208,4,3,0,7,6,4,0,10,7,5,0,12,12,5,0,17,14,7,0,21
110394,99,"ȘCOALA GENERALĂ I-IV IUPCA",IUPCA,MH,180,4,4,0,8,4,4,0,8,4,29,0,33,4,29,0,33,4,29,0,33
110303,100,"CĂMINUL CULTURAL BALA",BALA,MH,686,8,6,0,14,12,14,0,26,19,23,0,42,26,38,0,64,32,38,0,70
110321,101,"ȘCOALA GENERALĂ I-IV BRATEŞUL",BRATEŞUL,MH,105,2,0,0,2,5,1,0,6,8,4,0,12,12,5,0,17,14,5,0,19
110312,102,"ȘCOALA GENERALĂ I-IV BALA DE SUS","BALA DE SUS",MH,499,6,0,0,6,11,0,0,11,17,3,0,20,22,4,0,26,24,4,0,28
110410,103,"ȘCOALA GENERALĂ I-IV RUDINA",RUDINA,MH,392,6,3,0,9,6,5,0,11,7,5,0,12,7,5,0,12,7,5,0,12
110447,104,"ȘCOALA GENERALĂ I-IV VIDIMIREŞTI",VIDIMIREŞTI,MH,127,2,1,0,3,2,2,0,4,3,3,0,6,4,3,0,7,6,9,0,15
110385,105,"ȘCOALA GENERALĂ I-VIII DÎLMA",DÎLMA,MH,332,1,1,0,2,2,1,0,3,4,1,0,5,6,2,0,8,8,5,0,13
110465,106,"CĂMINUL CULTURAL BALTA",BALTA,MH,335,11,3,0,14,24,10,0,34,33,16,0,49,44,23,0,67,52,28,0,80
110517,107,"CĂMINUL CULTURAL PREJNA",PREJNA,MH,233,5,0,0,5,9,4,0,13,18,4,1,23,25,6,1,32,30,11,1,42
110483,108,"CĂMINUL CULTURAL COSTEŞTI",COSTEŞTI,MH,138,8,4,0,12,12,6,0,18,13,7,0,20,20,7,0,27,24,7,0,31
110492,109,"CĂMINUL CULTURAL GORNOVIŢA",GORNOVIŢA,MH,166,1,0,0,1,3,0,4,7,8,0,6,14,10,0,8,18,11,0,8,19
110544,110,"ŞCOALA GIMNAZIALĂ BĂLĂCIŢA",BĂLĂCIŢA,MH,990,3,2,0,5,19,10,0,29,44,11,0,55,54,19,0,73,56,19,0,75
110562,111,"ŞCOALA GIMNAZIALĂ GVARDINIŢA",GVARDINIŢA,MH,822,1,1,0,2,6,3,0,9,11,5,0,16,29,6,0,35,37,6,0,43
110553,112,"ŞCOALA PRIMARĂ DOBRA",DOBRA,MH,370,2,2,0,4,6,2,0,8,27,9,0,36,59,16,0,75,69,17,0,86
110580,113,"ȘCOALA GENERALĂ I-VIII BÎCLEȘ",BÎCLEŞ,MH,495,7,5,0,12,31,28,0,59,66,48,0,114,90,53,0,143,96,53,0,149
110642,114,"ȘCOALA GENERALĂ I-IV PODU GROSULUI","PODU GROSULUI",MH,168,8,3,0,11,14,4,0,18,51,8,0,59,68,8,0,76,68,11,0,79
110633,115,"ȘCOALA GENERALĂ I-IV PETRA",PETRA,MH,139,19,2,0,21,46,8,0,54,56,20,0,76,60,23,0,83,68,25,0,93
110615,116,"ȘCOALA GENERALĂ I-IV CORZU",CORZU,MH,348,18,2,0,20,65,8,0,73,87,18,0,105,103,24,0,127,103,25,0,128
110660,117,"ȘCOALA GENERALĂ I-IV SMADOVIŢA",SMADOVIŢA,MH,380,19,4,0,23,92,15,0,107,122,24,0,146,145,35,0,180,168,36,0,204
110697,118,"PRIMĂRIA BÎLVĂNEŞTI",BÎLVĂNEŞTI,MH,749,24,1,0,25,52,5,0,57,65,10,0,75,72,11,0,83,77,13,0,90
113867,119,"ȘCOALA GIMNAZIALĂ BRANIȘTEA",BRANIŞTEA,MH,1119,20,3,0,23,50,8,0,58,65,14,0,79,100,19,73,192,115,25,73,213
113876,120,"ȘCOALA GENERALĂ I-IV GOANŢA",GOANŢA,MH,404,10,4,0,14,24,4,0,28,34,4,0,38,53,8,19,80,54,8,19,81
110759,121,"ŞCOALA GENERALA I-VIII BREZNIŢA MOTRU",BREZNIŢA-MOTRU,MH,871,14,1,0,15,24,1,0,25,42,2,0,44,53,3,0,56,57,3,0,60
110786,122,"ŞCOALAGENERALĂ I-VIII FĂUROAIA",FĂUROAIA,MH,285,10,0,0,10,15,0,0,15,18,4,0,22,20,6,0,26,25,8,0,33
110839,123,"ŞCOALA GENERALĂ I-VIII BREZNIŢA OCOL",BREZNIŢA-OCOL,MH,1488,8,2,0,10,25,4,0,29,25,4,0,29,36,8,0,44,39,10,0,49
110857,124,"ŞCOALA GENERALĂ I-IV MAGHERU",MAGHERU,MH,898,0,0,0,0,1,0,0,1,6,2,0,8,15,4,0,19,18,4,0,22
110848,125,"ŞCOALA GENERALĂ I-IV JIDOŞTIŢA",JIDOŞTIŢA,MH,917,10,0,0,10,24,4,0,28,28,4,0,32,36,5,0,41,47,5,0,52
110884,126,"CĂMIN CULTURAL BROŞTENI",BROŞTENI,MH,1223,6,0,0,6,18,6,0,24,27,9,0,36,29,9,0,38,36,11,0,47
110919,127,"CĂMIN CULTURAL LUPŞA DE JOS","LUPŞA DE JOS",MH,1091,16,1,0,17,39,3,0,42,53,5,0,58,69,7,0,76,69,9,0,78
110955,128,"ȘCOALA GENERALĂ BURILA MARE","BURILA MARE",MH,598,40,3,0,43,48,6,0,54,49,8,0,57,59,10,0,69,70,14,0,84
110964,129,"ȘCOALA GENERALĂ CRIVINA",CRIVINA,MH,535,1,1,0,2,9,6,0,15,13,10,0,23,16,11,0,27,22,16,0,38
110982,130,"ȘCOALA GENERALĂ ŢIGĂNAŞI",ŢIGĂNAŞI,MH,255,4,4,0,8,12,8,0,20,14,13,0,27,24,16,0,40,25,18,0,43
110991,131,"ȘCOALA GENERALĂ VRANCEA",VRANCEA,MH,169,6,6,0,12,9,10,0,19,11,10,0,21,13,12,0,25,14,13,0,27
110973,132,"ȘCOALA GENERALĂ IZVORU FRUMOS","IZVORU FRUMOS",MH,182,2,1,0,3,8,1,0,9,14,4,0,18,21,7,0,28,23,18,0,41
111015,133,"PRIMĂRIA BUTOIEŞTI",BUTOIEŞTI,MH,859,7,2,0,9,12,5,0,17,14,9,0,23,15,9,0,24,17,12,0,29
111024,134,"ŞCOALA GENERALĂ I-IV ARGINEŞTI",ARGINEŞTI,MH,474,9,0,0,9,13,1,0,14,23,3,0,26,30,3,0,33,32,3,0,35
111042,135,"ŞCOALA GENERALĂ I-IV GURA MOTRULUI","GURA MOTRULUI",MH,236,3,2,0,5,6,2,0,8,10,5,0,15,15,6,0,21,17,6,0,23
111033,136,"ŞCOALA GENERALĂ I-IVBUICEŞTI",BUICEŞTI,MH,376,11,0,0,11,16,2,0,18,21,3,0,24,23,3,0,26,24,3,0,27
111060,137,"ŞCOALA GENERALĂ I-IV PLUTA",PLUTA,MH,350,2,0,0,2,7,1,0,8,9,1,0,10,11,1,0,12,11,1,0,12
111088,138,"ŞCOALA GENERALĂ I-IV ŢÎNŢARU",TÎNŢARU,MH,289,6,2,0,8,14,3,0,17,17,4,0,21,20,5,0,25,26,6,0,32
111104,139,"SCOALA GENERALĂ I-IV CĂZĂNEŞTI",CĂZĂNEŞTI,MH,721,11,9,0,20,23,22,0,45,30,25,0,55,36,40,0,76,46,40,0,86
111195,140,"SCOALA GENERALĂ I-IV SEVERINEŞTI",SEVERINEŞTI,MH,980,11,5,0,16,23,15,0,38,53,23,0,76,77,31,0,108,81,33,0,114
111239,141,"CĂMINUL CULTURAL CIREŞU",CIREŞU,MH,390,6,2,0,8,11,5,0,16,22,20,0,42,30,23,0,53,36,26,0,62
111284,142,"CĂMINUL CULTURAL CORCOVA",CORCOVA,MH,1306,11,0,0,11,32,0,0,32,35,0,0,35,42,0,0,42,47,1,0,48
111346,143,"ŞCOALA GENERALĂ IMOASA",IMOASA,MH,302,1,1,0,2,5,2,0,7,11,5,0,16,14,5,0,19,15,5,0,20
111319,144,"ŞCOALA GENERALĂ CORDUN",CORDUN,MH,596,2,0,0,2,7,4,0,11,13,4,0,17,21,4,0,25,25,4,0,29
111391,145,"ŞCOALA GENERALĂ I-IV STEJARU",STEJARU,MH,442,3,0,0,3,8,0,0,8,17,2,0,19,33,3,0,36,40,3,0,43
111355,146,"CĂMINUL CULTURAL JIROV",JIROV,MH,1207,5,0,0,5,14,0,0,14,20,3,0,23,40,4,0,44,45,6,0,51
111364,147,"ŞCOALA GENERALĂ MĂRU ROŞU","MĂRU ROŞU",MH,494,1,0,0,1,6,0,0,6,12,1,0,13,19,2,0,21,20,3,0,23
111300,148,"ŞCOALA GENERALĂ CERNAIA",CERNAIA,MH,416,3,3,0,6,18,5,0,23,22,7,0,29,26,7,0,33,36,7,0,43
111426,149,"ȘCOALA PROFESIONALĂ CORLĂŢEL",CORLĂŢEL,MH,600,9,6,0,15,23,7,0,30,41,8,0,49,63,15,0,78,79,22,0,101
111435,150,"ȘCOALA PROFESIONALĂ VALEA ANILOR","VALEA ANILOR",MH,444,5,3,0,8,25,5,0,30,31,5,0,36,34,7,0,41,37,7,0,44
111453,151,"CĂMINUL CULTURAL",CUJMIR,MH,911,1,0,0,1,8,2,0,10,10,2,0,12,17,2,0,19,19,2,0,21
111453,152,"CĂMINUL CULTURAL",CUJMIR,MH,891,2,1,0,3,7,1,0,8,7,37,5,49,18,37,5,60,27,40,5,72
111462,153,"ŞCOALA GENERALĂ AURORA",AURORA,MH,555,2,0,0,2,3,0,0,3,4,0,0,4,6,0,0,6,8,0,0,8
111471,154,"GRĂDINIŢA CUJMIRU MIC","CUJMIRU MIC",MH,391,1,0,0,1,2,0,0,2,4,0,0,4,5,0,0,5,7,0,0,7
111499,155,"CĂMINUL CULTURAL DEVESEL",DEVESEL,MH,1003,10,3,0,13,18,7,0,25,24,9,0,33,36,15,0,51,36,15,0,51
111505,156,ŞCOALAGENERALABATOŢI,BATOŢI,MH,346,6,4,0,10,9,12,0,21,20,15,0,35,26,15,0,41,27,15,0,42
111514,157,"ŞCOALA GENERALĂ BISTREŢU",BISTREŢU,MH,402,5,1,0,6,8,7,0,15,10,7,0,17,19,12,0,31,20,13,0,33
111532,158,"ŞCOALA GENERALĂ SCĂPĂU",SCĂPĂU,MH,648,5,2,0,7,9,8,0,17,22,15,0,37,25,16,0,41,28,18,0,46
111569,159,"CĂMINUL CULTURAL NOU-DÎRVARI",DÎRVARI,MH,1175,25,1,0,26,58,5,0,63,77,8,0,85,95,11,0,106,98,11,0,109
111578,160,"CĂMINUL CULTURAL VECHI-GEMENI",GEMENI,MH,913,11,0,0,11,17,0,0,17,26,0,0,26,51,0,0,51,70,0,0,70
112931,161,"PRIMĂRIA DUBOVA",DUBOVA,MH,418,0,4,0,4,1,35,0,36,6,41,0,47,17,52,0,69,18,57,0,75
112940,162,"FOSTA PRIMĂRIE EIBENTHAL",EIBENTHAL,MH,250,2,0,0,2,5,1,0,6,19,1,0,20,27,2,0,29,30,6,0,36
112922,163,"FOSTA ŞCOALĂ BAIA NOUĂ","BAIA NOUĂ",MH,142,4,0,0,4,11,5,0,16,15,5,0,20,20,5,0,25,23,7,0,30
111596,164,"CĂMINUL CULTURAL DUMBRAVA DE JOS","DUMBRAVA DE JOS",MH,390,7,3,0,10,21,9,0,30,41,18,0,59,61,46,0,107,62,46,6,114
111603,165,"ŞCOALA GENERALĂ ALBULEŞTI",ALBULEŞTI,MH,459,12,1,0,13,21,2,0,23,34,12,0,46,51,15,27,93,54,15,27,96
111667,166,"CLĂDIRE FOSTA ŞCOALĂ VALEA MARCULUI","VALEA MARCULUI",MH,104,5,1,0,6,7,2,0,9,16,5,11,32,24,9,11,44,31,9,11,51
111658,167,"CĂMINUL CULTURAL ROCŞORENI",ROCŞORENI,MH,91,2,5,0,7,15,7,0,22,19,8,0,27,23,11,0,34,24,11,2,37
110679,168,"CLĂDIRE FOSTĂ ŞCOALĂ VLĂDICA",VLĂDICA,MH,61,5,0,0,5,9,3,0,12,13,6,0,19,14,9,0,23,14,15,0,29
112254,169,"GRADINITA ESELNITA",EŞELNIŢA,MH,1162,9,0,0,9,20,0,0,20,23,1,0,24,30,1,0,31,36,1,0,37
112254,170,"GRADINITA ESELNITA",EŞELNIŢA,MH,1231,6,0,0,6,16,0,0,16,20,0,0,20,32,0,0,32,36,0,0,36
111694,171,"ŞCOALA GENERALĂ I-VIII FLOREŞTI",FLOREŞTI,MH,1367,6,1,0,7,12,2,0,14,19,2,0,21,33,2,0,35,38,2,0,40
111774,172,"ŞCOALA GENERALĂ I-VIII ZEGUJANI",ZEGUJANI,MH,800,3,5,0,8,18,8,0,26,25,8,0,33,42,12,0,54,45,14,0,59
111792,173,"CĂMINUL CULTURAL GÎRLA MARE","GÂRLA MARE",MH,1521,17,1,0,18,30,2,0,32,38,3,0,41,60,9,0,69,66,12,0,78
111792,174,"CĂMINUL CULTURAL GÎRLA MARE","GÂRLA MARE",MH,1075,14,2,0,16,26,3,0,29,34,3,0,37,44,5,0,49,50,5,0,55
111827,175,"PRIMĂRIA GODEANU",GODEANU,MH,474,2,0,0,2,6,6,0,12,13,9,0,22,23,22,0,45,37,23,0,60
111872,176,"ŞCOALA GENERALĂ CLASELE I-VIII GOGOȘU",GOGOŞU,MH,922,4,0,0,4,12,4,0,16,20,11,0,31,28,15,0,43,34,15,0,49
111881,177,"ŞCOALA GENERALĂBALTA VERDE","BALTA VERDE",MH,989,2,2,0,4,6,3,0,9,10,4,0,14,19,5,0,24,22,5,0,27
111890,178,"ŞCOALA GENERALĂ BURILA MICĂ","BURILA MICĂ",MH,749,3,0,0,3,5,0,0,5,7,0,0,7,32,1,0,33,32,1,0,33
111907,179,"ŞCOALA GENERALĂOSTROVU MARE","OSTROVU MARE",MH,527,3,0,0,3,8,5,0,13,15,5,0,20,22,10,0,32,22,12,0,34
111907,180,"GRĂDINIȚA PORŢILE DE FIER II","OSTROVU MARE",MH,68,0,4,0,4,0,8,0,8,0,13,0,13,0,16,0,16,0,16,0,16
111925,181,"CĂMINUL CULTURAL GRECI",GRECI,MH,509,11,6,0,17,18,8,0,26,33,12,0,45,38,14,0,52,45,15,0,60
111934,182,"ŞCOALA GENERALĂ BÎLTANELE",BÎLTANELE,MH,307,6,3,0,9,15,5,0,20,18,8,0,26,22,8,5,35,26,15,5,46
111952,183,"ŞCOALA GENERALĂ SĂLĂTRUC",SĂLĂTRUC,MH,173,0,0,0,0,3,0,0,3,9,3,0,12,23,3,0,26,23,3,0,26
111998,184,"ŞCOALA GENERALĂ I-VIII GROZEŞTI",GROZEŞTI,MH,388,11,3,0,14,23,4,0,27,52,7,0,59,60,7,0,67,61,7,0,68
112003,185,"ŞCOALA GENERALĂ I-IV CÎRCENI",CÎRCENI,MH,788,9,0,0,9,18,0,0,18,56,2,0,58,95,8,0,103,99,8,0,107
112021,186,"ŞCOALA GENERALĂ I-IV ŞUŞIŢA",ŞUŞIŢA,MH,388,6,0,0,6,21,4,0,25,41,13,0,54,51,20,0,71,57,23,0,80
112049,187,"CĂMINUL CULTURAL GRUIA",GRUIA,MH,685,4,0,0,4,9,2,0,11,12,2,0,14,19,2,0,21,22,3,0,25
112049,188,"STADIONUL COMUNAL GRUIA",GRUIA,MH,712,3,1,0,4,12,4,0,16,17,4,0,21,29,4,0,33,29,4,0,33
112058,189,"ŞCOALA GENERALĂ IZVOARELE",IZVOARELE,MH,720,1,0,0,1,15,3,0,18,16,3,0,19,25,5,0,30,30,5,0,35
112067,190,"ŞCOALA POIANA GRUII","POIANA GRUII",MH,132,5,4,0,9,12,5,0,17,21,6,0,27,25,8,0,33,25,8,0,33
112085,191,"ŞCOALA GENERALĂ I-VIII HINOVA",HINOVA,MH,862,3,1,0,4,23,9,0,32,34,12,0,46,49,12,0,61,49,12,0,61
112094,192,"ŞCOALA GENERALĂ I-VIII BISTRIŢA",BISTRIŢA,MH,1155,10,2,0,12,28,7,0,35,65,16,0,81,93,25,0,118,108,32,0,140
112110,193,"ŞCOALA GENERALĂ I-IV OSTROVU CORBULUI","OSTROVU CORBULUI",MH,307,4,0,0,4,9,1,0,10,10,1,0,11,16,2,0,18,17,2,0,19
112138,194,"ŞCOALA GIMNAZIALĂ HUSNICIOARA",HUSNICIOARA,MH,557,1,2,0,3,6,5,0,11,10,5,0,15,14,9,0,23,17,9,0,26
112218,195,"CĂMINUL CULTURAL PERI",PERI,MH,318,1,0,0,1,4,3,0,7,9,7,0,16,13,9,0,22,18,10,0,28
112156,196,"ŞCOALA GENERALĂ BĂDIŢEŞTI",BĂDIŢEŞTI,MH,154,0,0,0,0,0,0,0,0,1,2,0,3,8,7,0,15,8,7,0,15
112272,197,"DISPENSAR UMAN ILOVĂŢ",ILOVĂŢ,MH,1006,15,4,0,19,30,6,0,36,52,25,3,80,77,42,3,122,95,46,3,144
112343,198,"ȘCOALA GENERALĂ ILOVIŢA",ILOVIŢA,MH,655,4,0,0,4,9,0,0,9,14,0,0,14,21,4,0,25,27,5,0,32
112352,199,"CĂMINUL CULTURAL BAHNA",BAHNA,MH,421,6,0,0,6,8,3,0,11,14,6,0,20,20,6,0,26,21,7,0,28
112389,200,"CĂMIN CULTURAL ISVERNA",ISVERNA,MH,1285,7,1,0,8,11,1,0,12,16,2,0,18,18,6,0,24,25,6,0,31
112432,201,"ȘCOALA GENERALĂ NADANOVA",NADANOVA,MH,313,2,0,0,2,4,4,0,8,7,6,0,13,8,9,0,17,8,9,0,17
112398,202,"CĂMIN CULTURAL BUSEȘTI",BUSEŞTI,MH,146,0,1,0,1,2,2,0,4,6,3,0,9,8,6,0,14,8,6,0,14
112478,203,"CĂMINUL CULTURAL IZVORU BÎRZII","IZVORU BÎRZII",MH,1101,3,1,0,4,5,6,0,11,21,7,0,28,35,7,0,42,41,8,0,49
112487,204,"ȘCOALA GENERALĂ I-IV BALOTEŞTI",BALOTEŞTI,MH,498,3,1,0,4,10,8,0,18,19,18,0,37,31,23,0,54,35,24,0,59
112496,205,"ȘCOALA GENERALĂ I-VIII HALÎNGA",HALÎNGA,MH,733,2,0,0,2,6,2,0,8,11,3,0,14,18,3,0,21,22,3,0,25
112557,206,"ȘCOALA GENERALĂ I-VIII JIANA",JIANA,MH,566,21,4,0,25,65,8,0,73,87,13,0,100,101,16,0,117,129,16,0,145
112584,207,"ȘCOALA GENERALĂ I-IV JIANA MARE","JIANA MARE",MH,571,2,0,0,2,14,2,0,16,25,3,0,28,48,5,0,53,85,5,0,90
112593,208,"ȘCOALA GENERALĂ I-VIII JIANA VECHE","JIANA VECHE",MH,871,5,3,0,8,13,3,0,16,31,3,0,34,84,3,0,87,86,3,0,89
112575,209,"CĂMINUL CULTURAL DĂNCEU",DĂNCEU,MH,983,8,1,0,9,25,10,0,35,61,17,0,78,82,24,0,106,88,25,0,113
112566,210,"CĂMINUL CULTURAL CIOROBORENI",CIOROBORENI,MH,523,20,1,0,21,42,3,0,45,70,10,0,80,101,17,0,118,109,20,0,129
112619,211,"CĂMINUL CULTURAL LIVEZILE",LIVEZILE,MH,690,1,0,0,1,5,1,0,6,5,10,0,15,9,14,0,23,10,14,0,24
112637,212,"ŞCOALA PRIMARĂ IZVORU ANEŞTILOR","IZVORU ANEŞTILOR",MH,367,1,2,0,3,2,3,0,5,4,3,0,7,7,8,0,15,10,11,0,21
112628,213,"ŞCOALA PRIMARĂ IZVORĂLU DE JOS","IZVORĂLU DE JOS",MH,148,0,1,0,1,2,2,0,4,3,4,0,7,4,8,0,12,4,8,0,12
112673,214,"CĂMINUL CULTURAL MALOVĂŢ",MALOVĂŢ,MH,984,17,4,0,21,35,5,0,40,54,10,0,64,77,22,0,99,95,27,0,122
112735,215,"SCOALA GENERALĂ I-IV 23 AUGUST","23 AUGUST",MH,306,13,7,0,20,19,7,0,26,21,7,0,28,25,8,0,33,25,8,0,33
112682,216,"CĂMINUL CULTURAL BOBAIŢA",BOBAIŢA,MH,493,13,11,0,24,26,17,0,43,52,39,0,91,65,45,0,110,74,45,0,119
112736,217,"ŞCOALA GENERALĂ I-IV COLIBAŞI",COLIBAŞI,MH,363,3,0,0,3,17,3,0,20,28,7,0,35,36,13,0,49,41,13,0,54
112753,218,"CĂMINUL CULTURAL OBÂRŞIA DE CÂMP","OBÎRŞIA DE CÎMP",MH,634,10,4,0,14,24,9,0,33,47,12,0,59,57,13,0,70,63,14,0,77
112762,219,"CĂMINUL CULTURAL IZIMŞA",IZIMŞA,MH,855,14,5,0,19,34,8,0,42,44,16,0,60,69,18,0,87,75,20,0,95
110036,220,"ȘCOALA GENERALĂ I-VIII OBÎRȘIA CLOȘANI",OBÎRŞIA-CLOŞANI,MH,841,7,1,0,8,16,5,0,21,23,6,0,29,35,9,0,44,44,9,0,53
112780,221,"CĂMINULCULTURAL OPRIȘOR",OPRIŞOR,MH,765,8,0,0,8,16,1,0,17,21,3,0,24,23,3,0,26,23,3,0,26
112780,222,"ȘCOALA GENERALĂ I-VIII OPRIȘOR",OPRIŞOR,MH,761,5,1,0,6,10,1,0,11,15,2,0,17,16,2,0,18,17,2,0,19
112799,223,"ȘCOALA GENERALĂ PRISĂCEAUA",PRISĂCEAUA,MH,307,2,3,0,5,2,3,0,5,16,7,0,23,19,7,0,26,19,7,0,26
112815,224,"CĂMINUL CULTURAL PĂDINA MARE","PĂDINA MARE",MH,183,8,2,0,10,11,5,0,16,26,8,0,34,33,8,0,41,35,8,0,43
112851,225,"ŞCOALA GENERALĂ PĂDINA MICĂ","PĂDINA MICĂ",MH,202,0,0,0,0,3,0,0,3,7,0,0,7,9,5,0,14,14,6,0,20
112833,226,"ŞCOALA GENERALĂ IABLANIŢA",IABLANIŢA,MH,208,10,0,0,10,10,2,0,12,15,4,0,19,25,15,0,40,31,18,0,49
112860,227,"CĂMINUL CULTURAL SLAŞOMA",SLAŞOMA,MH,407,15,5,0,20,22,6,0,28,33,7,0,40,43,7,0,50,46,7,0,53
112888,228,"CĂMINUL CULTURAL PĂTULELE",PĂTULELE,MH,1245,11,1,0,12,45,11,0,56,67,13,0,80,85,15,0,100,100,15,0,115
112888,229,"ŞCOALA GENERALĂ I-IV PĂTULELE",PĂTULELE,MH,1046,15,0,0,15,27,2,0,29,39,2,0,41,65,2,0,67,65,3,0,68
112888,230,"GRĂDINIŢA NR. 3 RUDĂRIE",PĂTULELE,MH,377,0,0,0,0,15,0,0,15,55,2,0,57,77,2,0,79,80,2,0,82
112897,231,"CĂMINUL CULTURAL VIAŞU",VIAŞU,MH,417,3,4,0,7,13,8,0,21,22,8,0,30,28,8,0,36,42,8,0,50
112968,232,"CĂMINUL CULTURAL PODENI",PODENI,MH,565,17,0,0,17,29,1,0,30,35,4,0,39,46,5,0,51,55,9,0,64
112977,233,"CĂMINUL CULTURAL GORNENŢI",GORNENŢI,MH,140,3,1,0,4,4,2,0,6,5,2,0,7,20,11,0,31,25,14,0,39
113000,234,"CĂMINUL CULTURAL PONOARELE",PONOARELE,MH,840,1,0,0,1,2,0,0,2,9,0,0,9,13,2,0,15,20,3,0,23
113091,235,"CĂMINUL CULTURAL GHEORGHEŞTI",GHEORGHEŞTI,MH,547,0,0,0,0,3,0,0,3,5,2,0,7,7,5,0,12,11,8,0,19
113082,236,"ȘCOALA GENERALĂ I-IV GĂRDĂNEASA",GĂRDĂNEASA,MH,393,0,0,0,0,0,0,0,0,5,0,0,5,5,0,0,5,9,0,0,9
113028,237,"CĂMINUL CULTURAL BÎRÎIACU",BÎRÎIACU,MH,228,2,6,0,8,5,6,0,11,6,6,0,12,10,6,0,16,12,8,0,20
113162,238,"ŞCOALA GENERALĂ POROINA MARE","POROINA MARE",MH,319,2,1,0,3,5,1,0,6,7,1,0,8,10,3,0,13,10,7,0,17
113180,239,"ŞCOALA GENERALĂ I-IV STIGNIŢA",STIGNIŢA,MH,325,1,0,0,1,6,2,0,8,9,7,0,16,14,8,0,22,14,10,0,24
113171,240,"ŞCOALA GENERALĂ FÎNTÂNILE NEGRE","FÎNTÎNILE NEGRE",MH,132,3,2,0,5,4,6,0,10,4,7,0,11,6,7,0,13,8,8,0,16
113215,241,"CĂMINUL CULTURAL PRISTOL",PRISTOL,MH,797,20,1,0,21,43,7,0,50,84,13,0,97,113,22,0,135,115,22,0,137
113224,242,"ŞCOALA GENERALĂ COZIA",COZIA,MH,438,10,3,0,13,19,5,0,24,25,7,0,32,30,7,0,37,39,9,0,48
113242,243,"ŞCOALA GENERALĂ PRUNIŞOR",PRUNIŞOR,MH,436,9,3,0,12,17,7,0,24,24,10,0,34,38,12,0,50,42,14,0,56
113304,244,"CĂMINUL CULTURAL FÎNTÎNA DOMNEASCĂ","FÎNTÎNA DOMNEASCĂ",MH,308,12,1,0,13,17,4,0,21,24,5,0,29,26,7,0,33,33,8,0,41
113288,245,"CĂMINUL CULTURAL CERVENIŢA",CERVENIŢA,MH,305,2,1,0,3,11,6,0,17,16,9,0,25,24,10,0,34,26,12,0,38
113313,246,"IMOBIL PROPRIETATE PRIVATĂ - PERSOANĂ FIZICĂ",GHELMEGIOAIA,MH,306,3,3,0,6,5,7,0,12,7,7,0,14,7,10,0,17,8,10,0,18
113386,247,"ŞCOALA GENERALĂ ZEGAIA",ZEGAIA,MH,211,4,0,0,4,5,3,0,8,10,5,0,15,15,12,0,27,15,12,0,27
113402,248,"CĂMINUL CULTURAL PUNGHINA",PUNGHINA,MH,991,13,1,0,14,29,1,0,30,39,6,0,45,80,6,0,86,80,6,0,86
113448,249,"ŞCOALA I-IV RECEA",RECEA,MH,809,10,1,0,11,19,1,0,20,27,2,0,29,37,4,0,41,41,8,0,49
113411,250,"CĂMINUL CULTURAL CEARÎNG",CEARÎNGU,MH,123,7,0,0,7,9,1,0,10,11,1,0,12,16,3,0,19,21,4,0,25
113420,251,"CĂMINUL CULTURAL DRINCEA",DRINCEA,MH,285,7,3,0,10,16,8,0,24,30,11,0,41,47,18,0,65,62,19,0,81
113475,252,"ŞCOALA GENERALĂ I-VIII ROGOVA",ROGOVA,MH,1155,6,5,0,11,32,8,0,40,46,8,0,54,60,14,0,74,69,15,0,84
113509,253,"ŞCOALA GENERALĂ V-VIII SALCIA",SALCIA,MH,1141,5,3,0,8,11,5,0,16,16,6,0,22,16,6,0,22,19,8,0,27
113509,254,"ŞCOALA GENERALĂ V-VIII SALCIA",SALCIA,MH,1226,9,2,0,11,12,2,0,14,17,2,0,19,19,4,0,23,21,4,0,25
113527,255,"ŞCOALA GENERALĂ STÎNGĂCEAUA",STÎNGĂCEAUA,MH,709,7,1,0,8,21,4,0,25,27,6,0,33,28,13,0,41,28,13,0,41
113581,256,"ŞCOALA GENERALĂ SATU MARE","SATU MARE",MH,356,2,0,0,2,12,1,0,13,24,2,0,26,41,2,0,43,43,2,0,45
113616,257,"PRIMĂRIA SVINIŢA",SVINIŢA,MH,811,16,1,0,17,23,1,0,24,32,3,0,35,36,12,0,48,45,12,0,57
109835,258,"ŞCOALA GENERALĂ I-VIII ŞIMIAN",ŞIMIAN,MH,1640,12,1,0,13,34,5,0,39,44,12,0,56,83,28,0,111,106,29,0,135
109835,259,"ŞCOALA GENERALĂ I-VIII ŞIMIAN",ŞIMIAN,MH,1808,10,1,0,11,18,2,0,20,29,7,0,36,50,7,0,57,63,7,0,70
109844,260,"ŞCOALA GENERALĂ I-VIII CERNEŢI",CERNEŢI,MH,1442,10,3,0,13,18,4,0,22,33,4,0,37,66,5,0,71,75,8,0,83
109844,261,"ŞCOALA GENERALĂ I-VIII CERNEŢI",CERNEŢI,MH,1435,10,0,0,10,30,5,0,35,37,6,0,43,83,7,0,90,98,10,2,110
109871,262,"ŞCOALA GENERALĂ I-IV DUDAŞU",DUDAŞU,MH,1114,3,0,0,3,14,2,0,16,24,6,0,30,70,11,0,81,111,16,0,127
109853,263,"ŞCOALA GENERALĂ I-IV DEDOVIŢA NOUĂ","DEDOVIŢA NOUĂ",MH,326,3,8,0,11,6,11,0,17,11,11,0,22,13,17,0,30,18,22,0,40
109899,264,"ŞCOALA GENERALĂ I-IV POROINA",POROINA,MH,244,1,0,0,1,2,6,0,8,5,8,0,13,29,10,0,39,29,10,0,39
109880,265,"CLĂDIRE CONSUMCOOP ERGHEVIŢA",ERGHEVIŢA,MH,276,5,0,0,5,7,1,0,8,13,3,0,16,32,10,0,42,39,12,0,51
109906,266,"ŞCOALA GENERALĂ VALEA COPCII","VALEA COPCII",MH,108,0,0,0,0,2,0,0,2,6,0,0,6,11,2,0,13,11,2,0,13
113634,267,"CĂMINUL CULTURAL ŞIŞEŞTI",ŞIŞEŞTI,MH,986,53,3,0,56,81,13,0,94,96,18,0,114,111,26,0,137,131,26,0,157
113661,268,"ŞCOALA GENERALĂ I-IV COCOROVA",COCOROVA,MH,568,3,2,0,5,21,5,0,26,51,12,0,63,87,14,0,101,92,14,0,106
113689,269,"CĂMINUL CULTURAL NOAPTEȘA",NOAPTEŞA,MH,586,8,0,0,8,13,1,0,14,17,1,0,18,28,1,0,29,33,2,0,35
113705,270,"PRIMĂRIA ŞOVARNA",ŞOVARNA,MH,926,18,8,0,26,35,19,0,54,47,25,0,72,60,30,0,90,67,33,0,100
113741,271,"PRIMĂRIA TÎMNA",TÎMNA,MH,969,10,6,0,16,21,11,0,32,29,13,0,42,37,15,0,52,38,20,0,58
113741,272,"ŞCOALA GENERALĂ TÎMNA",TÎMNA,MH,540,1,0,0,1,11,4,0,15,15,7,0,22,24,8,0,32,28,16,0,44
113796,273,"CĂMIN CULTURAL IZVORĂLU",IZVORĂLU,MH,278,3,0,0,3,4,2,0,6,7,5,0,12,10,7,0,17,11,7,0,18
113821,274,"ŞCOALA GENERALĂ PLOPI",PLOPI,MH,483,5,0,0,5,11,1,0,12,13,1,0,14,22,1,0,23,38,2,0,40
113778,275,"ŞCOALA CREMENEA",CREMENEA,MH,166,3,3,0,6,5,7,0,12,12,14,0,26,13,15,0,28,15,15,0,30
113858,276,"ŞCOALA GENERALĂ I-VIII VÎNĂTORI",VÂNĂTORI,MH,918,3,0,0,3,6,0,0,6,18,1,0,19,24,3,0,27,32,3,0,35
113885,277,"ŞCOALA GENERALĂ I-IV ROŞIORI",ROŞIORI,MH,750,4,2,0,6,9,2,0,11,15,8,0,23,33,10,0,43,38,10,0,48
113901,278,"CĂMIN CULTURAL VÎNJULEŢ",VÎNJULEŢ,MH,1453,58,0,0,58,165,4,0,169,211,6,176,393,265,8,176,449,317,8,176,501
113938,279,"ŞCOALA I-VIII PREDA BUZESCU, VLĂDAIA",VLĂDAIA,MH,408,5,0,0,5,8,3,0,11,12,8,0,20,17,11,0,28,17,11,0,28
113947,280,"ŞCOALA GENERALĂ I-IV ALMĂJEL",ALMĂJEL,MH,571,11,2,0,13,21,5,0,26,41,7,0,48,67,16,0,83,69,16,0,85
113956,281,"ŞCOALA GENERALĂ I-IV SCORILA",SCORILA,MH,163,0,0,0,0,0,0,0,0,5,2,0,7,5,4,0,9,6,4,0,10
113965,282,"ŞCOALA GENERALĂ I-IV ŞTIRCOVIŢA",ŞTIRCOVIŢA,MH,162,4,3,0,7,7,5,0,12,8,5,0,13,14,5,0,19,14,5,0,19
113983,283,"ŞCOALA GENERALĂ I-VIII VOLOIAC",VOLOIAC,MH,512,8,2,0,10,29,3,0,32,36,16,0,52,49,21,0,70,60,22,0,82
113992,284,"ŞCOALA GENERALĂ I-IV COTOROAIA",COTOROAIA,MH,446,2,2,0,4,7,4,0,11,39,4,0,43,41,4,0,45,41,5,0,46
114006,285,"FOSTA ŞCOALĂ GENERALĂ I-IV LAC",LAC,MH,97,5,4,0,9,12,8,0,20,18,9,0,27,21,9,0,30,21,10,0,31
114042,286,"ŞCOALA GENERALĂ I-IV VALEA BUNĂ","VALEA BUNĂ",MH,300,12,2,0,14,16,3,0,19,28,9,0,37,30,11,0,41,33,13,0,46
111809,287,"CĂMINUL CULTURAL VRATA",VRATA,MH,1543,11,0,0,11,31,0,0,31,56,0,0,56,92,0,0,92,102,0,0,102
106327,1,"ŞCOALA GIMNAZIALĂ NR. 7","BAIA MARE",MM,1979,6,0,0,6,22,0,0,22,39,1,0,40,60,1,0,61,68,1,0,69
106327,2,"ŞCOALA GIMNAZIALĂ „DR. VICTOR BABEȘ""","BAIA MARE",MM,1997,28,6,0,34,51,6,0,57,71,6,0,77,100,8,0,108,105,8,0,113
106327,3,"ŞCOALA GIMNAZIALĂ „DR. VICTOR BABEȘ""","BAIA MARE",MM,1902,4,1,0,5,26,2,0,28,51,2,0,53,63,2,0,65,67,2,0,69
106327,4,"COLEGIUL TEHNIC„AUREL VLAICU""","BAIA MARE",MM,1397,4,4,0,8,18,7,0,25,28,8,0,36,48,10,0,58,50,10,0,60
106327,5,"COLEGIUL TEHNIC „AUREL VLAICU""","BAIA MARE",MM,1639,8,1,0,9,33,3,0,36,47,3,0,50,68,6,0,74,73,6,0,79
106327,6,"CENTRUL UNIVERSITAR NORD - „FACULTATEA TEHNICĂ""","BAIA MARE",MM,1358,7,0,0,7,17,0,0,17,26,1,0,27,42,2,0,44,43,2,0,45
106327,7,"ŞCOALA GIMNAZIALĂ „NICHITA STĂNESCU""","BAIA MARE",MM,1625,18,0,0,18,47,4,0,51,63,5,0,68,83,5,0,88,92,9,26,127
106327,8,"ŞCOALA GIMNAZIALĂ „NICHITA STĂNESCU""","BAIA MARE",MM,1551,20,0,0,20,57,1,0,58,74,10,0,84,96,12,20,128,99,12,20,131
106327,9,"ŞCOALA GIMNAZIALĂ „AVRAM IANCU""","BAIA MARE",MM,1063,6,1,0,7,20,3,0,23,29,3,0,32,37,3,0,40,38,3,0,41
106327,10,"ŞCOALA GIMNAZIALĂ „AVRAM IANCU""","BAIA MARE",MM,1102,1,2,0,3,7,2,0,9,12,2,0,14,31,2,0,33,36,2,0,38
106327,11,"ŞCOALA GIMNAZIALĂ „AVRAM IANCU""","BAIA MARE",MM,987,5,3,0,8,25,3,0,28,46,5,0,51,57,5,0,62,62,5,0,67
106327,12,"ŞCOALA GIMNAZIALĂ „AVRAM IANCU""","BAIA MARE",MM,1380,10,1,0,11,48,1,0,49,65,1,0,66,88,4,0,92,90,5,0,95
106327,13,"CENTRUL UNIVERSITAR NORD - „FACULTATEA DE LITERE""","BAIA MARE",MM,1459,10,4,0,14,19,6,0,25,48,14,0,62,55,14,0,69,57,18,0,75
106327,14,"CENTRUL UNIVERSITAR NORD - „FACULTATEA DE LITERE""","BAIA MARE",MM,910,9,3,0,12,32,3,0,35,52,3,0,55,65,3,0,68,68,4,0,72
106327,15,"ŞCOALA GIMNAZIALĂ „GEORGE COȘBUC""","BAIA MARE",MM,1234,5,2,0,7,32,4,0,36,50,5,0,55,75,6,0,81,77,7,0,84
106327,16,"ŞCOALA GIMNAZIALĂ „GEORGE COȘBUC""","BAIA MARE",MM,1103,8,0,0,8,34,3,0,37,49,3,0,52,65,4,0,69,67,4,0,71
106327,17,"ŞCOALA GIMNAZIALĂ „NICOLAE IORGA""","BAIA MARE",MM,919,12,1,0,13,29,4,0,33,42,4,0,46,46,5,0,51,49,5,0,54
106327,18,"ŞCOALA GIMNAZIALĂ „NICOLAE IORGA""","BAIA MARE",MM,1181,6,1,0,7,25,1,0,26,38,1,0,39,43,1,0,44,46,5,0,51
106327,19,"GRĂDINIȚA CU PROGRAM NORMAL NR. 20","BAIA MARE",MM,1578,16,1,0,17,50,1,0,51,63,1,0,64,79,6,0,85,88,6,0,94
106327,20,"LICEUL TEORETIC „EMIL RACOVIȚĂ""","BAIA MARE",MM,1521,13,1,0,14,34,5,0,39,54,9,0,63,70,12,0,82,73,12,0,85
106327,21,"LICEUL TEORETIC „EMIL RACOVIȚĂ""","BAIA MARE",MM,1506,8,2,0,10,29,3,0,32,51,3,0,54,84,5,0,89,92,5,0,97
106327,22,"ŞCOALA GIMNAZIALĂ „ALEXANDRU IOAN CUZA""","BAIA MARE",MM,1469,9,1,0,10,31,3,0,34,46,4,0,50,59,6,0,65,65,6,95,166
106327,23,"ŞCOALA GIMNAZIALĂ „ALEXANDRU IOAN CUZA""","BAIA MARE",MM,1587,15,0,0,15,37,4,0,41,59,7,0,66,68,7,0,75,73,8,0,81
106327,24,"GRĂDINIȚA CU PROGRAM PRELUNGIT „MICUL PRINŢ""","BAIA MARE",MM,1518,8,0,0,8,27,0,0,27,46,0,0,46,62,1,0,63,65,1,0,66
106327,25,"ŞCOALA GIMNAZIALĂ NR. 18","BAIA MARE",MM,1505,14,4,0,18,41,4,0,45,56,6,0,62,69,9,0,78,72,12,0,84
106327,26,"ŞCOALA GIMNAZIALĂ NR. 18","BAIA MARE",MM,1488,10,0,0,10,36,3,0,39,45,5,0,50,55,8,0,63,61,8,0,69
106327,27,"REGISTRU AUTO ROMÂN, REPREZENTANȚA MARAMUREȘ","BAIA MARE",MM,1440,7,0,0,7,21,0,0,21,33,0,1,34,42,4,0,46,45,4,0,49
106327,28,"GRĂDINIȚA CU PROGRAM PRELUNGIT NR. 28","BAIA MARE",MM,1512,15,5,0,20,41,6,0,47,59,7,0,66,89,7,0,96,92,7,0,99
106327,29,"GRĂDINIȚA CU PROGRAM PRELUNGIT NR. 25","BAIA MARE",MM,1474,17,0,0,17,37,0,0,37,49,1,0,50,61,1,0,62,61,1,0,62
106327,30,"GRĂDINIȚA CU PROGRAM PRELUNGIT NR. 25","BAIA MARE",MM,1296,13,0,0,13,30,0,0,30,43,0,0,43,53,0,0,53,57,0,0,57
106327,31,"ŞCOALA GIMNAZIALĂ „ION LUCA CARAGIALE""","BAIA MARE",MM,909,3,0,0,3,15,5,0,20,21,5,0,26,29,6,0,35,29,6,0,35
106327,32,"ŞCOALA GIMNAZIALĂ „ION LUCA CARAGIALE""","BAIA MARE",MM,1373,11,1,0,12,39,4,0,43,61,7,0,68,73,8,0,81,85,8,0,93
106327,33,"ŞCOALA GIMNAZIALĂ„ION LUCA CARAGIALE""","BAIA MARE",MM,1299,7,1,0,8,20,1,0,21,33,2,0,35,39,2,0,41,39,2,0,41
106327,34,"GRĂDINIȚA CU PROGRAM PRELUNGIT NR. 34","BAIA MARE",MM,1460,17,1,0,18,45,1,0,46,72,1,0,73,91,3,0,94,102,3,0,105
106327,35,"GRĂDINIȚA CU PROGRAM PRELUNGIT„FLOARE DE COLŢ""","BAIA MARE",MM,1481,9,2,0,11,27,2,0,29,43,4,0,47,55,7,0,62,64,8,0,72
106327,36,"ŞCOALA GIMNAZIALĂ„ALEXANDRU IVASIUC""","BAIA MARE",MM,1478,8,0,0,8,25,0,0,25,45,0,0,45,55,0,0,55,59,0,0,59
106327,37,"ŞCOALA GIMNAZIALĂ„ALEXANDRU IVASIUC""","BAIA MARE",MM,1456,13,0,0,13,32,0,0,32,52,1,0,53,76,2,0,78,89,3,0,92
106327,38,"ŞCOALA GIMNAZIALĂ „DIMITRIE CANTEMIR""","BAIA MARE",MM,1498,10,3,0,13,25,3,0,28,36,4,0,40,45,4,0,49,63,4,0,67
106327,39,"ŞCOALA GIMNAZIALĂ „DIMITRIE CANTEMIR""","BAIA MARE",MM,1446,14,0,0,14,32,1,0,33,48,1,0,49,74,1,0,75,79,1,0,80
106327,40,"ŞCOALA GIMNAZIALĂ „DIMITRIE CANTEMIR""","BAIA MARE",MM,1536,9,6,0,15,26,9,0,35,40,14,0,54,57,16,0,73,65,16,0,81
106327,41,"ANSAMBLUL FOLCLORIC NAȚIONAL„TRANSILVANIA""","BAIA MARE",MM,1419,7,5,0,12,33,6,0,39,56,6,0,62,93,6,0,99,97,10,0,107
106327,42,"LICEUL CU PROGRAM SPORTIV","BAIA MARE",MM,1478,7,3,0,10,40,5,0,45,50,5,0,55,71,6,0,77,83,12,0,95
106327,43,"LICEUL CU PROGRAM SPORTIV","BAIA MARE",MM,1286,7,0,0,7,29,0,0,29,48,0,0,48,66,0,0,66,69,0,0,69
106327,44,"LICEUL CU PROGRAM SPORTIV","BAIA MARE",MM,870,0,0,0,0,12,0,0,12,20,0,0,20,41,1,0,42,44,1,0,45
106327,45,"CENTRUL SOCIAL„ASSOC""","BAIA MARE",MM,1565,12,3,0,15,35,4,0,39,53,6,0,59,72,6,0,78,83,7,0,90
106327,46,"ADMINISTRAȚIA BAZELOR SPORTIVE","BAIA MARE",MM,1533,9,0,0,9,26,2,0,28,56,3,0,59,81,4,0,85,84,9,0,93
106327,47,"SALA SPORTURILOR„LASCĂR PANĂ""","BAIA MARE",MM,1383,4,8,0,12,15,18,0,33,36,24,0,60,47,39,0,86,53,42,0,95
106327,48,"SALA SPORTURILOR„LASCĂR PANĂ""","BAIA MARE",MM,1614,12,12,0,24,35,24,0,59,56,32,0,88,89,37,0,126,97,41,0,138
106327,49,"BIBLIOTECA JUDEȚEANĂ„PETRE DULFU”","BAIA MARE",MM,1275,14,0,0,14,40,3,0,43,60,3,0,63,68,3,0,71,83,3,0,86
106327,50,"LICEUL DE ARTE","BAIA MARE",MM,1128,5,4,0,9,25,5,0,30,50,7,0,57,61,9,0,70,65,9,0,74
106327,51,"LICEUL DE ARTE","BAIA MARE",MM,1163,2,2,2,6,15,6,0,21,30,7,0,37,38,8,0,46,45,8,0,53
106327,52,"LICEUL TEORETIC SANITAR","BAIA MARE",MM,1387,4,3,0,7,21,4,0,25,28,7,0,35,46,8,0,54,48,8,0,56
106327,53,"GRĂDINIȚA CU PROGRAM NORMAL NR. 12","BAIA MARE",MM,1670,8,1,0,9,17,1,0,18,23,1,0,24,33,2,0,35,38,2,0,40
106327,54,"ŞCOALA GIMNAZIALĂ„NICOLAE BĂLCESCU""","BAIA MARE",MM,1501,8,0,0,8,21,0,0,21,23,0,0,23,33,1,0,34,36,1,0,37
106327,55,"ŞCOALA GIMNAZIALĂ„NICOLAE BĂLCESCU""","BAIA MARE",MM,1332,5,0,0,5,24,0,0,24,33,0,0,33,47,0,0,47,58,0,0,58
106327,56,"ŞCOALA GIMNAZIALĂ „MIHAIL SADOVEANU""","BAIA MARE",MM,1207,8,2,0,10,13,2,0,15,29,2,0,31,44,2,0,46,61,2,0,63
106327,57,"ŞCOALA GIMNAZIALĂ„MIHAIL SADOVEANU""","BAIA MARE",MM,1177,9,0,0,9,16,0,0,16,28,0,0,28,51,0,0,51,64,0,0,64
106327,58,"ŞCOALA GIMNAZIALĂ NR. 13","BAIA MARE",MM,1350,3,0,0,3,21,3,0,24,29,7,0,36,35,10,0,45,40,10,0,50
106327,59,"ŞCOALA GIMNAZIALĂ „OCTAVIAN GOGA""","BAIA MARE",MM,1127,5,0,0,5,16,1,0,17,39,4,0,43,50,5,28,83,55,7,28,90
106327,60,"ŞCOALA GIMNAZIALĂ„OCTAVIAN GOGA""","BAIA MARE",MM,1240,5,0,0,5,13,0,0,13,22,1,0,23,39,1,17,57,45,1,17,63
106327,61,"COLEGIUL NAȚIONAL„GHEORGHE ȘINCAI""","BAIA MARE",MM,1631,7,0,0,7,38,2,0,40,53,6,0,59,69,8,0,77,77,13,0,90
106327,62,"COLEGIUL NAȚIONAL„VASILE LUCACIU""","BAIA MARE",MM,1458,14,0,0,14,56,1,0,57,64,1,0,65,75,2,0,77,83,2,0,85
106327,63,"COLEGIUL TEHNIC„GEORGE BARIȚIU""","BAIA MARE",MM,1481,13,3,0,16,43,6,0,49,63,7,0,70,79,11,0,90,81,14,0,95
106327,64,"ȘCOALA GIMNAZIALĂ„LUCIAN BLAGA""","BAIA MARE",MM,1098,7,0,0,7,22,0,0,22,35,0,0,35,47,4,0,51,49,4,0,53
106327,65,"ȘCOALA GIMNAZIALĂ„LUCIAN BLAGA""","BAIA MARE",MM,1055,10,1,0,11,24,3,0,27,30,5,0,35,41,6,0,47,48,6,0,54
106327,66,"ȘCOALA GIMNAZIALĂ„LUCIAN BLAGA""","BAIA MARE",MM,1718,11,3,0,14,29,5,0,34,44,5,0,49,67,5,0,72,74,6,0,80
106327,67,"ȘCOALA GIMNAZIALĂ „LUCIAN BLAGA""","BAIA MARE",MM,1638,3,0,0,3,13,0,0,13,19,0,0,19,27,1,0,28,30,1,0,31
106327,68,"COLEGIUL TEHNIC„ANGHEL SALIGNY""","BAIA MARE",MM,1678,9,2,0,11,29,6,0,35,37,10,0,47,58,29,0,87,61,29,0,90
106327,69,"SC DRUMURI ȘI PODURI MARAMUREȘ SA","BAIA MARE",MM,1443,7,4,0,11,18,5,0,23,24,6,0,30,32,6,0,38,32,6,0,38
106327,70,"CENTRUL „PHOENIX""","BAIA MARE",MM,1423,1,0,0,1,5,0,0,5,19,0,0,19,24,0,0,24,29,0,0,29
106327,71,"ŞCOALA GIMNAZIALĂ „VASILE ALECSANDRI""","BAIA MARE",MM,1511,7,1,0,8,15,3,0,18,26,6,0,32,39,6,0,45,44,6,0,50
106327,72,"ŞCOALA GIMNAZIALĂ „VASILE ALECSANDRI""","BAIA MARE",MM,1544,10,0,0,10,19,0,0,19,36,0,0,36,47,0,0,47,54,0,0,54
106327,73,"ŞCOALA GIMNAZIALĂ „VASILE ALECSANDRI""","BAIA MARE",MM,1469,2,0,0,2,16,0,0,16,35,0,0,35,41,1,0,42,45,1,0,46
106327,74,"ŞCOALA GIMNAZIALĂ „VASILE ALECSANDRI""","BAIA MARE",MM,1594,4,0,0,4,15,1,0,16,26,1,0,27,40,1,0,41,44,1,0,45
106327,75,"ŞCOALA GIMNAZIALĂ „VASILE ALECSANDRI""","BAIA MARE",MM,1356,2,2,0,4,15,4,0,19,25,5,0,30,38,5,0,43,43,5,0,48
106327,76,"GRĂDINIȚA CU PROGRAM PRELUNGIT „OTILIA CAZIMIR""","BAIA MARE",MM,1641,10,0,0,10,29,1,0,30,41,1,0,42,62,5,0,67,71,5,0,76
106327,77,"GRĂDINIȚA CU PROGRAM PRELUNGIT„OTILIA CAZIMIR""","BAIA MARE",MM,1354,3,0,0,3,8,0,0,8,11,6,0,17,17,6,0,23,20,6,0,26
106327,78,"CENTRUL„SFÂNTUL FRANCISC DE ASSISI""","BAIA MARE",MM,1541,4,3,0,7,8,4,0,12,9,4,0,13,18,4,0,22,24,4,0,28
106327,79,"GRĂDINIȚA CU PROGRAM PRELUNGIT NR. 27","BAIA MARE",MM,1803,4,1,0,5,16,1,0,17,28,2,0,30,45,3,0,48,49,4,0,53
106327,80,"ŞCOALA GIMNAZIALĂ „SIMION BĂRNUȚIU""","BAIA MARE",MM,1662,10,1,0,11,17,1,0,18,29,1,0,30,39,3,0,42,46,3,0,49
106327,81,"ŞCOALA GIMNAZIALĂ„SIMION BĂRNUȚIU""","BAIA MARE",MM,1983,8,0,0,8,23,0,0,23,44,0,0,44,68,0,0,68,79,9,0,88
106327,82,"CENTRUL„SALVAȚI FAMILIA”","BAIA MARE",MM,1889,5,0,0,5,16,0,0,16,34,7,0,41,45,8,0,53,49,8,0,57
106327,83,"CENTRUL COMUNITAR ROMANII","BAIA MARE",MM,1236,1,0,0,1,4,0,0,4,10,0,0,10,13,0,0,13,14,0,0,14
106327,84,"COLEGIUL TEHNIC „COSTIN D. NENIȚESCU""","BAIA MARE",MM,1530,9,0,0,9,21,1,0,22,31,1,0,32,39,1,0,40,40,1,0,41
106327,85,"COLEGIUL TEHNIC„COSTIN D. NENIȚESCU""","BAIA MARE",MM,1315,4,3,0,7,16,3,0,19,30,3,0,33,36,3,0,39,40,3,0,43
106568,86,"ȘCOALA GENERALĂ NR. 8","SIGHETU MARMAŢIEI",MM,1116,3,6,0,9,9,7,0,16,17,7,0,24,27,8,0,35,35,9,0,44
106568,87,"ȘCOALA GENERALĂ NR. 1","SIGHETU MARMAŢIEI",MM,1449,1,1,0,2,8,1,0,9,15,1,0,16,26,4,0,30,34,4,0,38
106568,88,"ȘCOALA GENERALĂ NR. 11","SIGHETU MARMAŢIEI",MM,1110,7,3,0,10,11,4,0,15,15,5,0,20,24,5,0,29,29,5,0,34
106568,89,"GRĂDINIȚA NR. 12","SIGHETU MARMAŢIEI",MM,1484,8,3,0,11,25,4,0,29,43,4,0,47,55,4,0,59,61,5,0,66
106568,90,"UNIVERSITATEA „BABEȘ-BOLYAI”","SIGHETU MARMAŢIEI",MM,1236,4,0,0,4,17,0,0,17,27,1,0,28,34,4,18,56,35,4,18,57
106568,91,"UNIVERSITATEA „BABEȘ-BOLYAI”","SIGHETU MARMAŢIEI",MM,542,1,0,0,1,8,0,0,8,13,0,0,13,20,0,0,20,20,0,0,20
106568,92,"LICEUL „REGELE FERDINAND”","SIGHETU MARMAŢIEI",MM,901,7,0,0,7,16,1,0,17,21,1,0,22,26,1,0,27,26,1,0,27
106568,93,"LICEUL „REGELE FERDINAND”","SIGHETU MARMAŢIEI",MM,1061,4,2,0,6,15,2,0,17,26,2,0,28,34,2,0,36,37,4,0,41
106568,94,"COLEGIUL NAȚIONAL „DRAGOȘ VODĂ”","SIGHETU MARMAŢIEI",MM,917,5,1,0,6,18,1,0,19,25,1,0,26,35,2,0,37,38,7,0,45
106568,95,"COLEGIUL NAȚIONAL „DRAGOȘ VODĂ”","SIGHETU MARMAŢIEI",MM,836,0,3,0,3,7,3,0,10,14,4,0,18,19,5,0,24,22,5,0,27
106568,96,"COLEGIUL NAȚIONAL „DRAGOȘ VODĂ”","SIGHETU MARMAŢIEI",MM,1510,9,2,0,11,27,3,0,30,38,3,0,41,48,3,0,51,48,3,0,51
106568,97,"LICEUL „TARAS SEVCENCO”","SIGHETU MARMAŢIEI",MM,1243,6,2,0,8,20,10,0,30,34,10,0,44,52,15,0,67,52,19,0,71
106568,98,"LICEUL „TARAS SEVCENCO”","SIGHETU MARMAŢIEI",MM,1302,12,2,0,14,35,5,0,40,57,6,0,63,69,8,0,77,71,8,0,79
106568,99,"ȘCOALA GENERALĂ NR. 2","SIGHETU MARMAŢIEI",MM,1406,20,0,0,20,25,7,0,32,31,9,0,40,38,12,0,50,41,12,0,53
106568,100,"GRĂDINIȚA NR. 9","SIGHETU MARMAŢIEI",MM,1575,7,0,0,7,23,2,0,25,30,2,0,32,35,3,0,38,37,3,0,40
106568,101,"ȘCOALA GENERALĂ NR. 9","SIGHETU MARMAŢIEI",MM,1249,7,0,0,7,18,0,0,18,32,0,0,32,43,4,0,47,60,5,0,65
106568,102,"ȘCOALA GENERALĂ NR. 9","SIGHETU MARMAŢIEI",MM,1115,11,0,0,11,18,0,0,18,29,1,0,30,36,1,0,37,41,1,0,42
106568,103,"LICEUL TEHNOLOGIC FORESTIER","SIGHETU MARMAŢIEI",MM,896,4,0,0,4,5,0,0,5,8,1,0,9,11,1,0,12,15,1,0,16
106568,104,"LICEUL TEHNOLOGIC FORESTIER","SIGHETU MARMAŢIEI",MM,1097,3,2,0,5,11,3,0,14,18,3,0,21,23,3,0,26,23,3,0,26
106568,105,"ȘCOALA GENERALĂ NR. 6","SIGHETU MARMAŢIEI",MM,1761,6,3,0,9,15,3,0,18,32,3,0,35,45,4,0,49,52,4,0,56
106568,106,"ȘCOALA GENERALĂ NR. 10","SIGHETU MARMAŢIEI",MM,1408,7,1,0,8,22,3,0,25,45,3,0,48,63,3,0,66,65,4,0,69
106568,107,"ȘCOALA GENERALĂ NR. 10","SIGHETU MARMAŢIEI",MM,820,6,1,0,7,22,3,0,25,33,3,0,36,35,6,0,41,39,9,0,48
106568,108,"ȘCOALA GENERALĂ NR. 10","SIGHETU MARMAŢIEI",MM,962,9,0,0,9,18,3,0,21,27,3,0,30,31,4,0,35,34,4,0,38
106568,109,"GRĂDINIȚA NR. 1","SIGHETU MARMAŢIEI",MM,1072,1,0,0,1,17,0,0,17,32,2,0,34,42,3,0,45,53,3,0,56
106568,110,"GRĂDINIȚA NR. 1","SIGHETU MARMAŢIEI",MM,837,4,0,0,4,7,0,0,7,8,0,0,8,9,0,0,9,9,0,0,9
106568,111,"SALA POLIVALENTĂ","SIGHETU MARMAŢIEI",MM,1070,9,0,0,9,24,2,0,26,34,2,0,36,44,2,0,46,50,2,0,52
106568,112,"SALA POLIVALENTĂ","SIGHETU MARMAŢIEI",MM,834,3,3,0,6,17,3,0,20,30,3,0,33,37,5,0,42,37,5,0,42
106568,113,"SALA POLIVALENTĂ","SIGHETU MARMAŢIEI",MM,1879,9,0,0,9,22,0,0,22,31,2,0,33,37,6,0,43,44,8,0,52
106568,114,"ȘCOALA GENERALĂ NR. 5","SIGHETU MARMAŢIEI",MM,1232,5,1,0,6,15,2,0,17,21,4,0,25,31,5,0,36,34,5,0,39
106568,115,"ȘCOALA GENERALĂ NR. 5","SIGHETU MARMAŢIEI",MM,1340,3,0,0,3,8,0,0,8,9,1,0,10,14,6,0,20,14,6,0,20
106568,116,"ȘCOALA GENERALĂ NR. 7","SIGHETU MARMAŢIEI",MM,833,2,0,0,2,2,0,0,2,2,0,0,2,5,0,0,5,6,2,0,8
106693,117,"COLEGIUL TEHNIC DE TRANSPORTURI AUTO","BAIA SPRIE",MM,1172,11,3,0,14,27,3,0,30,32,4,0,36,36,5,0,41,37,5,0,42
106693,118,"COLEGIUL TEHNIC DE TRANSPORTURI AUTO","BAIA SPRIE",MM,1252,9,2,0,11,16,3,0,19,18,3,0,21,29,3,0,32,32,3,0,35
106693,119,"COLEGIUL TEHNIC DE TRANSPORTURI AUTO","BAIA SPRIE",MM,1138,5,1,0,6,9,1,0,10,18,1,0,19,19,1,0,20,28,2,0,30
106693,120,"COLEGIUL TEHNIC DE TRANSPORTURI AUTO","BAIA SPRIE",MM,1244,10,2,0,12,17,2,0,19,24,3,0,27,34,3,0,37,34,3,0,37
106693,121,"ȘCOALA GIMNAZIALĂ","BAIA SPRIE",MM,1620,2,0,0,2,15,0,0,15,26,0,0,26,32,0,0,32,35,0,0,35
106693,122,"ȘCOALA GIMNAZIALĂ","BAIA SPRIE",MM,1554,7,0,0,7,25,0,0,25,44,0,0,44,52,0,0,52,54,0,0,54
106700,123,"ȘCOALA GIMNAZIALĂ",CHIUZBAIA,MM,538,6,4,0,10,14,4,0,18,20,4,0,24,25,5,0,30,31,5,0,36
106728,124,"ȘCOALA GIMNAZIALĂ „IOAN SLAVICI”","SATU NOU DE SUS",MM,887,2,0,0,2,7,0,0,7,12,1,0,13,16,1,0,17,18,3,0,21
106693,125,"SCOALA GIMNAZIALA","BAIA SPRIE",MM,793,0,0,0,0,2,2,0,4,5,2,0,7,5,2,0,7,5,2,0,7
106693,126,"SCOALA GIMNAZIALA","BAIA SPRIE",MM,1258,0,4,0,4,8,4,0,12,19,6,0,25,26,6,0,32,29,6,0,35
106719,127,"ȘCOALA GIMNAZIALĂ „IOAN SLAVICI”","TĂUŢII DE SUS",MM,1229,5,2,0,7,14,4,0,18,14,5,0,19,18,8,0,26,30,10,0,40
106719,128,"ȘCOALA GIMNAZIALĂ „IOAN SLAVICI”","TĂUŢII DE SUS",MM,1147,4,2,0,6,7,3,0,10,10,3,0,13,15,3,0,18,26,4,0,30
106755,129,"ŞCOALA NR. 1",BORŞA,MM,1542,2,8,0,10,2,9,0,11,10,9,0,19,15,9,0,24,15,9,0,24
106755,130,"ŞCOALA NR. 1",BORŞA,MM,1365,5,4,0,9,7,4,0,11,8,4,0,12,10,4,0,14,11,4,0,15
106755,131,"ŞCOALA NR. 8",BORŞA,MM,1308,2,6,0,8,10,6,0,16,10,6,0,16,10,6,0,16,10,6,0,16
106755,132,"ŞCOALA NR. 8",BORŞA,MM,1314,3,0,0,3,11,0,0,11,19,0,0,19,21,0,0,21,23,0,0,23
106755,133,"ŞCOALA NR. 9",BORŞA,MM,1568,5,5,0,10,10,5,0,15,18,5,0,23,19,7,0,26,19,7,0,26
106755,134,"ŞCOALA NR. 9",BORŞA,MM,1058,0,7,0,7,1,7,0,8,3,7,0,10,5,9,0,14,9,9,0,18
106755,135,"ŞCOALA NR. 9 CORP B",BORŞA,MM,1115,3,3,0,6,12,3,0,15,15,5,0,20,19,5,0,24,19,5,0,24
106755,136,"ŞCOALA NR. 9 CORP B",BORŞA,MM,828,2,0,0,2,6,0,0,6,11,1,0,12,11,4,0,15,11,5,0,16
106755,137,"ŞCOALA NR. 9 CORP B",BORŞA,MM,1086,4,5,0,9,14,6,0,20,19,6,0,25,24,6,0,30,25,6,0,31
106755,138,"ŞCOALA GÎRLEA",BORŞA,MM,1050,0,0,0,0,2,0,0,2,2,0,0,2,18,5,0,23,18,5,0,23
106755,139,"ŞCOALA REPEDEA",BORŞA,MM,851,0,4,0,4,0,5,0,5,0,5,0,5,0,5,0,5,0,5,0,5
106755,140,"ŞCOALA REPEDEA",BORŞA,MM,977,3,5,0,8,4,5,0,9,5,5,0,10,7,5,0,12,8,5,0,13
106755,141,"ŞCOALA POIANA",BORŞA,MM,948,1,0,0,1,5,4,0,9,6,4,0,10,8,4,0,12,8,4,0,12
106755,142,"ŞCOALA POIANA",BORŞA,MM,972,1,3,0,4,4,8,0,12,7,9,0,16,8,9,0,17,10,9,0,19
106755,143,"ŞCOALA BIRŢ",BORŞA,MM,1312,1,2,0,3,6,5,0,11,6,5,0,11,9,5,0,14,9,5,0,14
106755,144,"ŞCOALA FÎNTÎNA",BORŞA,MM,1148,0,0,0,0,3,0,0,3,3,0,0,3,6,0,0,6,6,0,0,6
106755,145,"ŞCOALA ROTUNDU",BORŞA,MM,1111,0,0,0,0,4,0,0,4,5,0,0,5,7,1,0,8,7,1,0,8
106755,146,"ŞCOALA ROTUNDU",BORŞA,MM,1201,1,0,0,1,6,0,0,6,9,0,0,9,9,0,0,9,9,0,0,9
106764,147,"ŞCOALA NR. 7","BĂILE BORŞA",MM,1212,1,3,0,4,4,3,0,7,8,3,0,11,10,3,0,13,10,3,0,13
106755,148,"ŞCOALA NR. 7",BORŞA,MM,1358,12,0,0,12,21,0,0,21,24,0,0,24,33,0,1,34,35,0,1,36
106791,149,"COLEGIUL ECONOMIC „PINTEA VITEAZUL”",CAVNIC,MM,1800,21,3,0,24,35,6,0,41,45,6,0,51,56,7,0,63,58,8,0,66
106791,150,"ŞCOALA GENERALĂ NR. 2",CAVNIC,MM,1706,9,6,0,15,19,6,0,25,33,11,0,44,38,11,0,49,45,13,0,58
106791,151,"ŞCOALA GENERALĂ NR. 1",CAVNIC,MM,779,4,1,0,5,6,2,0,8,6,3,0,9,7,3,0,10,9,7,0,16
108026,152,"SALA DE SPORT",DRAGOMIREŞTI,MM,1214,8,2,0,10,19,7,0,26,25,9,0,34,30,11,0,41,32,11,0,43
108026,153,"CENTRUL DE CERCETARI TEOLOGICO-FILOSOFICE",DRAGOMIREŞTI,MM,1378,4,10,0,14,14,12,0,26,23,12,0,35,26,14,0,40,28,14,0,42
108909,154,"CASA DE CULTURĂ","SĂLIŞTEA DE SUS",MM,1665,7,0,0,7,23,0,0,23,36,0,0,36,42,0,0,42,44,1,0,45
108909,155,"ŞCOALA GIMNAZIALĂ „MIHAI EMINESCU""","SĂLIŞTEA DE SUS",MM,1559,4,0,0,4,15,2,0,17,24,2,0,26,34,2,0,36,41,2,0,43
108909,156,"ŞCOALA GIMNAZIALĂ „MIHAI EMINESCU""","SĂLIŞTEA DE SUS",MM,1034,5,1,0,6,8,1,0,9,10,1,0,11,14,1,0,15,18,1,0,19
108972,157,"CASA DE CULTURĂ",SEINI,MM,1749,8,0,0,8,22,0,0,22,27,0,0,27,34,3,0,37,41,4,0,45
108972,158,"ŞCOALA GENERALĂ NR. 1",SEINI,MM,1713,12,1,0,13,24,1,0,25,41,8,0,49,53,8,0,61,60,8,0,68
108972,159,"LICEUL TEHNOLOGIC AGRICOL „ALEXIU BERINDE"", ŞCOALA GENERALĂ SEINI",SEINI,MM,1993,8,0,0,8,19,0,0,19,25,0,0,25,35,0,0,35,36,0,0,36
108972,160,"ŞCOALA MAGHIARĂ",SEINI,MM,1196,11,1,0,12,23,2,0,25,28,3,0,31,32,4,0,36,34,7,0,41
108981,161,ŞCOALA,SĂBIŞA,MM,682,4,1,0,5,7,2,0,9,9,3,0,12,17,4,0,21,21,4,0,25
108990,162,"SALA MULTIFUNCŢIONALĂ VIILE APEI","VIILE APEI",MM,541,3,2,0,5,8,2,0,10,10,2,0,12,13,2,0,15,13,4,0,17
109185,163,"CASA DE CULTURĂ","ŞOMCUTA MARE",MM,846,3,0,0,3,12,1,0,13,17,1,0,18,20,5,0,25,22,6,0,28
109185,164,"ȘCOALA GENERALĂ CU CLASELE I-IV","ŞOMCUTA MARE",MM,734,9,4,0,13,14,4,0,18,21,7,0,28,27,8,0,35,28,9,0,37
109185,165,"GRĂDINIȚA CU PROGRAM PRELUNGIT","ŞOMCUTA MARE",MM,984,7,3,0,10,14,4,0,18,24,5,0,29,34,5,0,39,34,5,0,39
109185,166,"ȘCOALA GENERALĂ NR. 2","ŞOMCUTA MARE",MM,737,1,0,0,1,4,0,0,4,7,0,0,7,11,0,0,11,14,0,0,14
109194,167,"CĂMINUL CULTURAL",BUCIUMI,MM,641,6,4,0,10,12,6,0,18,14,6,0,20,18,7,0,25,36,9,0,45
109201,168,"ȘCOALA GENERALĂ",BUTEASA,MM,320,1,1,0,2,3,2,0,5,4,3,0,7,5,3,0,8,6,4,0,10
109229,169,"ȘCOALA GENERALĂ","CODRU BUTESII",MM,203,3,3,0,6,3,4,0,7,3,4,0,7,4,4,0,8,5,5,0,10
109238,170,"ȘCOALA GENERALĂ","FINTEUŞU MARE",MM,531,8,1,0,9,13,1,0,14,16,1,0,17,21,2,0,23,25,3,0,28
109247,171,"CĂMINUL CULTURAL",HOVRILA,MM,220,0,3,0,3,2,3,0,5,3,3,0,6,5,3,0,8,5,3,0,8
109210,172,"CĂMINUL CULTURAL",CIOLT,MM,507,2,1,0,3,3,1,0,4,5,1,0,6,6,1,0,7,11,1,0,12
109256,173,"CĂMINUL CULTURAL","VĂLENII ŞOMCUTEI",MM,632,4,3,0,7,5,4,0,9,8,4,0,12,9,8,0,17,13,8,0,21
106489,174,"ȘCOALA GENERALĂ",BĂIŢA,MM,877,0,0,0,0,4,0,0,4,10,8,0,18,13,8,0,21,13,8,0,21
106498,175,"ȘCOALA GENERALĂ","BOZÂNTA MARE",MM,561,3,1,0,4,7,1,0,8,8,1,0,9,9,2,0,11,12,3,0,15
106522,176,"ȘCOALA GENERALĂ",NISTRU,MM,598,7,0,0,7,16,1,0,17,21,2,0,23,26,2,0,28,26,2,0,28
106470,177,"SALA MULTIFUNCȚIONALĂ MĂGHERĂUȘ",TĂUŢII-MĂGHERĂUŞ,MM,1123,8,2,0,10,19,2,0,21,26,2,0,28,31,4,0,35,35,4,0,39
106470,178,"LICEUL TEHNOLOGIC „TRAIAN VUIA”",TĂUŢII-MĂGHERĂUŞ,MM,1053,6,1,0,7,24,5,0,29,29,7,0,36,32,7,0,39,35,7,0,42
106470,179,"GRĂDINIȚA HOȘTEZE",TĂUŢII-MĂGHERĂUŞ,MM,774,4,0,0,4,10,0,0,10,14,0,0,14,15,0,0,15,19,0,0,19
106489,180,"CANTONUL SILVIC",BĂIŢA,MM,219,2,0,0,2,5,0,0,5,6,0,0,6,7,3,0,10,8,4,0,12
106489,181,"GRĂDINIȚA ROȘTI",BĂIŢA,MM,470,2,3,0,5,6,6,0,12,14,6,0,20,25,6,0,31,25,6,0,31
106504,182,"CĂMINUL CULTURAL",BUŞAG,MM,552,6,3,0,9,11,3,0,14,14,3,0,17,20,4,0,24,22,4,0,26
106513,183,"CĂMINUL CULTURAL",MERIŞOR,MM,246,5,4,0,9,13,4,0,17,16,4,0,20,17,5,0,22,17,5,0,22
106531,184,"CĂMINUL CULTURAL",ULMOASA,MM,154,4,0,0,4,7,1,0,8,12,2,0,14,15,2,0,17,16,2,0,18
106522,185,"GRĂDINIȚA 9 MAI",NISTRU,MM,325,12,3,0,15,17,3,0,20,26,3,0,29,41,3,0,44,43,3,0,46
106826,186,"CASA ORĂŞENEASCĂ DE CULTURĂ","TÎRGU LĂPUŞ",MM,1721,13,2,0,15,36,5,0,41,50,5,0,55,72,5,0,77,85,8,0,93
106826,187,"ŞCOALA GENERALĂ PENTRU COPII CU DEFICIENŢE","TÎRGU LĂPUŞ",MM,1876,17,3,0,20,54,5,0,59,74,5,0,79,89,6,0,95,114,8,0,122
106826,188,"PRIMĂRIA ORAŞULUI TÎRGU LĂPUŞ","TÎRGU LĂPUŞ",MM,1373,19,2,0,21,49,5,0,54,78,6,0,84,85,7,0,92,93,8,0,101
106835,189,"ŞCOALA GENERALĂ",BOIERENI,MM,304,5,3,0,8,13,11,0,24,16,12,0,28,18,13,0,31,20,13,0,33
106844,190,"ŞCOALA GENERALĂ",BORCUT,MM,412,4,4,0,8,4,4,0,8,4,4,0,8,8,4,0,12,9,4,0,13
106853,191,"ŞCOALA GENERALĂ",CUFOAIA,MM,174,2,5,0,7,3,6,0,9,4,8,0,12,5,8,1,14,5,8,1,14
106862,192,"ŞCOALA GENERALĂ",DĂMĂCUŞENI,MM,789,1,1,0,2,1,1,0,2,1,1,0,2,1,1,0,2,6,2,0,8
106871,193,"ŞCOALA GENERALĂ","DOBRICU LĂPUŞULUI",MM,319,3,4,0,7,4,4,0,8,6,4,0,10,7,4,0,11,8,4,0,12
106880,194,"ŞCOALA GENERALĂ",DUMBRAVA,MM,179,2,1,0,3,2,3,0,5,7,4,0,11,8,4,0,12,10,5,0,15
106899,195,"ŞCOALA GENERALĂ",FÎNTÎNELE,MM,207,1,0,0,1,4,0,0,4,4,0,0,4,5,0,0,5,5,0,0,5
106906,196,"ŞCOALA GENERALĂ",GROAPE,MM,59,1,3,0,4,2,4,0,6,3,4,0,7,4,4,0,8,4,4,0,8
106915,197,"ŞCOALA GENERALĂ",INĂU,MM,214,0,1,0,1,2,2,0,4,3,2,0,5,4,3,0,7,4,3,0,7
106924,198,"CĂMINUL CULTURAL",RĂZOARE,MM,658,10,0,0,10,12,0,0,12,20,0,0,20,30,0,0,30,35,0,0,35
106924,199,"ŞCOALA GENERALĂ",RĂZOARE,MM,484,4,3,0,7,21,6,0,27,31,8,0,39,38,8,0,46,41,8,0,49
106933,200,"CĂMINUL CULTURAL",ROGOZ,MM,1267,7,0,0,7,15,0,0,15,17,0,0,17,30,0,0,30,37,0,0,37
106942,201,GRĂDINIŢĂ,ROHIA,MM,597,3,3,0,6,5,3,0,8,9,3,0,12,14,5,0,19,16,7,0,23
106951,202,"ŞCOALA GENERALĂ",STOICENI,MM,216,1,0,0,1,1,0,0,1,2,0,0,2,6,1,0,7,7,1,0,8
109292,203,"ȘCOALA GIMNAZIALĂ",CHELINŢA,MM,1151,1,3,0,4,5,3,0,8,16,3,0,19,25,4,0,29,31,5,0,36
109274,204,"CENTRUL DE CULTURĂ ȘI ARTĂ",ULMENI,MM,1227,7,1,0,8,14,1,0,15,24,1,0,25,40,2,0,42,53,2,0,55
109283,205,"ȘCOALA GIMNAZIALĂ „KOS KAROLY”",ARDUZEL,MM,704,0,3,0,3,1,4,0,5,5,4,0,9,6,4,0,10,9,5,0,14
109309,206,"CĂMINUL CULTURAL",MÂNĂU,MM,893,4,1,0,5,6,1,0,7,16,2,0,18,29,3,0,32,36,3,0,39
109318,207,"CĂMINUL CULTURAL",SOMEŞ-UILEAC,MM,626,3,2,0,5,7,2,0,9,8,2,0,10,10,3,0,13,11,4,0,15
109327,208,"CĂMINUL CULTURAL",TOHAT,MM,200,1,0,0,1,1,1,0,2,4,1,0,5,4,1,0,5,5,1,0,6
109336,209,"ȘCOALA PRIMARĂ",ŢICĂU,MM,643,2,0,0,2,2,0,0,2,19,0,0,19,23,2,0,25,27,2,0,29
109345,210,"ȘCOALA PRIMARĂ",VICEA,MM,281,7,4,0,11,8,4,0,12,14,4,0,18,16,4,0,20,17,5,0,22
106988,211,"ŞCOALA GENERALĂ NR. 2","VIŞEU DE SUS",MM,1093,4,2,0,6,9,2,0,11,10,3,0,13,10,3,0,13,11,3,0,14
106988,212,"ŞCOALA GENERALĂ NR. 2","VIŞEU DE SUS",MM,1087,1,0,0,1,6,0,0,6,12,0,0,12,14,0,0,14,14,0,0,14
106988,213,"LICEUL TEORETIC BOGDAN VODĂ","VIŞEU DE SUS",MM,902,1,1,0,2,10,1,0,11,14,3,0,17,15,6,0,21,17,8,0,25
106988,214,"LICEUL TEORETIC BOGDAN VODĂ","VIŞEU DE SUS",MM,935,5,0,0,5,10,0,0,10,13,3,0,16,13,3,0,16,13,3,0,16
106988,215,"LICEUL TEHNOLOGIC","VIŞEU DE SUS",MM,1645,8,0,0,8,13,0,0,13,22,1,0,23,24,1,0,25,24,1,0,25
106988,216,"LICEUL TEHNOLOGIC","VIŞEU DE SUS",MM,1643,5,0,0,5,10,0,0,10,16,0,0,16,20,0,0,20,25,0,0,25
106988,217,"LICEUL TEHNOLOGIC NR. 4","VIŞEU DE SUS",MM,1070,1,0,0,1,5,0,0,5,10,0,0,10,13,0,0,13,13,0,0,13
106988,218,"LICEUL TEHNOLOGIC NR. 4","VIŞEU DE SUS",MM,968,1,0,0,1,2,0,0,2,3,0,0,3,3,0,0,3,6,0,0,6
106988,219,"CANTINA DE AJUTOR SOCIAL","VIŞEU DE SUS",MM,1541,7,0,0,7,26,1,0,27,38,2,0,40,47,3,0,50,54,3,0,57
106988,220,"ŞCOALA GIMNAZIALĂ NR. 7","VIŞEU DE SUS",MM,1638,4,0,0,4,11,4,0,15,12,4,0,16,12,5,0,17,16,7,0,23
106988,221,"ŞCOALA GIMNAZIALĂ NR. 7","VIŞEU DE SUS",MM,1550,7,0,0,7,16,1,0,17,24,2,0,26,30,2,0,32,32,3,0,35
106988,222,"ŞCOALA GIMNAZIALĂ NR. 3","VIŞEU DE SUS",MM,761,3,0,0,3,8,0,0,8,12,0,0,12,13,0,0,13,13,0,0,13
107010,223,"ŞCOALACU CLASELEI-VIII",ARDUSAT,MM,1550,10,0,0,10,23,3,0,26,32,3,0,35,36,3,0,39,41,5,0,46
107029,224,"ŞCOALA CU CLASELE I-IV","ARIEŞU DE CÎMP",MM,222,0,0,0,0,2,0,0,2,2,0,0,2,3,0,0,3,4,0,0,4
107038,225,"ŞCOALA CU CLASELEI-IV",COLŢIREA,MM,357,4,5,0,9,10,5,0,15,18,6,0,24,24,7,0,31,27,7,0,34
107056,226,"CĂMINUL CULTURAL",ARINIŞ,MM,684,4,4,0,8,8,4,0,12,12,5,0,17,19,5,0,24,22,5,0,27
107074,227,"CĂMIN CULTURAL TĂMĂŞEŞTI",TĂMĂŞEŞTI,MM,173,4,3,0,7,7,3,0,10,10,6,0,16,12,10,0,22,12,11,0,23
107092,228,PRIMĂRIA,"ASUAJU DE SUS",MM,770,12,3,0,15,20,5,0,25,27,6,0,33,28,9,0,37,30,10,0,40
107109,229,"CĂMINUL CULTURAL","ASUAJU DE JOS",MM,262,2,1,0,3,8,2,0,10,12,5,0,17,16,7,0,23,20,8,0,28
107127,230,"ŞCOALA GIMNAZIALĂ","BĂIŢA DE SUB CODRU",MM,1194,10,2,0,12,19,2,0,21,29,2,0,31,41,4,0,45,41,4,0,45
107145,231,"ŞCOALA CU CLASELE I-IV",URMENIŞ,MM,249,3,2,0,5,3,4,0,7,8,4,0,12,11,6,0,17,11,6,0,17
107181,232,"CĂMINUL CULTURAL",STRÎMBU-BĂIUŢ,MM,498,2,1,0,3,7,3,0,10,7,3,0,10,7,3,0,10,8,3,0,11
107163,233,"ŞCOALA DE ARTE ŞI MESERII",BĂIUŢ,MM,1288,6,0,0,6,10,0,0,10,15,0,0,15,15,0,0,15,16,1,0,17
107172,234,GRĂDINIŢA,"POIANA BOTIZII",MM,191,1,0,0,1,2,0,0,2,5,0,0,5,7,1,0,8,8,1,0,9
107207,235,PRIMĂRIA,BĂSEŞTI,MM,455,0,1,0,1,2,1,0,3,5,1,0,6,8,1,0,9,11,2,0,13
107136,236,"ŞCOALA CU CLASELE I-IV",ODEŞTI,MM,314,4,2,0,6,5,2,0,7,8,3,0,11,10,3,0,13,10,3,0,13
107216,237,"ȘCOALA CU CLASELE I-IV",SĂLIŞTE,MM,76,0,4,0,4,0,9,0,9,1,9,0,10,5,9,0,14,5,9,0,14
107225,238,"ŞCOALA CU CLASELE I-IV",STREMŢ,MM,232,3,3,0,6,4,5,0,9,4,5,0,9,4,5,0,9,4,5,0,9
107323,239,"ŞCOALA GIMNAZIALĂ „MIRCEAVULCANESCU”",BÂRSANA,MM,1492,3,0,0,3,13,19,0,32,15,20,0,35,21,20,0,41,26,20,0,46
107323,240,"ŞCOALAGIMNAZIALĂ „MIRCEAVULCĂNESCU”",BÂRSANA,MM,1168,7,1,0,8,17,29,0,46,26,29,0,55,30,29,0,59,42,29,0,71
107323,241,"ȘCOALA „VALEAMUNTELUI”",BÂRSANA,MM,628,7,1,0,8,9,1,0,10,10,1,0,11,10,1,0,11,12,1,0,13
107332,242,"ȘCOALA „NĂNEȘTI”",NĂNEŞTI,MM,531,2,2,0,4,2,2,0,4,2,3,0,5,3,5,0,8,5,3,0,8
107243,243,"CĂMINUL CULTURAL",BICAZ,MM,442,3,0,0,3,6,0,0,6,7,0,0,7,8,0,0,8,8,0,0,8
107252,244,"ŞCOALA CU CLASELE I-IV",CIUTA,MM,143,0,0,0,0,0,0,0,0,3,0,0,3,3,0,0,3,3,0,0,3
107261,245,"CĂMINUL CULTURAL",CORNI,MM,239,0,0,0,0,6,4,0,10,7,4,0,11,9,4,0,13,11,4,0,15
107289,246,"PRIMĂRIA BISTRA",BISTRA,MM,812,6,3,0,9,14,4,0,18,21,5,0,26,22,5,0,27,23,5,0,28
107298,247,"ŞCOALA GIMNAZIALĂ","CRASNA VIŞEULUI",MM,1271,5,0,0,5,11,0,0,11,14,0,0,14,20,4,0,24,24,5,0,29
107305,248,"ŞCOALA GIMNAZIALĂ","VALEA VIŞEULUI",MM,1190,6,2,0,8,11,3,0,14,14,3,0,17,21,3,0,24,29,3,0,32
107387,249,"ŞCOALA CU CLASELE I-VIII","LUNCA LA TISA",MM,701,2,1,0,3,6,1,0,7,6,1,0,7,8,1,0,9,9,1,0,10
107396,250,"ŞCOALA CU CLASELE I-VIII",TISA,MM,1196,6,1,0,7,7,1,0,8,15,3,0,18,18,3,0,21,22,3,0,25
107369,251,"GRĂDINIŢA DE COPII","BOCICOIU MARE",MM,501,1,0,0,1,3,0,0,3,6,0,0,6,7,0,0,7,8,0,0,8
107378,252,"GRĂDINIŢA DE COPII",CRĂCIUNEŞTI,MM,1277,6,2,0,8,11,2,0,13,17,2,0,19,23,2,0,25,23,2,0,25
107421,253,"ŞCOALA GENERALĂ",BOCICOEL,MM,544,4,4,0,8,8,4,0,12,14,4,0,18,15,8,0,23,17,8,0,25
107412,254,"CLUBUL DIN INCINTA PRIMĂRIEI","BOGDAN VODĂ",MM,1994,4,0,0,4,11,0,0,11,15,0,0,15,17,0,0,17,26,0,0,26
107449,255,PRIMĂRIA,"BOIU MARE",MM,470,3,0,0,3,8,0,0,8,8,0,0,8,13,0,0,13,25,4,0,29
107467,256,"ŞCOALA GENERALĂ",PRISLOP,MM,393,2,0,0,2,6,1,0,7,7,2,0,9,18,2,0,20,18,4,0,22
107458,257,"ŞCOALA GENERALĂ","FRÎNCENII BOIULUI",MM,49,2,0,0,2,2,0,0,2,8,0,0,8,9,1,0,10,9,4,0,13
107476,258,"ŞCOALA GENERALĂ",ROMĂNEŞTI,MM,58,1,1,0,2,3,2,0,5,6,3,0,9,6,5,0,11,6,5,0,11
107494,259,"SEDIUL PRIMĂRIEI BOTIZA",BOTIZA,MM,1847,10,0,0,10,41,0,0,41,54,0,0,54,68,5,0,73,72,6,0,78
107494,260,"ŞCOALA PRIMARĂ VALEA SASULUI",BOTIZA,MM,267,0,0,0,0,7,0,0,7,9,1,0,10,9,1,0,10,9,1,0,10
107537,261,"ȘCOALA CU CLASELE I-VIII",SÎRBI,MM,675,0,2,0,2,1,2,0,3,6,2,0,8,8,2,0,10,9,2,0,11
107528,262,SEDIULPRIMĂRIEI,BUDEŞTI,MM,1146,7,0,0,7,17,0,0,17,21,1,0,22,26,2,0,28,26,2,0,28
107528,263,"SEDIUL GRĂDINIȚEI",BUDEŞTI,MM,667,2,0,0,2,4,1,0,5,10,1,0,11,15,1,0,16,16,1,0,17
107564,264,"ŞCOALA GENERALĂ",CORNEŞTI,MM,354,5,0,0,5,12,0,0,12,14,0,0,14,15,0,0,15,15,0,0,15
107555,265,"CĂMINUL CULTURAL",CĂLINEŞTI,MM,1184,9,1,0,10,12,2,0,14,14,2,0,16,22,2,0,24,24,3,0,27
107573,266,"CĂMINUL CULTURAL",VĂLENI,MM,1094,6,2,0,8,10,2,0,12,10,2,0,12,15,3,0,18,18,3,0,21
107591,267,"CENTRUL CULTURAL CERNEȘTI",CERNEŞTI,MM,678,2,1,0,3,13,1,0,14,13,1,0,14,15,1,0,16,17,1,0,18
107653,268,"CĂMINUL CULTURAL TRESTIA",TRESTIA,MM,594,7,3,0,10,8,3,0,11,8,3,0,11,12,3,0,15,19,3,0,22
107608,269,"ȘCOALA PRIMARĂ BREBENI",BREBENI,MM,170,4,4,0,8,4,4,0,8,4,4,0,8,5,4,0,9,5,4,0,9
107644,270,"ȘCOALA PRIMARĂ MĂGURENI",MĂGURENI,MM,176,2,4,0,6,3,4,0,7,6,5,0,11,7,5,1,13,7,5,1,13
107626,271,"ȘCOALA PRIMARĂ FÎNAȚE",FÎNAŢE,MM,556,1,0,0,1,5,0,0,5,10,2,0,12,11,7,0,18,12,10,0,22
107617,272,"GRĂDINIȚA CIOCOTIȘ",CIOCOTIŞ,MM,812,5,5,0,10,14,7,0,21,22,8,0,30,29,10,0,39,44,10,0,54
107671,273,"CĂMIN CULTURAL",CICÎRLĂU,MM,1960,7,1,0,8,18,5,0,23,33,5,0,38,46,5,0,51,47,5,0,52
107706,274,"CĂMIN CULTURAL",ILBA,MM,1104,4,0,0,4,12,0,0,12,17,5,0,22,19,5,0,24,23,5,0,28
107699,275,"ŞCOALA GIMNAZIALĂ","HANDALU ILBEI",MM,379,1,0,0,1,3,0,0,3,6,0,0,6,8,0,0,8,12,0,0,12
107724,276,PRIMĂRIA,"CÎMPULUNG LA TISA",MM,2076,1,0,0,1,4,0,0,4,8,0,0,8,10,1,0,11,12,2,0,14
108829,277,"ŞCOALA GIMNAZIALA ,,ION POPESCU DE COAȘ""",COAŞ,MM,1109,2,0,0,2,7,0,0,7,13,0,0,13,15,1,0,16,21,1,0,22
108865,278,"ŞCOALA PRIMARĂ ÎNTRERÂURI",ÎNTRERÂURI,MM,68,1,1,0,2,3,2,0,5,3,2,0,5,6,5,0,11,6,5,0,11
108838,279,"CĂMINUL CULTURAL COLTĂU",COLTĂU,MM,2088,6,0,0,6,10,0,0,10,18,1,0,19,31,1,0,32,32,2,0,34
107751,280,"SCOALA GENERALA(CORP NOU)",BERINŢA,MM,605,2,0,0,2,8,0,0,8,11,0,0,11,12,0,0,12,13,0,0,13
107788,281,"CĂMINUL CULTURAL",COPALNIC-DEAL,MM,77,2,1,0,3,6,3,0,9,7,4,0,11,8,4,0,12,8,4,0,12
107804,282,"CĂMINUL CULTURAL",FĂUREŞTI,MM,706,4,0,0,4,6,0,0,6,10,2,0,12,15,2,0,17,18,2,0,20
107813,283,"CĂMINUL CULTURAL",LĂSCHIA,MM,414,3,1,0,4,4,2,0,6,8,3,0,11,12,3,0,15,13,3,0,16
107822,284,"CĂMINUL CULTURAL","PRELUCA NOUĂ",MM,262,0,0,0,0,0,0,0,0,1,0,0,1,1,0,0,1,4,0,0,4
107859,285,"CĂMINUL CULTURAL",VAD,MM,289,2,0,0,2,2,1,0,3,3,1,0,4,4,1,0,5,5,1,0,6
107760,286,ŞCOALA,CĂRPINIŞ,MM,282,0,0,0,0,4,0,0,4,5,0,0,5,5,0,0,5,7,0,0,7
107797,287,ŞCOALA,"CURTUIUŞU MIC",MM,210,0,0,0,0,0,0,0,0,0,0,0,0,2,0,0,2,3,0,0,3
107831,288,ŞCOALA,"PRELUCA VECHE",MM,294,0,0,0,0,2,0,0,2,2,0,0,2,5,0,0,5,5,0,0,5
107779,289,"CĂMINUL CULTURAL",COPALNIC,MM,539,0,0,0,0,1,0,0,1,6,0,0,6,9,0,0,9,11,0,0,11
107840,290,"CĂMINUL CULTURAL",RUŞOR,MM,219,3,1,0,4,4,3,0,7,7,4,0,11,9,5,0,14,10,5,0,15
107742,291,"CĂMINUL CULTURAL",COPALNIC-MĂNĂŞTUR,MM,739,8,1,0,9,11,2,0,13,14,2,0,16,18,2,1,21,18,2,1,21
107877,292,PRIMÃRIE,COROIENI,MM,338,3,0,0,3,6,1,0,7,9,1,0,10,10,4,0,14,10,5,0,15
107886,293,"ŞCOALACU CLASELE I-IV",BABA,MM,382,2,1,0,3,2,1,0,3,2,1,0,3,5,3,0,8,5,4,0,9
107902,294,"ŞCOALACU CLASELE I-IV",DRĂGHIA,MM,166,4,2,0,6,5,3,0,8,5,3,0,8,5,3,0,8,6,3,0,9
107895,295,"ŞCOALACU CLASELE I-IV","DEALU MARE",MM,177,5,2,0,7,12,3,0,15,16,4,0,20,23,4,0,27,24,4,0,28
107911,296,"ŞCOALA GENERALÃ","VĂLENII LĂPUŞULUI",MM,732,4,1,0,5,6,1,0,7,7,1,0,8,9,2,0,11,9,2,0,11
107939,297,"ŞCOALA CU CLASELE I-VIII",CUPŞENI,MM,648,2,0,0,2,4,0,0,4,8,0,0,8,13,0,0,13,13,0,0,13
107948,298,"ŞCOALA CU CLASELE I-VIII",COSTENI,MM,346,1,1,0,2,2,1,0,3,2,2,0,4,2,2,0,4,3,2,0,5
107957,299,"ŞCOALA CU CLASELE V-VIII",LIBOTIN,MM,876,5,0,0,5,12,0,0,12,18,0,0,18,21,2,0,23,27,2,0,29
107966,300,"ŞCOALA CU CLASELE V-VIII",UNGURENI,MM,989,3,2,0,5,8,2,0,10,10,2,0,12,15,4,0,19,15,4,0,19
107993,301,"CĂMINUL CULTURAL",HĂRNICEŞTI,MM,458,2,0,0,2,3,0,0,3,3,0,0,3,6,0,0,6,6,0,0,6
108008,302,ȘCOALA,MARA,MM,756,2,0,0,2,5,0,0,5,10,1,0,11,18,2,0,20,19,2,0,21
107984,303,"CĂMINUL CULTURAL",DESEŞTI,MM,761,5,5,0,10,12,5,0,17,15,6,0,21,18,7,0,25,20,9,0,29
108053,304,"ŞCOALA GENERALĂ",CĂRBUNARI,MM,525,2,2,0,4,3,2,0,5,9,2,0,11,12,2,0,14,12,2,0,14
108062,305,"ŞCOALA GENERALĂ",CHECHIŞ,MM,789,2,2,0,4,7,3,0,10,8,4,0,12,10,4,0,14,14,4,0,18
108071,306,"ŞCOALA GENERALĂ",RUS,MM,537,4,0,0,4,6,2,0,8,10,2,0,12,12,3,0,15,12,5,0,17
108080,307,"ŞCOALA GENERALĂ",ŞINDREŞTI,MM,494,4,1,0,5,6,2,0,8,8,2,0,10,8,5,0,13,8,6,0,14
108099,308,"ŞCOALA GENERALĂ",UNGURAŞ,MM,399,2,1,0,3,10,2,0,12,11,2,0,13,18,3,0,21,21,3,0,24
108044,309,"ŞCOALA NOUĂ",DUMBRĂVIŢA,MM,950,4,0,0,4,14,0,0,14,18,2,0,20,25,2,0,27,27,2,0,29
108115,310,"CĂMINUL CULTURAL",FĂRCAŞA,MM,1463,12,0,0,12,31,4,0,35,49,4,0,53,62,4,0,66,64,9,0,73
108124,311,"CĂMIN CULTURAL",BUZEŞTI,MM,531,1,0,0,1,5,0,0,5,10,1,0,11,16,5,0,21,18,8,0,26
108133,312,"CĂMIN CULTURAL",SÎRBI,MM,425,6,3,0,9,12,4,0,16,23,5,0,28,35,5,0,40,41,5,0,46
108142,313,GRĂDINIŢA,TĂMAIA,MM,849,5,0,0,5,17,4,0,21,21,4,0,25,26,5,0,31,27,6,0,33
108936,314,CĂMINULCULTURAL,GÂRDANI,MM,1111,23,1,0,24,26,2,0,28,39,4,0,43,43,6,0,49,46,6,0,52
108160,315,"CĂMINUL CULTURAL",GIULEŞTI,MM,1052,2,0,0,2,7,2,0,9,10,2,0,12,17,8,0,25,21,8,0,29
108179,316,"CĂMINUL CULTURAL",BERBEŞTI,MM,1223,7,3,0,10,15,3,0,18,17,3,0,20,22,4,0,26,31,5,0,36
108188,317,"ŞCOALA GENERALĂ",FEREŞTI,MM,393,5,2,0,7,13,4,0,17,13,4,0,17,14,4,0,18,15,5,0,20
106372,318,"SEDIUL PRIMĂRIEI GROȘI",GROŞI,MM,1181,5,1,0,6,8,2,0,10,16,2,0,18,25,2,0,27,26,2,0,28
106381,319,"ȘCOALA GENERALĂ",OCOLIŞ,MM,377,2,0,0,2,6,0,0,6,8,0,0,8,10,0,0,10,12,2,0,14
106390,320,"ȘCOALA GENERALĂ","SATU NOU DE JOS",MM,932,4,1,0,5,11,2,0,13,16,2,0,18,19,2,0,21,22,2,0,24
109069,321,"GRĂDINIŢA CU PROGRAM NORMAL GROŞII ŢIBLEŞULUI","GROŞII ŢIBLEŞULUI",MM,936,8,0,0,8,16,2,0,18,20,3,0,23,22,5,0,27,30,5,0,35
109069,322,"ŞCOALA CU CLASELE I-IV GREBLE","GROŞII ŢIBLEŞULUI",MM,778,9,0,0,9,12,0,0,12,15,3,0,18,21,5,0,26,27,5,0,32
108213,323,"ȘCOALA GIMNAZIALĂ",IEUD,MM,1540,9,1,0,10,23,4,0,27,29,4,0,33,31,4,0,35,33,4,0,37
108213,324,"ȘCOALA GIMNAZIALĂ",IEUD,MM,1607,15,3,0,18,23,4,0,27,29,6,0,35,38,6,0,44,40,6,0,46
108213,325,"ȘCOALA PLOPȘOR",IEUD,MM,347,1,2,0,3,2,4,0,6,5,4,0,9,9,5,0,14,10,8,0,18
108231,326,PRIMĂRIA,LĂPUŞ,MM,1451,6,0,0,6,11,1,0,12,20,4,0,24,26,5,0,31,29,5,0,34
108231,327,"GRĂDINIȚA CU PROGRAM NORMAL ,3 GRUPE",LĂPUŞ,MM,1562,12,0,0,12,28,0,0,28,36,0,0,36,46,4,0,50,49,4,0,53
108259,328,PRIMĂRIA,LEORDINA,MM,1444,10,0,0,10,13,6,0,19,23,7,0,30,27,7,0,34,30,7,0,37
108259,329,ŞCOALA,LEORDINA,MM,543,1,0,0,1,6,0,0,6,7,0,0,7,7,0,0,7,10,0,0,10
108295,330,"ŞCOALA GENERALĂ",IADĂRA,MM,788,2,3,0,5,8,6,0,14,14,6,0,20,26,8,0,34,28,8,0,36
108302,331,"CENTRUL MULTIFUNCŢIONAL",LUCĂCEŞTI,MM,516,4,6,0,10,4,9,0,13,12,10,0,22,17,11,0,28,17,11,0,28
108286,332,"CENTRUL SOCIAL DE ASIGURARE A SERVICIILOR SOCIALE","DĂNEŞTII CHIOARULUI",MM,405,7,3,0,10,15,4,0,19,18,4,0,22,23,5,0,28,28,5,0,33
108277,333,PRIMĂRIA,"MIREŞU MARE",MM,1140,3,1,0,4,12,3,0,15,20,3,0,23,31,9,0,40,33,10,0,43
108311,334,"ŞCOALA CU CLASELE I-IV","REMEŢI PE SOMEŞ",MM,469,4,1,0,5,10,1,0,11,14,1,0,15,16,1,0,17,17,3,0,20
108339,335,"ŞCOALA CU CLASELE I-IV",TULGHIEŞ,MM,530,9,0,0,9,20,0,0,20,26,1,0,27,32,4,0,36,47,9,0,56
108357,336,PRIMĂRIA,MOISEI,MM,1698,7,0,0,7,19,4,0,23,26,6,0,32,32,9,0,41,35,9,0,44
108357,337,"ȘCOALA NR. 4",MOISEI,MM,1062,1,0,0,1,3,1,0,4,9,1,0,10,9,2,0,11,13,2,0,15
108357,338,"ȘCOALA NR. 3",MOISEI,MM,1615,6,10,0,16,12,10,0,22,15,12,0,27,19,16,0,35,25,17,0,42
108357,339,"GOSPODĂRIE INDIVIDUALĂ",MOISEI,MM,1217,1,0,0,1,4,0,0,4,9,0,0,9,14,4,0,18,19,4,0,23
108357,340,"ȘCOALA NR. 2",MOISEI,MM,1963,5,4,0,9,10,4,0,14,16,7,0,23,25,7,0,32,29,7,0,36
108375,341,PRIMĂRIA,"OARŢA DE JOS",MM,368,1,0,0,1,2,0,0,2,3,0,0,3,4,2,0,6,6,4,0,10
108384,342,"ȘCOALA GENERALĂ","OARŢA DE SUS",MM,588,10,1,0,11,13,1,0,14,24,2,0,26,32,4,0,36,33,8,0,41
108428,343,"SCOALA CUCLASELE I-VIII",BREB,MM,884,3,0,0,3,4,0,0,4,5,2,0,7,5,3,0,8,8,3,0,11
108437,344,"SCOALA CU CLASELE I-IV",HOTENI,MM,274,1,0,0,1,1,0,0,1,1,0,0,1,1,0,0,1,3,0,0,3
108446,345,"ŞCOALA GENERALĂ",SAT-ŞUGATAG,MM,1002,2,0,0,2,2,0,0,2,3,1,0,4,4,1,0,5,8,1,0,9
108419,346,"SEDIU PRIMARIE","OCNA ŞUGATAG",MM,1366,16,2,0,18,37,18,0,55,50,28,0,78,60,34,0,94,64,37,0,101
107341,347,"CĂMINUL CULTURAL",ONCEŞTI,MM,1259,4,2,0,6,10,6,0,16,17,8,0,25,25,8,0,33,28,20,0,48
108464,348,"ŞCOALA GENERALĂ „MOCEARSCHI”",PETROVA,MM,1026,2,4,0,6,11,4,0,15,14,4,0,18,15,4,0,19,19,4,0,23
108464,349,"ŞCOALA GENERALĂ „SUSANI”",PETROVA,MM,967,9,1,0,10,20,5,0,25,32,9,0,41,36,9,0,45,37,9,0,46
108482,350,"LICEUL TEHNOLOGIC POIENILE DE SUB MUNTE","POIENILE DE SUB MUNTE",MM,1095,5,0,0,5,18,1,0,19,30,1,0,31,38,1,0,39,44,1,0,45
108482,351,"LICEUL TEHNOLOGIC POIENILE DE SUB MUNTE","POIENILE DE SUB MUNTE",MM,1097,9,0,0,9,29,0,0,29,39,0,0,39,44,0,0,44,59,0,0,59
108482,352,"INTERNATUL ȘCOLAR POIENILE DE SUB MUNTE","POIENILE DE SUB MUNTE",MM,1636,12,0,0,12,46,0,0,46,55,0,0,55,65,0,0,65,73,0,0,73
108482,353,"LICEUL TEHNOLOGIC POIENILE DE SUB MUNTE ȘCOALA NEJNEI CRAI","POIENILE DE SUB MUNTE",MM,1383,3,0,0,3,31,0,0,31,39,0,0,39,55,0,0,55,63,0,0,63
108482,354,"ȘCOALA GIMNAZIALĂ NR. 4 HORB POIENILE DE SUB MUNTE","POIENILE DE SUB MUNTE",MM,1324,4,0,0,4,14,0,0,14,28,0,0,28,40,0,0,40,58,1,0,59
108482,355,"ȘCOALA GIMNAZIALĂ NR. 4 STRUCTURA LUHEI POIENILE DE SUB MUNTE","POIENILE DE SUB MUNTE",MM,880,1,3,0,4,6,6,0,12,10,6,0,16,10,6,0,16,13,6,0,19
107500,356,PRIMĂRIA,"POIENILE IZEI",MM,761,9,0,0,9,13,0,0,13,29,0,0,29,34,4,0,38,40,10,0,50
106434,357,"ȘCOALA GIMNAZIALĂ",LĂPUŞEL,MM,1235,3,1,0,4,6,4,0,10,15,5,0,20,18,5,0,23,25,5,0,30
106452,358,"ȘCOALA GIMNAZIALĂ",SĂSAR,MM,1260,5,0,0,5,6,0,0,6,8,0,0,8,14,0,0,14,18,1,0,19
106425,359,"ȘCOALA CU CLASELE I-IV","BOZÎNTA MICĂ",MM,344,5,2,0,7,9,4,0,13,11,5,0,16,11,6,0,17,11,6,0,17
106443,360,"ȘCOALA CU CLASELE I-IV",MOCIRA,MM,933,7,0,0,7,24,0,0,24,38,0,0,38,45,2,0,47,51,4,0,55
106416,361,"ȘCOALĂ GIMNAZIALĂ",RECEA,MM,1034,9,0,0,9,20,0,0,20,37,0,0,37,52,3,0,55,56,7,0,63
106452,362,"CLĂDIREA ADMINISTRATIVĂ BISERICA ,,DUMINICA MIRONOSIȚELOR""",SĂSAR,MM,524,4,0,0,4,8,0,0,8,15,0,0,15,18,0,0,18,20,0,0,20
108516,363,"CĂMINUL CULTURAL",BERCHEZ,MM,526,7,1,0,8,7,2,0,9,9,2,0,11,11,2,0,13,12,3,0,15
108525,364,"CĂMINUL CULTURAL",BERCHEZOAIA,MM,352,1,2,0,3,1,2,0,3,1,3,0,4,1,3,0,4,2,4,0,6
108534,365,"SCOALA PRIMARA",POSTA,MM,269,2,1,0,3,3,3,0,6,5,5,0,10,8,5,0,13,8,5,0,13
108507,366,"SCOALA GIMNAZIALA","REMETEA CHIOARULUI",MM,864,6,1,0,7,8,1,0,9,10,1,0,11,17,4,0,21,18,4,0,22
108543,367,"ȘCOALA CU CLASELE I-IV",REMECIOARA,MM,220,3,0,0,3,6,0,0,6,13,0,0,13,14,0,0,14,16,0,0,16
108570,368,"CĂMIN CULTURAL",PIATRA,MM,312,2,2,0,4,3,2,0,5,4,2,0,6,7,3,0,10,7,3,0,10
108589,369,"CANTON DE EXPLOATARE ABA SOMEŞ-TISA","TECEU MIC",MM,140,1,1,0,2,2,3,0,5,2,5,0,7,2,7,0,9,2,7,0,9
108561,370,"ŞCOALA CU CLASELEI-VIII",REMEŢI,MM,1336,6,3,0,9,10,4,0,14,12,4,0,16,24,5,0,29,27,5,0,32
108561,371,GRĂDINIŢA,REMEŢI,MM,799,2,6,0,8,3,6,0,9,5,6,0,11,6,6,0,12,20,8,0,28
108605,372,"CĂMINUL CULTURAL",REPEDEA,MM,1731,19,2,0,21,83,4,0,87,124,8,0,132,149,9,0,158,164,9,0,173
108605,373,"ŞCOALA GENERALĂ CU CLASELE I-IV LUJANA",REPEDEA,MM,712,2,1,0,3,9,4,0,13,16,5,0,21,22,5,0,27,35,5,0,40
108605,374,"ŞCOALA GENERALĂ CU CLASEL I-IV LESPEDEA DE JOS",REPEDEA,MM,1180,7,5,0,12,16,5,0,21,38,5,0,43,55,6,0,61,80,8,0,88
108623,375,"ŞCOALA GIMNAZIALĂ „LAURENŢIU ULICI""","RONA DE JOS",MM,1710,1,0,0,1,3,0,0,3,7,0,0,7,15,3,0,18,20,4,0,24
108641,376,"CĂMINUL CULTURAL","RONA DE SUS",MM,1633,6,0,0,6,16,0,0,16,24,0,0,24,32,0,0,32,36,5,0,41
108641,377,"CĂMINUL CULTURAL","RONA DE SUS",MM,1518,3,0,0,3,9,3,0,12,9,4,0,13,15,5,0,20,17,6,0,23
108650,378,"GRĂDINIȚA CU PROGRAM NORMAL",COŞTIUI,MM,607,6,0,0,6,11,0,0,11,12,1,0,13,12,2,0,14,14,2,0,16
108678,379,PRIMĂRIA,ROZAVLEA,MM,1896,10,0,0,10,14,1,0,15,19,2,0,21,29,3,0,32,31,3,0,34
108678,380,"GRĂDINIȚA ȘESU MÂNĂSTIRII",ROZAVLEA,MM,759,1,0,0,1,4,0,0,4,8,0,0,8,12,0,0,12,16,0,0,16
108703,381,"CLUBUL TINERETULUI",RUSCOVA,MM,1536,13,0,0,13,16,0,0,16,41,2,0,43,61,2,0,63,67,2,0,69
108703,382,"GRĂDINIŢA NR.1",RUSCOVA,MM,1679,10,2,0,12,14,2,0,16,16,2,0,18,40,3,0,43,47,3,0,50
108703,383,"ŞCOALA GENERALĂ NR.2",RUSCOVA,MM,1117,2,0,0,2,5,3,0,8,11,3,0,14,18,7,0,25,20,7,0,27
106639,384,"CĂMINUL CULTURAL",SARASĂU,MM,1199,3,0,0,3,6,0,0,6,11,3,0,14,11,3,0,14,11,4,0,15
106639,385,"CĂMINUL CULTURAL",SARASĂU,MM,1037,1,1,0,2,3,1,0,4,5,1,0,6,11,1,0,12,13,1,0,14
108721,386,"ȘCOALA GIMNAZIALĂ",SATULUNG,MM,1258,6,0,0,6,16,2,0,18,19,4,0,23,29,4,0,33,34,4,0,38
108730,387,"CĂMINUL CULTURAL","ARIEŞU DE PĂDURE",MM,175,0,1,0,1,4,6,0,10,6,6,0,12,9,6,0,15,9,6,0,15
108749,388,"ŞCOALA PRIMARĂ",FERSIG,MM,579,6,0,0,6,14,1,0,15,20,1,0,21,22,2,0,24,26,2,0,28
108776,389,"ŞCOALA PRIMARĂ",MOGOŞEŞTI,MM,668,4,0,0,4,9,0,0,9,12,1,0,13,18,1,0,19,21,1,0,22
108758,390,"ȘCOALA GIMNAZIALĂ","FINTEUŞU MIC",MM,842,0,0,0,0,2,4,0,6,5,4,0,9,29,4,0,33,33,4,0,37
108767,391,"ȘCOALA GIMNAZIALĂ",HIDEAGA,MM,552,4,1,0,5,6,1,0,7,19,4,0,23,35,8,0,43,35,8,0,43
108785,392,"ŞCOALA GIMNAZIALĂ",PRIBILEŞTI,MM,616,6,0,0,6,9,0,0,9,10,2,0,12,15,2,0,17,15,2,0,17
108801,393,"SALA DE SPORT",SĂCĂLĂŞENI,MM,745,6,0,0,6,15,1,0,16,26,2,0,28,31,4,0,35,31,5,0,36
108847,394,"CĂMINUL CULTURAL",CORUIA,MM,664,8,1,0,9,11,2,0,13,12,2,0,14,13,2,0,15,13,2,0,15
108856,395,"CĂMINUL CULTURAL",CULCEA,MM,505,6,3,0,9,7,3,0,10,13,3,0,16,16,3,0,19,20,5,0,25
108883,396,PRIMĂRIA,SĂCEL,MM,1471,2,0,0,2,7,0,0,7,21,1,0,22,26,1,0,27,27,1,0,28
108883,397,"ŞCOALA VALEA CARELOR",SĂCEL,MM,1351,4,0,0,4,13,1,0,14,22,1,0,23,28,1,0,29,29,1,0,30
108927,398,"CĂMINUL CULTURAL",SĂLSIG,MM,1272,7,0,0,7,15,0,0,15,30,1,0,31,46,5,0,51,51,7,0,58
108954,399,"ȘCOALA GIMNAZIALĂ",SĂPÎNŢA,MM,1354,5,0,0,5,15,0,0,15,20,0,0,20,28,0,0,28,28,0,0,28
108954,400,"ȘCOALA GIMNAZIALĂ",SĂPÎNŢA,MM,1284,10,0,0,10,23,1,0,24,28,2,0,30,30,2,0,32,32,2,0,34
109014,401,"ȘCOALA GENERALĂ",STRÎMTURA,MM,1683,8,2,0,10,16,6,0,22,27,7,0,34,33,7,0,40,35,8,0,43
109014,402,"ȘCOALA GENERALĂ",STRÎMTURA,MM,423,2,1,0,3,3,2,0,5,7,7,0,14,7,8,0,15,7,8,0,15
109023,403,"ȘCOALA GENERALĂ",GLOD,MM,512,7,3,0,10,10,3,0,13,11,3,0,14,22,4,0,26,25,4,0,29
109032,404,"ȘCOALA GENERALĂ",SLĂTIOARA,MM,422,2,1,0,3,3,1,0,4,4,1,0,5,8,2,0,10,14,4,0,18
109087,405,"CĂMINUL CULTURAL","SUCIU DE JOS",MM,842,8,2,0,10,12,3,0,15,13,3,0,16,18,5,0,23,23,6,0,29
109050,406,PRIMĂRIA,"SUCIU DE SUS",MM,1366,10,1,0,11,15,1,0,16,22,2,0,24,40,2,0,42,42,2,0,44
109050,407,"ŞCOALA GENERALĂ CANDELA","SUCIU DE SUS",MM,725,3,4,0,7,7,4,0,11,12,4,0,16,20,4,0,24,22,6,0,28
109078,408,"ŞCOALA PRIMARĂ",LARGA,MM,282,4,0,0,4,5,0,0,5,8,0,0,8,13,0,0,13,13,0,0,13
108687,409,"CĂMINUL CULTURAL",ŞIEU,MM,1186,3,2,0,5,9,3,0,12,17,3,0,20,21,7,0,28,21,7,6,34
108687,410,"ȘCOALADE LA PODUL RÂTULUI",ŞIEU,MM,755,2,0,0,2,4,0,0,4,6,0,0,6,10,1,0,11,10,1,6,17
109103,411,"PRIMĂRIA COMUNEI ȘIȘEȘTI",ŞISEŞTI,MM,1289,3,1,0,4,11,1,0,12,17,3,0,20,20,3,0,23,31,4,0,35
109112,412,"ȘCOALA CU CLASELE I-IV",BONTĂIENI,MM,191,0,0,0,0,0,1,0,1,0,3,0,3,1,3,0,4,2,4,0,6
109149,413,"ŞCOALA CU CLASELE I-IV",NEGREIA,MM,385,0,0,0,0,0,1,0,1,5,1,0,6,5,1,0,6,7,3,0,10
109158,414,"ŞCOALA CU CLS I-IV",PLOPIŞ,MM,437,1,0,0,1,5,0,0,5,8,0,0,8,12,3,0,15,14,3,0,17
109121,415,"ŞCOALA GENERALĂ",CETĂŢELE,MM,515,2,4,0,6,6,5,0,11,11,7,0,18,11,7,0,18,11,7,0,18
109130,416,"ŞCOALA GENERALĂ",DĂNEŞTI,MM,519,1,1,0,2,4,1,0,5,4,1,0,5,5,4,0,9,5,4,0,9
109167,417,"SCOALA GENERALĂ",ŞURDEŞTI,MM,1197,4,0,0,4,8,0,0,8,12,0,0,12,17,1,0,18,21,1,0,22
106657,418,"SCOALA GIMNAZIALA VADU IZEI","VADU IZEI",MM,2051,5,0,0,5,33,0,0,33,35,0,0,35,45,3,0,48,45,5,0,50
106666,419,"SALA DE FESTIVITĂȚI","VALEA STEJARULUI",MM,389,0,0,0,0,5,2,0,7,7,3,0,10,8,5,0,13,12,6,0,18
109372,420,"CAMINUL CULTURAL","CURTUIUŞU MARE",MM,237,7,3,0,10,15,5,0,20,16,5,0,21,22,6,0,28,24,6,0,30
109390,421,"ȘCOALA GENERALĂ",FERICEA,MM,364,1,5,0,6,6,5,0,11,7,5,0,12,11,9,0,20,13,10,0,23
109407,422,"ȘCOALA GENERALĂ",MESTEACĂN,MM,291,2,5,0,7,3,7,0,10,15,8,0,23,27,10,0,37,34,11,0,45
109416,423,"ȘCOALA GENERALĂ",VĂRAI,MM,216,4,1,0,5,6,3,0,9,7,3,0,10,11,5,0,16,12,6,0,18
109363,424,CĂMINULCULTURAL,"VALEA CHIOARULUI",MM,532,7,0,0,7,14,0,0,14,15,3,0,18,18,4,0,22,26,4,0,30
109381,425,CĂMINULCULTURAL,DURUŞA,MM,46,1,0,0,1,4,0,0,4,4,0,0,4,5,0,0,5,5,0,0,5
109434,426,"CĂMINUL CULTURAL","VIMA MICĂ",MM,302,6,0,0,6,11,0,0,11,17,1,0,18,20,2,4,26,20,3,4,27
109452,427,"CĂMINUL CULTURAL","DEALU CORBULUI",MM,82,1,0,0,1,3,2,0,5,3,2,0,5,3,2,0,5,5,2,0,7
109470,428,"CĂMINUL CULTURAL",PETERITEA,MM,196,6,0,0,6,6,1,0,7,9,1,0,10,9,1,0,10,10,1,0,11
109489,429,"CĂMINUL CULTURAL",SĂLNIŢA,MM,206,8,1,0,9,10,4,0,14,12,4,0,16,15,4,0,19,16,4,0,20
109498,430,"CĂMINUL CULTURAL","VIMA MARE",MM,341,2,2,0,4,2,3,0,5,2,3,0,5,3,3,0,6,5,3,0,8
109443,431,"ȘCOALA PRIMARĂ",ASPRA,MM,40,1,0,0,1,1,2,0,3,1,2,0,3,2,2,0,4,2,2,0,4
109461,432,"ȘCOALA PRIMARĂ",JUGĂSTRENI,MM,41,1,0,0,1,2,2,0,4,2,2,0,4,3,2,0,5,3,2,0,5
109513,433,PRIMĂRIE,"VIŞEU DE JOS",MM,1424,5,0,0,5,16,0,0,16,23,1,0,24,35,1,0,36,35,1,0,36
109513,434,CĂMINULCULTURAL,"VIŞEU DE JOS",MM,1520,6,0,0,6,15,6,0,21,24,6,0,30,28,6,0,34,30,6,0,36
109513,435,"ȘCOALA GIMNAZIALĂNR. 2","VIŞEU DE JOS",MM,1299,3,2,0,5,10,2,0,12,12,2,0,14,15,2,0,17,16,2,0,18
114328,1,"CASA “APOLLO” (ŞCOALA DE ARTE)","TÎRGU MUREŞ",MS,1342,12,5,0,17,44,6,0,50,58,10,0,68,76,16,0,92,83,17,0,100
114328,2,"UNIVERSITATEA ""PETRU MAIOR""","TÎRGU MUREŞ",MS,1598,12,0,0,12,37,4,0,41,53,4,0,57,68,6,0,74,71,6,0,77
114328,3,"LICEUL TEORETIC “BOLYAI FARKAS”,","TÎRGU MUREŞ",MS,1414,7,3,0,10,27,8,87,122,39,13,87,139,59,16,87,162,60,22,87,169
114328,4,"INTERNAT LICEUL TEHNOLOGIC ""AVRAM IANCU""","TÎRGU MUREŞ",MS,1348,11,0,0,11,47,0,0,47,67,2,0,69,94,3,0,97,102,3,0,105
114328,5,"ŞCOALA GIMNAZIALĂ ""NICOLAE BĂLCESCU""","TÎRGU MUREŞ",MS,1657,20,3,0,23,52,4,0,56,70,4,0,74,99,4,0,103,109,4,0,113
114328,6,"ŞCOALA GIMNAZIALĂ ""NICOLAE BĂLCESCU""","TÎRGU MUREŞ",MS,1214,8,5,0,13,16,5,0,21,26,6,0,32,42,6,0,48,47,8,0,55
114328,7,"ŞCOALA GIMNAZIALĂ ""NICOLAE BĂLCESCU""","TÎRGU MUREŞ",MS,1363,6,0,0,6,30,0,0,30,44,0,0,44,60,0,0,60,63,0,0,63
114328,8,"ŞCOALA GIMNAZIALĂ ""NICOLAE BĂLCESCU""","TÎRGU MUREŞ",MS,1278,8,0,0,8,25,0,0,25,38,0,0,38,50,0,0,50,57,0,0,57
114328,9,"ŞCOALA GIMNAZIALĂ ""NICOLAE BĂLCESCU""","TÎRGU MUREŞ",MS,1635,12,3,0,15,40,4,0,44,58,4,0,62,71,4,0,75,78,4,0,82
114328,10,"LICEUL TEHNOLOGIC ""AUREL PERŞU""","TÎRGU MUREŞ",MS,1276,1,0,0,1,7,0,0,7,17,0,0,17,21,0,0,21,27,0,0,27
114328,11,"LICEUL TEHNOLOGIC ""AUREL PERŞU""","TÎRGU MUREŞ",MS,1264,6,0,0,6,19,1,0,20,25,2,0,27,39,4,0,43,41,4,0,45
114328,12,"PRIMĂRIA MUNICIPIULUI TG.MUREŞ","TÎRGU MUREŞ",MS,1368,7,3,0,10,30,7,0,37,41,23,0,64,51,31,0,82,59,38,0,97
114328,13,"COLEGIUL AGRICOL ""TRAIAN SAVULESCU""","TÎRGU MUREŞ",MS,1558,10,3,0,13,40,5,0,45,68,7,0,75,84,9,0,93,89,11,0,100
114328,14,"ŞCOALA GIMNAZIALĂ ""AL.I.CUZA""","TÎRGU MUREŞ",MS,1585,12,0,0,12,31,0,0,31,42,0,0,42,70,1,0,71,81,4,0,85
114328,15,"ŞCOALA GIMNAZIALĂ ""AL.I.CUZA""","TÎRGU MUREŞ",MS,1690,4,2,0,6,19,2,0,21,35,4,0,39,55,4,0,59,62,7,0,69
114328,16,"ŞCOALA GIMNAZIALĂ ""AL.I.CUZA""","TÎRGU MUREŞ",MS,1647,9,0,0,9,42,0,0,42,50,0,0,50,64,0,0,64,75,0,0,75
114328,17,"ŞCOALA GIMNAZIALĂ""AL.I.CUZA""","TÎRGU MUREŞ",MS,1733,15,4,0,19,53,5,0,58,55,6,0,61,74,10,0,84,83,14,0,97
114328,18,"ŞCOALA GIMNAZIALĂ""AL.I.CUZA""","TÎRGU MUREŞ",MS,1626,4,0,0,4,21,0,0,21,37,0,0,37,50,0,0,50,67,3,0,70
114328,19,"ŞCOALA GIMNAZIALĂ""AL.I.CUZA""","TÎRGU MUREŞ",MS,1897,19,1,0,20,34,2,0,36,42,4,0,46,66,4,0,70,78,5,0,83
114328,20,"ŞCOALA GEN. NR. 19 BEŞA","TÎRGU MUREŞ",MS,774,0,0,0,0,0,0,0,0,4,0,0,4,5,0,0,5,7,0,0,7
114328,21,"ŞCOALA GIMNAZIALĂ ""FRIEDERICH SCHILLER""","TÎRGU MUREŞ",MS,1280,9,2,0,11,34,2,0,36,47,5,0,52,67,7,0,74,80,8,0,88
114328,22,"ŞCOALA GIMNAZIALĂ ""FRIEDERICH SCHILLER""","TÎRGU MUREŞ",MS,1262,7,0,0,7,34,0,0,34,58,1,0,59,67,2,0,69,77,3,0,80
114328,23,"LICEUL CU PROGRAM SPORTIV ""SZASZ ADALBERT""","TÎRGU MUREŞ",MS,1553,4,0,0,4,16,0,0,16,28,1,0,29,38,7,0,45,46,7,0,53
114328,24,"ŞCOALA GIMNAZIALĂ ""EUROPA""","TÎRGU MUREŞ",MS,1493,8,1,0,9,46,12,0,58,68,38,0,106,84,45,0,129,91,55,0,146
114328,25,"GRĂDINIŢA PROGR.PREL.NR.6","TÎRGU MUREŞ",MS,1298,13,1,0,14,36,4,0,40,42,5,0,47,50,6,0,56,54,8,0,62
114328,26,"LICEUL TEHNOLOGIC ""C-TIN BRÂNCUŞI""","TÎRGU MUREŞ",MS,1398,10,2,0,12,45,3,0,48,72,5,0,77,93,14,0,107,100,17,65,182
114328,27,"ŞCOALA GIMNAZIALĂ NR. 7 CORP A","TÎRGU MUREŞ",MS,1429,12,2,0,14,52,11,0,63,76,12,0,88,100,16,0,116,105,18,0,123
114328,28,"ŞCOALA GIMNAZIALĂ NR. 7, CORPUL B","TÎRGU MUREŞ",MS,1133,6,5,0,11,20,8,0,28,35,11,0,46,45,15,0,60,56,20,0,76
114328,29,"ŞCOALA GIMNAZIALĂ NR. 7, CORPUL B","TÎRGU MUREŞ",MS,1322,7,0,0,7,35,0,0,35,49,0,0,49,57,2,0,59,63,2,0,65
114328,30,"LICEUL TEHNOLOGIC ""ION VLASIU""","TÎRGU MUREŞ",MS,1531,3,0,0,3,38,8,0,46,54,13,0,67,118,17,103,238,95,17,103,215
114328,31,"CENTRUL CULTURAL ""MIHAI EMINESCU""","TÎRGU MUREŞ",MS,831,7,6,0,13,37,19,0,56,54,30,82,166,60,41,82,183,70,51,82,203
114328,32,"COLEGIUL NAŢIONAL ""UNIREA""","TÎRGU MUREŞ",MS,1638,10,1,0,11,44,5,84,133,53,9,84,146,62,19,84,165,75,20,84,179
114328,33,"LICEUL VOCAŢIONAL ""M. EMINESCU""","TÎRGU MUREŞ",MS,1632,7,2,0,9,26,2,0,28,44,2,0,46,62,5,0,67,76,5,0,81
114328,34,"ŞCOALA GIMNAZIALĂ ""T.VLADIMIRESCU""","TÎRGU MUREŞ",MS,1532,6,0,0,6,13,2,0,15,28,4,0,32,44,12,0,56,53,13,0,66
114328,35,"ŞCOALA GIMNAZIALĂ ""T.VLADIMIRESCU""","TÎRGU MUREŞ",MS,1548,16,0,0,16,44,2,0,46,59,2,0,61,85,10,0,95,91,10,0,101
114328,36,"ŞCOALA GIMNAZIALĂ ""T.VLADIMIRESCU""","TÎRGU MUREŞ",MS,1536,17,0,0,17,34,0,0,34,45,0,0,45,76,2,0,78,86,2,0,88
114328,37,"ŞCOALA GIMNAZIALĂ ""T.VLADIMIRESCU""","TÎRGU MUREŞ",MS,1584,10,2,0,12,25,2,0,27,48,2,0,50,64,4,0,68,73,5,0,78
114328,38,"ŞCOALA GIMNAZIALĂ ""T.VLADIMIRESCU""","TÎRGU MUREŞ",MS,1418,2,0,0,2,21,0,0,21,43,0,0,43,73,0,0,73,80,0,0,80
114328,39,"LICEUL TEHNOLOGIC ELECTROMUREŞ","TÎRGU MUREŞ",MS,1667,15,6,0,21,46,7,0,53,73,7,0,80,95,9,0,104,107,9,0,116
114328,40,"LICEUL TEHNOLOGIC ELECTROMUREŞ","TÎRGU MUREŞ",MS,1663,9,0,0,9,40,0,0,40,55,0,0,55,73,6,0,79,86,6,0,92
114328,41,"LICEUL TEHNOLOGIC ELECTROMUREŞ","TÎRGU MUREŞ",MS,1526,6,5,0,11,20,30,0,50,30,30,0,60,43,30,0,73,47,30,0,77
114328,42,"LICEUL TEHNOLOGIC ELECTROMUREŞ","TÎRGU MUREŞ",MS,1506,15,3,0,18,43,5,0,48,57,5,0,62,81,6,0,87,88,6,0,94
114328,43,"PUNCT COLECTARE TAXE ŞI IMPOZITE","TÎRGU MUREŞ",MS,1094,11,5,0,16,31,7,0,38,52,7,0,59,66,9,0,75,71,11,0,82
114328,44,"ŞCOALA GIMNAZIALĂ ""MIHAI VITEAZUL""","TÎRGU MUREŞ",MS,1630,8,1,0,9,44,3,0,47,60,4,0,64,81,13,0,94,82,13,0,95
114328,45,"ŞCOALA GIMNAZIALĂ ""MIHAI VITEAZUL""","TÎRGU MUREŞ",MS,1591,21,1,0,22,48,1,0,49,61,2,0,63,85,2,0,87,94,2,0,96
114328,46,"ŞCOALA GIMNAZIALĂ ""MIHAI VITEAZUL""","TÎRGU MUREŞ",MS,1599,6,6,0,12,39,7,0,46,43,7,0,50,68,7,0,75,78,7,0,85
114328,47,"ŞCOALA GIMNAZIALĂ ""MIHAI VITEAZUL""","TÎRGU MUREŞ",MS,1570,13,4,0,17,48,4,0,52,58,5,0,63,77,5,0,82,87,5,0,92
114328,48,"ŞCOALA GIMNAZIALĂ ""ROMULUS GUGA""","TÎRGU MUREŞ",MS,1510,11,3,0,14,34,10,0,44,51,12,0,63,70,18,0,88,73,20,0,93
114328,49,"ŞCOALA GIMNAZIALĂ ""ROMULUS GUGA""","TÎRGU MUREŞ",MS,1715,16,2,0,18,45,3,0,48,61,3,0,64,85,4,0,89,92,5,0,97
114328,50,"ŞCOALA GIMNAZIALĂ ""ROMULUS GUGA""","TÎRGU MUREŞ",MS,1550,11,4,0,15,37,5,0,42,55,5,0,60,77,6,0,83,83,7,0,90
114328,51,"ŞCOALA GIMNAZIALĂ ""ROMULUS GUGA""","TÎRGU MUREŞ",MS,1455,8,0,0,8,32,0,0,32,44,0,0,44,72,0,0,72,77,0,0,77
114328,52,"GRĂDINIŢA CU PROGR.PREL.""CODRIŞOR""","TÎRGU MUREŞ",MS,1639,7,1,0,8,23,2,0,25,46,3,0,49,55,3,0,58,61,8,0,69
114328,53,"ŞCOALA GIMNAZIALĂ ""G.COŞBUC""","TÎRGU MUREŞ",MS,1446,10,0,0,10,39,1,1,41,51,1,1,53,76,2,1,79,84,2,1,87
114328,54,"ŞCOALA GIMNAZIALĂ ""G.COŞBUC""","TÎRGU MUREŞ",MS,1576,8,0,0,8,39,1,0,40,52,3,0,55,68,3,0,71,70,3,0,73
114328,55,"ŞCOALA GIMNAZIALĂ ""DACIA""/B","TÎRGU MUREŞ",MS,1509,13,0,0,13,55,0,0,55,73,0,0,73,97,0,0,97,102,0,0,102
114328,56,"ŞCOALA GIMNAZIALĂ ""DACIA""/B","TÎRGU MUREŞ",MS,1514,15,0,0,15,57,0,0,57,82,0,0,82,107,2,0,109,109,2,0,111
114328,57,"CENTRUL ŞCOLAR PENTRU EDUCAŢIE INCLUZIVĂ NR.1","TÎRGU MUREŞ",MS,1573,4,0,0,4,26,1,0,27,48,1,0,49,72,1,0,73,77,2,0,79
114328,58,"CENTRUL ŞCOLAR PENTRU EDUCAŢIE INCLUZIVĂ NR.1","TÎRGU MUREŞ",MS,1395,1,0,0,1,7,6,0,13,12,6,0,18,17,6,0,23,20,6,0,26
114328,59,"ŞCOALA GIMNAZIALĂ ""DACIA""/A","TÎRGU MUREŞ",MS,1558,8,1,0,9,38,1,0,39,64,1,0,65,81,1,0,82,93,1,0,94
114328,60,"ŞCOALA GIMNAZIALĂ ""DACIA""/A","TÎRGU MUREŞ",MS,1440,11,2,0,13,45,2,0,47,65,4,5,74,90,4,5,99,98,5,5,108
114328,61,"ŞCOALA GIMNAZIALĂ ""DACIA""/A","TÎRGU MUREŞ",MS,978,11,0,0,11,18,0,0,18,27,2,0,29,36,16,0,52,38,19,0,57
114328,62,"LICEUL TEHNOLOGIC ""AVRAM IANCU""","TÎRGU MUREŞ",MS,1331,8,0,0,8,43,2,0,45,61,3,0,64,90,4,0,94,103,4,0,107
114328,63,"LICEUL TEHNOLOGIC ""AVRAM IANCU""","TÎRGU MUREŞ",MS,1544,11,3,0,14,35,3,0,38,51,5,0,56,67,5,0,72,79,7,0,86
114328,64,"LICEUL TEHNOLOGIC ""AVRAM IANCU""","TÎRGU MUREŞ",MS,1426,5,8,0,13,30,11,0,41,50,11,0,61,91,14,15,120,91,14,15,120
114328,65,"GRĂDINIŢA PROG.PREL.""ALBINUŢA""","TÎRGU MUREŞ",MS,1333,6,1,0,7,27,1,0,28,34,1,0,35,53,4,0,57,60,4,0,64
114328,66,"ŞCOALA GIMNAZIALĂ ""LIVIU REBREANU""","TÎRGU MUREŞ",MS,1423,13,0,0,13,43,1,0,44,58,2,0,60,66,3,0,69,68,3,0,71
114328,67,"ŞCOALA GIMNAZIALĂ ""LIVIU REBREANU""","TÎRGU MUREŞ",MS,1430,12,1,0,13,37,2,0,39,55,5,0,60,89,5,0,94,94,5,0,99
114328,68,"ŞCOALA GIMNAZIALĂ ""LIVIU REBREANU""","TÎRGU MUREŞ",MS,1462,12,0,0,12,41,0,0,41,60,0,0,60,80,2,0,82,85,2,0,87
114328,69,"ŞCOALA GIMNAZIALĂ ""LIVIU REBREANU""","TÎRGU MUREŞ",MS,1463,5,5,0,10,24,7,0,31,39,8,0,47,58,8,0,66,73,9,0,82
114328,70,"GRĂDINIŢA PROG.PREL.""LICURICI""","TÎRGU MUREŞ",MS,1487,6,0,0,6,29,0,0,29,44,0,0,44,58,3,0,61,63,3,0,66
114328,71,"GRĂDINIŢA PROG.PREL.""LICURICI""","TÎRGU MUREŞ",MS,1269,10,1,0,11,43,1,0,44,48,2,0,50,53,2,1,56,58,2,1,61
114328,72,"LICEUL TEHNOLOGIC ""GH. ŞINCAI""","TÎRGU MUREŞ",MS,1519,12,0,0,12,44,1,0,45,60,5,0,65,72,5,0,77,80,5,0,85
114328,73,"LICEUL TEHNOLOGIC ""GH. ŞINCAI""","TÎRGU MUREŞ",MS,1475,16,0,0,16,51,0,0,51,69,0,0,69,92,0,0,92,106,0,0,106
114328,74,"ŞCOALA GIMNAZIALĂ LIVIU REBREANU","TÎRGU MUREŞ",MS,1367,15,0,0,15,39,0,0,39,64,5,0,69,95,5,0,100,101,5,0,106
114328,75,"ŞCOALA GIMNAZIALĂ LIVIU REBREANU","TÎRGU MUREŞ",MS,1449,7,0,0,7,29,0,0,29,54,1,0,55,69,2,0,71,76,2,0,78
114328,76,"GRĂDINIŢA CU PROG.PREL.""RÂNDUNICA""","TÎRGU MUREŞ",MS,1675,13,2,0,15,36,4,0,40,55,4,0,59,59,5,0,64,80,6,0,86
114328,77,"LICEUL TEHNOLOGIC ""GH.ŞINCAI""","TÎRGU MUREŞ",MS,1573,14,1,0,15,40,1,0,41,51,4,0,55,73,4,0,77,76,4,0,80
114328,78,"ŞCOALA GIMNAZIALĂ ""SERAFIM DUICU""","TÎRGU MUREŞ",MS,1641,13,3,0,16,34,3,0,37,43,3,0,46,52,4,0,56,62,5,0,67
114328,79,"ŞCOALA GIMNAZIALĂ ""SERAFIM DUICU""","TÎRGU MUREŞ",MS,1428,12,1,0,13,19,1,0,20,27,1,0,28,31,4,0,35,38,4,0,42
114328,80,"ŞCOALA GIMNAZIALĂ ""SERAFIM DUICU""","TÎRGU MUREŞ",MS,1623,5,0,0,5,18,2,0,20,31,4,0,35,48,4,0,52,56,5,0,61
114328,81,"LICEUL TEHNOLOGIC ""TRAIAN VUIA""","TÎRGU MUREŞ",MS,1639,4,1,0,5,20,3,0,23,42,4,0,46,54,6,0,60,57,4,0,61
114328,82,"LICEUL TEHNOLOGIC ""TRAIAN VUIA""","TÎRGU MUREŞ",MS,1608,3,0,0,3,14,0,0,14,26,0,0,26,32,0,0,32,36,0,0,36
114328,83,"LICEUL TEHNOLOGIC ""TRAIAN VUIA""","TÎRGU MUREŞ",MS,1525,16,2,0,18,37,7,0,44,43,7,0,50,55,7,0,62,61,7,0,68
114328,84,"LICEUL TEHNOLOGIC ""EMIL DANDEA""","TÎRGU MUREŞ",MS,1210,4,3,0,7,18,5,0,23,20,5,0,25,27,5,0,32,27,5,0,32
114328,85,"CĂMINUL CULTURAL","TÎRGU MUREŞ",MS,1009,5,0,0,5,8,1,0,9,12,1,0,13,23,1,0,24,27,1,0,28
114818,86,"ŞCOALA GIMNAZIALĂ""ALEXANDRU CEUŞIANU""",REGHIN,MS,1477,16,3,0,19,43,9,0,52,58,10,0,68,79,11,0,90,84,11,0,95
114818,87,"CLUBUL COPIILOR",REGHIN,MS,1384,7,1,0,8,16,4,0,20,22,7,0,29,34,7,0,41,40,7,0,47
114818,88,"LICEUL TEHNOLOGIC""LUCIAN BLAGA""",REGHIN,MS,1533,7,0,0,7,25,2,0,27,29,2,0,31,38,2,0,40,47,2,0,49
114818,89,"LICEUL TEHNOLOGIC""LUCIAN BLAGA""",REGHIN,MS,1294,3,2,0,5,16,2,0,18,21,2,0,23,26,2,0,28,35,2,0,37
114818,90,"LICEUL TEHNOLOGIC""PETRU MAIOR""",REGHIN,MS,1635,9,5,0,14,24,6,0,30,38,8,0,46,53,8,0,61,57,8,0,65
114818,91,"LICEUL TEHNOLOGIC""PETRU MAIOR""",REGHIN,MS,1569,20,0,0,20,28,0,0,28,35,0,0,35,41,0,0,41,47,0,0,47
114818,92,"LICEUL TEHNOLOGIC ""PETRU MAIOR""",REGHIN,MS,1544,3,3,0,6,22,3,0,25,28,4,0,32,44,4,0,48,48,4,0,52
114818,93,"LICEUL TEHNOLOGIC""IOAN BOJOR""",REGHIN,MS,1661,3,2,0,5,17,2,0,19,29,2,0,31,39,2,0,41,41,2,0,43
114818,94,"LICEUL TEHNOLOGIC ""IOAN BOJOR""",REGHIN,MS,1700,11,0,0,11,28,0,0,28,48,0,0,48,73,0,0,73,79,0,0,79
114818,95,"GRĂDINIŢA CU PROGRAM PRELUNGIT NR.4",REGHIN,MS,1003,6,2,0,8,14,2,0,16,21,3,0,24,28,5,0,33,28,6,0,34
114818,96,"GRĂDINIŢA CU PROGRAM PRELUNGIT NR.4",REGHIN,MS,983,3,0,0,3,12,0,0,12,21,4,0,25,28,4,0,32,32,4,0,36
114818,97,"CĂMINUL CULTURAL ""IERNUŢENI""",REGHIN,MS,1577,11,0,0,11,22,1,0,23,27,2,0,29,33,3,0,36,35,5,0,40
114818,98,"ŞCOALA GIMNAZIALĂ NR.4",REGHIN,MS,1052,1,0,0,1,5,1,0,6,11,1,0,12,14,1,0,15,20,1,0,21
114818,99,"ŞCOALA GIMNAZIALĂ NR.4",REGHIN,MS,1141,7,0,0,7,19,1,0,20,21,1,0,22,27,1,0,28,33,1,0,34
114818,100,"GRĂDINIŢA CU PROGRAM PRELUNGIT NR.3",REGHIN,MS,1424,22,2,0,24,52,2,0,54,64,2,0,66,91,2,0,93,97,5,0,102
114818,101,"ŞCOALA GIMNAZIALĂ""FLOREA BOGDAN""",REGHIN,MS,1360,6,0,0,6,16,3,0,19,31,3,0,34,44,3,0,47,53,3,0,56
114818,102,"ŞCOALA GIMNAZIALĂ ""FLOREA BOGDAN""",REGHIN,MS,1445,4,6,0,10,21,6,0,27,29,6,0,35,35,6,0,41,42,7,0,49
114818,103,"ŞCOALA GIMNAZIALĂ ""FLOREA BOGDAN""",REGHIN,MS,1376,14,3,0,17,26,3,0,29,37,3,0,40,45,3,0,48,50,3,0,53
114818,104,"GRĂDINIŢA CU PROGRAM NORMAL NR.3",REGHIN,MS,1240,9,0,0,9,31,1,0,32,41,1,0,42,51,1,0,52,60,1,0,61
114818,105,"GRĂDINIŢA CU PROGRAM NORMAL NR.3",REGHIN,MS,1043,5,0,0,5,14,1,0,15,17,3,0,20,23,3,0,26,25,3,0,28
114818,106,"CASA DE CULTURĂ A TINERETULUI ""GEORGE ENESCU""",REGHIN,MS,1180,7,2,0,9,27,2,0,29,38,5,0,43,48,5,0,53,51,5,0,56
114818,107,"ŞCOALA GIMNAZIALĂ ""AUGUSTIN MAIOR""",REGHIN,MS,1221,6,6,0,12,18,6,0,24,27,6,0,33,33,6,0,39,35,6,0,41
114818,108,"CASA DE CULTURĂ DR. ""EUGEN NICOARA""",REGHIN,MS,1246,11,4,0,15,28,5,0,33,37,5,0,42,47,5,0,52,57,6,0,63
114523,109,"ŞCOALA GIMNAZIALĂ "" OCTAVIAN GOGA """,SIGHIŞOARA,MS,1358,11,4,0,15,25,4,0,29,27,5,0,32,38,5,0,43,46,6,0,52
114523,110,"LICEUL TEHNOLOGIC NR. 2",SIGHIŞOARA,MS,1123,2,1,0,3,15,3,0,18,28,9,0,37,40,9,0,49,42,12,0,54
114523,111,"LICEUL TEHNOLOGIC NR. 2",SIGHIŞOARA,MS,960,7,1,0,8,20,2,0,22,28,2,0,30,35,3,0,38,37,3,0,40
114523,112,"ŞCOALA GIMNAZIALĂ""MIRON NEAGU""",SIGHIŞOARA,MS,1350,8,0,0,8,35,6,0,41,39,12,0,51,54,14,0,68,58,14,0,72
114523,113,"ŞCOALA GIMNAZIALĂ""MIRON NEAGU""",SIGHIŞOARA,MS,1326,5,0,0,5,26,4,0,30,40,4,0,44,44,7,0,51,45,8,0,53
114523,114,"LICEUL TEORETIC""JOSEPH HALTRICH""",SIGHIŞOARA,MS,1117,7,0,0,7,28,24,0,52,40,35,0,75,43,46,0,89,43,51,0,94
114523,115,"GRĂDINIŢA CU PROGRAM PRELUNGIT NR.2",SIGHIŞOARA,MS,1259,7,2,0,9,27,2,0,29,38,2,0,40,51,2,0,53,54,2,0,56
114523,116,"ŞCOALA GIMNAZIALĂ "" NICOLAE IORGA """,SIGHIŞOARA,MS,1010,4,3,0,7,16,4,0,20,29,5,0,34,37,6,0,43,37,6,0,43
114523,117,"ŞCOALA GIMNAZIALĂ "" NICOLAE IORGA """,SIGHIŞOARA,MS,1000,8,0,0,8,25,0,0,25,39,0,0,39,43,2,0,45,43,2,0,45
114523,118,"ŞCOALA GIMNAZIALĂ "" NICOLAE IORGA """,SIGHIŞOARA,MS,1441,3,0,0,3,25,0,0,25,43,0,0,43,52,0,0,52,58,2,0,60
114523,119,"ŞCOALA GIMNAZIALĂ "" NICOLAE IORGA """,SIGHIŞOARA,MS,1181,3,1,0,4,22,1,0,23,24,1,0,25,30,1,0,31,32,1,0,33
114523,120,"ŞCOALA GIMNAZIALĂ "" ZAHARIA BOIU """,SIGHIŞOARA,MS,1287,9,3,0,12,29,3,0,32,36,3,0,39,42,3,0,45,47,3,0,50
114523,121,"ŞCOALA GIMNAZIALĂ "" ZAHARIA BOIU """,SIGHIŞOARA,MS,1315,9,2,0,11,20,2,0,22,31,2,0,33,40,2,0,42,42,3,0,45
114523,122,"ŞCOALA GIMNAZIALĂ "" ZAHARIA BOIU """,SIGHIŞOARA,MS,1186,3,1,0,4,14,5,0,19,21,5,0,26,34,6,0,40,37,6,0,43
114523,123,"ŞCOALA GIMNAZIALĂ "" ZAHARIA BOIU """,SIGHIŞOARA,MS,1598,5,2,0,7,14,2,0,16,25,2,0,27,35,4,0,39,38,4,0,42
114523,124,"ŞCOALA GIMNAZIALĂ "" ZAHARIA BOIU """,SIGHIŞOARA,MS,1415,8,5,0,13,22,5,0,27,27,7,0,34,39,7,0,46,40,7,0,47
114523,125,"ŞCOALA PRIMARĂ ""DEALUL VIILOR""",SIGHIŞOARA,MS,1616,3,0,0,3,10,0,0,10,18,0,0,18,27,0,0,27,32,0,0,32
114523,126,"ŞCOALA GIMNAZIALĂ ""AUREL MOSORA""",SIGHIŞOARA,MS,1414,9,0,0,9,29,1,0,30,41,2,0,43,55,2,0,57,57,3,0,60
114523,127,"ŞCOALA GIMNAZIALĂ ""AUREL MOSORA""",SIGHIŞOARA,MS,1366,16,2,0,18,37,13,1,51,47,14,1,62,57,16,1,74,67,16,1,84
114523,128,"ŞCOALA GIMNAZIALĂ ""RADU POPA""",SIGHIŞOARA,MS,1170,11,1,0,12,34,2,0,36,49,5,0,54,57,15,0,72,65,21,9,95
114523,129,"ŞCOALA GIMNAZIALĂ "" VICTOR JINGA""",SIGHIŞOARA,MS,1215,17,6,0,23,45,8,0,53,55,11,0,66,66,12,0,78,76,13,0,89
114523,130,"ŞCOALA GIMNAZIALĂ "" VICTOR JINGA""",SIGHIŞOARA,MS,996,5,0,0,5,23,0,0,23,26,0,0,26,32,0,0,32,32,0,0,32
114596,131,"GRĂDINIŢA CU PROGRAM NORMALHETIUR",HETIUR,MS,846,0,0,0,0,13,3,0,16,21,3,0,24,23,3,0,26,24,3,0,27
114934,132,"GRĂDINIȚA CU PROGRAM PRELUNGIT NR. 4",TÂRNĂVENI,MS,984,4,0,0,4,27,5,0,32,40,6,0,46,56,7,0,63,63,7,0,70
114934,133,"ȘCOALA GIMNAZIALĂ NR.3",TÂRNĂVENI,MS,1096,1,0,0,1,4,0,0,4,10,0,0,10,16,0,0,16,16,0,0,16
114934,134,"ȘCOALA GIMNAZIALĂ NR.3",TÂRNĂVENI,MS,974,6,2,0,8,17,2,0,19,21,2,0,23,29,2,0,31,31,5,0,36
114934,135,"GRĂDINIȚA CU PROGRAM PRELUNGIT NR.1",TÂRNĂVENI,MS,936,13,4,0,17,42,5,0,47,50,5,0,55,60,6,0,66,66,6,0,72
114934,136,"ȘCOALA GIMNAZIALĂ TRAIAN",TÂRNĂVENI,MS,1077,8,4,0,12,26,6,0,32,30,6,0,36,37,7,0,44,43,7,0,50
114934,137,"LICEUL CONSTANTIN BRÂNCUŞI",TÂRNĂVENI,MS,1210,6,0,0,6,25,0,0,25,32,0,0,32,48,0,0,48,49,0,0,49
114934,138,"CASA DE CULTURĂ MIHAI EMINESCU",TÂRNĂVENI,MS,1194,4,0,0,4,29,0,0,29,41,1,0,42,49,1,0,50,49,1,0,50
114934,139,"COLEGIUL TEHNIC",TÂRNĂVENI,MS,964,6,3,0,9,22,4,0,26,29,4,0,33,37,4,0,41,38,4,0,42
114934,140,"ŞCOALA GIMNAZIALĂ AVRAM IANCU",TÂRNĂVENI,MS,951,4,0,0,4,20,1,0,21,32,2,0,34,38,5,0,43,38,5,0,43
114934,141,"ȘCOALA GIMNAZIALĂ AVRAM IANCU",TÂRNĂVENI,MS,891,6,3,0,9,26,3,0,29,37,3,0,40,45,4,0,49,45,4,0,49
114934,142,"LICEUL TEORETIC ANDREI BÂRSEANU",TÂRNĂVENI,MS,1302,7,0,0,7,29,0,0,29,40,0,0,40,48,1,0,49,48,1,0,49
114934,143,"LICEUL TEORETIC ANDREI BÂRSEANU",TÂRNĂVENI,MS,1364,8,0,0,8,20,0,0,20,28,0,0,28,36,0,0,36,38,0,0,38
114934,144,"GRĂDINIȚA CU PROGRAM NORMAL NR. 6",TÂRNĂVENI,MS,1195,9,1,0,10,17,1,0,18,34,1,0,35,45,3,0,48,50,3,0,53
114934,145,"CLUBUL PENSIONARILOR NR. 2",TÂRNĂVENI,MS,1180,14,0,0,14,26,0,0,26,40,0,0,40,54,0,0,54,59,6,0,65
114934,146,"CENTRUL SOCIAL VICTORIA",TÂRNĂVENI,MS,1089,7,0,0,7,21,0,0,21,28,2,0,30,31,5,0,36,34,7,0,41
114934,147,"ŞCOALA GIMNAZIALĂ VASILE MOLDOVAN",TÂRNĂVENI,MS,1111,1,0,0,1,13,0,0,13,19,0,0,19,25,2,0,27,27,4,0,31
114934,148,"ŞCOALA GIMNAZIALĂ VASILE MOLDOVAN",TÂRNĂVENI,MS,1146,1,0,0,1,12,0,0,12,15,0,0,15,20,0,0,20,25,0,0,25
114934,149,"ŞCOALA GIMNAZIALĂ VASILE MOLDOVAN",TÂRNĂVENI,MS,1180,5,0,0,5,15,0,0,15,21,0,0,21,26,0,0,26,29,0,0,29
114934,150,"ŞCOALA PRIMARĂ BOTORCA",TÂRNĂVENI,MS,295,0,0,0,0,4,1,0,5,6,3,0,9,8,4,0,12,8,4,0,12
114961,151,"CĂMINUL CULTURAL BOBOHALMA",BOBOHALMA,MS,860,24,0,0,24,28,0,0,28,36,0,0,36,51,3,0,54,51,3,0,54
116956,152,"GRĂDINIŢA CU PROGRAM NORMAL NR. 6",CUŞTELNIC,MS,456,5,3,0,8,5,3,0,8,10,3,0,13,16,3,0,19,16,3,0,19
117836,153,"CASA DE CULTURĂ IERNUT",IERNUT,MS,1339,7,0,0,7,27,1,0,28,36,2,0,38,47,3,0,50,50,3,0,53
117836,154,"GRĂDINIŢA CU PROGRAM NORMAL IERNUT",IERNUT,MS,1116,4,0,0,4,11,1,0,12,20,1,0,21,31,2,0,33,36,2,0,38
117836,155,"ŞCOALA GIMNAZIALĂ IERNUT",IERNUT,MS,1233,5,3,0,8,16,3,0,19,18,4,0,22,19,7,0,26,26,7,0,33
117836,156,"ŞCOALA GIMNAZIALĂ IERNUT",IERNUT,MS,1366,16,1,0,17,28,2,0,30,35,3,0,38,45,7,0,52,52,7,0,59
117845,157,"ŞCOALA GIMNAZIALĂ CIPĂU",CIPĂU,MS,884,3,0,0,3,11,0,0,11,14,0,0,14,18,0,0,18,20,0,0,20
117854,158,"CĂMIN CULTURAL",DEAG,MS,285,2,0,0,2,2,2,0,4,4,3,0,7,5,3,0,8,5,3,0,8
117863,159,"ŞCOALA GIMNAZIALĂ LECHINŢA",LECHINŢA,MS,721,3,3,0,6,5,3,0,8,10,5,0,15,11,5,0,16,11,5,0,16
117872,160,"CĂMIN CULTURAL OARBA DE MUREŞ","OARBA DE MUREŞ",MS,97,0,1,0,1,0,1,0,1,4,2,0,6,6,2,0,8,7,2,0,9
117907,161,"ŞCOALA PRIMARĂ SĂLCUD",SĂLCUD,MS,543,0,4,0,4,7,8,0,15,8,8,0,16,10,8,0,18,11,8,0,19
117916,162,"ŞCOALA PRIMARĂ SFÎNTU GHEORGHE","SFÎNTU GHEORGHE",MS,328,0,0,0,0,3,1,0,4,5,2,0,7,17,3,0,20,20,4,0,24
114729,163,"CĂMINUL CULTURAL GHEJA-LUDUȘ",LUDUŞ,MS,1276,5,24,0,29,21,27,0,48,36,27,0,63,63,27,0,90,70,31,0,101
114729,164,"CĂMINUL CULTURAL ROȘIORI-LUDUȘ",LUDUŞ,MS,1059,1,0,0,1,2,0,0,2,6,0,0,6,8,3,0,11,15,4,0,19
114729,165,"CASA DE CULTURĂ ""POMPEIU HĂRĂŞTEANU"" - LUDUȘ",LUDUŞ,MS,1605,11,1,0,12,23,1,0,24,36,2,0,38,54,4,0,58,66,7,0,73
114729,166,"ŞCOALA GIMNAZIALĂ ""IOAN VLĂDUŢIU"" - LUDUȘ",LUDUŞ,MS,1397,11,1,0,12,37,1,0,38,62,1,0,63,81,2,0,83,86,3,0,89
114729,167,"ŞCOALA GIMNAZIALĂ ""IOAN VLĂDUŢIU"" - LUDUȘ",LUDUŞ,MS,1603,6,5,0,11,28,5,0,33,48,9,0,57,66,9,0,75,80,10,0,90
114729,168,"LICEUL TEHNOLOGIC NR. 1 - LUDUȘ",LUDUŞ,MS,1365,16,0,0,16,30,0,0,30,55,0,0,55,87,3,0,90,97,3,0,100
114729,169,"GRĂDINIŢA ""CĂSUŢA FERMECATĂ"" - LUDUȘ",LUDUŞ,MS,1387,10,0,0,10,37,0,0,37,55,3,0,58,67,4,0,71,74,4,0,78
114729,170,"GRĂDINIȚACU PROGRAM NORMAL NR. 02 - LUDUȘ",LUDUŞ,MS,1504,10,6,0,16,40,6,0,46,55,8,0,63,78,8,0,86,85,11,0,96
114729,171,"GRĂDINIŢA CU PROGRAM PRELUNGIT NR. 01 - LUDUȘ",LUDUŞ,MS,1116,13,2,0,15,22,3,0,25,45,5,0,50,58,6,0,64,61,6,0,67
114729,172,"ŞCOALA GIMNAZIALĂNR.1 - LUDUȘ",LUDUŞ,MS,1106,3,3,0,6,17,4,14,35,28,8,14,50,32,8,14,54,33,8,14,55
114729,173,"ŞCOALA GIMNAZIALĂNR.1 - LUDUȘ",LUDUŞ,MS,1126,3,0,0,3,15,0,0,15,18,2,0,20,26,6,0,32,30,6,0,36
118290,174,"CĂMINUL CULTURAL","MIERCUREA NIRAJULUI",MS,973,1,0,0,1,5,2,0,7,5,2,0,7,9,2,0,11,13,2,0,15
118290,175,"ŞCOALA GIMNAZIALĂ DEÁK FARKAS","MIERCUREA NIRAJULUI",MS,1077,1,0,0,1,7,1,0,8,7,1,0,8,9,2,0,11,13,2,0,15
118290,176,INTERNATULŞCOLAR,"MIERCUREA NIRAJULUI",MS,1048,2,0,0,2,7,0,0,7,9,0,0,9,12,0,0,12,14,0,0,14
118316,177,"CAMINUL CULTURAL",DUMITREŞTII,MS,253,0,1,0,1,0,2,0,2,2,2,0,4,2,2,0,4,2,2,0,4
118352,178,"CAMINUL CULTURAL",TÂMPA,MS,432,0,0,0,0,1,0,0,1,2,0,0,2,4,0,0,4,4,3,0,7
118343,179,"ŞCOALA GIMNAZIALĂ","ŞARDU NIRAJULUI",MS,563,2,0,0,2,2,0,0,2,8,0,0,8,11,0,0,11,11,0,0,11
118334,180,"ŞCOALA PRIMARĂ",MOŞUNI,MS,327,1,0,0,1,3,1,0,4,3,1,0,4,4,3,0,7,4,3,0,7
119260,181,"CĂMINUL CULTURAL BALDA",BALDA,MS,914,3,1,0,4,5,1,0,6,6,3,0,9,8,3,0,11,10,3,0,13
119304,182,"CĂMINUL CULTURAL SĂRMĂŞEL GARĂ",SĂRMĂŞEL-GARĂ,MS,572,2,0,0,2,5,0,0,5,8,1,0,9,9,1,0,10,12,1,0,13
119322,183,"CĂMINUL CULTURAL VIŞINELU",VIŞINELU,MS,374,4,1,0,5,15,2,0,17,17,3,0,20,22,4,0,26,25,4,0,29
119251,184,"SALĂ SPORT SĂRMAŞU",SARMAŞU,MS,1174,10,0,0,10,23,0,0,23,30,1,0,31,44,2,0,46,61,4,0,65
119251,185,"CASĂ CULTURĂ SĂRMAŞU",SARMAŞU,MS,825,4,0,0,4,13,3,0,16,18,7,0,25,18,7,0,25,27,9,0,36
119251,186,"LICEUL TEORETIC ""SAMUIL MICU"" - ŞCOALA GIMNAZIALĂ SĂRMAŞU",SARMAŞU,MS,1005,6,1,0,7,9,1,0,10,13,1,0,14,19,1,0,20,25,1,0,26
119279,187,"ŞCOALA PRIMARĂ LARGA",LARGA,MS,154,0,0,0,0,0,0,0,0,2,0,0,2,3,3,0,6,3,3,0,6
119297,188,"CĂMINUL CULTURAL SĂRMĂŞEL",SĂRMĂŞEL,MS,618,3,0,0,3,6,1,0,7,11,1,0,12,13,2,0,15,13,2,0,15
119340,189,"CAMINUL CULTURAL SÂNGEORGIU DE PĂDURE","SÂNGEORGIU DE PĂDURE",MS,1250,6,3,0,9,6,5,0,11,11,5,0,16,15,5,0,20,18,5,0,23
119340,190,"CAMINUL CULTURAL SÂNGEORGIU DE PĂDURE","SÂNGEORGIU DE PĂDURE",MS,1299,5,0,0,5,8,0,0,8,10,0,0,10,11,0,0,11,15,0,0,15
119340,191,"LICEUL TEHNOLOGIC RHEDEY CLAUDIA SÂNGEORGIU DE PĂDURE","SÂNGEORGIU DE PĂDURE",MS,1314,2,1,0,3,13,2,0,15,13,6,0,19,19,7,0,26,20,8,0,28
119359,192,"SCOALAGIMNAZIALĂ BEZID",BEZID,MS,513,1,2,0,3,1,2,0,3,2,3,0,5,3,3,0,6,3,4,0,7
114881,193,"CĂMINUL CULTURAL SATULILIEŞI",ILIEŞI,MS,364,2,1,0,3,2,2,0,4,3,3,0,6,5,3,0,8,8,3,0,11
114890,194,"ŞCOALA PRIMARĂ SĂCĂDATU DE JOS",SĂCĂDAT,MS,1163,0,0,0,0,3,0,0,3,11,0,0,11,12,0,0,12,12,0,0,12
114863,195,"ŞCOALAGIMNAZIALĂ ""S.ILLYES LAJOS""SOVATA",SOVATA,MS,1089,4,0,0,4,20,3,0,23,25,3,0,28,30,4,0,34,30,5,0,35
114863,196,"ŞCOALA GIMNAZIALĂ""S.ILLYESLAJOS"" SOVATA",SOVATA,MS,1378,7,0,0,7,16,0,0,16,18,2,0,20,25,2,0,27,25,2,0,27
114863,197,"PRIMĂRIA ORAŞ SOVATA",SOVATA,MS,1462,11,6,0,17,22,16,0,38,29,19,0,48,34,24,0,58,39,24,0,63
114863,198,"BIBLIOTECA ORĂŞENEASCĂ SOVATA BĂI",SOVATA,MS,448,2,5,0,7,2,21,0,23,4,50,0,54,4,75,0,79,6,87,0,93
114863,199,"CENTRUL CULTURAL ""DOMOKOS KÁZMÉR"" SOVATA",SOVATA,MS,1556,7,1,0,8,18,1,0,19,25,1,0,26,33,1,0,34,40,1,0,41
114863,200,"ŞCOALA PRRIMARĂ SOVATA NR.3",SOVATA,MS,1089,1,0,0,1,6,3,0,9,7,3,0,10,8,3,0,11,9,3,0,12
119901,201,"ŞCOALA GIMNAZIALĂ ""EMIL DRĂGAN"" UNGHENI",UNGHENI,MS,913,2,5,0,7,9,8,0,17,16,8,0,24,26,8,0,34,28,8,0,36
119901,202,"ŞCOALA GIMNAZIALĂ ""EMIL DRĂGAN""UNGHENI",UNGHENI,MS,865,7,2,0,9,9,4,0,13,19,6,0,25,27,8,0,35,30,13,0,43
119901,203,"CĂMIN CULTURAL UNGHENI",UNGHENI,MS,804,9,2,0,11,21,3,0,24,34,6,0,40,74,7,0,81,83,7,0,90
119901,204,"CĂMIN CULTURAL UNGHENI",UNGHENI,MS,810,4,0,0,4,13,0,0,13,14,0,0,14,49,3,0,52,52,3,0,55
119910,205,"CĂMIN CULTURAL CERGHID",CERGHID,MS,405,2,0,0,2,8,1,0,9,13,1,0,14,20,3,0,23,23,3,0,26
119938,206,"CĂMIN CULTURAL MOREŞTI",MOREŞTI,MS,641,5,5,0,10,10,5,0,15,21,5,0,26,30,6,0,36,35,6,0,41
119929,207,"ȘCOALA PRIMARĂ CERGHIZEL",CERGHIZEL,MS,390,3,1,0,4,9,3,0,12,13,3,0,16,21,6,0,27,24,6,0,30
119956,208,"ȘCOALA PRIMARĂ ŞĂUŞA",ŞĂUŞA,MS,199,3,0,0,3,5,1,0,6,8,2,0,10,10,2,0,12,10,2,0,12
119965,209,"ȘCOALA PRIMARĂ VIDRASĂU",VIDRASĂU,MS,911,7,1,0,8,26,12,0,38,34,24,0,58,50,25,0,75,51,25,0,76
114989,210,"SALĂ DE SPORT ACĂȚARI",ACĂŢARI,MS,1002,0,0,0,0,5,1,0,6,15,1,0,16,20,3,0,23,20,3,0,23
115012,211,"ȘCOALA PRIMARĂ GRUIȘOR",GRUIŞOR,MS,343,3,1,0,4,5,2,0,7,7,3,0,10,7,3,0,10,11,4,0,15
115003,212,"CĂMIN CULTURAL GĂIEȘTI",GĂIEŞTI,MS,295,3,1,0,4,3,1,0,4,3,2,0,5,6,2,0,8,6,2,0,8
115021,213,"CĂMIN CULTURAL MURGEȘTI",MURGEŞTI,MS,420,0,0,0,0,3,0,0,3,3,0,0,3,5,0,0,5,5,0,0,5
115030,214,"CĂMINUL CULTURAL ROTENI",ROTENI,MS,645,1,0,0,1,5,2,0,7,8,2,0,10,9,3,0,12,9,3,0,12
115049,215,"CĂMIN CULTURAL STEJERIȘ",STEJERIŞ,MS,281,4,0,0,4,5,0,0,5,6,0,0,6,8,0,0,8,10,0,0,10
115058,216,"CĂMIN CULTURAL SUVEICA",SUVEICA,MS,177,1,3,0,4,4,3,0,7,5,3,0,8,7,3,0,10,9,3,0,12
115067,217,"ȘCOALA PRIMARĂ VĂLENII",VĂLENII,MS,649,0,0,0,0,3,1,0,4,4,1,0,5,9,1,0,10,10,1,0,11
115085,218,ȘCOALAGIMNAZIALĂADĂMUȘ,ADĂMUŞ,MS,676,5,3,0,8,6,3,0,9,13,3,0,16,15,5,0,20,16,5,0,21
115085,219,"CĂMINUL CULTURAL ADĂMUȘ",ADĂMUŞ,MS,1091,5,1,0,6,10,1,0,11,12,1,0,13,16,3,0,19,16,4,0,20
115101,220,"ȘCOALA PRIMARĂ CORNEȘTI",CORNEŞTI,MS,1005,7,0,0,7,16,4,0,20,27,4,0,31,55,6,0,61,65,10,0,75
115110,221,"SCOALA PRIMARĂ CRĂIEȘTI",CRĂIEŞTI,MS,876,2,0,0,2,6,0,0,6,9,2,0,11,12,2,0,14,14,2,0,16
115129,222,"GRĂDINIȚA DE COPII CU PROGRAM NORMAL DÎMBĂU",DÎMBĂU,MS,890,2,0,0,2,4,1,0,5,5,1,0,6,11,1,0,12,12,1,0,13
114667,223,"ȘCOALA GIMNAZIALĂ ȚOPA",ŢOPA,MS,289,2,0,0,2,4,0,0,4,8,0,0,8,11,4,0,15,11,5,0,16
114612,224,"ȘCOALA GIMNAZIALĂ ALBEȘTI",ALBEŞTI,MS,1664,6,0,0,6,19,0,0,19,32,1,0,33,37,1,0,38,41,2,0,43
114612,225,"ȘCOALA GIMNAZIALĂ ALBEȘTI",ALBEŞTI,MS,1762,8,2,0,10,22,4,0,26,34,4,0,38,47,5,0,52,53,8,0,61
114630,226,"ȘCOALA GIMNAZIALĂ BOIU",BOIU,MS,1205,1,0,0,1,6,0,0,6,7,0,0,7,17,4,0,21,22,4,0,26
115156,227,"CĂMINUL CULTURAL ALUNIŞ-SALA MARE",ALUNIŞ,MS,796,23,0,0,23,43,0,0,43,50,0,0,50,77,0,0,77,79,0,0,79
115156,228,"CĂMINUL CULTURAL ALUNIŞ-SALA MICĂ",ALUNIŞ,MS,819,22,2,0,24,30,5,0,35,42,6,0,48,42,6,0,48,42,7,0,49
115165,229,"ŞCOALA PRIMARĂFIŢCĂU",FIŢCĂU,MS,400,0,0,0,0,0,0,0,0,0,3,0,3,0,5,0,5,3,6,0,9
115174,230,"CĂMINUL CULTURAL LUNCA- MUREŞ - SALA MICĂ","LUNCA MUREŞULUI",MS,551,2,0,0,2,8,0,0,8,10,0,0,10,11,2,0,13,13,2,0,15
115192,231,"GRĂDINIŢA CU PROGRAM NORMAL APOLD",APOLD,MS,814,0,0,0,0,2,0,0,2,6,0,0,6,6,0,0,6,10,0,0,10
115209,232,"ŞCOALA PRIMARĂ DAIA",DAIA,MS,565,1,0,0,1,3,0,0,3,4,0,0,4,4,0,0,4,4,1,0,5
115218,233,"ŞCOALA GIMNAZIALĂ ŞAEŞ",ŞAEŞ,MS,1084,3,0,0,3,9,1,0,10,12,2,0,14,15,2,0,17,15,2,0,17
115245,234,"SEDIUL PRIMARIEIATINTIS",AŢINTIŞ,MS,611,3,0,0,3,5,1,0,6,6,2,0,8,7,2,0,9,7,2,0,9
115254,235,"SCOALA PRIMARABOTEZ",BOTEZ,MS,140,0,1,0,1,1,1,0,2,4,1,0,5,7,5,0,12,7,5,0,12
115263,236,"SCOALA PRIMARA CECALACA",CECĂLACA,MS,321,1,1,0,2,1,2,0,3,2,2,0,4,4,2,0,6,7,2,0,9
115272,237,"SCOALA PRIMARA ISTIHAZA",IŞTIHAZA,MS,164,0,2,0,2,0,2,0,2,0,2,0,2,1,2,0,3,2,2,0,4
115316,238,"ŞCOALA GIMNAZIALĂ BAHNEA",BAHNEA,MS,977,2,1,0,3,10,1,0,11,14,1,0,15,18,2,0,20,26,2,0,28
115316,239,"ŞCOALA GIMNAZIALĂ BAHNEA",BAHNEA,MS,596,2,2,0,4,5,2,0,7,5,4,0,9,6,6,0,12,7,6,0,13
115325,240,"ŞCOALA PRIMARĂ BERNADEA",BERNADEA,MS,141,0,0,0,0,0,1,0,1,0,1,0,1,0,2,0,2,0,2,0,2
115370,241,"ŞCOALA PRIMARĂ LEPINDEA",LEPINDEA,MS,145,2,0,0,2,2,0,0,2,2,0,0,2,3,6,0,9,5,6,0,11
115343,242,"ŞCOALA PRIMARĂ DAIA",DAIA,MS,138,0,0,0,0,0,0,0,0,0,0,0,0,0,1,0,1,0,1,0,1
115361,243,"ŞCOALA GIMNAZIALĂ IDICIU",IDICIU,MS,248,0,0,0,0,1,0,0,1,1,0,0,1,4,0,0,4,4,0,0,4
115352,244,"ŞCOALA GIMNAZIALĂ GOGAN",GOGAN,MS,416,1,0,0,1,1,0,0,1,3,0,0,3,4,0,0,4,4,0,0,4
115334,245,"ŞCOALA PRIMARĂ CUND",CUND,MS,174,0,0,0,0,0,0,0,0,0,0,0,0,2,1,0,3,3,3,0,6
115398,246,"SCOALA PROFESIONALA BAND",BAND,MS,664,3,0,0,3,7,0,0,7,9,0,0,9,9,1,0,10,9,1,0,10
115398,247,"SCOALA PROFESIONALA BAND",BAND,MS,797,1,0,0,1,2,0,0,2,2,0,0,2,4,0,0,4,4,0,0,4
115398,248,"SCOALA PROFESIONALA BAND",BAND,MS,875,0,3,0,3,1,3,0,4,1,3,0,4,2,3,0,5,2,3,0,5
115398,249,"GRĂDINIŢA CU PROGRAM NORMAL BAND",BAND,MS,773,1,0,0,1,1,0,0,1,2,0,0,2,4,0,0,4,4,0,0,4
115496,250,"CONSUMCOOPSOCIETATE COOPERATIVĂ",ŢIPTELNIC,MS,91,0,1,0,1,1,1,0,2,1,3,0,4,1,4,0,5,1,4,0,5
115511,251,"ŞCOALA PRIMARA VALEA RECE","VALEA RECE",MS,218,1,0,0,1,2,0,0,2,3,0,0,3,3,0,0,3,3,0,0,3
115450,252,"ŞCOALA PRIMARAMĂRĂŞEŞTI",MĂRĂŞEŞTI,MS,251,0,2,0,2,1,2,0,3,1,2,0,3,1,2,0,3,1,2,0,3
115414,253,"ŞCOALA GIMNAZIALA FÎNAŢE",FÂNAŢE,MS,353,2,2,0,4,4,2,0,6,6,3,0,9,8,3,0,11,9,3,0,12
115478,254,"ŞCOALA PRIMARA OROIU",OROIU,MS,241,3,0,0,3,3,0,0,3,5,1,0,6,8,1,0,9,8,1,0,9
115487,255,"ŞCOALA PRIMARAPETEA",PETEA,MS,155,1,0,0,1,2,0,0,2,4,0,0,4,6,2,0,8,6,2,0,8
115405,256,"ŞCOALA PRIMARA DRĂCULEA BANDULUI","DRĂCULEA BANDULUI",MS,100,0,0,0,0,1,0,0,1,1,0,0,1,3,0,0,3,3,0,0,3
115469,257,"SALA SEDINTA- PAROHIA REFORMATA NEGRENII DE CAMPIE","NEGRENII DE CÂMPIE",MS,99,1,0,0,1,1,0,0,1,5,0,0,5,5,3,0,8,5,3,0,8
115502,258,"ŞCOALA PRIMARA VALEA MARE","VALEA MARE",MS,166,3,6,0,9,4,7,0,11,10,7,0,17,10,7,0,17,10,7,0,17
115539,259,"ŞCOALA GIMNAZIALĂ BATOŞ",BATOŞ,MS,1131,3,0,0,3,10,3,0,13,10,4,0,14,10,4,0,14,11,4,0,15
115548,260,"ŞCOALA GIMNAZIALĂ DEDRAD",DEDRAD,MS,1305,6,2,0,8,15,4,0,19,16,5,0,21,21,5,0,26,22,5,0,27
115557,261,"GRĂDINIŢA CU PROGRAM NORMAL GORENI",GORENI,MS,499,2,0,0,2,5,0,0,5,7,0,0,7,9,2,0,11,9,2,0,11
115566,262,"ŞCOALA PRIMARĂ UILA",UILA,MS,482,2,0,0,2,4,0,0,4,4,0,0,4,5,0,0,5,7,0,0,7
115584,263,"CĂMINUL CULTURAL BĂGACIU",BĂGACIU,MS,1118,7,0,0,7,10,1,0,11,19,1,0,20,27,1,0,28,31,3,0,34
115593,264,"ŞCOALA GIMNAZIALĂ",DELENII,MS,903,6,2,0,8,6,3,0,9,13,5,0,18,18,7,0,25,20,7,0,27
115619,265,"CĂMIN CULTURAL",BĂLA,MS,450,2,1,0,3,4,1,0,5,6,2,0,8,9,2,0,11,14,3,0,17
115628,266,"ȘCOALA PRIMARĂ",ERCEA,MS,141,0,0,0,0,4,0,0,4,4,0,0,4,6,0,0,6,6,0,0,6
115646,267,"CĂMINUL CULTURAL BĂLĂUŞERI",BĂLĂUŞERI,MS,964,0,0,0,0,0,3,0,3,1,3,0,4,2,3,0,5,2,3,0,5
115655,268,"CĂMIN CULTURAL AGRIŞTEU",AGRIŞTEU,MS,636,5,1,0,6,7,4,0,11,8,6,0,14,11,6,0,17,11,6,0,17
115673,269,"CĂMIN CULTURAL DUMITRENI",DUMITRENI,MS,376,7,0,0,7,12,1,0,13,19,1,0,20,22,2,0,24,22,2,0,24
115682,270,"CĂMIN CULTURAL FILITELNIC",FILITELNIC,MS,184,0,0,0,0,3,0,0,3,5,0,0,5,8,5,0,13,8,5,0,13
115664,271,"SCOALĂ GIMNAZIALĂ SAMUEL JOZSEF CHENDU",CHENDU,MS,1182,2,0,0,2,4,0,0,4,4,0,0,4,6,2,0,8,6,2,0,8
115691,272,"SCOALĂ GIMNAZIALĂ SENEREUŞ",SENEREUŞ,MS,534,2,6,0,8,2,6,0,8,2,6,0,8,13,7,0,20,13,7,0,20
115717,273,"CĂMINUL CULTURAL BEICA DE JOS","BEICA DE JOS",MS,704,3,1,0,4,5,3,0,8,11,4,0,15,22,5,0,27,26,7,0,33
115726,274,"GRĂDINIȚA CU PROGRAM NORMAL BEICA DE SUS","BEICA DE SUS",MS,213,0,0,0,0,2,4,0,6,7,4,0,11,14,4,0,18,14,6,0,20
115744,275,"ȘCOALA PRIMARĂ NADĂȘA",NADĂŞA,MS,187,7,5,0,12,7,6,0,13,11,9,0,20,13,13,0,26,15,16,0,31
115735,276,"ȘCOALA PRIMARĂ CĂCUCIU",CĂCUCIU,MS,113,0,0,0,0,5,3,0,8,10,8,0,18,13,11,0,24,14,11,0,25
115762,277,"ȘCOALA PRIMARĂ ȘERBENI",ŞERBENI,MS,275,3,4,0,7,7,4,0,11,7,6,0,13,11,8,0,19,13,9,0,22
115753,278,"CĂMINUL CULTURAL SÎNMIHAI DE PĂDURE","SÎNMIHAI DE PĂDURE",MS,199,0,1,0,1,2,1,0,3,6,2,0,8,8,6,0,14,9,8,0,17
118110,279,"CĂMINUL CULTURAL BERENI",BERENI,MS,432,0,0,0,0,1,0,0,1,1,0,0,1,1,0,0,1,1,0,0,1
118156,280,"CĂMINUL CULTURAL EREMIENI",EREMIENI,MS,192,1,2,0,3,1,2,0,3,4,2,0,6,4,2,0,6,7,2,0,9
118174,281,"CĂMINUL CULTURAL MĂRCULENI",MĂRCULENI,MS,366,1,0,0,1,3,2,0,5,3,2,0,5,4,3,0,7,5,3,0,8
115780,282,"CĂMIN CULTURAL BICHIŞ",BICHIŞ,MS,162,1,0,0,1,1,0,0,1,1,0,0,1,1,0,0,1,1,0,0,1
115799,283,"ŞCOALA PRIMARĂ GÎMBUŢ",GÎMBUŢ,MS,131,0,0,0,0,0,3,0,3,0,3,0,3,2,3,0,5,2,3,0,5
115806,284,"ŞCOALA PRIMARĂ NANDRA",NANDRA,MS,121,0,0,0,0,3,0,0,3,6,2,0,8,9,3,0,12,9,3,0,12
115815,285,"CĂMINUL CULTURAL OZD",OZD,MS,253,0,1,0,1,2,3,0,5,3,3,0,6,4,3,0,7,6,4,0,10
115842,286,"ŞCOALA PRIMARĂ",RANTA,MS,243,1,1,0,2,2,1,0,3,5,1,0,6,5,1,0,6,5,1,0,6
115833,287,"PRIMARIA BOGATA",BOGATA,MS,1270,4,1,0,5,20,2,0,22,22,2,0,24,24,2,0,26,26,2,0,28
115879,288,"ȘCOALA PRIMARĂ FILPIȘU MARE","FILPIŞU MARE",MS,640,1,0,0,1,6,0,0,6,6,2,0,8,10,2,0,12,11,2,0,13
115888,289,"ȘCOALA PRIMARĂ FILPIȘU MIC","FILPIŞU MIC",MS,351,2,2,0,4,5,2,0,7,6,2,0,8,6,2,0,8,6,2,0,8
115860,290,"CAMIN CULTURAL BREAZA",BREAZA,MS,1058,5,0,0,5,11,0,0,11,16,0,0,16,16,0,0,16,16,0,0,16
115922,291,"CĂMIN CULTURAL",IDICEL-PĂDURE,MS,394,0,0,0,0,2,0,0,2,2,0,0,2,5,0,0,5,6,0,0,6
115904,292,"ȘCOALA PRIMARĂ",BRÎNCOVENEŞTI,MS,1337,1,0,0,1,4,0,0,4,8,0,0,8,8,0,0,8,15,2,0,17
115913,293,"ȘCOALA PRIMARĂ",IDICEL,MS,334,2,3,0,5,4,4,0,8,4,6,0,10,6,8,0,14,7,8,0,15
115931,294,"ȘCOALA PRIMARĂ","SĂCALU DE PĂDURE",MS,276,2,5,0,7,3,5,0,8,4,5,0,9,6,5,0,11,8,5,0,13
115940,295,"CLUB-CĂMIN CULTURAL","VĂLENII DE MUREŞ",MS,1022,5,0,0,5,29,0,0,29,35,0,0,35,37,0,0,37,38,1,0,39
115968,296,"CĂMINUL CULTURAL CEUAȘU DE CÎMPIE","CEUAŞU DE CÎMPIE",MS,1335,2,0,0,2,6,1,0,7,10,1,0,11,16,1,0,17,18,1,0,19
115977,297,"CĂMINUL CULTURAL BOZED",BOZED,MS,125,2,0,0,2,2,0,0,2,6,3,0,9,8,4,0,12,10,4,0,14
115986,298,"ŞCOALA PRIMARĂ CÎMPENIȚA",CÎMPENIŢA,MS,727,0,0,0,0,3,0,0,3,3,0,0,3,5,0,0,5,10,1,0,11
115995,299,"CĂMINUL CULTURAL CULPIU",CULPIU,MS,310,0,0,0,0,0,0,0,0,2,0,0,2,2,0,0,2,2,0,0,2
116000,300,"CĂMINUL CULTURAL HERGHELIA",HERGHELIA,MS,320,1,4,0,5,1,4,0,5,2,9,0,11,2,12,0,14,15,18,0,33
116019,301,"ȘCOALA PRIMARĂ PORUMBENI",PORUMBENI,MS,463,0,0,0,0,1,0,0,1,1,0,0,1,2,0,0,2,2,0,0,2
116028,302,"CĂMINULCULTURAL SĂBED",SĂBED,MS,620,4,1,0,5,7,1,0,8,10,1,0,11,13,1,0,14,15,1,0,16
116037,303,"CĂMINUL CULTURAL VOINICENI",VOINICENI,MS,916,4,0,0,4,12,1,0,13,27,4,0,31,30,7,0,37,37,7,0,44
116091,304,"CAMIN CULTURAL",GRINDENI,MS,467,2,0,0,2,2,0,0,2,2,0,0,2,4,0,0,4,4,1,0,5
116055,305,"SEDIUL PRIMARIEI CHETANI",CHEŢANI,MS,941,5,1,0,6,14,5,0,19,25,5,0,30,30,8,0,38,32,9,0,41
116108,306,"CAMIN CULTURAL HADARENI",HĂDĂRENI,MS,674,3,0,0,3,9,2,0,11,18,2,0,20,27,2,0,29,35,6,0,41
117088,307,"PRIMĂRIA COMUNEI CHIBED",CHIBED,MS,1357,3,0,0,3,3,2,0,5,6,5,0,11,11,6,0,17,14,6,0,20
116135,308,"SEDIUL PRIMĂRIEI COMUNEI CHIHERU DE JOS","CHIHERU DE JOS",MS,347,3,0,0,3,12,2,0,14,14,2,0,16,18,2,0,20,19,2,0,21
116144,309,"ŞCOALA PRIMARĂ CHIHERU DE SUS","CHIHERU DE SUS",MS,307,1,2,0,3,4,3,0,7,6,3,0,9,10,3,0,13,10,3,0,13
116153,310,"ŞCOALA PRIMARĂ URISIU DE JOS","URISIU DE JOS",MS,253,3,5,0,8,4,5,0,9,4,7,0,11,5,7,0,12,7,7,0,14
116162,311,"CAMINUL CULTURAL URISIU DE SUS","URISIU DE SUS",MS,349,0,0,0,0,4,0,0,4,8,4,0,12,11,6,0,17,13,7,0,20
116180,312,"ȘCOALA GIMNAZIALĂ COROISÎNMĂRTIN",COROISÎNMĂRTIN,MS,339,1,0,0,1,2,0,0,2,4,0,0,4,6,0,0,6,8,0,0,8
116215,313,"ȘCOALA PRIMARĂ ȘOIMUȘ",ŞOIMUŞ,MS,323,3,3,0,6,13,5,0,18,15,6,0,21,24,8,0,32,27,12,0,39
116206,314,"CĂMINUL CULTURAL ODRIHEI",ODRIHEI,MS,392,3,1,0,4,8,1,0,9,15,1,0,16,19,2,0,21,30,2,0,32
116199,315,"ȘCOALA PRIMARĂ COROI",COROI,MS,101,1,0,0,1,1,0,0,1,3,0,0,3,3,0,0,3,3,0,0,3
117952,316,"CĂMINUL CULTURAL CORUNCA",CORUNCA,MS,1042,1,4,0,5,7,4,0,11,10,5,0,15,12,9,0,21,14,11,0,25
117952,317,"CĂMINUL CULTURAL CORUNCA",CORUNCA,MS,1619,5,1,0,6,23,5,0,28,29,8,0,37,42,8,0,50,45,8,0,53
117943,318,"CĂMINUL CULTURAL BOZENI",BOZENI,MS,113,0,0,0,0,0,0,0,0,0,0,0,0,0,0,0,0,0,0,0,0
116251,319,"CAMIN CULTURAL","SOCOLU DE CÎMPIE",MS,108,2,0,0,2,4,0,0,4,4,0,0,4,4,0,0,4,6,0,0,6
116233,320,"PRIMARIA COZMA",COZMA,MS,320,4,0,0,4,6,0,0,6,7,0,0,7,7,2,0,9,7,2,0,9
116297,321,"CĂMIN CULTURAL CRĂCIUNEŞTI SALA MICĂ",CRĂCIUNEŞTI,MS,847,2,0,0,2,6,0,0,6,6,2,0,8,12,3,0,15,24,5,0,29
116297,322,"CĂMINUL CULTURAL CRĂCIUNEŞTI SALA MARE",CRĂCIUNEŞTI,MS,968,1,0,0,1,2,0,0,2,3,0,0,3,7,0,0,7,8,5,0,13
116322,323,"CĂMINUL CULTURAL CORNEŞTI",CORNEŞTI,MS,714,1,0,0,1,4,0,0,4,4,0,0,4,4,0,0,4,4,3,0,7
116313,324,"ŞCOALA PRIMARĂ CINTA",CINTA,MS,430,0,0,0,0,1,0,0,1,1,0,0,1,2,1,0,3,2,1,0,3
116304,325,"ŞCOALA PRIMARĂ BUDIU MIC","BUDIU MIC",MS,304,0,0,0,0,1,1,0,2,2,1,0,3,2,1,0,3,2,1,0,3
116359,326,"PRIMARIACOMUNEI CRAIESTI",CRĂIEŞTI,MS,514,8,2,0,10,11,2,0,13,15,2,0,17,20,2,0,22,24,2,0,26
116377,327,CĂMINCULTURALMILAȘEL,MILĂŞEL,MS,147,1,0,0,1,1,1,0,2,2,1,0,3,3,4,0,7,3,4,0,7
116368,328,"CĂMIN CULTURALLEFAIA",LEFAIA,MS,48,1,4,0,5,3,5,0,8,4,6,0,10,4,8,0,12,4,8,0,12
114364,329,PRIMARIA,CRISTEŞTI,MS,1434,8,0,0,8,19,2,0,21,32,4,0,36,36,5,0,41,40,6,0,46
114364,330,PRIMĂRIE,CRISTEŞTI,MS,1313,9,0,0,9,23,0,0,23,33,0,0,33,44,0,0,44,51,0,0,51
114364,331,"ŞCOALA GIMNAZIALA CRISTEŞTI",CRISTEŞTI,MS,1476,8,0,0,8,28,0,0,28,48,1,0,49,57,2,0,59,65,3,0,68
114373,332,"CĂMINUL CULTURAL",VĂLURENI,MS,815,1,0,0,1,1,0,0,1,4,0,0,4,8,0,0,8,10,0,0,10
116402,333,"PRIMARIA CUCERDEA",CUCERDEA,MS,583,1,0,0,1,3,0,0,3,6,0,0,6,10,0,0,10,12,1,0,13
116420,334,"ȘCOALA GIMNAZIALĂ ȘEULIA DE MUREȘ","ŞEULIA DE MUREŞ",MS,473,1,0,0,1,4,0,0,4,7,0,0,7,10,0,0,10,12,0,0,12
116411,335,"CĂMIN CULTURAL BORD",BORD,MS,103,1,0,0,1,1,0,0,1,2,0,0,2,3,0,0,3,3,0,0,3
116475,336,"CAMIN CULTURAL",OROSIA,MS,135,6,1,0,7,13,1,0,14,17,1,0,18,21,1,0,22,23,1,0,24
116484,337,"CĂMIN CULTURAL",PETRILACA,MS,441,4,2,0,6,6,4,0,10,10,5,0,15,21,5,0,26,23,5,0,28
116457,338,"SCOALA PRIMARĂ",DĂTĂŞENI,MS,277,1,0,0,1,4,0,0,4,4,0,0,4,8,0,0,8,10,0,0,10
116448,339,"PRIMĂRIA CUCI",CUCI,MS,673,2,3,0,5,5,3,0,8,5,6,0,11,14,6,0,20,16,6,0,22
116509,340,"CĂMINUL CULTURAL DANES",DANEŞ,MS,1005,8,1,0,9,13,1,0,14,21,1,0,22,26,2,0,28,29,2,0,31
116509,341,"CLUBUL TINERETULUI",DANEŞ,MS,988,2,0,0,2,9,0,0,9,10,0,0,10,14,0,0,14,18,0,0,18
116527,342,"SCOALA GIMNAZIALA SELEUS-DANES",SELEUŞ,MS,860,3,1,0,4,11,1,0,12,16,1,0,17,21,1,0,22,28,1,0,29
116527,343,"SCOALA GIMNAZIALA SELEUS-DANES",SELEUŞ,MS,876,4,2,0,6,5,2,0,7,14,3,0,17,15,3,0,18,15,3,0,18
116518,344,"ŞCOALA GIMNAZIALA INV.""STROIESCU IOAN ""CRIŞ",CRIŞ,MS,587,2,4,0,6,4,4,0,8,7,5,0,12,11,6,0,17,14,7,0,21
116536,345,"CĂMINUL CULTURAL STEJĂRENII",STEJĂRENII,MS,272,0,1,0,1,2,1,0,3,3,2,0,5,3,2,0,5,5,3,0,8
116563,346,"ŞCOALA GIMNAZIALĂ BISTRA-MUREŞULUI","BISTRA MUREŞULUI",MS,828,4,0,0,4,10,0,0,10,17,0,0,17,26,1,0,27,31,3,0,34
116572,347,"ŞCOALA PRIMARĂ FILEA",FILEA,MS,565,2,0,0,2,7,2,0,9,9,3,0,12,11,3,0,14,11,3,0,14
116581,348,"ŞCOALA PRIMARĂ PIETRŞ",PIETRIŞ,MS,378,1,0,0,1,7,0,0,7,8,0,0,8,10,0,0,10,10,0,0,10
116554,349,"CĂMIN CULTURAL DEDA",DEDA,MS,1524,13,0,0,13,23,0,0,23,36,2,0,38,43,2,0,45,45,3,0,48
116607,350,"ȘCOALA GIMNAZIALĂ ,,DR. NYULAS FERENC '' EREMITU",EREMITU,MS,1454,3,0,0,3,10,2,0,12,10,2,0,12,16,2,0,18,18,2,0,20
116616,351,"ȘCOALA PRIMARĂ CĂLUGĂRENI",CĂLUGĂRENI,MS,454,0,2,0,2,3,2,0,5,3,2,0,5,3,2,0,5,7,3,0,10
116625,352,"ȘCOALAPRIMARĂ CÎMPU CETĂŢII","CÎMPU CETĂŢII",MS,318,0,0,0,0,4,6,0,10,7,6,0,13,8,6,0,14,8,6,0,14
116634,353,"ȘCOALAPRIMARĂ DĂMIENI",DĂMIENI,MS,185,1,0,0,1,5,0,0,5,6,0,0,6,7,0,0,7,8,0,0,8
116643,354,"ȘCOALA GIMNAZIALĂ MĂTRICI",MĂTRICI,MS,714,2,6,0,8,2,6,0,8,6,6,0,12,7,8,0,15,7,9,0,16
116661,355,"CĂMINUL CULTURAL ERNEI",ERNEI,MS,867,6,1,0,7,7,6,0,13,12,6,0,18,16,6,0,22,17,6,0,23
116661,356,"SALA DE ŞEDINŢE - PRIMĂRIA COMUNEI ERNEI",ERNEI,MS,1052,6,0,0,6,13,3,0,16,14,3,0,17,17,4,0,21,18,4,0,22
116670,357,"CĂMINUL CULTURAL CĂLUŞERI",CĂLUŞERI,MS,472,2,2,0,4,2,2,0,4,3,2,0,5,4,2,0,6,7,2,0,9
116689,358,"CĂMINUL CULTURAL DUMBRĂVIOARA",DUMBRĂVIOARA,MS,1462,2,0,0,2,11,0,0,11,13,1,0,14,19,4,0,23,26,4,0,30
116698,359,"CĂMINUL CULTURAL ICLAND",ICLAND,MS,315,0,0,0,0,1,0,0,1,6,0,0,6,8,0,0,8,8,0,0,8
116705,360,"SCOALA PRIMARĂ SĂCĂRENI",SĂCĂRENI,MS,205,0,1,0,1,2,1,0,3,3,1,0,4,3,3,0,6,4,4,0,8
116714,361,"CĂMINUL CULTURAL SÎNGERU DE PĂDURE","SÎNGERU DE PĂDURE",MS,334,3,0,0,3,5,1,0,6,8,3,0,11,8,4,0,12,8,4,0,12
116732,362,"SEDIU PRIMARIE",FĂRĂGĂU,MS,376,4,0,0,4,20,0,0,20,14,6,0,20,21,9,0,30,26,11,0,37
116778,363,"CLADIRE FOSTUL CAP",POARTA,MS,176,5,4,0,9,11,6,0,17,12,8,0,20,14,8,0,22,17,8,0,25
116787,364,"SCOALA GIMNAZIALA TONCIU",TONCIU,MS,700,46,0,0,46,87,5,0,92,94,6,0,100,136,7,0,143,155,7,0,162
116803,365,"ŞCOALA GIMNAZIALĂ FÎNTÎNELE",FÎNTÎNELE,MS,995,0,0,0,0,4,0,0,4,4,0,0,4,7,0,0,7,8,0,0,8
116803,366,"ŞCOALA GIMNAZIALĂ FÎNTÎNELE",FÎNTÎNELE,MS,993,2,0,0,2,3,1,0,4,4,2,0,6,5,2,0,7,5,2,0,7
116821,367,"ŞCOALA GIMNAZIALĂ CĂLIMĂNEŞTI",CĂLIMĂNEŞTI,MS,705,1,0,0,1,2,0,0,2,4,0,0,4,5,2,0,7,5,2,0,7
116858,368,"ŞCOALA PRIMARĂ VIFOROASA",VIFOROASA,MS,656,1,4,0,5,1,4,0,5,3,5,0,8,3,5,0,8,3,5,0,8
116812,369,"ŞCOALA PRIMARĂ BORDOŞIU",BORDOŞIU,MS,245,1,0,0,1,2,0,0,2,2,0,0,2,3,0,0,3,3,4,0,7
116830,370,"GRĂDINIŢA CU PROGRAM NORMAL CIBU",CIBU,MS,90,0,0,0,0,1,0,0,1,1,0,0,1,2,0,0,2,2,0,0,2
116849,371,"ŞCOALA PRIMARĂ ROUA",ROUA,MS,283,0,0,0,0,3,0,0,3,3,0,0,3,4,0,0,4,4,0,0,4
116876,372,"ŞCOALA GIMNAZIALĂ „SZENTIVÁNI MIHÁLY”GĂLEŞTI",GĂLEŞTI,MS,759,1,0,0,1,1,0,0,1,3,0,0,3,5,2,0,7,5,2,0,7
116929,373,"ŞCOALA GIMNAZIALĂ TROIŢA",TROIŢA,MS,594,0,0,0,0,1,0,0,1,1,1,0,2,2,2,0,4,2,4,0,6
116910,374,"ŞCOALA PRIMARĂ MAIAD",MAIAD,MS,227,1,1,0,2,5,1,0,6,10,1,0,11,10,3,0,13,11,4,0,15
120520,375,"CĂMINUL CULTURALSÂNVĂSII",SÂNVĂSII,MS,258,1,1,0,2,1,1,0,2,3,1,0,4,5,1,0,6,9,1,0,10
116885,376,"ŞCOALA PRIMARĂ ADRIANU MARE","ADRIANU MARE",MS,107,1,0,0,1,7,0,0,7,7,0,0,7,7,0,0,7,7,0,0,7
116901,377,"CĂMINUL CULTURAL BEDENI",BEDENI,MS,118,0,0,0,0,3,0,0,3,3,0,0,3,4,0,0,4,4,0,0,4
116947,378,"GRĂDINIŢA CU PROGRAM NORMAL GĂNEŞTI",GĂNEŞTI,MS,989,5,0,0,5,9,4,0,13,13,5,0,18,17,5,0,22,17,6,0,23
116947,379,"ŞCOALA GIMNAZIALĂ FOGARASI SAMUEL GĂNEŞTI",GĂNEŞTI,MS,784,3,0,0,3,6,0,0,6,7,0,0,7,9,0,0,9,9,0,0,9
116965,380,"ŞCOALA PRIMARĂPĂUCIŞOARA",PĂUCIŞOARA,MS,219,2,0,0,2,2,0,0,2,2,0,0,2,3,0,0,3,3,0,0,3
120566,381,"ŞCOALA PRIMARĂ SEUCA",SEUCA,MS,958,7,0,0,7,11,0,0,11,12,0,0,12,12,1,0,13,12,2,0,14
116992,382,"CĂMINUL CULTURAL GHEORGHE DOJA","GHEORGHE DOJA",MS,398,0,0,0,0,0,0,0,0,2,1,0,3,5,1,0,6,6,1,0,7
117006,383,"CĂMINUL CULTURAL ILIENI",ILIENI,MS,335,1,0,0,1,2,0,0,2,4,0,0,4,14,1,0,15,16,1,0,17
117015,384,"CĂMINUL CULTURAL LEORDENI",LEORDENI,MS,310,0,0,0,0,0,1,0,1,1,1,0,2,2,3,0,5,2,4,0,6
117024,385,"ȘCOALA PRIMARĂ SATU NOU","SATU NOU",MS,610,0,0,0,0,0,0,0,0,1,0,0,1,1,0,0,1,1,2,0,3
117033,386,"ȘCOALĂ GIMNAZIALĂ TIRIMIA",TIRIMIA,MS,706,2,1,0,3,8,2,0,10,13,2,0,15,16,2,0,18,24,2,0,26
117051,387,"ȘCOALA GIMNAZIALĂ WESSELÉNYI MIKLÓS",GHINDARI,MS,1246,1,0,0,1,3,0,0,3,4,1,0,5,9,1,0,10,15,2,0,17
117104,388,"CĂMIN CULTURAL TREI SATE","TREI SATE",MS,954,0,0,0,0,1,0,0,1,2,0,0,2,3,0,0,3,3,0,0,3
117097,389,"ȘCOALĂ PRIMARĂ SOLOCMA",SOLOCMA,MS,255,1,4,0,5,2,6,0,8,2,6,0,8,6,6,0,12,10,6,0,16
117060,390,"ȘCOALĂ PRIMARĂ ABUD",ABUD,MS,110,2,0,0,2,2,0,0,2,2,0,0,2,2,0,0,2,2,0,0,2
117122,391,"ȘCOALA GIMNAZIALĂ „ADORJANI KAROLY” GLODENI",GLODENI,MS,930,0,1,0,1,0,2,0,2,0,2,0,2,1,2,0,3,5,2,0,7
117122,392,"ȘCOALA GIMNAZIALĂ „ADORJANI KAROLY” GLODENI",GLODENI,MS,1078,2,0,0,2,4,0,0,4,4,0,0,4,8,0,0,8,9,1,0,10
117131,393,"ȘCOALA PRIMARĂ MERIȘOR",MERIŞOR,MS,135,2,1,0,3,2,1,0,3,5,1,0,6,5,3,0,8,6,3,0,9
117140,394,"ŞCOALA PRIMARĂ MOIȘA",MOIŞA,MS,200,1,1,0,2,6,3,0,9,6,3,0,9,7,4,0,11,7,4,0,11
117159,395,"ŞCOALA PRIMARĂ PĂCURENI",PĂCURENI,MS,181,0,0,0,0,0,2,0,2,1,2,0,3,2,2,0,4,2,2,0,4
117168,396,"ȘCOALA PRIMARĂ PĂINGENI",PĂINGENI,MS,300,2,0,0,2,2,0,0,2,2,0,0,2,4,0,0,4,6,0,0,6
117202,397,"CAMIN CULTURAL",ILIOARA,MS,92,0,0,0,0,0,0,0,0,0,0,0,0,0,0,0,0,0,0,0,0
117239,398,"CAMIN CULTURAL",PĂDURENI,MS,356,3,0,0,3,5,0,0,5,6,0,0,6,7,0,0,7,8,0,0,8
117257,399,"CAMIN CULTURAL","PETRILACA DE MUREŞ",MS,341,0,0,0,0,1,0,0,1,4,0,0,4,5,1,0,6,5,3,0,8
117266,400,"SCOALA PRIMARĂ TELEAC",TELEAC,MS,336,2,0,0,2,2,0,0,2,2,0,0,2,3,0,0,3,5,0,0,5
117186,401,"SCOALA GIMNAZIALATELEKI DOMOKOS",GORNEŞTI,MS,803,2,0,0,2,7,1,0,8,7,1,0,8,14,2,0,16,15,2,0,17
117186,402,"GRADINITA CU PROGRAMNORMAL",GORNEŞTI,MS,805,2,0,0,2,6,2,0,8,11,3,0,14,14,3,0,17,16,3,0,19
117248,403,"CAMIN CULTURAL PERIS",PERIŞ,MS,1500,4,1,0,5,7,1,0,8,11,2,0,13,13,3,0,16,13,4,0,17
117195,404,"SCOALA PRIMARĂ IARA DE MUREŞ","IARA DE MUREŞ",MS,245,0,0,0,0,1,0,0,1,1,0,0,1,1,0,0,1,1,0,0,1
117284,405,"CĂMIN CULTURAL GREBENISU DE CIMPIE","GREBENIŞU DE CÎMPIE",MS,1319,2,5,0,7,19,5,0,24,24,5,0,29,25,5,0,30,31,5,0,36
117328,406,"CĂMINUL CULTURAL GURGHIU",GURGHIU,MS,861,5,4,0,9,10,4,0,14,12,4,0,16,13,4,0,17,15,4,0,19
117328,407,"CAMINUL CULTURAL GURGHIU",GURGHIU,MS,774,13,2,0,15,17,2,0,19,17,2,0,19,19,2,0,21,19,2,0,21
117337,408,"CĂMINUL CULTURAL ADRIAN",ADRIAN,MS,227,8,5,0,13,14,5,0,19,15,6,0,21,26,6,0,32,30,7,0,37
117346,409,"SCOALA PRIMARACASVA",CAŞVA,MS,669,0,0,0,0,5,0,0,5,5,3,0,8,9,3,0,12,12,3,0,15
117355,410,"FOSTA SCOALA PRIMARA COMORI",COMORI,MS,158,0,0,0,0,3,0,0,3,6,0,0,6,7,0,0,7,7,0,0,7
117373,411,"CAMINUL CULTURAL GLAJARIE",GLĂJĂRIE,MS,1427,12,1,0,13,16,2,0,18,24,3,0,27,33,4,0,37,36,4,0,40
117382,412,"SCOALA PRIMARA LARGA",LARGA,MS,190,0,0,0,0,1,0,0,1,1,2,0,3,4,6,0,10,4,6,0,10
117391,413,"CAMINUL CULTURAL ORSOVA",ORŞOVA,MS,662,5,0,0,5,12,0,0,12,21,0,0,21,23,0,0,23,23,0,0,23
117435,414,"CAMINUL CULTURALHODAC",HODAC,MS,995,0,0,0,0,6,0,0,6,8,1,0,9,10,2,0,12,10,2,0,12
117435,415,"SCOALA GIMNAZIALA HODAC",HODAC,MS,1059,10,1,0,11,14,2,0,16,20,2,0,22,22,2,0,24,24,2,0,26
117480,416,"GRADINITA CU PROGRAM NORMAL TOACA",TOACA,MS,666,5,0,0,5,5,0,0,5,7,1,0,8,7,1,0,8,10,1,0,11
117462,417,"SCOALA GIMNAZIALA DUBISTEA DE PADURE","DUBIŞTEA DE PĂDURE",MS,373,2,0,0,2,3,0,0,3,5,0,0,5,7,0,0,7,9,1,0,10
117480,418,"CAMINUL CULTURAL TOACA",TOACA,MS,875,3,0,0,3,6,0,0,6,7,0,0,7,15,2,0,17,23,2,0,25
117514,419,"ȘCOALA PRIMARĂ HODOȘA",HODOŞA,MS,166,0,1,0,1,0,2,0,2,3,2,0,5,3,2,0,5,3,2,0,5
117523,420,"ȘCOALA PRIMARĂ IHOD",IHOD,MS,95,1,0,0,1,1,0,0,1,1,0,0,1,1,0,0,1,1,0,0,1
117532,421,"ȘCOALA PRIMARĂ ISLA",ISLA,MS,223,0,0,0,0,1,0,0,1,2,1,0,3,2,1,0,3,2,1,0,3
117541,422,"ȘCOALA GIMNAZIALĂ ”PETREȘ KÁLMÁN „ SÎMBRIAȘ",SÎMBRIAŞ,MS,510,1,0,0,1,3,1,0,4,6,1,0,7,7,1,0,8,10,2,0,12
117569,423,"GRĂDINIŢA CU PROGRAM NORMAL IBĂNEŞTI",IBĂNEŞTI,MS,1335,5,4,0,9,22,5,0,27,34,5,0,39,52,6,0,58,58,6,0,64
117569,424,"SALĂ MANIFESTĂRI ISTICEU",IBĂNEŞTI,MS,490,3,1,0,4,8,2,0,10,14,2,0,16,14,6,0,20,15,8,0,23
117603,425,"GRĂDINIŢA CU PROGRAM PRELUNGIT IBĂNEŞTI-PĂDURE",IBĂNEŞTI-PĂDURE,MS,777,1,2,0,3,4,3,0,7,7,4,0,11,13,6,0,19,13,7,0,20
117596,426,"CĂMIN CULTURAL DULCEA",DULCEA,MS,906,3,0,0,3,9,0,0,9,18,0,0,18,24,2,0,26,28,2,0,30
117676,427,"CAMINUL CULTURAL",ICLĂNZEL,MS,1031,0,0,0,0,5,1,0,6,7,1,0,8,10,1,0,11,13,1,0,14
117685,428,"ȘCOALA GIMNAZIALĂ ”PETRU MAIOR”","CĂPUŞU DE CÎMPIE",MS,620,2,3,0,5,3,5,0,8,8,5,0,13,11,5,0,16,15,6,0,21
117792,429,"CAMINUL CULTURAL IDECIU DE JOS","IDECIU DE JOS",MS,835,3,0,0,3,4,0,0,4,6,2,0,8,7,2,0,9,10,2,0,12
117792,430,"GRADINITA CU PROGRAM NORMAL IDECIU DE SUS","IDECIU DE JOS",MS,693,11,4,0,15,30,5,0,35,38,5,0,43,50,5,0,55,53,6,0,59
117792,431,"FOSTA SCOALA PRIMARA DELENI","IDECIU DE JOS",MS,213,2,0,0,2,2,0,0,2,3,0,0,3,4,2,0,6,5,2,0,7
117961,432,"CAMIN CULTURAL",IVĂNEŞTI,MS,361,5,0,0,5,5,0,0,5,6,1,0,7,8,1,0,9,8,1,0,9
117970,433,"CAMIN CULTURAL",POIENIŢA,MS,236,4,1,0,5,4,1,0,5,4,1,0,5,5,7,0,12,5,7,0,12
117934,434,"ȘCOALA GIMNAZIALĂ BENEDEK ELEK",LIVEZENI,MS,1856,2,8,0,10,9,11,0,20,12,12,0,24,19,16,0,35,23,17,0,40
117989,435,"CĂMIN CULTURAL",SÎNIŞOR,MS,203,0,1,0,1,1,1,0,2,1,1,0,2,1,1,0,2,4,2,0,6
118003,436,"SEDIUL ADMINISTRATIV AL PRIMĂRIEI",LUNCA,MS,419,0,0,0,0,3,1,0,4,4,1,0,5,8,3,0,11,8,3,0,11
118012,437,"ŞCOALA GIMNAZIALĂ BĂIŢA",BĂIŢA,MS,624,0,0,0,0,3,1,0,4,4,1,0,5,11,3,0,14,11,3,0,14
118021,438,"ŞCOALA PRIMARĂ FRUNZENI",FRUNZENI,MS,328,1,3,0,4,5,4,0,9,10,4,0,14,11,8,0,19,11,8,0,19
118030,439,"ŞCOALA PRIMARĂ LOGIG",LOGIG,MS,324,1,0,0,1,5,0,0,5,6,0,0,6,8,0,0,8,10,1,0,11
118049,440,"ŞCOALA PRIMARĂ SÎNTU",SÎNTU,MS,265,4,0,0,4,6,0,0,6,7,0,0,7,9,0,0,9,11,0,0,11
118067,441,"CASA DE CULTURA LUNCA BRADULUI","LUNCA BRADULUI",MS,1227,15,0,0,15,29,5,0,34,32,10,0,42,38,13,0,51,38,13,0,51
118076,442,"SCOALA PRIMARA SAT NEAGRA",NEAGRA,MS,367,1,2,0,3,3,4,0,7,4,4,0,8,5,5,0,10,8,5,0,13
115441,443,"SEDIUL PRIMĂRIEI COMUNEI MĂDĂRAȘ",MĂDĂRAŞ,MS,1042,5,4,0,9,7,4,0,11,10,4,0,14,13,4,0,17,15,5,0,20
115441,444,"ȘCOALA PRIMARĂ CU CLASELE I-IV FÂNAȚTELE MĂDĂRAȘULUI",MĂDĂRAŞ,MS,230,4,1,0,5,5,1,0,6,5,1,0,6,10,1,0,11,10,2,0,12
118101,445,"ŞCOALA GIMNAZIALĂ MĂGHERANI",MĂGHERANI,MS,605,1,0,0,1,1,22,0,23,5,22,0,27,5,22,0,27,8,22,0,30
118183,446,"ŞCOALA PRIMARĂ ŞILEA NIRAJULUI","ŞILEA NIRAJULUI",MS,328,0,0,0,0,0,0,0,0,0,0,0,0,1,0,0,1,1,0,0,1
118192,447,"GRĂDINIŢA CU PROGRAM NORMAL TORBA",TORBA,MS,126,0,0,0,0,2,0,0,2,3,0,0,3,3,0,0,3,5,0,0,5
118218,448,"ȘCOALA PRIMARĂ MICA",MICA,MS,578,0,0,0,0,2,0,0,2,4,0,0,4,4,1,0,5,4,1,0,5
118245,449,"ȘCOALA GIMNAZIALĂ ”BELLE JOZSEF”",CEUAŞ,MS,707,0,0,0,0,0,0,0,0,1,0,0,1,2,0,0,2,2,0,0,2
118254,450,"ȘCOALA GIMNAZIALĂ DEAJ",DEAJ,MS,1186,0,0,0,0,1,0,0,1,5,0,0,5,5,0,0,5,7,0,0,7
118263,451,"ȘCOALA GIMNAZIALĂ HĂRĂNGLAB",HĂRĂNGLAB,MS,621,4,0,0,4,9,0,0,9,9,0,0,9,9,0,0,9,9,0,0,9
118272,452,"ȘCOALA PRIMARĂ ȘOMOȘTELNIC",ŞOMOŞTELNIC,MS,208,0,0,0,0,3,0,0,3,3,0,0,3,6,0,0,6,6,0,0,6
118227,453,"ȘCOALA PRIMARĂ",ABUŞ,MS,242,5,0,0,5,6,0,0,6,7,0,0,7,9,0,0,9,9,0,0,9
118389,454,"CĂMINUL CULTURAL MIHEȘU DE CÎMPIE","MIHEŞU DE CÎMPIE",MS,1238,5,1,0,6,7,1,0,8,11,1,0,12,13,2,0,15,13,2,0,15
118432,455,"CĂMINUL CULTURAL RĂZOARE",RĂZOARE,MS,679,3,0,0,3,15,2,0,17,25,6,0,31,27,6,0,33,27,8,0,35
118478,456,"ŞCOALAGIMNAZIALĂ CORPUL ANADEŞ",NADEŞ,MS,1181,2,0,0,2,5,0,0,5,5,0,0,5,9,0,0,9,11,0,0,11
118487,457,ŞCOALAPRIMARĂMĂGHERUŞ,MĂGHERUŞ,MS,103,1,0,0,1,2,0,0,2,4,5,0,9,4,5,0,9,4,5,0,9
118496,458,"CĂMINUL CULTURALPIPEA",PIPEA,MS,53,1,2,0,3,1,3,0,4,1,3,0,4,3,3,0,6,3,3,0,6
118502,459,"ŞCOALA GIMNAZIALĂŢIGMANDRU",ŢIGMANDRU,MS,874,0,0,0,0,5,1,0,6,6,1,0,7,6,1,0,7,7,1,0,8
118520,460,"ŞCOALA GIMNAZIALĂ NEAUA",NEAUA,MS,309,2,1,0,3,3,2,0,5,3,2,0,5,6,2,0,8,6,2,0,8
118566,461,"CĂMINUL CULTURAL VĂDAȘ",VĂDAŞ,MS,298,0,0,0,0,1,0,0,1,5,0,0,5,7,0,0,7,8,0,0,8
118539,462,"ŞCOALA PRIMARĂ GHINEȘTI",GHINEŞTI,MS,216,0,0,0,0,0,0,0,0,2,0,0,2,4,0,0,4,4,0,0,4
118557,463,"CĂMINUL CULTURAL SÎNSIMION",SÎNSIMION,MS,56,0,0,0,0,0,0,0,0,0,0,0,0,0,0,0,0,0,0,0,0
118548,464,"ŞCOALA PRIMARĂ RIGMANI",RIGMANI,MS,196,0,0,0,0,1,0,0,1,1,1,0,2,1,1,0,2,1,3,0,4
118584,465,"CLUB CĂMIN CULTURAL OGRA",OGRA,MS,1300,3,0,0,3,11,5,0,16,17,7,0,24,60,11,0,71,60,11,0,71
118584,466,"ȘCOALA GIMNAZIALĂ OGRA",OGRA,MS,135,1,1,0,2,1,3,0,4,1,3,0,4,1,3,0,4,2,3,0,5
118600,467,"FOSTA ŞCOALĂ GENERALĂ GIULUŞ",GIULUŞ,MS,112,1,1,0,2,3,1,0,4,6,3,0,9,8,3,0,11,8,3,0,11
118619,468,"ŞCOALA PRIMARĂ LĂSCUD",LĂSCUD,MS,189,2,0,0,2,2,0,0,2,7,2,0,9,12,3,0,15,12,3,0,15
118628,469,"GRĂDINIȚA CU PROGRAM NORMAL VAIDEIU",VAIDEIU,MS,100,0,0,0,0,1,1,0,2,5,2,0,7,5,2,0,7,5,2,0,7
118646,470,"CAMIN CULTURAL","PAPIU ILARIAN",MS,688,5,0,0,5,6,0,0,6,7,0,0,7,7,1,0,8,13,1,0,14
118708,471,"GRĂDINIŢA CU PROGRAM NORMAL PĂNET",PĂNET,MS,1065,2,0,0,2,9,0,0,9,27,0,0,27,32,2,0,34,36,3,0,39
118708,472,"SEDIUL PRIMĂRIEI COMUNEI PĂNET",PĂNET,MS,871,3,1,0,4,18,2,0,20,39,2,0,41,53,6,0,59,61,6,0,67
118717,473,"CĂMINUL CULTURAL BERGHIA",BERGHIA,MS,998,1,0,0,1,4,1,0,5,9,1,0,10,11,1,0,12,16,1,0,17
118726,474,"ŞCOALA PRIMARĂ CUIEŞD",CUIEŞD,MS,662,0,0,0,0,1,0,0,1,6,0,0,6,12,0,0,12,12,0,0,12
118735,475,"CĂMINUL CULTURAL HĂRŢĂU",HĂRŢĂU,MS,282,2,0,0,2,3,0,0,3,5,1,0,6,10,1,0,11,11,2,0,13
118744,476,"CĂMINUL CULTURAL SINTIOANA DE MUREŞ","SÎNTIOANA DE MUREŞ",MS,1171,6,0,0,6,13,0,0,13,15,0,0,15,17,0,0,17,34,1,0,35
118762,477,"ŞCOALA GIMNANZIALĂ ”KISS GERGELY” PĂSĂRENI",PĂSĂRENI,MS,699,0,0,0,0,6,0,0,6,9,0,0,9,9,1,0,10,11,4,0,15
118780,478,"ŞCOALA PRIMARĂ GĂLĂŢENI, SAT GĂLĂȚENI",GĂLĂŢENI,MS,552,3,0,0,3,4,2,0,6,5,2,0,7,5,2,0,7,5,2,0,7
118771,479,"CĂMIN CULTURAL BOLINTINENI, SAT BOLINTINENI",BOLINTINENI,MS,178,0,0,0,0,1,3,0,4,1,3,0,4,1,3,0,4,2,3,0,5
118806,480,"FOSTUL SEDIU AL POSTEI ROMANE",PETELEA,MS,1080,3,0,0,3,5,0,0,5,7,0,0,7,7,0,0,7,7,0,0,7
118806,481,"SEDIUL PRIMARIEI",PETELEA,MS,914,5,4,0,9,6,4,0,10,8,4,0,12,9,4,0,13,9,4,0,13
118815,482,"SCOALA PRIMARA HABIC",HABIC,MS,201,3,2,0,5,5,3,0,8,5,4,0,9,5,4,0,9,5,6,0,11
118833,483,"CĂMINUL CULTURAL POGĂCEAUA",POGĂCEAUA,MS,1069,3,0,0,3,11,0,0,11,18,0,0,18,30,1,0,31,31,1,0,32
118922,484,"CĂMINUL CULTURAL VĂLENI",VĂLENI,MS,413,6,0,0,6,11,0,0,11,16,3,0,19,26,4,0,30,30,6,0,36
118940,485,"ȘCOALA GIMNAZIALĂ RĂSTOLIȚA",RĂSTOLIŢA,MS,1468,13,0,0,13,30,0,0,30,34,0,0,34,38,0,0,38,42,2,0,44
119108,486,"CĂMINUL CULTURAL SÎNMARTINU DE CÎMPIE","SÎNMĂRTINU DE CÎMPIE",MS,731,6,0,0,6,8,0,0,8,11,0,0,11,12,2,0,14,20,2,0,22
119073,487,"CĂMINUL CULTURAL NIMA RÎCIULUI","NIMA RÎCIULUI",MS,134,2,4,0,6,2,5,0,7,2,5,0,7,2,5,0,7,3,5,0,8
119117,488,"ŞCOALA GIMNAZIALĂ ULIEŞ",ULIEŞ,MS,603,4,3,0,7,5,4,0,9,6,4,0,10,6,5,0,11,6,6,0,12
119000,489,"ŞCOALA GIMNAZIALĂ,,GHEORGHE ŞINCAI""",RÎCIU,MS,1340,8,0,0,8,19,2,0,21,29,2,0,31,35,2,0,37,37,5,0,42
119162,490,"CĂMINUL CULTURAL",RUŞII-MUNŢI,MS,1263,8,1,0,9,16,1,0,17,23,5,0,28,42,5,0,47,47,5,0,52
119171,491,"CĂMINUL CULTURAL",MAIOREŞTI,MS,195,6,0,0,6,13,0,0,13,14,1,0,15,19,2,0,21,20,2,0,22
119180,492,"FOSTA SCOALA PRIMARA",MORĂRENI,MS,319,1,0,0,1,2,1,0,3,3,2,0,5,9,3,0,12,9,3,0,12
119215,493,"ȘCOALA GIMNAZIALĂ ”ION DACIAN”",SASCHIZ,MS,1392,9,2,0,11,18,6,0,24,21,6,0,27,30,6,0,36,34,8,0,42
119233,494,"CĂMIN CULTURAL MIHAI VITEAZU","MIHAI VITEAZU",MS,242,2,0,0,2,4,0,0,4,8,0,0,8,11,1,0,12,12,1,0,13
119224,495,"CĂMIN CULTURAL CLOAȘTERF",CLOAŞTERF,MS,156,1,0,0,1,3,1,0,4,3,3,0,6,4,3,0,7,5,3,0,8
114907,496,"PRIMĂRIA COMUNEI SĂRĂȚENI",SĂRĂŢENI,MS,1234,5,0,0,5,10,0,0,10,10,0,0,10,10,0,0,10,11,0,0,11
119395,497,"GRADINITA CU PROGRAM NORMAL SANGER",SÂNGER,MS,1280,2,1,0,3,8,1,0,9,14,1,0,15,16,1,0,17,16,1,0,17
119411,498,"CAMINUL CULTURAL CIPAIENI",CIPĂIENI,MS,593,3,0,0,3,6,0,0,6,13,0,0,13,15,0,0,15,15,0,0,15
114391,499,"CĂMINUL CULTURAL SÎNCRAIU DE MUREŞ","SÎNCRAIU DE MUREŞ",MS,1519,11,3,0,14,25,4,0,29,35,7,0,42,49,11,0,60,66,12,0,78
114391,500,"PRIMĂRIA SÎNCRAIU DE MUREŞ","SÎNCRAIU DE MUREŞ",MS,1802,4,3,0,7,25,6,0,31,43,9,0,52,52,11,0,63,69,17,0,86
114391,501,"FOSTUL CĂMIN CULTURAL SÎNCRAIU DE MUREŞ","SÎNCRAIU DE MUREŞ",MS,1861,10,6,0,16,20,6,0,26,32,7,0,39,52,8,0,60,52,9,0,61
114408,502,"CĂMINULCULTURAL NAZNA",NAZNA,MS,1144,14,1,0,15,28,2,0,30,41,2,0,43,66,3,0,69,73,3,0,76
114408,503,"ŞCOALA GIMNAZIALĂ NAZNA",NAZNA,MS,965,9,0,0,9,28,0,0,28,35,1,0,36,40,2,0,42,49,2,0,51
114426,504,"CĂMINUL CULTURAL SÎNGEORGIU DE MUREȘ","SÎNGEORGIU DE MUREŞ",MS,1162,8,1,0,9,23,1,0,24,40,3,0,43,58,6,0,64,64,7,0,71
114426,505,"CĂMINUL CULTURAL SÎNGEORGIU DE MUREȘ","SÎNGEORGIU DE MUREŞ",MS,1582,12,0,0,12,32,2,0,34,55,5,0,60,79,8,0,87,86,8,0,94
114435,506,"ȘCOALA GIMNAZIALĂ ”SFÂNTUL GHEORGHE” - ȘCOALA PRIMARĂ COTUȘ",COTUŞ,MS,403,1,0,0,1,1,0,0,1,1,4,0,5,5,4,0,9,11,5,0,16
114426,507,"GRĂDINIȚA CU PROGRAM PRELUNGIT ”BAMBI” SÎNGEORGIU DE MUREȘ","SÎNGEORGIU DE MUREŞ",MS,1498,6,0,0,6,23,1,0,24,30,4,0,34,56,10,0,66,56,11,0,67
114426,508,"ȘCOALA GIMNAZIALĂ ”SFÂNTUL GHEORGHE” SÎNGEORGIU DE MUREȘ","SÎNGEORGIU DE MUREŞ",MS,1208,3,1,0,4,14,2,0,16,21,2,0,23,38,2,0,40,45,3,0,48
114426,509,"ȘCOALA GIMNAZIALĂ ”SFÂNTUL GHEORGHE” SÎNGEORGIU DE MUREȘ","SÎNGEORGIU DE MUREŞ",MS,1255,3,1,0,4,22,1,0,23,31,1,0,32,45,2,0,47,50,3,0,53
114426,510,"ȘCOALA GIMNAZIALĂ ”SFÂNTUL GHEORGHE” SÎNGEORGIU DE MUREȘ","SÎNGEORGIU DE MUREŞ",MS,1178,11,0,0,11,27,0,0,27,39,0,0,39,59,2,0,61,76,3,0,79
119475,511,"CĂMINUL CULTURAL",SÎNPAUL,MS,1421,7,4,0,11,15,5,0,20,19,5,0,24,30,6,0,36,30,6,0,36
119484,512,"ŞCOALA GENERALĂ CHIRILEU",CHIRILEU,MS,686,5,0,0,5,11,0,0,11,11,3,0,14,21,5,0,26,21,7,0,28
119493,513,"CĂMINUL CULTURAL","DILEU NOU",MS,139,1,0,0,1,3,0,0,3,5,0,0,5,12,0,0,12,15,0,0,15
119509,514,"CĂMINUL CULTURAL",SÎNMĂRGHITA,MS,197,7,0,0,7,11,3,0,14,11,4,0,15,11,4,0,15,13,6,0,19
119518,515,"CĂMINUL CULTURAL","VALEA IZVOARELOR",MS,959,5,0,0,5,12,3,0,15,18,3,0,21,28,3,0,31,36,3,0,39
119536,516,"CĂMINUL CULTURAL SÎNPETRU DE CÎMPIE","SÎNPETRU DE CÎMPIE",MS,850,6,0,0,6,10,1,0,11,13,1,0,14,19,3,0,22,20,3,0,23
119545,517,"CĂMINUL CULTURAL BÎRLIBAȘ",BÎRLIBAŞ,MS,97,1,2,0,3,4,2,0,6,4,2,0,6,4,2,0,6,4,2,0,6
119554,518,"ȘCOALA GENERALĂDÎMBU",DÎMBU,MS,459,2,0,0,2,5,0,0,5,6,1,0,7,7,2,0,9,10,2,0,12
119563,519,"FOSTA ȘCOALA PRIMARASATU -NOU","SATU NOU",MS,159,3,5,0,8,4,6,0,10,5,6,0,11,7,7,0,14,7,9,0,16
119572,520,"CĂMINUL CULTURAL SÎNGEORGIU DE CÎMPIE","SÎNGEORGIU DE CÎMPIE",MS,286,2,0,0,2,6,0,0,6,7,2,0,9,11,2,0,13,13,2,0,15
119581,521,"CĂMINUL CULTURAL TUȘINU",TUŞINU,MS,400,3,3,0,6,4,3,0,7,4,7,0,11,4,9,0,13,5,9,0,14
114462,522,"ŞCOALA GIMNAZIALĂ ”ION CHINEZU"" SÎNTANA DE MUREȘ","SÎNTANA DE MUREŞ",MS,1450,9,1,0,10,15,3,0,18,24,3,0,27,31,3,0,34,36,5,0,41
114462,523,"ŞCOALA GIMNAZIALĂ ”ION CHINEZU” SÎNTANA DE MUREȘ","SÎNTANA DE MUREŞ",MS,1482,10,0,0,10,22,2,0,24,32,5,0,37,39,7,0,46,40,7,0,47
114499,524,"ȘCOALA PRIMARĂ CURTENI",CURTENI,MS,830,4,4,0,8,9,5,0,14,12,5,0,17,17,5,0,22,19,5,0,24
114480,525,"GRĂDINIȚA CU PROGRAM NORMAL CHINARI",CHINARI,MS,592,1,0,0,1,1,0,0,1,7,0,0,7,9,2,0,11,17,2,0,19
114471,526,"CĂMINUL CULTURAL BĂRDEŞTI",BĂRDEŞTI,MS,401,2,0,0,2,9,2,0,11,15,3,0,18,24,4,0,28,26,4,0,30
119607,527,"ŞCOALA GIMNAZIALĂ SOLOVĂSTRU",SOLOVĂSTRU,MS,1396,12,0,0,12,17,4,0,21,27,5,0,32,44,7,0,51,47,7,0,54
119616,528,"ŞCOALA GIMNAZIALĂ JABENIŢA",JABENIŢA,MS,977,4,3,0,7,11,4,0,15,13,5,0,18,20,5,0,25,29,6,0,35
119634,529,"CĂMIN CULTURAL STÎNCENI",STÎNCENI,MS,1208,7,1,0,8,18,3,0,21,19,3,0,22,26,3,0,29,31,3,0,34
119670,530,"ȘCOALA PRIMARĂSUPLAC",SUPLAC,MS,648,2,0,0,2,5,2,0,7,9,2,0,11,13,3,0,16,22,4,0,26
119689,531,"ȘCOALA GIMNAZIALĂ ” BORDI ANDRÁS ”IDRIFAIA",IDRIFAIA,MS,514,4,4,0,8,4,4,0,8,4,4,0,8,5,4,0,9,6,4,0,10
119698,532,"ȘCOALA GIMNAZIALĂ ” SF.NICOLAE” LASLĂU MARE","LASLĂU MARE",MS,296,2,0,0,2,3,5,0,8,5,5,0,10,6,5,0,11,6,5,0,11
119705,533,"ŞCOALA PRIMARĂ LASLĂU MIC","LASLĂU MIC",MS,413,1,0,0,1,2,0,0,2,2,0,0,2,7,1,0,8,7,1,0,8
119732,534,"ŞCOALA GIMNAZIALĂ SUSENI",SUSENI,MS,1393,4,0,0,4,13,2,0,15,17,2,0,19,24,2,0,26,28,3,0,31
119741,535,"FOSTA ŞCOALĂ GENERALĂ LUIERIU",LUIERIU,MS,541,5,2,0,7,8,2,0,10,10,2,0,12,21,2,0,23,21,3,0,24
119769,536,"CĂMINUL CULTURAL ȘĂULIA",ŞĂULIA,MS,1319,7,3,0,10,24,4,0,28,38,7,0,45,45,7,0,52,48,7,0,55
119769,537,"CLUBUL TINERETULUI ȘĂULIA",ŞĂULIA,MS,251,0,3,0,3,3,3,0,6,3,4,0,7,3,7,0,10,3,9,0,12
119812,538,"CONSILIULLOCAL ŞINCAI",ŞINCAI,MS,846,4,1,0,5,5,2,0,7,9,2,0,11,12,2,0,14,14,3,0,17
119821,539,"ŞCOALA PRIMARĂ LECHINCIOARA",LECHINCIOARA,MS,79,4,0,0,4,9,1,0,10,12,1,0,13,15,2,0,17,16,2,0,18
119830,540,"ŞCOALA PRIMARĂ PUSTA",PUSTA,MS,98,0,0,0,0,1,1,0,2,1,1,0,2,2,1,0,3,2,1,0,3
119849,541,"ŞCOALA PRIMARĂ ŞINCAI-FÎNAŢE",ŞINCAI-FÎNAŢE,MS,173,2,0,0,2,2,1,0,3,3,1,0,4,3,1,0,4,4,1,0,5
119867,542,"PRIMĂRIA TĂURENI",TĂURENI,MS,762,2,2,0,4,3,2,0,5,6,2,0,8,10,4,0,14,16,7,0,23
119983,543,"PRIMARIA COMUNEI VALEA LARGA","VALEA LARGĂ",MS,1109,2,1,0,3,8,1,0,9,12,2,0,14,14,2,0,16,18,2,0,20
119983,544,"CĂMINUL CULTURAL VALEA LARGA","VALEA LARGĂ",MS,916,11,0,0,11,16,0,0,16,17,0,0,17,22,0,0,22,24,0,0,24
120021,545,"ŞCOALA PRIMARĂ VALEA FRĂŢIEI","VALEA FRĂŢIEI",MS,496,2,4,0,6,2,4,0,6,5,4,0,9,7,4,0,11,9,4,0,13
120085,546,"ŞCOALA GIMNAZIALĂ VĂRGATA",VĂRGATA,MS,647,1,0,0,1,1,0,0,1,3,0,0,3,5,1,0,6,5,1,0,6
120094,547,"ŞCOALA PRIMARĂ GRÎUŞORUL",GRÎUŞORUL,MS,138,0,0,0,0,1,0,0,1,1,0,0,1,1,0,0,1,1,0,0,1
120110,548,"ŞCOALA GIMNAZIALĂ VADU",VADU,MS,200,2,0,0,2,2,0,0,2,2,0,0,2,2,0,0,2,2,0,0,2
120129,549,"ŞCOALA PRIMARĂ VALEA",VALEA,MS,546,1,0,0,1,4,1,0,5,6,1,0,7,9,1,0,10,9,1,0,10
120147,550,"CĂMINUL CULTURAL VĂTAVA",VĂTAVA,MS,642,6,1,0,7,11,3,0,14,12,3,0,15,22,6,0,28,23,7,0,30
120156,551,"ȘCOALA PRIMARĂ DUMBRAVA",DUMBRAVA,MS,562,3,0,0,3,6,2,0,8,7,2,0,9,14,2,0,16,14,2,0,16
120165,552,"ȘCOALA ”MIHAI TOMSA” RÎPA DE JOS","RÎPA DE JOS",MS,377,4,1,0,5,9,3,0,12,10,4,0,14,13,7,0,20,16,7,0,23
120183,553,"CĂMINUL CULTURAL VEȚCA",VEŢCA,MS,384,1,0,0,1,1,0,0,1,2,1,0,3,2,1,0,3,3,1,0,4
120192,554,"CĂMINUL CULTURAL JACODU",JACODU,MS,192,2,2,0,4,3,2,0,5,4,4,0,8,5,4,0,9,6,9,0,15
120227,555,"PRIMĂRIA VIIŞOARA",VIIŞOARA,MS,621,4,1,0,5,5,1,0,6,6,1,0,7,13,1,0,14,13,2,0,15
120245,556,"CĂMINUL CULTURAL SÎNTIOANA",SÎNTIOANA,MS,432,6,1,0,7,9,3,0,12,12,4,0,16,17,4,0,21,19,4,0,23
120236,557,"CĂMINUL CULTURAL ORMENIŞ",ORMENIŞ,MS,345,1,1,0,2,2,2,0,4,2,2,0,4,2,2,0,4,2,2,0,4
120263,558,"ŞCOALA GIMNAZIALĂ "" PETRE N. POPESCU ""VÎNĂTORI",VÎNĂTORI,MS,1429,11,2,0,13,22,3,0,25,36,4,0,40,41,4,0,45,45,4,0,49
120272,559,"GRĂDINIŢACU PROGRAMNORMAL ARCHITA",ARCHITA,MS,711,6,0,0,6,10,1,0,11,13,1,0,14,19,1,0,20,19,1,0,20
120281,560,ŞCOALAPRIMARĂFELEAG,FELEAG,MS,165,2,1,0,3,2,1,0,3,2,1,0,3,5,3,0,8,5,3,0,8
120290,561,ŞCOALAPRIMARĂMURENI,MURENI,MS,280,2,0,0,2,2,0,0,2,3,0,0,3,3,0,0,3,3,1,0,4
120307,562,ŞCOALAPRIMARĂŞOARD,ŞOARD,MS,593,0,0,0,0,4,1,0,5,5,2,0,7,5,2,0,7,7,2,0,9
120325,563,"ȘCOALA GIMNAZIALĂ VOIVODENI",VOIVODENI,MS,1302,4,0,0,4,7,0,0,7,12,0,0,12,19,1,0,20,24,1,0,25
120334,564,"CĂMINUL CULTURAL TOLDAL",TOLDAL,MS,183,2,0,0,2,5,2,0,7,5,2,0,7,9,6,0,15,13,6,0,19
120352,565,"PRIMARIA ZAGAR",ZAGĂR,MS,1002,10,1,0,11,19,1,0,20,23,1,0,24,28,1,0,29,29,1,0,30
120389,566,"ȘCOALA PRIMARĂ CLASELE 0-IV ZAU DE CÎMPIE","ZAU DE CÎMPIE",MS,963,2,0,0,2,8,1,0,9,13,2,0,15,17,2,0,19,17,2,0,19
120389,567,"ŞCOALAGIMNAZIALĂ ZAU DE CÎMPIE","ZAU DE CÎMPIE",MS,1262,4,0,0,4,14,0,0,14,22,1,0,23,34,1,0,35,36,2,0,38
120398,568,"ȘCOALA GIMNAZIALĂ BĂRBOȘI",BĂRBOŞI,MS,385,1,4,0,5,1,4,0,5,5,4,0,9,5,4,0,9,5,4,0,9
120735,1,"ŞCOALA GIMNAZIALĂ NR.3",PIATRA-NEAMŢ,NT,970,17,0,0,17,58,2,0,60,79,8,0,87,86,16,2,104,92,17,2,111
120735,2,"ŞCOALA GIMNAZIALĂ NR.3",PIATRA-NEAMŢ,NT,941,19,2,0,21,53,2,0,55,78,4,0,82,103,7,0,110,105,7,0,112
120735,3,"ȘCOALA GIMNAZIALĂ NR.3",PIATRA-NEAMŢ,NT,1135,13,5,0,18,43,6,0,49,64,7,0,71,92,7,0,99,99,7,0,106
120735,4,"GRĂDINIȚA CU PROGRAM PRELUNGIT NR.6",PIATRA-NEAMŢ,NT,972,17,1,0,18,61,4,0,65,89,5,1,95,114,5,1,120,121,7,1,129
120735,5,"COLEGIUL NAȚIONAL ”PETRU RAREȘ”",PIATRA-NEAMŢ,NT,1366,15,1,0,16,41,4,0,45,74,6,0,80,93,6,0,99,99,7,0,106
120735,6,"LICEUL DE ARTE ""VICTOR BRAUNER"" - CORPUL B",PIATRA-NEAMŢ,NT,1291,11,5,0,16,42,8,0,50,62,9,0,71,78,10,0,88,83,10,0,93
120735,7,"COLEGIUL NAȚIONAL ”CALISTRAT HOGAȘ”",PIATRA-NEAMŢ,NT,920,16,1,0,17,44,3,0,47,62,3,0,65,78,3,0,81,90,3,0,93
120735,8,"LICEUL TEHNOLOGIC ”SPIRU HARET”",PIATRA-NEAMŢ,NT,1281,22,2,0,24,51,5,0,56,76,5,0,81,95,6,0,101,99,6,0,105
120735,9,"LICEUL TEHOLOGIC ”SPIRU HARET”",PIATRA-NEAMŢ,NT,1125,12,0,0,12,39,3,0,42,68,5,0,73,84,5,0,89,94,8,0,102
120735,10,"GRĂDINIȚA CU PROGRAM PRELUNGIT NR.3 CORP B",PIATRA-NEAMŢ,NT,1079,14,4,0,18,29,5,0,34,45,5,0,50,60,5,0,65,64,5,0,69
120735,11,"LICEUL CU PROGRAM SPORTIV",PIATRA-NEAMŢ,NT,1345,15,4,0,19,46,4,0,50,77,4,0,81,101,5,0,106,107,5,0,112
120735,12,"LICEUL CU PROGRAM SPORTIV",PIATRA-NEAMŢ,NT,1156,20,6,0,26,47,9,0,56,65,11,0,76,81,13,0,94,87,15,0,102
120735,13,"ŞCOALA GIMNAZIALĂ NR.8",PIATRA-NEAMŢ,NT,1321,23,2,0,25,65,5,0,70,100,5,0,105,122,5,0,127,127,5,0,132
120735,14,"ȘCOALA GIMNAZIALĂ NR.8",PIATRA-NEAMŢ,NT,1491,29,4,0,33,58,6,0,64,91,7,0,98,109,7,0,116,115,7,0,122
120735,15,"GRĂDINIȚA CUPLATĂ CU CREŞĂ NR.5",PIATRA-NEAMŢ,NT,1411,14,1,0,15,40,1,0,41,65,1,0,66,99,3,0,102,104,3,0,107
120735,16,"GRĂDINIȚA CUPLATĂ CU CREŞĂ NR.5",PIATRA-NEAMŢ,NT,1066,6,0,0,6,23,3,0,26,32,3,0,35,42,4,0,46,55,7,0,62
120735,17,"GRĂDINIȚA CU PROGRAM PRELUNGIT NR.8",PIATRA-NEAMŢ,NT,941,15,6,0,21,33,6,0,39,49,6,0,55,56,6,0,62,61,6,0,67
120735,18,"GRĂDINIȚA CU PROGRAM NORMAL OCOL",PIATRA-NEAMŢ,NT,1853,15,9,0,24,57,17,0,74,69,19,0,88,86,21,0,107,101,22,0,123
120735,19,"ASE BUCUREȘTI",PIATRA-NEAMŢ,NT,1498,26,4,0,30,55,6,0,61,84,6,0,90,103,7,0,110,107,8,0,115
120735,20,"ȘCOALA GIMNAZIALĂ NR.11",PIATRA-NEAMŢ,NT,1455,10,2,0,12,37,5,0,42,54,5,0,59,67,5,0,72,70,6,0,76
120735,21,"COLEGIUL NAȚIONAL ”GH. ASACHI”",PIATRA-NEAMŢ,NT,962,6,0,0,6,27,4,0,31,30,8,0,38,40,8,0,48,40,8,0,48
120735,22,"COLEGIUL NAȚIONAL ”GH. ASACHI”",PIATRA-NEAMŢ,NT,1045,4,0,0,4,19,0,0,19,29,6,0,35,34,6,0,40,37,6,0,43
120735,23,"ŞCOALA GIMNAZIALĂ NR.5",PIATRA-NEAMŢ,NT,1521,17,1,0,18,59,4,0,63,88,6,0,94,107,6,0,113,111,6,0,117
120735,24,"ŞCOALA GIMNAZIALĂ NR.5",PIATRA-NEAMŢ,NT,1424,19,4,0,23,52,6,0,58,80,7,0,87,110,7,0,117,120,7,0,127
120735,25,"GRĂDINIŢA CU PROGRAM PRELUNGIT NR.12",PIATRA-NEAMŢ,NT,1341,12,8,0,20,36,8,0,44,54,9,0,63,70,9,0,79,74,9,0,83
120735,26,"GRĂDINIŢA CU PROGRAM PRELUNGIT NR.12",PIATRA-NEAMŢ,NT,1277,14,1,0,15,51,1,0,52,76,2,0,78,100,2,0,102,103,3,0,106
120735,27,"GRĂDINIŢA CU PROGRAM PRELUNGIT NR.12",PIATRA-NEAMŢ,NT,1370,10,4,0,14,33,4,0,37,53,4,0,57,75,5,0,80,82,5,0,87
120735,28,"CENTRUL SOCIAL PIETRICICA",PIATRA-NEAMŢ,NT,1578,29,5,0,34,50,5,0,55,94,6,0,100,115,7,0,122,126,7,0,133
120735,29,"COLEGIUL NAȚIONAL DE INFORMATICĂ",PIATRA-NEAMŢ,NT,859,9,1,0,10,22,1,0,23,34,1,0,35,43,1,0,44,44,1,0,45
120735,30,"COLEGIUL NAȚIONAL DE INFORMATICĂ",PIATRA-NEAMŢ,NT,2115,13,6,0,19,53,8,1,62,66,9,1,76,107,10,1,118,128,11,1,140
120735,31,"COLEGIUL NAȚIONAL DE INFORMATICĂ",PIATRA-NEAMŢ,NT,1662,15,1,0,16,48,2,0,50,67,2,0,69,83,2,0,85,90,3,0,93
120735,32,"COLEGIUL NAȚIONAL DE INFORMATICĂ",PIATRA-NEAMŢ,NT,1418,15,5,0,20,40,5,0,45,69,7,0,76,81,10,0,91,84,10,0,94
120735,33,"COLEGIUL NAȚIONAL DE INFORMATICĂ",PIATRA-NEAMŢ,NT,1065,4,0,0,4,19,0,0,19,33,0,0,33,48,0,0,48,50,0,0,50
120735,34,"COLEGIUL NAȚIONAL DE INFORMATICĂ",PIATRA-NEAMŢ,NT,925,7,0,0,7,35,1,0,36,48,1,0,49,60,3,0,63,63,4,0,67
120735,35,"ŞCOALA GIMNAZIALĂ NR.7",PIATRA-NEAMŢ,NT,1627,7,2,0,9,10,2,0,12,20,2,0,22,31,3,0,34,32,3,0,35
120735,36,"CENTRUL SOCIAL - CARTIER SPERANŢA",PIATRA-NEAMŢ,NT,919,10,0,0,10,18,6,0,24,44,6,0,50,55,7,0,62,64,7,0,71
120735,37,"CLĂDIRE ADMINISTRATIVĂ S.C. CMI URBAN S.A. (ŞTRAND MUNICIPAL)",PIATRA-NEAMŢ,NT,739,2,3,0,5,8,3,0,11,17,4,0,21,22,4,0,26,22,4,0,26
120735,38,"ȘCOALA GIMNAZIALĂ NR.2",PIATRA-NEAMŢ,NT,1057,20,0,0,20,54,0,0,54,93,4,0,97,102,4,0,106,103,4,38,145
120735,39,"ȘCOALA GIMNAZIALĂ NR.2",PIATRA-NEAMŢ,NT,924,14,0,0,14,43,2,0,45,57,3,0,60,79,6,37,122,84,7,37,128
120735,40,"ȘCOALA GIMNAZIALĂ NR.2",PIATRA-NEAMŢ,NT,901,12,3,0,15,48,5,0,53,70,5,0,75,91,7,38,136,101,7,38,146
120735,41,"ŞCOALA GIMNAZIALĂ NR.2",PIATRA-NEAMŢ,NT,1163,22,5,0,27,44,6,0,50,55,8,0,63,80,10,25,115,87,11,25,123
120735,42,"ŞCOALA GIMNAZIALĂ NR.2",PIATRA-NEAMŢ,NT,1365,15,2,0,17,66,6,0,72,99,9,0,108,117,10,28,155,123,10,28,161
120735,43,"DIRECȚIA AGRICOLĂ",PIATRA-NEAMŢ,NT,1356,25,2,0,27,75,8,0,83,96,10,0,106,123,10,0,133,135,11,0,146
120735,44,"S.C. APA SERV S.A.",PIATRA-NEAMŢ,NT,1160,10,1,0,11,38,2,0,40,57,3,0,60,83,4,1,88,86,5,1,92
120735,45,"COMPLEXUL EXPOZIȚIONAL MUNICIPAL",PIATRA-NEAMŢ,NT,1418,14,4,0,18,52,4,0,56,80,11,0,91,117,14,0,131,127,15,0,142
120735,46,"ȘCOALA GIMNAZIALĂ ""ELENA CUZA""",PIATRA-NEAMŢ,NT,1448,16,0,0,16,63,9,0,72,93,12,0,105,113,14,0,127,117,14,0,131
120735,47,"ȘCOALA GIMNAZIALĂ ""ELENA CUZA""",PIATRA-NEAMŢ,NT,1388,21,0,0,21,70,1,0,71,97,1,0,98,124,2,0,126,133,2,0,135
120735,48,"ŞCOALA GIMNAZIALĂ ""NICU ALBU""",PIATRA-NEAMŢ,NT,1220,11,3,0,14,42,3,0,45,64,3,0,67,83,7,0,90,87,7,0,94
120735,49,"ŞCOALA GIMNAZIALĂ ""NICU ALBU""",PIATRA-NEAMŢ,NT,1381,11,5,0,16,33,5,0,38,57,8,0,65,85,9,0,94,104,9,0,113
120735,50,"ŞCOALA GIMNAZIALĂ ""NICU ALBU""",PIATRA-NEAMŢ,NT,1252,11,1,0,12,30,1,0,31,50,1,0,51,66,1,0,67,67,1,0,68
120735,51,"ŞCOALA GIMNAZIALĂ ""NICU ALBU""",PIATRA-NEAMŢ,NT,1379,8,0,0,8,32,0,0,32,46,0,0,46,67,0,0,67,72,0,0,72
120735,52,"ŞCOALA GIMNAZIALĂ ""NICU ALBU""",PIATRA-NEAMŢ,NT,1395,14,6,0,20,35,7,0,42,55,7,0,62,70,12,0,82,84,12,0,96
120735,53,"ŞCOALA GIMNAZIALĂ ""NICU ALBU""",PIATRA-NEAMŢ,NT,1410,11,0,0,11,36,2,0,38,47,4,0,51,66,8,0,74,74,10,0,84
120735,54,"CASA CORPULUI DIDACTIC",PIATRA-NEAMŢ,NT,1300,9,1,0,10,26,3,0,29,36,4,0,40,59,6,0,65,62,7,0,69
120735,55,"COLEGIUL TEHNIC DE TRANSPORTURI",PIATRA-NEAMŢ,NT,1209,7,0,0,7,18,1,0,19,31,1,0,32,45,3,0,48,49,3,0,52
120735,56,"COLEGIUL TEHNIC FORESTIER",PIATRA-NEAMŢ,NT,1290,12,1,0,13,29,1,0,30,43,1,0,44,77,3,0,80,79,3,0,82
120735,57,"COLEGIUL TEHNIC FORESTIER",PIATRA-NEAMŢ,NT,1359,16,7,0,23,38,7,0,45,58,7,0,65,79,8,0,87,83,8,0,91
120735,58,"LICEUL TEHNOLOGICECONOMIC ADMINISTRATIV",PIATRA-NEAMŢ,NT,1403,16,5,0,21,42,8,0,50,62,9,0,71,80,9,0,89,87,9,0,96
120735,59,"COLEGIUL TEHNIC ""GHEORGHE CARTIANU""",PIATRA-NEAMŢ,NT,1404,15,5,0,20,39,8,0,47,59,8,0,67,87,8,0,95,95,8,0,103
120735,60,"COLEGIUL TEHNIC ""GHEORGHE CARTIANU""",PIATRA-NEAMŢ,NT,923,2,4,0,6,22,6,0,28,32,7,0,39,43,7,0,50,45,8,0,53
120735,61,"COLEGIUL TEHNIC ""GHEORGHE CARTIANU""",PIATRA-NEAMŢ,NT,1294,4,2,0,6,22,2,0,24,52,3,1,56,72,4,1,77,80,4,1,85
120735,62,"COLEGIUL TEHNIC ""GHEORGHE CARTIANU""",PIATRA-NEAMŢ,NT,1311,1,1,0,2,16,1,0,17,25,4,0,29,35,6,0,41,38,6,0,44
120735,63,"ŞCOALA GIMNAZIALĂ NR.1",PIATRA-NEAMŢ,NT,1776,14,0,0,14,43,4,0,47,62,5,0,67,77,6,0,83,81,8,0,89
120735,64,"GRĂDINIȚA CU PROGRAM NORMAL NR.19",PIATRA-NEAMŢ,NT,787,10,1,0,11,27,2,0,29,37,2,0,39,45,2,0,47,50,2,0,52
120735,65,"LICEUL TEHNOLOGIC ""DIMITRIE LEONIDA""",PIATRA-NEAMŢ,NT,1422,14,0,0,14,37,1,0,38,44,2,0,46,64,3,0,67,74,6,0,80
120735,66,"LICEUL TEHNOLOGIC ""DIMITRIE LEONIDA""",PIATRA-NEAMŢ,NT,1288,4,5,0,9,23,6,0,29,24,6,0,30,45,8,0,53,47,8,0,55
120735,67,"LICEUL TEHNOLOGIC ""DIMITRIE LEONIDA"" CORP B",PIATRA-NEAMŢ,NT,1083,13,3,0,16,24,3,0,27,28,3,0,31,47,6,0,53,51,6,0,57
120735,68,"ȘCOALA GIMNAZIALĂ ""DANIELA CUCIUC""",PIATRA-NEAMŢ,NT,1811,7,2,0,9,31,3,0,34,54,3,0,57,67,3,0,70,73,3,0,76
120735,69,"ȘCOALA GIMNAZIALĂ ""DANIELA CUCIUC""",PIATRA-NEAMŢ,NT,1009,8,0,0,8,30,2,0,32,47,4,0,51,60,5,0,65,62,5,0,67
120735,70,"ȘCOALA GIMNAZIALĂ ""DANIELA CUCIUC""",PIATRA-NEAMŢ,NT,1250,12,0,0,12,34,5,0,39,48,6,0,54,66,6,0,72,68,6,0,74
120735,71,"ȘCOALA GIMNAZIALĂ ""DANIELA CUCIUC""",PIATRA-NEAMŢ,NT,924,16,0,0,16,43,2,0,45,55,2,0,57,81,3,0,84,82,3,0,85
120735,72,"ȘCOALA GIMNAZIALĂ ""DANIELA CUCIUC""",PIATRA-NEAMŢ,NT,1725,10,0,0,10,36,2,0,38,53,2,0,55,64,4,1,69,67,4,1,72
120735,73,"GRĂDINIŢA CU PROGRAM PRELUNGIT ""FLOARE DE COLŢ""",PIATRA-NEAMŢ,NT,1547,13,2,0,15,56,3,0,59,84,3,0,87,111,4,0,115,118,8,0,126
120735,74,"GRĂDINIŢA CU PROGRAM PRELUNGIT ""FLOARE DE COLŢ""",PIATRA-NEAMŢ,NT,1290,25,1,0,26,64,1,0,65,82,1,0,83,97,1,0,98,101,1,0,102
120735,75,"GRĂDINIŢA CU PROGRAM NORMAL NR.1",PIATRA-NEAMŢ,NT,1571,20,0,0,20,77,0,0,77,110,2,0,112,136,5,1,142,152,6,2,160
120879,76,"COLEGIUL NAŢIONAL ""ROMAN VODĂ"" - CORP A",ROMAN,NT,1271,11,2,0,13,30,4,0,34,53,4,0,57,72,5,0,77,74,6,0,80
120879,77,"GRĂDINIŢA DE COPII NR. 2 CU PROGRAM PRELUNGIT",ROMAN,NT,1217,37,1,0,38,77,3,0,80,92,7,0,99,103,7,0,110,109,7,0,116
120879,78,"GRĂDINIŢA DE COPII NR. 6 CU PROGRAM PRELUNGIT",ROMAN,NT,1283,16,1,0,17,56,1,0,57,72,2,0,74,85,2,0,87,92,2,0,94
120879,79,"ŞCOALA GIMNAZIALĂ ,,CALISTRAT HOGAŞ”",ROMAN,NT,1593,23,2,0,25,44,3,0,47,56,5,0,61,61,5,0,66,61,5,0,66
120879,80,"ŞCOALA GIMNAZIALĂ ,,CALISTRAT HOGAŞ”",ROMAN,NT,1180,8,0,0,8,20,0,0,20,29,0,0,29,39,0,0,39,42,0,1,43
120879,81,"ŞCOALA GIMNAZIALĂ ,,CALISTRAT HOGAŞ”",ROMAN,NT,1445,4,1,0,5,12,1,0,13,18,2,0,20,31,4,0,35,36,4,0,40
120879,82,"CENTRUL DE PERMANENŢĂ DE LA DISPENSARUL MEDICAL NR. 6",ROMAN,NT,1291,5,2,0,7,16,2,0,18,23,2,0,25,31,2,0,33,36,2,0,38
120879,83,"AGENŢIA PENTRU PROTECŢIA MEDIULUI",ROMAN,NT,1306,8,3,0,11,19,3,0,22,31,5,0,36,38,5,0,43,39,5,0,44
120879,84,"GRĂDINIŢA DE COPII NR. 6 CU PROGRAM NORMAL",ROMAN,NT,1620,15,0,0,15,40,0,0,40,54,0,0,54,66,3,0,69,72,3,0,75
120879,85,"LICEUL TEHNOLOGIC „VASILE SAV”",ROMAN,NT,1104,13,2,0,15,29,3,0,32,36,5,0,41,58,5,0,63,65,5,0,70
120879,86,"LICEUL TEHNOLOGIC „VASILE SAV”",ROMAN,NT,1085,6,2,0,8,21,2,0,23,27,2,0,29,39,2,0,41,42,2,0,44
120879,87,"CIRCUMSCRIPTIA SANITAR VETERINARA",ROMAN,NT,1024,5,10,0,15,10,11,0,21,16,11,0,27,22,11,0,33,25,11,0,36
120879,88,"ŞCOALA GIMNAZIALĂ ,,CAROL I”",ROMAN,NT,1454,5,2,0,7,15,3,0,18,22,4,0,26,35,5,0,40,37,6,0,43
120879,89,"ŞCOALA GIMNAZIALĂ ,,CAROL I”",ROMAN,NT,1407,9,2,0,11,21,2,0,23,32,2,0,34,51,2,0,53,51,2,0,53
120879,90,"ŞCOALA DE ARTĂ ,,SERGIU CELIBIDACHE” - CORP A",ROMAN,NT,1364,9,2,0,11,25,2,0,27,49,2,0,51,60,2,0,62,67,2,0,69
120879,91,"ŞCOALA DE ARTĂ ,,SERGIU CELIBIDACHE” - CORP A",ROMAN,NT,1402,14,2,0,16,49,2,0,51,67,4,0,71,84,4,0,88,93,4,0,97
120879,92,"ŞCOALA DE ARTĂ ,,SERGIU CELIBIDACHE” - CORP B",ROMAN,NT,1457,10,5,0,15,43,6,0,49,56,7,0,63,78,7,0,85,94,8,0,102
120879,93,"GRĂDINIŢA DE COPII NR. 4 CU PROGRAM NORMAL",ROMAN,NT,1419,15,0,0,15,43,0,0,43,68,0,0,68,85,0,0,85,92,3,0,95
120879,94,"GRĂDINIŢA DE COPII NR. 5 CU PROGRAM PRELUNGIT",ROMAN,NT,1532,20,0,0,20,60,0,0,60,90,0,0,90,110,2,0,112,114,4,0,118
120879,95,"CREŞA SMIRODAVA",ROMAN,NT,1397,15,0,0,15,38,0,0,38,59,0,0,59,77,1,1,79,80,1,1,82
120879,96,"GRĂDINIŢA DE COPII NR. 1 CU PROGRAM PRELUNGIT",ROMAN,NT,1446,16,0,0,16,33,0,0,33,45,4,0,49,54,4,0,58,58,4,0,62
120879,97,"GRĂDINIŢA DE COPII NR. 1 CU PROGRAM PRELUNGIT",ROMAN,NT,1449,13,0,0,13,35,0,0,35,62,0,0,62,83,6,0,89,84,6,0,90
120879,98,"ŞCOALA GIMNAZIALĂ ,,MIHAI EMINESCU”",ROMAN,NT,1418,19,0,0,19,54,1,0,55,78,1,0,79,99,3,0,102,105,3,0,108
120879,99,"COLEGIUL TEHNIC „MIRON COSTIN”",ROMAN,NT,1316,8,3,0,11,27,4,0,31,37,5,0,42,45,6,0,51,48,6,0,54
120879,100,"LICEUL CU PROGRAM SPORTIV",ROMAN,NT,1129,6,3,0,9,26,3,0,29,33,3,0,36,46,5,3,54,47,5,3,55
120879,101,"ŞCOALA GIMNAZIALĂ ,,VASILE ALECSANDRI” - LOCAL VECHI",ROMAN,NT,1277,19,1,0,20,54,2,0,56,72,2,0,74,93,2,0,95,96,3,0,99
120879,102,"ŞCOALA GIMNAZIALĂ ,,VASILE ALECSANDRI” - LOCAL NOU",ROMAN,NT,1478,5,5,0,10,38,6,0,44,57,6,0,63,82,6,1,89,84,7,1,92
120879,103,"CENTRUL DE ÎNGRIJIRE ŞI ASISTENŢĂ BĂTRÂNI (DISPENSAR 7)",ROMAN,NT,1782,15,5,0,20,46,7,0,53,55,7,0,62,71,7,0,78,81,7,0,88
120879,104,"DIRECŢIA DE ASISTENŢĂ SOCIALĂ ROMAN",ROMAN,NT,1104,14,1,0,15,31,2,0,33,45,2,0,47,62,4,0,66,62,4,0,66
120879,105,"LICEUL TEOLOGIC „EPISCOP MELCHISEDEC”",ROMAN,NT,1352,11,8,0,19,27,8,0,35,43,10,0,53,64,12,0,76,68,14,0,82
120879,106,"ŞCOALA GIMNAZIALĂ ,,ROMAN MUŞAT”",ROMAN,NT,1363,4,6,0,10,25,6,0,31,32,6,0,38,47,7,0,54,50,7,0,57
120879,107,"ŞCOALA GIMNAZIALĂ ,,ROMAN MUŞAT”",ROMAN,NT,1273,2,6,0,8,14,7,0,21,24,7,0,31,35,7,0,42,36,7,0,43
120879,108,"COMPLEX SERVICII SOCIALE INTEGRATE",ROMAN,NT,1450,8,2,0,10,32,3,0,35,44,6,0,50,59,6,0,65,61,9,0,70
120879,109,"GRĂDINIŢA DE COPII NR. 5 CU PROGRAM NORMAL",ROMAN,NT,1543,24,5,0,29,40,6,0,46,58,7,0,65,78,7,0,85,83,7,0,90
120879,110,"ŞCOALA GIMNAZIALĂ ,,COSTACHE NEGRI” - LOCAL NOU",ROMAN,NT,973,12,5,0,17,29,6,0,35,37,6,0,43,53,6,0,59,53,6,0,59
120879,111,"ŞCOALA GIMNAZIALĂ ,,COSTACHE NEGRI” - LOCAL NOU",ROMAN,NT,1485,12,0,0,12,23,0,0,23,41,5,0,46,55,7,0,62,58,7,0,65
120879,112,"COLEGIUL TEHNIC „PETRU PONI” - CORP A",ROMAN,NT,1249,8,1,0,9,20,2,0,22,24,27,0,51,38,30,0,68,39,32,0,71
120879,113,"COLEGIUL TEHNIC „PETRU PONI” - CORP B",ROMAN,NT,1492,18,9,0,27,52,10,0,62,75,17,0,92,102,20,0,122,109,21,0,130
120879,114,"ŞCOALA GIMNAZIALĂ „ALEXANDRU IOAN CUZA”(ŞCOALA NR. 5)",ROMAN,NT,1561,14,6,0,20,34,8,0,42,64,11,0,75,82,12,0,94,82,12,0,94
120879,115,"ŞCOALA GIMNAZIALĂ „ALEXANDRU IOAN CUZA”(ŞCOALA NR. 5)",ROMAN,NT,1334,12,1,0,13,35,2,0,37,46,2,0,48,58,2,1,61,62,7,1,70
120879,116,"ŞCOALA GIMNAZIALĂ „ALEXANDRU IOAN CUZA” CORP C(GRĂDINIŢA DE COPII NR. 3 CU PROGRAM PRELUNGIT)",ROMAN,NT,1346,9,0,0,9,23,2,0,25,33,3,0,36,42,3,0,45,46,3,0,49
120879,117,"ŞCOALA GIMNAZIALĂ „ALEXANDRU IOAN CUZA” CORP B(GRĂDINIŢA DE COPII NR. 12 CU PROGRAM NORMAL)",ROMAN,NT,1286,5,0,0,5,21,0,0,21,28,1,0,29,46,2,0,48,49,5,0,54
120879,118,"COLEGIUL TEHNIC „DANUBIANA”",ROMAN,NT,1386,11,0,0,11,25,1,0,26,34,2,0,36,43,3,0,46,43,3,0,46
120977,119,"PRIMARIA ORASULUI BICAZ",BICAZ,NT,1212,32,0,0,32,88,7,0,95,114,11,0,125,140,12,0,152,147,13,0,160
120977,120,"SCOALA GENERALA NR. 1 MARCENI",BICAZ,NT,777,26,3,0,29,57,3,0,60,75,3,0,78,85,3,0,88,87,3,0,90
120977,121,"SCOALA GENERALA NR. 1 MARCENI",BICAZ,NT,1198,28,2,0,30,60,7,0,67,94,9,0,103,114,9,0,123,123,10,0,133
120986,122,"LICEUL CAROL I",CAPŞA,NT,1074,29,5,0,34,45,5,0,50,63,9,1,73,80,9,1,90,87,10,1,98
120995,123,"SCOALA GENERALA NR.2 DODENI",DODENI,NT,978,12,2,0,14,27,3,0,30,36,7,0,43,40,8,0,48,40,8,0,48
120995,124,"SCOALA GENERALA NR.2 DODENI",DODENI,NT,1045,16,0,0,16,37,0,0,37,54,0,0,54,79,0,0,79,81,0,0,81
121000,125,"CENTRUL CULTURAL IZVORU MUNTELUI","IZVORU MUNTELUI",NT,405,3,3,0,6,9,5,0,14,12,8,0,20,12,17,0,29,12,17,0,29
121019,126,"SCOALA GENERALA NR.1 MARCENI","IZVORUL ALB",NT,129,3,3,0,6,6,3,0,9,10,3,0,13,14,3,0,17,19,3,0,22
121028,127,"SCOALA GENERALA NR.1 MARCENI",POTOCI,NT,208,2,3,0,5,4,4,0,8,4,4,0,8,11,6,0,17,11,6,0,17
121037,128,"SCOALA GENERALA NR.1 MARCENI",SECU,NT,66,0,1,0,1,0,1,0,1,1,2,0,3,1,3,0,4,1,3,0,4
124126,129,"ȘCOALA GENERALĂ ROZNOV",ROZNOV,NT,1744,21,7,0,28,42,34,0,76,64,37,0,101,86,44,4,134,90,44,4,138
124126,130,"GARA ROZNOV",ROZNOV,NT,1517,44,7,0,51,71,8,0,79,79,9,0,88,94,11,0,105,103,12,0,115
124126,131,"CĂMINUL PENTRU PERSOANE VÂRSTNICE ROZNOV",ROZNOV,NT,1344,13,6,0,19,53,10,0,63,58,10,0,68,77,11,0,88,81,11,0,92
124135,132,"ȘCOALA GENERALĂ CHINTINICI",CHINTINICI,NT,967,10,1,0,11,20,1,0,21,26,2,0,28,34,2,0,36,47,2,0,49
124144,133,"DISPENSAR MEDICAL SLOBOZIA",SLOBOZIA,NT,1435,10,0,0,10,20,1,0,21,25,1,0,26,42,1,0,43,46,1,0,47
124144,134,"ȘCOALA GENERALĂ SLOBOZIA",SLOBOZIA,NT,1351,8,0,0,8,21,1,0,22,32,1,0,33,38,3,0,41,43,7,0,50
121064,135,"SALA DE SPORT PARC CETATE","TÎRGU NEAMŢ",NT,777,15,1,0,16,31,4,0,35,52,32,0,84,70,33,0,103,74,37,0,111
121064,136,"GRĂDINIŢA CU PROGRAM PRELUNGIT NR.2","TÎRGU NEAMŢ",NT,519,15,5,0,20,24,5,0,29,33,12,0,45,38,12,0,50,38,12,0,50
121064,137,"SCOALA GIMNAZIALĂ DOMNEASCĂ ""GRIGORE GHICA VODĂ""","TÎRGU NEAMŢ",NT,1731,25,5,0,30,81,8,0,89,102,47,0,149,133,46,0,179,147,56,0,203
121064,138,"LICEUL ""VASILE CONTA""","TÎRGU NEAMŢ",NT,1686,26,4,0,30,52,6,0,58,89,9,0,98,105,12,0,117,111,12,0,123
121064,139,"COLEGIUL NAŢIONAL ""ŞTEFAN CEL MARE"", CORP B, SALA 1","TÎRGU NEAMŢ",NT,1680,17,1,0,18,53,5,0,58,76,7,0,83,96,10,0,106,102,12,0,114
121064,140,"COLEGIUL NAŢIONAL ""ŞTEFAN CEL MARE"", CORP B, SALA 2 (FOSTA SECŢIE DE LA CASA CULTURII)","TÎRGU NEAMŢ",NT,1689,21,2,0,23,63,7,0,70,103,8,0,111,129,11,0,140,135,11,0,146
121064,141,"COLEGIUL NAŢIONAL ""ŞTEFAN CEL MARE"", CORP A, SALA 1","TÎRGU NEAMŢ",NT,1911,33,4,0,37,85,5,0,90,115,6,0,121,144,11,0,155,151,14,0,165
121064,142,"CLUBUL COPIILOR","TÎRGU NEAMŢ",NT,1806,29,0,0,29,74,7,0,81,90,11,0,101,119,14,0,133,131,15,0,146
121064,143,"COLEGIUL TEHNIC ""ION CREANGĂ"", CORP B","TÎRGU NEAMŢ",NT,1824,34,6,0,40,63,9,0,72,91,11,0,102,121,12,0,133,127,12,0,139
121064,144,"CĂMINUL CULTURAL LOC.BLEBEA","TÎRGU NEAMŢ",NT,685,5,3,0,8,22,4,0,26,36,5,0,41,48,8,7,63,53,8,7,68
121064,145,"ŞCOALA GIMNAZIALĂ ""ION CREANGĂ"", CORP B, LOC. HUMULEŞTI","TÎRGU NEAMŢ",NT,1582,12,3,0,15,15,5,0,20,24,5,0,29,50,8,0,58,53,8,0,61
121064,146,"ŞCOALA GIMNAZIALĂ ""ION CREANGĂ"", CORP A, LOC. HUMULEŞTI","TÎRGU NEAMŢ",NT,1704,4,1,0,5,15,2,0,17,26,6,0,32,51,10,0,61,60,11,0,71
121064,147,"ŞCOALA GIMNAZIALĂ ""ION CREANGĂ"", CORP C, LOC. HUMULEŞTII NOI","TÎRGU NEAMŢ",NT,489,0,0,5,5,9,0,5,14,19,0,5,24,33,1,5,39,35,1,5,41
121117,148,"ŞCOALAGIMNAZIALĂ NICOLAE GRIGORESCU AGAPIA",AGAPIA,NT,1463,125,5,0,130,220,13,0,233,244,28,0,272,290,40,0,330,295,45,0,340
121126,149,"ŞCOALAGIMNAZIALĂ MIHAI EMINESCU FILIOARA",FILIOARA,NT,859,13,5,0,18,36,7,0,43,47,8,0,55,62,8,27,97,63,8,28,99
121135,150,"ŞCOALA PRIMARĂSĂCĂLUŞEŞTI",SĂCĂLUŞEŞTI,NT,535,15,3,0,18,26,6,0,32,36,7,0,43,37,8,0,45,37,8,0,45
121144,151,ŞCOALANOUĂVĂRATEC,VARATEC,NT,738,44,2,0,46,100,13,0,113,164,33,0,197,182,24,73,279,181,35,73,289
124947,152,"SEDIUL S.V.S.U.",VIIŞOARA,NT,930,4,0,0,4,26,5,0,31,39,11,26,76,54,16,26,96,58,16,26,100
124992,153,"SCOALA GIMNAZIALĂ VADURI",VADURI,NT,872,2,6,0,8,12,6,0,18,24,8,0,32,32,14,0,46,34,18,0,52
124974,154,"SCOALAGIMNAZIALĂ VADURI",BISTRIŢA,NT,1854,21,4,0,25,66,19,0,85,120,24,0,144,124,24,0,148,124,39,0,163
125007,155,"SCOALAGIMNAZIALĂ VADURI",VĂDURELE,NT,1400,15,4,0,19,27,5,0,32,35,5,0,40,47,9,0,56,57,11,0,68
121162,156,"CĂMINUL CULTURAL,LOCALITATEA BAHNA",BAHNA,NT,545,7,0,0,7,14,0,0,14,14,1,0,15,15,4,0,19,15,4,0,19
121199,157,"GRĂDINIŢĂ CU PROGRAM NORMAL,LOCALITATEA BROŞTENI",BROŞTENI,NT,394,4,3,0,7,9,7,0,16,12,8,0,20,14,8,0,22,14,8,0,22
121233,158,"FOSTA ŞCOALA CU CLASELE I-IV,LOCALITATEA ŢUŢCANII DIN VALE","ŢUŢCANII DIN VALE",NT,254,0,0,0,0,0,0,0,0,1,0,0,1,2,0,0,2,6,0,0,6
121180,159,"GRĂDINIŢA CU PROGRAM NORMAL,LOCALITATEA BĂHNIŞOARA",BĂHNIŞOARA,NT,366,4,2,0,6,4,2,0,6,9,2,0,11,13,2,0,15,13,2,0,15
121206,160,"ŞCOALA GIMNAZIALĂ,LOCALITATEA IZVOARE",IZVOARE,NT,1070,1,0,0,1,9,3,0,12,10,5,0,15,12,5,0,17,12,5,0,17
121251,161,"PRIMĂRIA COMUNEI BĂLŢĂTEŞTI",BĂLŢĂTEŞTI,NT,1726,30,24,0,54,68,43,0,111,95,65,0,160,106,70,0,176,114,71,0,185
121288,162,"ŞCOALA GIMNAZIALĂ","VALEA SEACĂ",NT,1227,9,1,0,10,19,1,0,20,38,1,0,39,45,1,0,46,47,2,0,49
121279,163,"CASA DE PRĂZNUIRE A PAROHIEI VALEA ARINI","VALEA ARINI",NT,497,6,0,0,6,8,0,0,8,8,1,0,9,9,1,0,10,12,1,0,13
121304,164,"CAMIN CULTURAL",BICAZ-CHEI,NT,1134,5,1,0,6,16,4,0,20,36,4,0,40,44,4,0,48,49,5,0,54
121304,165,"SCOALA GIMNAZIALA NR. 2",BICAZ-CHEI,NT,806,10,1,0,11,14,1,0,15,18,2,0,20,38,3,0,41,40,4,0,44
121304,166,"SCOALA GIMNAZIALA NR.1",BICAZ-CHEI,NT,1034,5,0,0,5,18,0,0,18,20,0,0,20,34,0,0,34,36,0,0,36
121331,167,"SCOALA GIMNAZIALA NR.3",IVANEŞ,NT,701,11,3,0,14,14,3,0,17,26,4,8,38,54,6,8,68,54,6,8,68
121359,168,"ȘCOALA GIMNAZIALĂ NR. 1","BICAZU ARDELEAN",NT,1374,10,1,0,11,29,1,0,30,50,1,0,51,62,2,0,64,67,2,0,69
121368,169,"ŞCOALA GIMNAZIALA NR.2",TELEC,NT,1100,8,1,0,9,14,3,0,17,22,6,0,28,34,6,0,40,36,6,0,42
121368,170,"GRĂDINIȚA CU PROGRAM NORMAL NR. 1",TELEC,NT,424,3,0,0,3,6,1,0,7,9,1,0,10,14,1,0,15,16,2,0,18
121377,171,"ȘCOALA PRIMARĂ NOUĂ TICOȘ",TICOŞ,NT,258,6,2,0,8,6,2,0,8,6,2,0,8,9,2,1,12,14,3,1,18
121395,172,"CĂMINUL CULTURAL BÎRA",BIRA,NT,645,1,0,0,1,2,0,0,2,9,1,0,10,11,1,0,12,11,1,0,12
121448,173,"GRĂDINIȚA REDIU",REDIU,NT,536,2,1,0,3,5,3,0,8,7,3,0,10,10,6,0,16,13,6,0,19
121448,174,"SCOALA PRIMARA NR.2 REDIU",REDIU,NT,228,3,4,0,7,5,4,0,9,10,6,0,16,10,6,0,16,12,6,0,18
121420,175,"CLADIRE FOSTA SCOALA PRIMARA",NEGREŞTI,NT,159,4,4,0,8,8,4,0,12,14,4,0,18,15,4,0,19,15,4,0,19
121475,176,"PRIMĂRIA BÎRGĂUANI",BÎRGAUANI,NT,463,5,0,0,5,12,0,0,12,16,0,0,16,17,3,0,20,17,3,0,20
121475,177,"FOSTA GRĂDINIȚĂ DE COPII BÎRGĂUANI DEAL",BÎRGAUANI,NT,492,5,1,0,6,9,1,0,10,12,2,0,14,18,3,0,21,21,5,0,26
121518,178,"FOSTA ȘCOALĂ PRIMARĂ BREAZA",BREAZA,NT,176,0,0,0,0,1,0,0,1,2,1,0,3,6,2,0,8,8,2,0,10
121527,179,"FOSTA ȘCOALĂ PRIMARĂ CERTIENI",CERTIENI,NT,178,0,4,0,4,3,5,0,8,3,5,0,8,5,9,0,14,11,10,0,21
121563,180,"CĂMINUL CULTURAL HÎRTOP",HÎRTOP,NT,193,3,5,0,8,10,5,0,15,13,6,0,19,21,7,0,28,22,7,0,29
121509,181,"ȘCOALA PRIMARĂ BĂLĂNEȘTI",BĂLĂNEŞTI,NT,540,5,0,0,5,12,0,0,12,19,2,0,21,24,4,0,28,27,4,0,31
121581,182,"ȘCOALA PRIMARĂ TALPA",TALPA,NT,569,18,7,0,25,26,11,0,37,35,12,0,47,50,12,0,62,61,12,0,73
121590,183,"FOSTA ȘCOALĂ PRIMARĂ VLĂDICENI",VLĂDICENI,NT,487,18,5,0,23,25,9,0,34,32,13,0,45,38,17,0,55,41,17,0,58
121616,184,"ŞCOALA CU CLASELE I-IV",BODEŞTI,NT,902,4,4,0,8,9,5,0,14,13,5,0,18,21,5,0,26,29,5,0,34
121616,185,"ŞCOALA CU CLASELE I-IV",BODEŞTI,NT,888,8,2,0,10,24,4,0,28,29,4,0,33,38,4,0,42,43,4,0,47
121634,186,ŞCOALA,CORNI,NT,121,8,14,0,22,11,16,0,27,16,16,0,32,16,17,1,34,16,18,1,35
121643,187,ŞCOALA,OŞLOBENI,NT,774,8,0,0,8,15,0,0,15,17,0,0,17,23,1,0,24,25,1,0,26
121625,188,"GRĂDINIŢĂ - (CĂTUNĂ)","BODEŞTII DE JOS",NT,515,3,0,0,3,6,0,0,6,10,0,0,10,12,1,0,13,16,1,0,17
121625,189,"ŞCOALA CU CLASELE I-VIII","BODEŞTII DE JOS",NT,745,6,2,0,8,11,3,0,14,20,5,0,25,26,5,0,31,28,5,0,33
121402,190,"ȘCOALA GIMNAZIALĂ BOGHICEA",BOGHICEA,NT,1005,12,0,0,12,22,1,0,23,27,1,0,28,30,3,0,33,33,3,0,36
121457,191,"ȘCOALA GIMNAZIALĂ SLOBOZIA",SLOBOZIA,NT,595,11,4,0,15,20,5,0,25,22,6,0,28,28,6,0,34,29,7,0,36
121411,192,"ȘCOALA PRIMARĂ CĂUȘENI",CĂUŞENI,NT,137,1,1,0,2,6,1,0,7,10,3,0,13,11,4,0,15,11,8,0,19
121439,193,"ȘCOALA PRIMARĂ NISTRIA",NISTRIA,NT,207,4,4,0,8,7,4,0,11,8,5,0,13,14,5,0,19,14,5,0,19
121661,194,"LICEUL ,,MIHAIL SADOVEANU""(CORPUL B)",BORCA,NT,882,6,2,0,8,17,7,0,24,26,9,0,35,57,11,10,78,57,11,10,78
121689,195,"SALA DE FESTIVITĂŢI MADEI",MĂDEI,NT,907,8,2,0,10,12,2,0,14,18,6,0,24,24,6,3,33,25,6,3,34
121698,196,"ŞCOALA PRIMARĂ NR.3 LOCALITATEAPÎRÎUL CÎRJEI","PÎRÎUL CÎRJEI",NT,596,5,0,0,5,8,0,0,8,12,1,0,13,17,5,0,22,25,5,0,30
121714,197,"GRĂDINIŢA CU PROGRAM NORMAL - BORCA CENTRU",SABASA,NT,784,5,3,0,8,17,5,0,22,30,6,0,36,34,6,0,40,40,6,0,46
121714,198,"CĂMIN CULTURAL SABASA",SABASA,NT,939,14,1,0,15,25,2,0,27,45,5,0,50,54,5,0,59,62,7,0,69
121705,199,"ŞCOALA PRIMARĂ NR.2 LOCALITATEA PÎRÎULPÎNTEI","PÎRÎUL PÎNTEI",NT,429,6,5,0,11,13,5,0,18,21,5,0,26,21,6,12,39,21,6,12,39
121723,200,"ŞCOALA PRIMARĂ NR.1 LOCALITATEA SOCI",SOCI,NT,726,11,1,0,12,17,6,0,23,30,6,0,36,45,8,0,53,56,8,0,64
121741,201,"SCOALA GIMNAZIALĂ BORLEŞTI",BORLEŞTI,NT,1544,9,0,0,9,26,0,0,26,36,1,0,37,44,1,0,45,44,1,0,45
121741,202,"GRĂDINIŢA BORLEŞTI II",BORLEŞTI,NT,788,10,1,1,12,45,1,1,47,54,5,1,60,63,9,1,73,67,9,1,77
121769,203,"ŞCOALA GIMNAZIALĂ ""ŞTEFAN CEL MARE""",MASTACĂN,NT,1545,8,0,0,8,22,1,0,23,33,1,0,34,43,1,0,44,44,3,0,47
121778,204,"ŞCOALA GIMNAZIALA ""GRIGORE TEODORESCU""",RUSENI,NT,1808,11,1,0,12,22,5,0,27,46,7,0,53,60,7,0,67,65,7,0,72
121778,205,"ŞCOALA GIMNAZIALĂ ""IOAN GRIGORE TEODORESCU""",RUSENI,NT,1277,19,6,0,25,25,6,0,31,32,9,0,41,37,9,0,46,39,9,0,48
121787,206,GRĂDINIŢA,ŞOVOAIA,NT,423,3,2,0,5,4,2,0,6,11,4,0,15,12,4,0,16,12,7,0,19
121750,207,GRĂDINIŢA,NECHIT,NT,238,9,2,0,11,19,20,0,39,23,23,0,46,27,23,0,50,29,23,0,52
121803,208,"ŞCOALA CU CLASELEI-IV",BOTEŞTI,NT,353,9,2,0,11,15,3,0,18,16,6,0,22,17,6,0,23,18,6,0,24
121858,209,"LICEUL TEHNOLOGIC",NISIPOREŞTI,NT,979,5,1,0,6,6,4,0,10,11,4,0,15,15,4,0,19,15,5,0,20
121858,210,"LICEUL TEHNOLOGIC",NISIPOREŞTI,NT,1060,8,0,0,8,12,0,0,12,13,0,0,13,17,1,0,18,19,2,0,21
121812,211,"SCOALA CU CLASELE I-VII",BARTICEŞTI,NT,1752,21,4,0,25,36,5,0,41,42,5,0,47,47,6,0,53,52,6,0,58
121885,212,"ȘCOALA GIMNAZIALĂ BOZIENI (ȘCOALA GENERALĂ BOZIENI)",BOZIENI,NT,926,4,0,0,4,8,0,0,8,10,0,0,10,13,0,0,13,13,0,0,13
121910,213,"ȘCOALA GIMNAZIALĂ BOZIENI - ȘCOALA PRIMARĂ CUCI (ŞCOALA GENERALĂ BOZIENI)",CUCI,NT,683,5,1,0,6,6,1,0,7,7,3,0,10,10,3,0,13,10,3,0,13
121929,214,"ȘCOALA GIMNAZIALĂ BOZIENI - ȘCOALA PRIMARĂ IUCȘA (ŞCOALA GENERALĂ BOZIENI)",IUCŞA,NT,632,1,0,0,1,2,0,0,2,2,0,0,2,4,0,0,4,4,0,0,4
121947,215,"ŞCOALA GIMNAZIALĂ „IEREMIA IRIMESCU” BRUSTURI",BRUSTURI,NT,1556,12,3,0,15,32,3,0,35,49,9,0,58,60,13,20,93,75,14,20,109
121965,216,"GRADINITA CU PROGRAM NORMAL GROSI",GROŞI,NT,391,2,1,0,3,7,1,0,8,8,1,0,9,10,2,0,12,11,2,0,13
121983,217,"GRADINITA CU PROGRAM NORMAL POIANA",POIANA,NT,652,3,2,0,5,15,3,0,18,21,3,0,24,30,3,0,33,37,3,0,40
122016,218,"ŞCOALA GIMNAZIALĂ „GRIGORE STURZU” TIRZIA",TÎRZIA,NT,620,2,4,0,6,7,5,0,12,12,7,0,19,14,7,0,21,14,7,0,21
122043,219,"CĂMIN CULTURAL",BISTRICIOARA,NT,608,5,5,0,10,11,6,0,17,15,8,0,23,24,8,0,32,25,8,0,33
122034,220,"ŞCOALA GRIGORE UNGUREANU",CEAHLĂU,NT,1430,50,7,0,57,81,15,0,96,91,18,0,109,108,25,0,133,116,25,45,186
122070,221,"ȘCOALA GIMNAZIALĂ",CÎNDESTI,NT,1321,15,2,0,17,23,2,0,25,24,2,0,26,31,3,0,34,31,3,0,34
122123,222,"GRĂDINIȚA CU PROGRAM NORMAL",VĂDURELE,NT,1054,2,0,0,2,8,0,0,8,11,0,0,11,13,1,0,14,17,6,0,23
122089,223,"GRĂDINIȚA CU PROGRAM NORMAL",BĂRCĂNEŞTI,NT,704,4,5,0,9,9,5,0,14,13,6,0,19,30,7,0,37,31,7,0,38
122105,224,"ȘCOALA PRIMARĂ",PĂDURENI,NT,317,13,1,0,14,25,4,0,29,26,4,0,30,27,4,0,31,27,4,0,31
120897,225,"ȘCOALA GIMNAZIALĂ NR. 1 - GRĂDINIŢA CU PROGRAM PRELUNGIT CORDUN",CORDUN,NT,1309,1,2,0,3,10,3,0,13,19,4,0,23,23,6,0,29,23,6,0,29
120897,226,"ȘCOALA GIMNAZIALĂ NR. 1 - GRĂDINIŢA CU PROGRAM PRELUNGIT CORDUN",CORDUN,NT,1031,6,1,0,7,15,1,0,16,25,4,0,29,32,6,0,38,35,6,0,41
120913,227,"ȘCOALA GIMNAZIALĂ NR.1 - GRĂDINIȚA SIMIONEŞTI",SIMIONEŞTI,NT,720,10,1,0,11,20,1,0,21,33,3,0,36,40,5,0,45,42,6,0,48
120904,228,"ŞCOALA GIMNAZIALĂ NR.1 PILDEŞTI",PILDEŞTI,NT,1744,0,0,0,0,6,1,0,7,10,1,0,11,18,1,0,19,20,1,0,21
120904,229,"ȘCOALA GIMNAZIALĂ NR. 1 PILDEŞTI",PILDEŞTI,NT,1740,5,0,0,5,11,3,0,14,18,5,0,23,24,5,0,29,28,5,0,33
122141,230,"ŞCOALA GIMNAZIALA SAT COSTISA",COSTIŞA,NT,1430,43,6,0,49,90,9,0,99,123,13,0,136,125,15,0,140,129,15,0,144
122178,231,ŞCOALAPRIMARASATMANOAIA,MĂNOAIA,NT,771,8,2,0,10,26,5,0,31,32,5,0,37,40,8,0,48,43,8,0,51
122169,232,ŞCOALAPRIMARASATFRUNZENI,FRUNZENI,NT,541,11,1,0,12,37,4,0,41,48,4,0,52,61,5,0,66,65,8,0,73
122150,233,CLADIREŞCOALĂ,DORNEŞTI,NT,214,10,5,0,15,45,10,0,55,59,12,0,71,71,13,8,92,75,13,8,96
122196,234,"ŞCOALA GIMNAZIALĂ ""GHEORGHE SĂVINESCU""",CRĂCĂOANI,NT,898,15,2,0,17,24,7,0,31,25,8,0,33,32,13,0,45,32,14,0,46
122196,235,"ŞCOALA GIMNAZIALĂ ""GHEORGHE SĂVINESCU""",CRĂCĂOANI,NT,919,7,0,0,7,26,2,0,28,29,4,0,33,36,7,0,43,36,7,0,43
122212,236,"ŞCOALA GENERALĂ",MAGAZIA,NT,551,10,4,0,14,16,5,0,21,18,5,0,23,21,7,0,28,25,7,0,32
122203,237,"ŞCOALA GENERALĂ","CRACĂUL NEGRU",NT,884,10,0,0,10,15,1,0,16,20,3,0,23,25,3,0,28,28,4,0,32
122221,238,"ŞCOALA GENERALĂ","MITOCU BĂLAN",NT,260,7,2,0,9,8,4,0,12,10,5,0,15,20,6,0,26,21,6,0,27
122267,239,"SCOALA GENERALA",HUISUREZ,NT,632,15,1,0,16,35,2,0,37,46,8,10,64,70,8,10,88,79,8,10,97
122258,240,"CAMINUL CULTURAL DAMUC",DĂMUC,NT,1304,82,7,0,89,137,12,0,149,175,14,0,189,196,19,22,237,213,19,22,254
122258,241,"ŞCOALA GENERALĂ",DĂMUC,NT,494,7,2,0,9,8,2,0,10,16,4,0,20,18,8,0,26,24,8,0,32
122294,242,"CĂMINUL CULTURAL DOBRENI",DOBRENI,NT,1482,23,0,0,23,40,3,0,43,54,7,0,61,65,14,0,79,68,16,0,84
122720,243,"CĂMINUL CULTURAL",BĂLUŞEŞTI,NT,105,4,2,0,6,4,2,0,6,7,2,0,9,11,5,0,16,11,6,0,17
122766,244,"ŞCOALA GIMNAZIALĂ NR.1",DOCHIA,NT,802,5,2,0,7,13,2,0,15,19,3,0,22,28,5,0,33,35,5,0,40
122766,245,"ŞCOALA GIMNAZIALĂ NR.1",DOCHIA,NT,1100,9,1,0,10,22,1,0,23,27,4,0,31,37,7,0,44,42,7,0,49
122356,246,"ŞCOALA GIMNAZIALĂNR.1 DOLJEŞTI",DOLJEŞTI,NT,1012,4,0,0,4,16,1,0,17,20,3,0,23,25,3,0,28,30,3,0,33
122383,247,"ŞCOALA GIMNAZIALĂNR.2 ROTUNDA",ROTUNDA,NT,1325,14,1,0,15,52,9,0,61,62,9,0,71,80,16,0,96,89,16,0,105
122365,248,"ŞCOALA PRIMARĂNR.1 BUHONCA",BUHONCA,NT,563,6,1,0,7,6,1,0,7,7,1,0,8,11,1,0,12,11,1,0,12
122374,249,"ŞCOALA GIMNAZIALĂ ,,GHEORGHE PATRAŞCU"" BURUIENEŞTI, CORP B",BURUIENEŞTI,NT,1602,4,1,0,5,6,2,0,8,10,2,0,12,14,3,0,17,16,5,0,21
122374,250,"ŞCOALA GIMNAZIALĂ ,,GHEORGHE PATRAŞCU"" BURUIENESTI, CORP C",BURUIENEŞTI,NT,1480,7,0,0,7,16,0,0,16,19,2,0,21,21,2,0,23,22,2,0,24
122454,251,"GRĂDINIŢA CU PROGRAM NORMAL VAD",VAD,NT,698,5,1,0,6,16,4,0,20,24,8,0,32,32,9,0,41,44,11,0,55
122418,252,"SCOALA GENERALA",BORNIŞ,NT,101,2,0,0,2,4,6,0,10,5,6,0,11,6,10,0,16,6,10,0,16
122436,253,"SCOALA GENERALA",MASTACĂN,NT,161,1,8,0,9,2,9,0,11,4,9,5,18,4,9,5,18,5,11,5,21
122445,254,"SCOALA GENERALA",UNGHI,NT,94,2,1,0,3,2,5,0,7,2,5,0,7,2,5,0,7,5,5,0,10
122427,255,"ŞCOALA PRIMARĂ HLĂPEŞTI",HLĂPEŞTI,NT,676,1,0,0,1,6,0,0,6,7,1,0,8,14,1,0,15,15,1,0,16
121956,256,"SCOALA GIMNAZIALA",DRĂGĂNEŞTI,NT,579,3,3,0,6,5,4,0,9,6,5,0,11,13,5,0,18,14,6,0,20
121974,257,"SCOALA PRIMARA",ORŢĂŞTI,NT,278,4,3,0,7,12,3,0,15,14,3,0,17,18,3,0,21,18,3,0,21
122007,258,"SCOALA PRIMARA",ŞOIMĂREŞTI,NT,379,5,0,0,5,8,3,0,11,15,3,0,18,17,4,0,21,20,4,0,24
122515,259,"ŞCOALA CORHANA",CORHANA,NT,509,7,2,0,9,8,4,0,12,12,4,0,16,16,4,0,20,19,4,0,23
122506,260,"ŞCOALA CÎRLIG",CÂRLIG,NT,473,5,0,0,5,11,1,0,12,11,1,0,12,15,2,0,17,15,2,0,17
122533,261,"ŞCOALA ROŞIORI",ROŞIORI,NT,268,2,0,0,2,5,3,0,8,5,3,0,8,8,9,0,17,10,10,0,20
122472,262,"ŞCOALA GIMNAZIALADULCESTI",DULCEŞTI,NT,915,8,0,0,8,13,0,0,13,21,0,0,21,25,0,0,25,28,0,0,28
120799,263,"SCOALA GIMNAZIALA NR 4 BRASAUTI",BRĂŞĂUŢI,NT,587,5,0,0,5,7,1,0,8,12,1,0,13,18,1,0,19,20,1,0,21
120780,264,"SCOALA GIMNAZIALA NR. 1 DUMBRAVA ROSIE","DUMBRAVA ROŞIE",NT,1440,12,1,0,13,38,3,0,41,46,4,0,50,56,8,0,64,59,8,0,67
120780,265,"SCOALA GIMNAZIALA NR. 1 DUMBRAVA ROSIE","DUMBRAVA ROŞIE",NT,1727,11,1,0,12,18,2,0,20,31,2,0,33,39,2,0,41,50,3,0,53
120815,266,"SCOALA GIMNAZIALA NR. 2 IZVOARE",IZVOARE,NT,1025,3,1,0,4,7,2,0,9,12,3,0,15,16,4,0,20,18,4,0,22
120806,267,"SCOALA GIMNAZIALA NR. 3 CUT",CUT,NT,1019,8,1,0,9,17,2,0,19,26,2,0,28,34,2,0,36,38,3,0,41
120806,268,"SCOALA GIMNAZIALA NR 3 CUT",CUT,NT,1153,7,0,0,7,13,1,0,14,20,4,0,24,25,6,0,31,28,6,0,34
122560,269,"ŞCOALA GIMNAZIALA "" IOAN LUCA "" FARCASA",FARCAŞA,NT,1145,8,3,0,11,32,4,0,36,48,7,7,62,59,9,7,75,65,9,7,81
122588,270,"CĂMINUL CULTURAL",FRUMOSU,NT,766,13,1,0,14,31,2,11,44,53,7,12,72,81,14,19,114,104,19,19,142
122604,271,"CĂMINUL CULTURAL",STEJARU,NT,637,31,7,0,38,51,9,0,60,75,9,2,86,98,9,2,109,105,9,2,116
122631,272,"SCOALA PRIMARA BUDESTI",BUDEŞTI,NT,865,3,0,0,3,6,2,0,8,9,3,0,12,11,4,0,15,13,5,0,18
122622,273,"SCOALA GIMNAZIALA, COMUNA FAUREI",FĂUREI,NT,623,0,0,0,0,10,1,0,11,11,4,0,15,15,4,0,19,15,4,0,19
122640,274,"BIBLIOTECA COMUNALA FAUREI",CLIMEŞTI,NT,231,2,3,0,5,5,3,0,8,6,4,0,10,7,5,0,12,7,5,0,12
124171,275,"SCOALA GIMNAZIALA GADINTI (CORP 1)",GÂDINŢI,NT,1029,4,0,0,4,11,0,0,11,14,0,4,18,17,0,4,21,19,0,4,23
124171,276,"SCOALA GIMNAZIALA GADINTI (CORP 2)",GÂDINŢI,NT,1026,6,0,0,6,13,1,0,14,24,1,1,26,32,3,1,36,36,3,1,40
122677,277,"SCOALA GIMNAZIALA, COMUNA GHERAESTI",GHERĂEŞTI,NT,1429,8,1,0,9,15,1,0,16,32,1,0,33,35,1,0,36,43,1,0,44
122677,278,"SCOALA GIMNAZIALA, COMUNA GHERAESTI",GHERĂEŞTI,NT,1351,7,2,0,9,13,2,0,15,15,2,0,17,22,3,0,25,26,3,0,29
122677,279,"SCOALA GIMNAZIALA, COMUNA GHERAESTI",GHERĂEŞTI,NT,1437,6,1,0,7,9,1,0,10,12,4,0,16,20,4,0,24,23,5,0,28
122686,280,"SCOALA PRIMARA, GHERAESTII NOI","GHERĂEŞTII NOI",NT,489,5,0,0,5,6,0,0,6,6,0,0,6,11,0,0,11,12,1,0,13
122695,281,"SCOALA PRIMARA, TETCANI",TEŢCANI,NT,741,3,0,0,3,5,5,0,10,11,5,0,16,19,6,0,25,22,7,0,29
121260,282,"CLĂDIREA ""SALA DE NUNŢI""",GHINDĂOANI,NT,1652,26,1,0,27,57,2,0,59,75,4,1,80,81,4,1,86,88,4,1,93
122711,283,"SCOALA GIMNAZIALA ""PROF. GHEORGHE DUMITREASA"" GIROV",GIROV,NT,1401,14,1,0,15,37,3,0,40,51,3,0,54,58,4,0,62,59,4,0,63
122748,284,"SCOALA GIMNAZIALA NR. 1 CACIULESTI",CĂCIULEŞTI,NT,578,7,2,0,9,11,2,0,13,15,4,0,19,19,6,0,25,21,6,0,27
122784,285,"SCOALA PRIMARA GURA VAII","GURA VĂII",NT,630,1,0,0,1,7,2,0,9,12,2,0,14,17,4,0,21,18,4,0,22
122800,286,"PENSIUNEA ELENA",TURTUREŞTI,NT,504,8,2,0,10,21,4,0,25,33,4,0,37,45,8,0,53,47,11,0,58
122739,287,"SCOALA BOTESTI",BOŢEŞTI,NT,423,2,0,0,2,3,0,0,3,5,0,0,5,10,1,0,11,11,3,0,14
122775,288,"SCOALA DOINA",DOINA,NT,237,0,0,0,0,2,3,0,5,5,5,0,10,8,5,0,13,9,5,0,14
122757,289,"SCOALA DANESTI",DĂNEŞTI,NT,246,2,0,0,2,2,0,0,2,3,0,0,3,6,2,0,8,9,2,0,11
122819,290,"SCOALA VERSESTI",VERŞEŞTI,NT,261,2,4,0,6,7,11,0,18,15,11,0,26,18,12,0,30,19,13,0,32
122837,291,"ŞCOALA GIMNAZIALĂ ""EPISCOP MELCHISEDEC ŞTEFĂNESCU"", CORP A",GÎRCINA,NT,1191,5,1,0,6,11,2,0,13,15,2,0,17,17,2,0,19,17,2,0,19
122846,292,"ŞCOALA ALMAŞ",ALMAŞ,NT,560,5,0,0,5,12,0,0,12,18,3,0,21,23,3,0,26,27,3,0,30
122855,293,"ŞCOALA GIMNAZIALĂ ""EPISCOP MELCHISEDEC ŞTEFĂNESCU""",CUEJDIU,NT,1051,2,0,0,2,3,2,0,5,4,2,0,6,18,2,0,20,21,2,0,23
122837,294,"ŞCOALA GIMNAZIALĂ ""EPISCOP MELCHISEDEC ŞTEFĂNESCU""",GÎRCINA,NT,1112,5,0,0,5,12,2,0,14,13,2,0,15,18,2,0,20,21,7,0,28
122873,295,"CĂMINUL CULTURAL",GRINŢIEŞ,NT,1380,16,1,0,17,41,2,0,43,48,2,0,50,62,5,0,67,63,6,0,69
122882,296,"SALA DE FESTIVITĂŢI",BRADU,NT,673,6,0,0,6,12,0,0,12,18,1,0,19,31,2,0,33,38,2,0,40
122944,297,SCOALA,TOPOLIŢA,NT,1369,5,3,0,8,10,4,0,14,21,4,0,25,27,6,0,33,31,6,0,37
122926,298,"SCOALA PRIMARA",CURECHIŞTEA,NT,599,9,7,0,16,22,23,0,45,49,35,0,84,55,35,0,90,56,35,0,91
122917,299,GRADINITA,GRUMĂZEŞTI,NT,1449,10,1,0,11,17,2,0,19,29,2,0,31,36,3,0,39,36,5,0,41
122917,300,GRADINITA,GRUMĂZEŞTI,NT,988,6,0,0,6,14,1,0,15,18,1,0,19,23,3,0,26,23,3,0,26
122971,301,"ŞCOALA GIMNAZIALĂ BUHALNIŢA",BUHALNIŢA,NT,700,19,1,0,20,39,3,0,42,49,6,0,55,68,6,5,79,73,7,5,85
122962,302,"ŞCOALA GIMNAZIALĂ,COMUNA HANGU",HANGU,NT,985,10,8,0,18,27,10,0,37,48,12,13,73,74,12,13,99,102,12,13,127
122962,303,"ŞCOALA PRIMARĂ BOBOTENI",HANGU,NT,485,9,3,0,12,21,3,0,24,31,4,0,35,31,4,0,35,31,6,0,37
122980,304,"ŞCOALA PRIMARĂ CHIRIŢENI",CHIRIŢENI,NT,407,1,1,0,2,6,2,0,8,12,4,0,16,21,5,5,31,22,5,5,32
122999,305,"ŞCOALA PRIMARĂ GROZĂVEŞTI",GROZĂVEŞTI,NT,356,3,2,0,5,4,2,0,6,5,2,0,7,8,3,0,11,11,4,0,15
123004,306,"ŞCOALA PRIMARĂ RUGINEŞTI",RUGINEŞTI,NT,301,1,0,0,1,4,0,0,4,6,1,0,7,10,1,6,17,11,1,6,18
120931,307,"SCOALA GIMNAZIALA ''CARMEN SYLVA''",HORIA,NT,1687,13,1,0,14,25,6,0,31,36,6,0,42,42,7,0,49,47,7,0,54
120931,308,CAMINCULTURAL,HORIA,NT,1677,6,0,0,6,10,0,0,10,14,0,0,14,20,0,0,20,22,0,0,22
120940,309,"SCOALAGIMNAZIALA '' OTILIACAZIMIR '' COTU VAMES","COTU VAMEŞ",NT,1416,8,1,0,9,16,1,0,17,28,1,0,29,33,4,0,37,38,5,0,43
120940,310,"GRADINITA DE COPII","COTU VAMEŞ",NT,1331,5,3,0,8,12,5,0,17,19,5,0,24,24,5,0,29,30,8,0,38
123022,311,"SCOALA GIMNAZIALA ICUSESTI",ICUŞEŞTI,NT,611,4,1,0,5,5,6,0,11,10,6,0,16,14,7,0,21,14,7,0,21
123031,312,"SCOALA GIMNAZIALA BALUSESTI",BĂLUŞEŞTI,NT,992,5,3,0,8,8,4,0,12,11,4,0,15,26,4,0,30,26,4,0,30
123031,313,"SCOALA GIMNAZIALA BALUSESTI",BĂLUŞEŞTI,NT,980,6,0,0,6,9,0,0,9,11,2,0,13,16,3,0,19,19,3,0,22
123077,314,"SCOALA PRIMARA ROCNA",ROCNA,NT,453,0,0,0,0,4,1,0,5,4,4,0,8,4,4,0,8,4,4,0,8
123068,315,"SCOALA PRIMARA MESTEACAN",MESTEACĂN,NT,435,9,6,0,15,17,6,0,23,29,12,0,41,33,12,0,45,37,12,0,49
123086,316,"SCOALA PRIMARA SPIRIDONESTI",SPIRIDONEŞTI,NT,190,2,3,0,5,3,5,0,8,4,6,0,10,5,7,0,12,5,7,0,12
123139,317,ŞCOALA,IZVORU,NT,376,3,0,0,3,6,4,0,10,11,4,0,15,11,4,0,15,11,4,0,15
123157,318,ŞCOALA,RECEA,NT,663,9,5,0,14,28,5,0,33,38,7,0,45,42,9,0,51,42,9,0,51
123166,319,"CĂMIN CULTURAL",STEJARU,NT,667,3,0,0,3,16,2,0,18,25,4,0,29,26,4,0,30,27,4,0,31
123111,320,CAMINCULTURAL,"ION CREANGĂ",NT,970,4,1,0,5,6,2,0,8,10,3,0,13,11,3,0,14,13,3,0,16
123111,321,CAMINCULTURAL,"ION CREANGĂ",NT,1181,7,0,0,7,12,1,0,13,16,2,0,18,23,2,0,25,23,2,0,25
123120,322,CAMINCULTURAL,AVEREŞTI,NT,781,2,0,0,2,8,2,0,10,11,3,0,14,17,3,0,20,18,4,0,22
123184,323,"ŞCOALA GENERALĂ",MĂRGINENI,NT,862,10,0,0,10,18,2,0,20,23,2,0,25,30,2,0,32,31,3,0,34
123184,324,GRĂDINIŢA,MĂRGINENI,NT,955,5,0,0,5,13,0,0,13,22,0,0,22,28,1,0,29,28,2,0,30
123193,325,"SCOALA GENERALA",HÎRŢEŞTI,NT,184,0,6,0,6,2,8,0,10,6,8,0,14,10,9,0,19,10,9,0,19
123200,326,"ŞCOALA GENERALĂ",HOISEŞTI,NT,790,7,2,0,9,14,2,0,16,16,3,0,19,21,4,0,25,21,4,0,25
123219,327,"ŞCOALA GENERALĂ",ITRINEŞTI,NT,232,6,2,1,9,8,2,1,11,9,2,1,12,12,2,1,15,15,2,1,18
123237,328,"SCOALA GIMNAZIALA SATUL MOLDOVENI",MOLDOVENI,NT,1039,2,2,0,4,10,2,0,12,18,5,0,23,24,8,0,32,24,8,0,32
123246,329,"FOSTA SCOALA CU CLASELE I-IV SATUL HOCIUNGI",HOCIUNGI,NT,716,3,3,0,6,8,3,0,11,10,4,0,14,15,4,0,19,15,4,0,19
122310,330,"SCOALA GIMNAZIALA ""DUMITRU ALMAS"" NEGRESTI",NEGREŞTI,NT,1207,10,0,0,10,27,2,0,29,30,5,0,35,39,5,0,44,44,5,0,49
122329,331,"GRADINITA CU PROGRAM NORMAL POIANA",POIANA,NT,322,2,2,0,4,9,2,0,11,16,2,0,18,19,3,0,22,19,3,0,22
123264,332,"ŞCOALA GENERALĂ",ONICENI,NT,646,0,1,0,1,5,3,0,8,5,3,0,8,12,5,0,17,13,5,0,18
123282,333,"ŞCOALA GENERALĂ",GORUN,NT,226,4,4,0,8,9,4,0,13,13,4,0,17,16,4,0,20,24,5,0,29
123317,334,"ŞCOALA GENERALĂ",MĂRMURENI,NT,351,4,2,0,6,5,2,0,7,10,3,0,13,15,3,0,18,16,4,0,20
123353,335,"ŞCOALA GENERALĂ",SOLCA,NT,984,1,0,0,1,5,0,0,5,10,0,0,10,29,0,0,29,31,0,0,31
123362,336,"ŞCOALA GENERALĂ","VALEA ENEI",NT,297,0,1,0,1,1,1,0,2,4,2,0,6,9,4,0,13,12,6,0,18
123380,337,"ŞCOALAGIMNAZIALA, COMUNAPASTRAVENI",PĂSTRĂVENI,NT,727,7,6,0,13,10,11,0,21,15,11,0,26,22,11,0,33,25,11,0,36
123380,338,"CENTRU DE RECUPERARE SI REABILITARE A PERSOANELOR CU HANDICAP",PĂSTRĂVENI,NT,719,9,2,0,11,16,2,0,18,22,2,0,24,26,3,0,29,26,3,0,29
123406,339,"SCOALAGIMNAZIALANR. 1 RADENI",RĂDENI,NT,785,10,1,0,11,26,1,0,27,35,3,0,38,51,7,0,58,52,7,0,59
123406,340,"SCOALAPRIMARA NR. 2 RADENI",RĂDENI,NT,579,3,6,0,9,7,6,0,13,8,6,0,14,20,7,0,27,23,7,0,30
123399,341,"SCOALAPRIMARA LUNCA MOLDOVEI","LUNCA MOLDOVEI",NT,252,2,2,0,4,9,2,0,11,16,2,0,18,18,2,0,20,20,4,0,24
123763,342,"ŞCOALA GIMNAZIALA ,,VLAD DANULESCU '' PANCESTI",PÂNCEŞTI,NT,978,4,0,0,4,9,0,0,9,12,3,0,15,14,3,0,17,14,3,0,17
123736,343,"ŞCOALA PRIMARA CIUREA",CIUREA,NT,201,3,3,0,6,5,3,0,8,8,4,0,12,8,4,0,12,8,4,0,12
123433,344,"LICEUL TEHNOLOGIC",PETRICANI,NT,1443,7,0,0,7,12,5,0,17,19,7,0,26,27,8,0,35,29,8,0,37
123442,345,"SCOALA GENERALA",BOIŞTEA,NT,749,4,2,0,6,14,3,0,17,32,4,0,36,47,5,0,52,48,5,0,53
123451,346,"SCOALA GENERALA",TÎRPEŞTI,NT,1140,7,4,0,11,18,5,0,23,19,5,0,24,22,6,0,28,30,6,0,36
123460,347,"SCOALA GENERALA",ŢOLICI,NT,1351,2,0,0,2,38,2,0,40,65,5,0,70,104,6,0,110,118,6,0,124
123497,348,"SCOALA GIMNAZIALA LUMINIS,COMUNA PIATRA SOIMULUI",LUMINIŞ,NT,1144,9,1,0,10,15,3,0,18,25,3,0,28,39,9,5,53,41,11,5,57
123512,349,"SCOALA GIMNAZIALA POIENI,COMUNA PIATRA SOIMULUI",POIENI,NT,1095,3,1,0,4,7,1,0,8,9,1,0,10,14,1,0,15,14,1,0,15
123497,350,"ŞCOALA GIMNAZIALA LUMINIS,COMUNA PIATRA SOIMULUI",LUMINIŞ,NT,1014,11,0,0,11,21,0,0,21,28,0,0,28,36,0,6,42,36,0,6,42
123503,351,"GRADINITA CU PROGRAM NORMAL NEGULESTI,COMUNA PIATRA SOIMULUI",NEGULEŞTI,NT,571,3,2,0,5,12,3,0,15,16,3,0,19,17,3,0,20,19,3,0,22
123488,352,"SCOALA GIMNAZIALA,COMUNA PIATRA SOIMULUI","PIATRA ŞOIMULUI",NT,1595,5,3,0,8,20,5,0,25,30,6,0,36,39,6,0,45,43,6,0,49
123488,353,"ŞCOALA PRIMARA,COMUNA PIATRA SOIMULUI","PIATRA ŞOIMULUI",NT,1481,6,0,0,6,18,0,0,18,20,0,0,20,24,0,0,24,25,0,0,25
123558,354,"LICEUL TEHNOLOGIC ""ION CREANGA"" PIPIRIG",DOLHEŞTI,NT,1458,7,0,0,7,13,4,0,17,22,10,1,33,31,11,1,43,32,11,1,44
123530,355,"SCOALA PIPIRIG NR. 2",PIPIRIG,NT,895,7,0,0,7,31,2,0,33,44,5,0,49,57,8,0,65,66,8,0,74
123549,356,"SCOALA GIMNAZIALA NR. 1",BOBOIEŞTI,NT,1306,5,0,0,5,7,4,0,11,13,5,0,18,29,5,0,34,29,5,0,34
123567,357,"GRADINITA CU PROGRAM NORMAL",LEGHIN,NT,525,7,3,0,10,20,3,0,23,24,4,5,33,27,5,5,37,29,5,5,39
123594,358,"SCOALAGIMNAZIALA STINCA",STÎNCA,NT,1253,10,6,0,16,21,8,0,29,27,12,0,39,53,16,0,69,58,16,0,74
123558,359,"SCOALA CU CLASELE I-IV DOLHESTI",DOLHEŞTI,NT,879,4,1,0,5,9,1,0,10,12,3,0,15,23,3,0,26,29,3,0,32
123585,360,"SCOALA GIMNAZIALA PLUTON",PLUTON,NT,841,0,4,0,4,7,4,0,11,8,4,0,12,11,5,0,16,12,5,0,17
123638,361,"ŞCOALA GIMNAZIALĂ ”NICOLAE IORGA” - SAT PÎNGĂRĂCIOR",PÎNGĂRĂCIOR,NT,1726,5,1,0,6,14,5,0,19,21,5,0,26,31,7,0,38,40,10,0,50
123610,362,"ŞCOALA GIMNAZIALĂ ”NICOLAE IORGA” -SAT PÎNGĂRAȚI- PUNCT CASTEL",PÎNGARAŢI,NT,617,8,0,0,8,35,16,0,51,40,18,0,58,44,27,0,71,47,29,0,76
123665,363,"ŞCOALA GIMNAZIALĂ ”NICOLAE IORGA” - SAT STEJARU",STEJARU,NT,881,14,1,0,15,18,2,0,20,29,5,0,34,36,8,0,44,51,8,0,59
123629,364,"ŞCOALA GIMNAZIALĂ ”NICOLAE IORGA” - SAT OANȚU",OANŢU,NT,1287,2,0,0,2,3,0,0,3,11,1,0,12,17,1,0,18,21,1,0,22
123683,365,"GRĂDINIŢA CU PROGRAM NORMAL NR. 2",PODOLENI,NT,1210,10,4,0,14,28,4,0,32,44,5,0,49,52,7,0,59,58,7,0,65
123683,366,"ŞCOALA GIMNAZIALĂ ""ALEXANDRU PODOLEANU""",PODOLENI,NT,1065,10,3,0,13,27,5,0,32,35,6,0,41,45,9,0,54,54,10,0,64
123683,367,"ŞCOALA GIMNAZIALĂ ""ALEXANDRU PODOLEANU""",PODOLENI,NT,1190,12,3,0,15,24,5,0,29,30,8,0,38,39,10,0,49,45,10,0,55
123683,368,"GRĂDINIŢA CU PROGRAM NORMAL NR. 3",PODOLENI,NT,897,6,0,0,6,20,0,0,20,31,4,0,35,41,4,0,45,41,4,0,45
123692,369,"ŞCOALA PRIMARĂ NEGRITEŞTI",NEGRITEŞTI,NT,295,4,1,0,5,9,3,0,12,13,3,0,16,18,3,0,21,18,3,0,21
123825,370,"ŞCOALA GIMNAZIALA ""CONSTANTIN ROMANESCU"" DREPTU",DREPTU,NT,960,9,2,0,11,25,4,0,29,36,4,0,40,44,5,9,58,46,5,9,60
123861,371,"SOCIETATEA COMERCIALǍ TCEPETROFORESTSRL","POIANA LARGULUI",NT,765,35,3,0,38,64,6,0,70,84,8,0,92,98,50,0,148,100,52,0,152
123843,372,"ŞCOALA GIMNAZIALA PETRU VODA","PETRU VODĂ",NT,1084,12,4,0,16,124,31,0,155,167,38,0,205,232,52,0,284,249,54,37,340
123807,373,"ȘCOALA GIMNAZIALǍ ""IUSTIN PÎRVU""","POIANA TEIULUI",NT,1321,8,0,0,8,33,5,0,38,55,8,0,63,77,14,0,91,91,18,0,109
123718,374,"SCOALA GIMNAZIALA NR. 1",POIENARI,NT,970,3,1,0,4,17,3,0,20,19,7,0,26,24,10,0,34,26,10,0,36
123772,375,"SCOALA GIMNAZIALA STRUCTURA SACALENI",SĂCĂLENI,NT,279,0,0,0,0,2,1,0,3,6,1,0,7,6,2,0,8,6,2,0,8
123932,376,"LICEUL TEHNOLOGIC OGLINZI",OGLINZI,NT,1672,14,10,0,24,33,10,0,43,44,12,0,56,56,14,0,70,58,15,0,73
123932,377,"ŞCOALA PRIMARĂ NR. 2 OGLINZI",OGLINZI,NT,813,4,3,0,7,11,4,0,15,12,5,0,17,19,8,0,27,23,8,0,31
123950,378,"ŞCOALA UNGHENI",UNGHENI,NT,427,2,4,0,6,7,7,0,14,14,8,0,22,20,8,0,28,20,8,0,28
123923,379,"ŞCOALA GIMNAZIALĂ NR. 1 RĂUCEŞTI",RĂUCEŞTI,NT,1316,14,4,0,18,23,7,0,30,42,7,0,49,50,7,0,57,59,7,0,66
123923,380,"ŞCOALA GIMNAZIALĂ NR. 2 ""MIHAIL KOGĂLNICEANU"" RĂUCEŞTI",RĂUCEŞTI,NT,676,6,2,2,10,21,3,0,24,21,4,0,25,25,9,0,34,25,9,0,34
123923,381,"GRĂDINIŢA CU PROGRAM NORMAL NR. 2 RĂUCEŞTI",RĂUCEŞTI,NT,595,5,5,0,10,9,6,0,15,12,7,0,19,20,9,0,29,22,10,0,32
123932,382,"LICEUL TEHNOLOGIC OGLINZI(GRĂDINIŢA NR. 1- CORP C)",OGLINZI,NT,811,1,3,0,4,2,3,0,5,2,3,0,5,2,4,0,6,7,4,0,11
123941,383,"ŞCOALA SĂVEŞTI",SĂVEŞTI,NT,366,4,6,0,10,8,9,0,17,10,9,0,19,12,9,0,21,12,9,0,21
123987,384,"SCOALA GENERALA",BORŞENI,NT,295,4,0,0,4,7,0,0,7,19,0,0,19,20,5,0,25,20,5,0,25
124000,385,"SCOALA GENERALA","VALEA ALBĂ",NT,341,2,0,0,2,5,1,0,6,7,2,0,9,10,2,0,12,13,5,0,18
123978,386,"SCOALA GENERALA CU CLASELE I-VIII","RĂZBOIENII DE JOS",NT,627,5,5,0,10,14,13,0,27,18,17,0,35,19,21,0,40,22,23,0,45
123996,387,"SCOALA GENERALA CU CLASELE I-IV NR. 3",RĂZBOIENI,NT,495,10,1,0,11,23,3,0,26,30,6,0,36,49,10,0,59,50,12,0,62
124046,388,"ŞCOALA CU CLASELE I-IV BETESTI",BEŢEŞTI,NT,635,1,2,0,3,8,2,0,10,9,2,0,11,15,3,0,18,16,3,0,19
124037,389,"SCOALA CU CLASELE I-VIII REDIU",REDIU,NT,693,1,0,0,1,9,0,0,9,4,0,0,4,7,0,0,7,7,0,0,7
124055,390,"ŞCOALA CU CLASELE I-VIII POLOBOC",POLOBOC,NT,1217,8,1,0,9,20,4,0,24,32,4,0,36,45,5,0,50,45,5,0,50
124064,391,"GRADINITA SOCEA",SOCEA,NT,637,4,1,0,5,6,2,0,8,7,2,0,9,9,2,0,11,9,2,0,11
124037,392,"ŞCOALA CU CLASELE I-VIII REDIU",REDIU,NT,1221,4,0,0,4,9,0,0,9,10,0,0,10,11,1,0,12,17,1,0,18
124082,393,"ŞCOALA CU CLASELE I-VIII",ROMÂNI,NT,781,11,1,0,12,20,1,0,21,35,1,0,36,43,1,0,44,43,1,0,44
124108,394,"ŞCOALA CU CLASELE I-VIII",SILIŞTEA,NT,1041,10,0,0,10,19,0,0,19,28,2,0,30,49,6,0,55,50,7,0,57
124091,395,"ŞCOALA CU CLASELE I-VIII",GOŞMANI,NT,811,5,1,0,6,10,2,0,12,16,2,0,18,23,5,0,28,24,6,0,30
124108,396,"SCOALA CU CLASELE I-VIII SILISTEAII",SILIŞTEA,NT,842,3,1,0,4,10,3,0,13,17,3,0,20,20,3,0,23,21,3,0,24
122481,397,"FOSTA SCOALĂ BOZIENII DE SUS","BOZIENII DE SUS",NT,304,0,0,0,0,2,0,0,2,4,0,0,4,7,1,0,8,7,1,0,8
122542,398,"ȘCOALA GIMNAZIALĂ "" NICOLAE APOSTOL"" RUGINOASA",RUGINOASA,NT,625,2,0,0,2,3,1,0,4,10,1,0,11,15,1,0,16,16,2,0,18
122542,399,"ȘCOALA GIMNAZIALĂ "" NICOLAE APOSTOL "" RUGINOASA",RUGINOASA,NT,679,5,2,0,7,7,2,0,9,10,3,0,13,13,3,0,16,14,3,0,17
124162,400,"ŞCOALA GIMNAZIALĂ, COMUNA SAGNA",SAGNA,NT,1673,19,1,0,20,29,2,0,31,56,4,0,60,65,6,0,71,68,6,0,74
124162,401,"ŞCOALA GIMNAZIALĂ, COMUNA SAGNA",SAGNA,NT,1518,8,1,0,9,19,1,0,20,38,2,0,40,63,5,0,68,64,6,0,70
124180,402,"GRĂDINIŢA CU PROGRAM NORMAL LUŢCA",LUŢCA,NT,394,4,3,0,7,11,3,0,14,20,5,0,25,31,8,0,39,35,8,0,43
124199,403,"ŞCOALA PRIMARĂ VULPĂŞEŞTI",VULPĂŞEŞTI,NT,685,1,0,0,1,2,0,0,2,6,0,0,6,13,3,0,16,13,3,0,16
124224,404,"ŞCOALA GIMNAZIALĂ TRAIAN-SĂBĂOANI",TRAIAN,NT,1017,7,1,0,8,12,1,0,13,21,26,0,47,29,27,0,56,39,27,0,66
124215,405,"LICEUL TEORETIC ""VASILE ALECSANDRI"" COMUNA SĂBĂOANI",SĂBĂOANI,NT,1091,15,0,0,15,23,1,0,24,27,1,0,28,30,2,0,32,31,2,0,33
124215,406,"LICEUL TEORETIC ""VASILE ALECSANDRI"" COMUNA SĂBĂOANI",SĂBĂOANI,NT,1870,13,1,0,14,22,1,0,23,30,1,0,31,40,3,0,43,41,3,0,44
124215,407,"LICEUL TEORETIC ""VASILE ALECSANDRI"" COMUNA SĂBĂOANI",SĂBĂOANI,NT,1139,13,2,0,15,18,2,0,20,26,3,0,29,31,3,0,34,31,3,0,34
124215,408,"LICEUL TEORETIC ""VASILE ALECSANDRI"" COMUNA SĂBĂOANI",SĂBĂOANI,NT,1032,10,0,0,10,15,0,0,15,22,0,0,22,23,0,0,23,23,0,0,23
124215,409,"LICEUL TEORETIC ""VASILE ALECSANDRI"" COMUNA SĂBĂOANI",SĂBĂOANI,NT,885,9,0,0,9,12,0,0,12,17,0,0,17,21,0,0,21,22,0,0,22
124215,410,"LICEUL TEORETIC ""VASILE ALECSANDRI"" COMUNA SĂBĂOANI",SĂBĂOANI,NT,1452,12,7,0,19,15,8,0,23,18,9,0,27,25,11,0,36,25,11,0,36
124215,411,"LICEUL TEORETIC ""VASILE ALECSANDRI"" COMUNA SĂBĂOANI",SĂBĂOANI,NT,1105,10,0,0,10,12,0,0,12,14,0,0,14,25,0,0,25,25,0,0,25
120833,412,"SCOALA GIMNAZIALA I.GERVESCU SAVINESTI",SĂVINEŞTI,NT,1920,6,0,0,6,32,3,0,35,47,4,0,51,73,9,7,89,75,9,7,91
120842,413,"SCOALA PRIMARA DUMBRAVA DEAL","DUMBRAVA DEAL",NT,352,4,2,0,6,10,3,0,13,13,3,0,16,20,3,0,23,20,3,0,23
120833,414,"GRADINITA CU PROGRAM NORMAL SAVINESTI",SĂVINEŞTI,NT,444,4,0,0,4,15,0,0,15,21,2,0,23,23,2,0,25,25,2,0,27
120833,415,"GRADINIŢA CU PROGRAM PRELUNGIT SAVINESTI",SĂVINEŞTI,NT,551,9,3,0,12,19,3,0,22,25,4,0,29,35,4,0,39,36,4,0,40
120833,416,"ŞCOALA GIMNAZIALA SĂVINESTI",SĂVINEŞTI,NT,1455,14,3,0,17,33,5,0,38,52,8,0,60,65,10,0,75,66,11,0,77
120833,417,"SCOALA PRIMARA SAVINESTI",SĂVINEŞTI,NT,1209,8,1,0,9,17,3,0,20,26,4,0,30,38,5,0,43,42,5,0,47
124242,418,"CĂMINUL CULTURAL",SECUIENI,NT,975,2,3,0,5,8,5,0,13,11,5,5,21,16,5,5,26,16,5,5,26
124251,419,"CĂMINUL CULTURAL",BAŞTA,NT,537,13,0,0,13,29,10,0,39,30,12,0,42,33,12,0,45,38,17,0,55
124288,420,"CĂMINUL CULTURAL",BUTNĂREŞTI,NT,940,9,1,0,10,13,4,0,17,21,5,0,26,23,5,7,35,26,5,7,38
124297,421,CLĂDIRE,GIULEŞTI,NT,214,0,0,0,0,0,0,0,0,0,0,0,0,1,0,0,1,2,1,0,3
124340,422,"SCOALA GIMNAZIALACOMUNASTANITA",STĂNIŢA,NT,398,2,1,0,3,3,2,0,5,9,3,0,12,10,4,0,14,12,4,0,16
124359,423,"SCOALA PRIMARA NR. 5 CHICEREA",CHICEREA,NT,213,48,12,3,63,48,12,3,63,48,12,3,63,48,12,3,63,48,12,3,63
124368,424,"SCOALA PRIMARA NR.2 GHIDION",GHIDION,NT,310,1,4,0,5,2,4,0,6,4,4,0,8,9,6,0,15,11,6,0,17
124377,425,"SCOALAPRIMARA NR.4 POIENILE OANCEI","POIENILE OANCEI",NT,190,0,0,0,0,0,0,0,0,2,0,0,2,2,0,0,2,2,0,0,2
124386,426,"SCOALA PRIMARA NR.1TODIRENI",TODIRENI,NT,244,4,0,0,4,13,5,0,18,19,5,0,24,22,5,0,27,25,5,0,30
124395,427,"SCOALA PRIMARA NR.3VEJA",VEJA,NT,246,1,0,0,1,3,1,0,4,7,1,0,8,7,1,0,8,7,1,0,8
124484,428,ŞCOALA,SOCI,NT,271,3,4,0,7,6,4,0,10,14,4,0,18,15,10,0,25,15,10,0,25
124475,429,"SCOALA PRIMARA",GHIGOIEŞTI,NT,474,5,2,0,7,9,3,0,12,9,3,0,12,12,6,0,18,13,9,0,22
124448,430,"GRĂDINIŢA CU PROGRAM NORMAL",CÎRLIGI,NT,426,5,2,0,7,29,13,0,42,33,13,0,46,43,13,0,56,43,13,0,56
124420,431,"SCOALA GIMNAZIALA DR. EMANUIEL RIGLER","ŞTEFAN CEL MARE",NT,697,9,0,0,9,13,0,0,13,19,0,0,19,24,0,0,24,36,1,0,37
124420,432,"SCOALA GIMNAZIALA DR. EMANUIEL RIGLER","ŞTEFAN CEL MARE",NT,723,8,0,0,8,10,0,0,10,14,0,0,14,32,5,0,37,43,5,0,48
124509,433,"ŞCOLA GIMNAZIALĂ ""IULIA HĂLĂUCESCU"", COMUNA TARCĂU, JUDEŢUL NEAMŢ",TARCĂU,NT,812,3,0,0,3,12,6,0,18,20,6,0,26,28,7,0,35,31,8,0,39
124509,434,"ŞCOLA GIMNAZIALĂ ""IULIA HĂLĂUCESCU"", COMUNA TARCĂU, JUDEŢUL NEAMŢ",TARCĂU,NT,838,8,0,0,8,17,5,0,22,24,5,0,29,26,6,0,32,29,6,0,35
124554,435,GRĂDINIŢA,STRAJA,NT,534,4,1,0,5,6,1,0,7,15,7,0,22,16,9,0,25,17,12,0,29
124536,436,GRĂDINIŢA,CAZACI,NT,426,6,1,0,7,14,1,0,15,16,3,0,19,16,6,0,22,16,6,0,22
124527,437,GRĂDINIŢA,BRATEŞ,NT,276,2,3,0,5,13,11,5,29,26,13,5,44,34,16,5,55,36,17,5,58
124572,438,"CAMIN CULTURAL",TAŞCA,NT,1407,13,0,0,13,29,0,0,29,42,0,0,42,70,2,0,72,80,4,0,84
124590,439,"SCOALA NEAGRA",NEAGRA,NT,793,0,0,0,0,24,3,0,27,37,8,0,45,48,9,1,58,52,11,1,64
124625,440,"SCOALA GIMNAZIALA ""I.I. MIRONESCU""",TAZLĂU,NT,1077,1,0,0,1,14,0,0,14,20,2,0,22,29,2,0,31,29,2,0,31
124625,441,"CAMINUL CULTURAL",TAZLĂU,NT,1216,14,0,0,14,22,0,0,22,27,3,1,31,28,3,1,32,28,3,1,32
124652,442,"LICEUL TEHNOLOGIC ADJUDENI",ADJUDENI,NT,1517,5,0,0,5,9,0,0,9,13,0,0,13,16,4,0,20,18,5,0,23
124643,443,GRADINITA,TĂMĂŞENI,NT,1291,3,0,0,3,9,0,0,9,12,0,0,12,23,3,0,26,28,3,0,31
124652,444,GRADINITA,ADJUDENI,NT,1403,4,2,0,6,7,2,0,9,11,2,0,13,16,2,0,18,19,5,0,24
124643,445,"SCOALA GIMNAZIALA COMUNA TAMASENI",TĂMĂŞENI,NT,1380,4,3,0,7,9,3,0,12,11,3,0,14,14,3,0,17,17,3,0,20
124643,446,"CAMINUL CULTURAL",TĂMĂŞENI,NT,1051,4,0,0,4,6,0,0,6,10,0,0,10,13,0,0,13,13,0,0,13
124652,447,"CENTRUL MEDICAL ADJUDENI",ADJUDENI,NT,1198,8,3,0,11,12,5,0,17,18,6,0,24,24,7,0,31,27,7,0,34
124670,448,"ŞCOALA GIMNAZIALĂ",TIMIŞEŞTI,NT,1043,15,1,0,16,38,8,0,46,48,9,0,57,63,9,0,72,68,9,0,77
124689,449,"ŞCOALA GIMNAZIALĂ",DUMBRAVA,NT,1003,4,2,0,6,12,8,0,20,21,9,0,30,32,10,0,42,33,11,0,44
124698,450,"ŞCOALA PRIMARĂ",PLĂIEŞU,NT,638,13,1,0,14,22,2,0,24,28,2,0,30,37,2,0,39,38,2,0,40
124705,451,"ŞCOALA PRIMARĂ",PREUTEŞTI,NT,443,7,0,0,7,29,5,0,34,37,12,0,49,48,12,0,60,48,12,0,60
124714,452,"IMOBIL-LOCUINȚĂ PARTICULARĂ A FAMILIEI TOFAN D. CONSTANTIN",ZVORĂNEŞTI,NT,142,6,2,0,8,7,2,0,9,8,5,0,13,12,6,0,18,12,6,0,18
124732,453,"ȘCOALA CU CLASELEI - VIII",TRIFEŞTI,NT,1852,8,3,0,11,14,3,0,17,18,3,0,21,22,3,0,25,23,4,0,27
124741,454,"ȘCOALA CU CLASELEI - VIII","MIRON COSTIN",NT,840,4,0,0,4,8,4,0,12,11,4,0,15,13,4,0,17,17,4,0,21
124732,455,"ȘCOALA CU CLASELEI - IV",TRIFEŞTI,NT,757,0,2,0,2,1,2,0,3,4,2,0,6,14,4,0,18,14,4,0,18
124741,456,"ȘCOALA CU CLASELEI-IV","MIRON COSTIN",NT,702,1,3,0,4,3,3,0,6,3,3,0,6,5,3,0,8,9,3,0,12
124769,457,"SCOALA CU CLASELE I-VIII",TUPILAŢI,NT,943,10,4,0,14,21,6,0,27,25,7,0,32,30,7,0,37,31,7,0,38
124796,458,"SCOALA CU CLASELE I-VIII",TOTOIEŞTI,NT,291,1,4,0,5,5,5,0,10,6,12,0,18,8,13,0,21,8,14,0,22
124769,459,"PRIMARIA TUPILAŢI",TUPILAŢI,NT,540,12,4,0,16,17,4,0,21,18,4,0,22,28,6,0,34,30,6,0,36
124830,460,"FOSTA ȘCOALA PRIMARĂ (SALA DE FESTIVITĂȚI)","ŢIBUCANII DE JOS",NT,330,3,2,0,5,4,2,0,6,6,2,0,8,9,2,0,11,12,4,0,16
124821,461,"ȘCOALA GIMNAZIALĂ DAVIDENI",DAVIDENI,NT,793,12,2,0,14,18,5,0,23,20,9,0,29,25,11,0,36,25,11,0,36
124812,462,"ȘCOALA GIMNAZIALĂ NR.1 ȚIBUCANI",ŢIBUCANI,NT,1325,5,2,0,7,8,2,0,10,9,2,0,11,12,3,0,15,19,3,0,22
124812,463,"ŞCOALA GIMNAZIALĂ NR.3 ȚIBUCANI",ŢIBUCANI,NT,848,4,0,0,4,8,0,0,8,9,0,0,9,12,4,0,16,16,5,0,21
124858,464,"SCOALA GIMNAZIALA URECHENI",URECHENI,NT,594,7,0,0,7,10,0,0,10,15,1,0,16,19,1,1,21,22,1,1,24
124858,465,"SCOALA GIMNAZIALA URECHENI",URECHENI,NT,874,4,2,0,6,10,2,0,12,16,7,0,23,31,8,0,39,35,8,0,43
124858,466,"SCOALA GIMNAZIALAFUNDATURA",URECHENI,NT,558,3,2,0,5,8,3,0,11,17,5,0,22,18,5,0,23,18,5,0,23
124858,467,"GRADINITA CU PROGRAM NORMAL CATUNA",URECHENI,NT,515,10,1,0,11,14,2,0,16,17,2,0,19,18,2,0,20,18,2,0,20
124867,468,"SCOALA GIMNAZIALA INGARESTI",INGĂREŞTI,NT,732,3,2,0,5,4,4,0,8,4,5,0,9,6,5,0,11,8,6,0,14
124894,469,"CAMIN CULTURAL VALEA URSULUI","VALEA URSULUI",NT,741,3,1,0,4,4,3,0,7,10,3,0,13,12,3,0,15,16,4,0,20
124901,470,"SCOALA BUCIUM , COMUNA VALEA URSULUI",BUCIUM,NT,567,1,2,0,3,2,2,0,4,9,2,0,11,11,3,0,14,11,3,0,14
123059,471,"SCOALA CHILII , COMUNA VALEA URSULUI",CHILII,NT,922,7,1,0,8,14,1,0,15,18,2,0,20,21,2,0,23,22,2,0,24
124910,472,"SCOALA GIURGENI , COMUNA VALEA URSULUI",GIURGENI,NT,506,1,0,0,1,5,1,0,6,6,2,0,8,9,3,0,12,10,3,0,13
124929,473,"SCOALA MUNCEL , COMUNA VALEA URSULUI","MUNCELU DE JOS",NT,314,1,0,0,1,2,0,0,2,6,0,0,6,13,0,1,14,14,0,1,15
121830,474,"ŞCOALA GIMNAZIALA COMUNA VALENI",MORENI,NT,569,5,2,0,7,12,3,0,15,18,3,0,21,20,3,0,23,28,4,0,32
121867,475,"SALA SEDINTE CONSILIUL LOCAL VĂLENI",VĂLENI,NT,571,3,3,0,6,5,3,0,8,9,3,0,12,9,3,0,12,9,3,0,12
125025,476,"SCOALA GIMNAZIALA""ARHIM. CHIRIAC NICOLAU""",VÎNĂTORI-NEAMŢ,NT,1368,15,3,0,18,34,3,0,37,44,3,5,52,60,7,5,72,60,8,5,73
125025,477,"GRADINITA NR.2 UNGURENI",VÎNĂTORI-NEAMŢ,NT,1497,13,3,0,16,34,5,0,39,52,6,8,66,65,7,8,80,69,7,8,84
125025,478,"SCOALA GIMNAZIALA""ARHIM. CHIRIAC NICOLAU"" NR.2",VÎNĂTORI-NEAMŢ,NT,1395,7,2,0,9,15,4,0,19,24,4,0,28,35,5,0,40,37,5,0,42
125034,479,"SCOALA GIMNAZIALA ""ARHIM. CHIRIAC NICOLAU""",LUNCA,NT,1018,4,3,0,7,14,4,0,18,24,4,0,28,38,6,1,45,41,6,1,48
125052,480,"SCOALAGIMNAZIALA,,ARHIM.CHIRIAC NECULAU"" NEMTISOR",NEMŢIŞOR,NT,1327,4,3,0,7,10,4,0,14,18,4,0,22,47,4,13,64,50,4,13,67
125043,481,"MĂNĂSTIREA NEAMȚ","MĂNĂSTIREA NEAMŢ",NT,216,19,21,0,40,44,34,0,78,54,36,0,90,69,44,0,113,70,44,0,114
125025,482,"MANASTIREA SIHASTRIA",VÎNĂTORI-NEAMŢ,NT,167,20,36,0,56,66,75,0,141,84,125,0,209,95,235,0,330,99,351,0,450
125089,483,"GRĂDINIŢA CU PROGRAM NORMAL, LOC TRAIAN",TRAIAN,NT,886,7,2,0,9,16,6,0,22,23,10,0,33,31,10,0,41,37,10,0,47
125070,484,"ŞCOALA GIMNAZIALĂ NR. 2, LOC ZĂNEŞTI",ZĂNEŞTI,NT,1618,16,1,0,17,50,1,0,51,71,10,0,81,81,10,0,91,81,10,0,91
125070,485,"ŞCOALA GIMNAZIALĂ NR. 1, LOC ZĂNEŞTI",ZĂNEŞTI,NT,1470,11,0,0,11,28,0,0,28,41,0,0,41,54,0,0,54,65,1,1,67
125070,486,"CENTRU CULTURAL MULTIFUNCTIONAL",ZĂNEŞTI,NT,1092,10,0,0,10,17,6,0,23,29,7,0,36,37,11,0,48,39,11,0,50
125356,1,"COLEGIUL NAŢIONAL RADU GRECEANU",SLATINA,OT,1268,12,1,0,13,51,1,0,52,63,4,0,67,87,6,0,93,101,7,0,108
125356,2,"COLEGIUL NAŢIONAL RADU GRECEANU",SLATINA,OT,1502,10,1,0,11,43,4,0,47,80,9,0,89,107,11,0,118,115,11,0,126
125356,3,"COLEGIUL NAŢIONAL RADU GRECEANU",SLATINA,OT,1806,20,0,0,20,60,0,0,60,95,0,0,95,150,4,0,154,150,4,0,154
125356,4,"ŞCOALA GENERALĂ NR. 1",SLATINA,OT,1194,26,1,0,27,57,2,4,63,81,6,4,91,104,8,4,116,112,9,4,125
125356,5,"ŞCOALA GENERALĂ NR. 1",SLATINA,OT,969,14,3,0,17,49,3,0,52,49,6,0,55,51,8,0,59,56,8,0,64
125356,6,"COLEGIUL NAŢIONAL ION MINULESCU",SLATINA,OT,1488,9,1,0,10,37,1,0,38,58,1,0,59,78,4,0,82,89,4,0,93
125356,7,"COLEGIUL NAŢIONAL ION MINULESCU",SLATINA,OT,1559,20,0,0,20,47,1,0,48,60,4,0,64,82,5,0,87,94,7,0,101
125356,8,"COLEGIUL NAŢIONAL ION MINULESCU",SLATINA,OT,1418,29,0,0,29,71,3,0,74,88,8,0,96,113,19,0,132,120,26,0,146
125356,9,"COLEGIUL NAŢIONAL ION MINULESCU",SLATINA,OT,1353,18,0,0,18,52,2,0,54,76,3,0,79,108,3,0,111,126,3,0,129
125356,10,"ŞCOALA GENERALĂ ŞTEFAN PROTOPOPESCU",SLATINA,OT,1868,28,5,0,33,80,8,0,88,112,12,0,124,155,18,0,173,160,19,0,179
125356,11,"ŞCOALA GENERALĂ ŞTEFAN PROTOPOPESCU",SLATINA,OT,1822,18,0,0,18,53,0,0,53,76,0,0,76,104,0,0,104,107,0,0,107
125356,12,"COLEGIUL NAŢIONAL VOCAŢIONAL NICOLAE TITULESCU",SLATINA,OT,1637,30,0,0,30,67,3,0,70,81,5,0,86,98,7,0,105,106,9,0,115
125356,13,"COLEGIUL NAŢIONAL VOCAŢIONAL NICOLAE TITULESCU",SLATINA,OT,1570,21,3,0,24,58,10,0,68,92,10,0,102,116,11,0,127,121,12,0,133
125356,14,"COLEGIUL NAŢIONAL VOCAŢIONAL NICOLAE TITULESCU",SLATINA,OT,1230,18,4,0,22,51,5,0,56,76,6,0,82,102,9,0,111,119,9,0,128
125356,15,"COLEGIUL NAŢIONAL VOCAŢIONAL NICOLAE TITULESCU",SLATINA,OT,1077,24,5,0,29,47,7,0,54,63,8,0,71,80,10,0,90,86,10,0,96
125356,16,"COLEGIUL NAŢIONAL VOCAŢIONAL NICOLAE TITULESCU",SLATINA,OT,1292,12,3,0,15,49,4,0,53,65,4,0,69,87,5,0,92,95,5,0,100
125356,17,"ŞCOALA GENERALĂ NICOLAE IORGA",SLATINA,OT,1563,23,0,0,23,71,0,0,71,96,1,0,97,120,15,0,135,130,16,0,146
125356,18,"ŞCOALA GENERALĂ NICOLAE IORGA",SLATINA,OT,1387,14,6,0,20,65,11,0,76,72,12,0,84,116,13,0,129,118,14,0,132
125356,19,"ŞCOALA CU CLASELE I-VIII EUGEN IONESCU",SLATINA,OT,1681,18,3,0,21,36,4,0,40,57,4,1,62,82,10,1,93,96,11,1,108
125356,20,"ŞCOALA CU CLASELE I-VIII EUGEN IONESCU",SLATINA,OT,1262,19,1,0,20,64,3,0,67,90,4,0,94,116,5,0,121,124,5,0,129
125356,21,"ŞCOALA CU CLASELE I-VIII EUGEN IONESCU",SLATINA,OT,1240,11,1,0,12,30,3,0,33,48,4,0,52,77,4,0,81,87,4,0,91
125356,22,"ŞCOALA GENERALĂ NR. 7",SLATINA,OT,1534,24,3,0,27,57,4,0,61,70,6,0,76,85,6,0,91,89,6,0,95
125356,23,"ŞCOALA GENERALĂ NR. 7",SLATINA,OT,1242,13,0,0,13,58,3,0,61,82,4,0,86,108,4,0,112,111,4,0,115
125356,24,"ŞCOALA GENERALĂ NR. 7",SLATINA,OT,1415,12,2,0,14,45,3,0,48,57,3,0,60,78,3,87,168,82,3,87,172
125356,25,"COLEGIUL ECONOMIC P.S. AURELIAN",SLATINA,OT,1247,15,6,0,21,43,6,0,49,76,7,0,83,96,10,0,106,102,10,0,112
125356,26,"COLEGIUL ECONOMIC P.S. AURELIAN",SLATINA,OT,1849,11,1,0,12,33,1,0,34,63,2,0,65,103,4,0,107,114,5,0,119
125356,27,"LICEUL CU PROGRAM SPORTIV",SLATINA,OT,1871,16,0,0,16,74,1,0,75,76,9,0,85,105,14,0,119,117,15,0,132
125356,28,"LICEUL CU PROGRAM SPORTIV",SLATINA,OT,1762,32,0,0,32,67,0,0,67,96,2,0,98,134,4,0,138,139,4,0,143
125356,29,"LICEUL CU PROGRAM SPORTIV",SLATINA,OT,1482,19,0,0,19,68,5,0,73,92,8,0,100,101,11,0,112,111,13,0,124
125356,30,"ŞCOALA GENERALĂ NR. 3",SLATINA,OT,1561,20,0,0,20,44,0,0,44,55,0,0,55,72,0,0,72,79,0,0,79
125356,31,"ŞCOALA GENERALĂ NR. 3",SLATINA,OT,1376,22,1,0,23,48,1,0,49,60,6,0,66,76,6,0,82,94,6,0,100
125356,32,"ŞCOALA GENERALĂ NR. 3",SLATINA,OT,882,8,3,0,11,17,3,0,20,34,4,0,38,47,5,0,52,47,5,0,52
125356,33,"ŞCOALA GENERALĂ NR. 3",SLATINA,OT,1618,16,0,0,16,48,0,0,48,62,2,0,64,84,2,0,86,108,4,0,112
125356,34,"GRUPUL ŞCOLAR METALURGIC",SLATINA,OT,1635,5,6,0,11,22,8,0,30,29,8,0,37,44,11,0,55,47,12,0,59
125356,35,"GRUPUL ŞCOLAR METALURGIC",SLATINA,OT,1688,12,1,0,13,37,1,0,38,55,1,0,56,74,2,0,76,80,2,0,82
125356,36,"GRUPUL ŞCOLAR METALURGIC",SLATINA,OT,791,15,4,0,19,34,5,0,39,48,5,0,53,70,5,0,75,79,5,0,84
125356,37,"ŞCOALA GENERALĂ CONSTANTIN BRÂNCOVEANU",SLATINA,OT,1190,11,0,0,11,30,12,0,42,43,17,0,60,53,19,0,72,60,22,0,82
125356,38,"ŞCOALA GENERALĂ CONSTANTIN BRÂNCOVEANU",SLATINA,OT,1572,6,0,0,6,24,0,0,24,34,3,0,37,48,3,0,51,57,4,0,61
125356,39,"ŞCOALA GENERALĂ CONSTANTIN BRÂNCOVEANU",SLATINA,OT,1704,18,0,0,18,33,1,0,34,54,1,0,55,62,4,0,66,66,4,0,70
125356,40,"ŞCOALA GENERALĂ CONSTANTIN BRÂNCOVEANU",SLATINA,OT,1476,11,1,0,12,39,2,0,41,63,4,0,67,90,6,0,96,100,7,0,107
125356,41,"ŞCOALA GENERALĂ CONSTANTIN BRÂNCOVEANU",SLATINA,OT,1632,7,0,0,7,19,0,0,19,35,1,0,36,51,2,0,53,56,3,0,59
125356,42,"GRĂDINIȚA CU PROGRAM NORMAL NR. 5",SLATINA,OT,1628,23,4,0,27,51,4,0,55,80,4,0,84,112,4,0,116,113,4,0,117
125356,43,"GRUPUL ŞCOLAR INDUSTRIAL CONSTRUCŢII MAŞINI",SLATINA,OT,1557,10,3,0,13,33,3,0,36,50,5,0,55,63,5,0,68,76,8,0,84
125356,44,"GRUPUL ŞCOLAR INDUSTRIAL CONSTRUCŢII MAŞINI",SLATINA,OT,1521,5,4,0,9,28,5,0,33,39,6,0,45,58,7,0,65,65,8,0,73
125356,45,"GRUPUL ŞCOLAR INDUSTRIAL CONSTRUCŢII MAŞINI",SLATINA,OT,1625,13,0,0,13,33,0,0,33,48,0,0,48,63,6,0,69,77,6,0,83
125356,46,"ŞCOALA CIREAŞOV",SLATINA,OT,1248,8,0,0,8,17,1,0,18,24,1,0,25,36,1,0,37,43,1,0,44
125356,47,"ŞCOALA GENERALĂ GEORGE POBORAN",SLATINA,OT,1342,23,1,0,24,44,1,0,45,60,6,0,66,90,9,0,99,98,12,0,110
125356,48,"ŞCOALA GENERALĂ GEORGE POBORAN",SLATINA,OT,1240,3,6,0,9,23,13,0,36,39,14,0,53,52,18,0,70,61,18,0,79
125481,49,"COLEGIUL NAŢIONAL IONIŢĂ ASAN",CARACAL,OT,1746,29,3,0,32,47,6,0,53,64,7,0,71,82,7,0,89,88,7,0,95
125481,50,"GRĂDINIŢA CU PROGRAM PRELUNGIT NR.1",CARACAL,OT,1852,23,0,0,23,42,1,0,43,64,1,0,65,82,3,0,85,95,7,0,102
125481,51,"GRĂDINIŢA CU PROGRAM NORMAL NR.4",CARACAL,OT,1576,29,2,0,31,78,2,0,80,107,2,2,111,126,3,2,131,135,3,2,140
125481,52,"LICEUL TEHNOLOGIC CONSTANTIN FILIPESCU",CARACAL,OT,1842,13,7,0,20,36,9,0,45,53,9,0,62,83,10,0,93,101,10,0,111
125481,53,"LICEUL MIHAI VITEAZUL",CARACAL,OT,1447,9,3,0,12,37,4,0,41,50,5,27,82,64,5,27,96,71,6,27,104
125481,54,"COLEGIUL TEHNIC MATEI BASARAB",CARACAL,OT,1803,14,3,0,17,38,5,0,43,57,7,0,64,75,7,0,82,82,7,0,89
125481,55,"GRĂDINIŢA CU PROGRAM PRELUNGIT NR.3",CARACAL,OT,1643,14,0,0,14,50,3,0,53,57,7,0,64,84,12,0,96,96,12,0,108
125481,56,"ŞCOALA GIMNAZIALĂ NICOLAE TITULESCU",CARACAL,OT,1740,16,4,0,20,50,5,0,55,69,5,0,74,87,5,0,92,106,5,0,111
125481,57,"ŞCOALA GIMNAZIALĂ NICOLAE TITULESCU",CARACAL,OT,1534,15,5,0,20,36,8,0,44,51,8,0,59,75,8,0,83,88,9,1,98
125481,58,"ŞCOALA GIMNAZIALĂ NR.2",CARACAL,OT,1672,38,0,0,38,96,4,0,100,124,5,0,129,153,7,0,160,155,7,0,162
125481,59,"GRĂDINIȚACU PROGRAM PRELUNGIT NR.4",CARACAL,OT,1683,27,0,0,27,78,2,0,80,110,3,0,113,128,4,0,132,135,7,0,142
125481,60,"GRĂDINIȚA CU PROGRAM PRELUNGIT NR. 4",CARACAL,OT,1773,30,8,0,38,67,10,0,77,82,11,0,93,103,13,0,116,116,13,0,129
125481,61,"CENTRUL CULTURAL MUNICIPAL CARACAL",CARACAL,OT,1287,18,5,0,23,57,11,0,68,92,12,0,104,110,13,0,123,115,13,0,128
125481,62,"ŞCOALA GIMNAZIALĂ GHEORGHE MAGHERU",CARACAL,OT,1795,14,0,0,14,37,6,0,43,54,7,0,61,70,9,0,79,80,9,0,89
125481,63,"ŞCOALA GIMNAZIALĂ NR. 4",CARACAL,OT,1708,18,2,0,20,60,5,0,65,80,11,0,91,110,12,0,122,115,12,0,127
125481,64,"ŞCOALA GIMNAZIALĂ NR. 3",CARACAL,OT,1850,21,2,0,23,57,4,0,61,75,5,0,80,102,5,0,107,111,5,0,116
125481,65,"ŞCOALA GIMNAZIALĂ NR.1",CARACAL,OT,1595,30,4,0,34,73,7,0,80,99,9,0,108,139,9,0,148,147,9,0,156
125427,66,"SCOALA GIMNAZIALĂ NR 3 ROMANA",BALŞ,OT,945,10,0,0,10,21,0,0,21,28,0,0,28,32,0,0,32,35,0,0,35
125427,67,"SCOALA GIMNAZIALĂ NR 2 VIRTINA",BALŞ,OT,1225,4,5,0,9,10,5,0,15,15,5,0,20,33,7,0,40,36,7,0,43
125427,68,"SCOALA GIMNAZIALA NR. 1 BALS",BALŞ,OT,1018,6,0,0,6,13,0,0,13,24,0,0,24,28,0,0,28,28,0,0,28
125427,69,"SCOALA GIMNAZIALA SPECIALA",BALŞ,OT,1944,13,3,0,16,37,4,0,41,57,8,0,65,80,16,0,96,93,19,0,112
125427,70,"LICEUL TEORETIC PETRE PANDREA",BALŞ,OT,1479,31,0,0,31,55,3,0,58,90,7,0,97,110,8,0,118,124,10,0,134
125427,71,"LICEUL TEORETIC PETRE PANDREA",BALŞ,OT,1502,11,1,0,12,43,3,0,46,56,4,0,60,77,4,0,81,84,4,0,88
125427,72,"SCOALA GIMNAZIALĂ ""MIHAIL DRUMES""",BALŞ,OT,1510,13,1,0,14,35,2,0,37,48,3,0,51,62,7,0,69,66,9,0,75
125427,73,"SCOALA GIMNAZIALĂ ""MIHAIL DRUMES""",BALŞ,OT,1608,10,0,0,10,29,1,0,30,46,2,0,48,61,2,0,63,65,4,0,69
125427,74,"GRADINITA CU PROGRAM NORMAL NR 1",BALŞ,OT,1053,6,0,0,6,20,1,0,21,28,1,0,29,38,6,0,44,45,7,0,52
125427,75,"GRADINITA CU PROGRAM NORMAL NR 1",BALŞ,OT,1521,8,0,0,8,37,2,0,39,38,3,0,41,41,3,0,44,49,3,0,52
125427,76,"COLEGIUL TEHNIC",BALŞ,OT,1676,11,3,0,14,23,13,0,36,50,26,0,76,53,28,0,81,60,28,0,88
125427,77,"COLEGIUL TEHNIC",BALŞ,OT,1265,12,4,0,16,24,12,0,36,36,18,0,54,48,19,0,67,50,21,0,71
125427,78,"SCOALA GIMNAZIALA TEIS",BALŞ,OT,632,7,5,0,12,16,6,0,22,23,7,0,30,35,7,0,42,36,7,0,43
125551,79,"ŞCOALA GIMNAZIALĂ NR. 1",CORABIA,OT,1486,25,2,0,27,48,6,0,54,63,6,0,69,86,8,0,94,90,8,0,98
125551,80,"ŞCOALA GIMNAZIALĂ DUMITRU BUZDUN",CORABIA,OT,1214,42,0,0,42,77,2,0,79,97,3,31,131,126,7,31,164,136,7,31,174
125551,81,"SCOALA GIMNAZIALAVIRGIL MAZILESCU",CORABIA,OT,1027,14,3,0,17,37,3,0,40,43,5,0,48,70,5,0,75,72,6,0,78
125551,82,"ŞCOALA GIMNAZIALĂVIRGIL MAZILESCU",CORABIA,OT,1119,15,0,0,15,35,1,0,36,42,5,0,47,56,5,0,61,59,5,0,64
125551,83,"ŞCOALA GIMNAZIALĂVIRGIL MAZILESCU",CORABIA,OT,961,23,2,0,25,38,4,0,42,41,4,0,45,49,8,0,57,51,8,0,59
125551,84,"COLEGIUL NAŢIONALAL I.CUZA",CORABIA,OT,1004,13,0,0,13,28,5,0,33,34,6,0,40,55,6,0,61,63,13,0,76
125551,85,"COLEGIUL NAŢIONALAL I.CUZA",CORABIA,OT,1200,25,1,0,26,58,2,0,60,73,5,0,78,96,8,0,104,103,9,0,112
125551,86,"ŞCOALA GIMNAZIALĂ MIHAIL EMINESCU",CORABIA,OT,1234,22,0,0,22,34,0,0,34,46,2,0,48,71,4,0,75,81,4,0,85
125551,87,"ŞCOALA GIMNAZIALĂMIHAIL EMINESCU",CORABIA,OT,1188,12,2,0,14,25,2,0,27,31,2,0,33,45,2,0,47,46,4,0,50
125551,88,"SCOALA CORABIA VECHE",CORABIA,OT,1556,19,3,0,22,40,4,0,44,63,5,0,68,81,5,0,86,81,5,0,86
125551,89,"ŞCOALA GIMNAZIALĂ CELEIU",CORABIA,OT,1455,30,2,0,32,72,3,6,81,99,4,6,109,146,4,6,156,160,4,6,170
125579,90,"GRADINIŢA SAT VÎRTOPU",VÎRTOPU,OT,348,2,3,0,5,4,3,0,7,8,3,0,11,9,5,0,14,9,5,0,14
125560,91,"ŞCOALA GIMNAZIALĂ SATTUDOR VLADIMIRESCU","TUDOR VLADIMIRESCU",OT,503,9,3,0,12,16,3,0,19,27,3,0,30,40,3,0,43,41,3,0,44
125551,92,"ŞCOALA CARTIER SILIŞTIOARA",CORABIA,OT,428,13,1,0,14,19,2,0,21,27,3,0,30,39,3,0,42,40,3,0,43
125631,93,"LICEUL T.VLADIMIRESCU DRĂGĂNEŞTI-OLT",DRĂGĂNEŞTI-OLT,OT,1651,17,2,0,19,43,2,0,45,65,2,0,67,86,2,0,88,92,3,0,95
125631,94,"LICEUL T.VLADIMIRESCU DRĂGĂNEŞTI-OLT",DRĂGĂNEŞTI-OLT,OT,1596,26,2,0,28,67,3,0,70,89,9,0,98,115,11,0,126,126,11,0,137
125631,95,"LICEUL TEHNOLOGIC DRĂGĂNEŞTI-OLT",DRĂGĂNEŞTI-OLT,OT,1187,4,0,0,4,23,5,0,28,30,6,0,36,40,6,0,46,47,8,0,55
125631,96,"LICEUL TEHNOLOGIC DRĂGĂNEŞTI-OLT",DRĂGĂNEŞTI-OLT,OT,857,9,6,0,15,22,8,0,30,32,8,0,40,38,8,0,46,38,8,0,46
125631,97,"COMPANIA DE APĂ OLT SLATINA",DRĂGĂNEŞTI-OLT,OT,1810,18,0,0,18,53,1,0,54,66,17,0,83,92,28,0,120,96,28,0,124
125640,98,"ŞCOALA GIMNAZIALĂ COMANI",COMANI,OT,1187,18,3,0,21,50,4,0,54,44,6,0,50,74,8,0,82,87,8,0,95
125640,99,"ŞCOALA GIMNAZIALĂ COMANI",COMANI,OT,1292,17,3,0,20,37,3,0,40,50,3,0,53,88,5,0,93,94,6,0,100
128114,100,"MUZEU PIATRA OLT",PIATRA-OLT,OT,968,20,3,0,23,36,4,0,40,43,11,0,54,51,14,0,65,65,14,0,79
128114,101,"MUZEUL PIATRA OLT",PIATRA-OLT,OT,926,27,3,0,30,41,3,0,44,56,4,0,60,82,6,0,88,88,6,0,94
128123,102,"SCOALA GENERALA CU CLASELE I-IV","BISTRIŢA NOUĂ",OT,435,15,1,0,16,25,3,0,28,28,3,0,31,36,15,0,51,37,16,0,53
128141,103,"GRADINITA CU PROGRAM NORMAL","CRIVA DE SUS",OT,961,0,5,0,5,17,6,0,23,41,6,0,47,51,6,0,57,56,6,0,62
128150,104,"GRADINITA CU PROGRAM NORMAL",ENOŞEŞTI,OT,267,2,0,0,2,9,0,0,9,15,1,0,16,25,1,0,26,28,3,0,31
128169,105,"GRADINITA CU PROGRAM NORMAL PIATRA",PIATRA,OT,728,4,5,0,9,10,14,0,24,14,18,0,32,27,18,0,45,38,18,0,56
128169,106,"GRADINITA PIATRA",PIATRA,OT,950,10,1,0,11,21,1,0,22,35,2,0,37,46,3,0,49,52,3,0,55
128383,107,"ŞCOALA CU CLASELE. I-IV FĂLCOIENI",POTCOAVA,OT,809,6,2,0,8,9,4,0,13,12,4,0,16,21,5,0,26,21,9,0,30
128383,108,"LICEUL ""ŞTEFAN DIACONESCU"" POTCOAVA",POTCOAVA,OT,1285,7,1,0,8,17,8,0,25,37,11,0,48,51,14,0,65,61,15,0,76
128383,109,"LICEUL ""ŞTEFAN DIACONESCU"" POTCOAVA",POTCOAVA,OT,1104,5,0,0,5,22,0,0,22,31,0,0,31,43,0,0,43,60,0,0,60
128409,110,"ŞCOALA GENERALĂ SINEŞTI",SINEŞTI,OT,1591,3,0,0,3,11,2,0,13,15,2,0,17,34,6,0,40,48,6,0,54
128720,111,"GRUPUL SCOLAR AGRICOL SCORNICEŞTI",SCORNICEŞTI,OT,1860,22,4,0,26,29,5,0,34,33,8,0,41,47,14,23,84,52,16,23,91
128720,112,"SCOALA GEN.CLASELE I-VIII SCORNICESTI",SCORNICEŞTI,OT,1879,18,0,0,18,40,5,0,45,46,6,0,52,66,16,0,82,74,17,0,91
128784,113,"SCOALA GENERALA MĂRGINENI","MĂRGINENI SLOBOZIA",OT,1586,5,2,0,7,12,3,0,15,17,6,0,23,24,9,0,33,25,12,0,37
128819,114,"SCOALA GENERALA NEGRENI",NEGRENI,OT,999,7,1,0,8,14,2,0,16,18,4,0,22,26,5,0,31,33,9,0,42
128748,115,"SCOALA GENERLA BIRCII",BIRCII,OT,886,3,0,0,3,17,0,0,17,30,0,0,30,42,3,0,45,47,3,0,50
128800,116,GRADINITAMOGOSESTI,MOGOŞEŞTI,OT,443,3,7,0,10,3,9,0,12,6,10,0,16,14,17,0,31,17,17,0,34
128766,117,"GRADINITA CONSTANTINESTI",CONSTANTINEŞTI,OT,449,0,1,0,1,2,2,0,4,7,2,0,9,14,5,0,19,15,6,0,21
128855,118,"GRADINITA TEIUS",TEIUŞ,OT,464,6,2,0,8,10,2,0,12,14,2,0,16,22,2,0,24,27,3,0,30
128846,119,"GRADINITA ȘUICA",ŞUICA,OT,196,4,4,0,8,5,4,0,9,8,4,0,12,13,4,0,17,16,4,0,20
128775,120,JITARU,JITARU,OT,833,6,1,0,7,9,7,0,16,14,7,0,21,18,8,0,26,20,8,0,28
128757,121,"SCOALA GENERALA CHIȚEASCA",CHIŢEASCA,OT,383,2,6,0,8,3,7,0,10,3,7,0,10,4,7,0,11,5,7,0,12
125695,122,"ŞCOALA GENERALĂ CU CLASELE I-VIII BALDOVINEŞTI",BALDOVINEŞTI,OT,505,4,1,0,5,12,9,0,21,16,18,0,34,22,40,0,62,23,43,0,66
125748,123,GRĂDINIŢĂ,PIETRIŞ,OT,282,4,4,0,8,7,7,0,14,10,18,0,28,18,25,0,43,19,25,0,44
125739,124,"ŞCOALA GENERALĂ CU CLASELE I-IV GUBANDRU",GUBANDRU,OT,98,8,4,0,12,15,26,0,41,22,33,3,58,26,39,3,68,27,39,3,69
125668,125,"CĂMINUL CULTURAL BĂBICIU",BĂBICIU,OT,721,11,2,0,13,22,2,0,24,38,2,31,71,82,7,31,120,88,7,31,126
125668,126,"CĂMINUL CULTURAL BĂBICIU",BĂBICIU,OT,1014,10,0,0,10,25,9,0,34,39,9,0,48,88,21,0,109,111,24,36,171
128070,127,"ŞCOALA GIMNAZIALĂ ,, ION I.GRAURE ,, BĂLTENI",BĂLTENI,OT,1366,6,4,0,10,23,6,0,29,35,7,0,42,78,10,0,88,85,11,0,96
125766,128,"ŞCOALA GENERALĂ CLASELE I-VIII","BĂRĂŞTII DE VEDE",OT,682,8,0,0,8,25,0,4,29,34,3,4,41,46,20,9,75,48,23,9,80
125775,129,"ŞCOALA GENERALĂ CLASELE I-IV.","BĂRĂŞTII DE CEPTURI",OT,417,8,2,0,10,21,4,0,25,27,11,0,38,39,14,4,57,40,17,4,61
125828,130,"SEDIU FOSTĂ BRIGADĂ AGRICOLĂ",MOŢOEŞTI,OT,59,3,1,0,4,4,1,0,5,4,2,0,6,5,5,0,10,5,9,0,14
125855,131,"ȘCOALA GIMNAZIALĂ BÎRZA",BÎRZA,OT,910,15,2,0,17,36,2,0,38,57,2,0,59,88,3,0,91,89,3,0,92
125864,132,"SCOALA GIMNAZIALĂ BRANEȚ",BRANEŢ,OT,1271,18,3,0,21,22,3,0,25,40,5,0,45,66,5,0,71,71,5,0,76
125882,133,"CAMINUL CULTURAL BOBICESTI",BOBICEŞTI,OT,849,13,1,0,14,29,2,0,31,32,2,0,34,45,6,0,51,48,8,0,56
125891,134,"SCOALA GENERALA BECHET",BECHET,OT,303,5,0,0,5,7,1,0,8,12,2,0,14,19,2,0,21,21,2,0,23
125917,135,"SCOALA GENERALA CHINTESTI",CHINTEŞTI,OT,213,0,4,0,4,4,7,0,11,7,7,0,14,13,7,0,20,14,8,0,22
125944,136,"ŞCOALA GIMNAZIALĂ CU CLASELE I-VIII",LEOTEŞTI,OT,1269,9,1,0,10,22,2,0,24,30,2,0,32,45,3,0,48,52,4,0,56
125971,137,"ŞCOALA GENERALĂ CU CLASELE I-VIII BRASTAVĂŢU",BRASTAVĂŢU,OT,1303,7,1,0,8,15,2,0,17,40,2,0,42,64,6,0,70,71,6,0,77
125971,138,"ŞCOALA GENERALĂ CU CLASELE I-VIII BRASTAVĂŢU",BRASTAVĂŢU,OT,1428,11,1,0,12,17,1,0,18,22,1,0,23,44,5,53,102,49,7,53,109
125980,139,"ŞCOALA GENERALĂ CRUŞOVU",CRUŞOVU,OT,902,12,4,0,16,20,7,0,27,35,10,31,76,50,10,31,91,50,10,31,91
126004,140,"ŞCOALA CU CLASELE I-IV BREBENI",BREBENI,OT,924,4,1,3,8,12,2,3,17,13,6,0,19,18,10,0,28,20,10,0,30
126004,141,"ŞCOALA GIMNAZIALĂ BREBENI",BREBENI,OT,1294,9,3,0,12,21,5,0,26,27,8,0,35,36,9,0,45,37,12,0,49
126031,142,"GRĂDINIŢA CU PROGRAM NORMAL BRÎNCOVENI",BRÎNCOVENI,OT,872,20,0,0,20,40,1,0,41,68,2,0,70,79,5,0,84,87,5,0,92
126059,143,"ŞCOALA GIMNAZIALĂ MATEI BASARAB",OCIOGI,OT,913,6,0,0,6,28,3,0,31,37,4,0,41,45,6,0,51,51,6,0,57
126068,144,"GRĂDINIŢA CU PROGRAM NORMAL DOMNIŢA BĂLAŞA",VĂLENI,OT,407,6,0,0,6,14,2,0,16,20,5,0,25,28,8,0,36,36,11,0,47
126086,145,"ŞCOALA GENERALĂ BUCINIŞU",BUCINIŞU,OT,1639,15,3,0,18,29,4,0,33,48,6,0,54,65,6,0,71,98,6,0,104
127830,146,"SCOALA GIMNAZIALA CALUI",CĂLUI,OT,753,11,4,0,15,30,8,0,38,32,8,0,40,53,13,0,66,64,13,0,77
127849,147,"GRADINITA CU PROGRAM NORMAL GURA CALUIU","GURA CĂLUIU",OT,494,4,5,0,9,9,5,0,14,17,5,0,22,51,7,0,58,52,7,0,59
126111,148,"SCOALA GIMANZIALA NICOLAE MARINEANU",CEZIENI,OT,983,15,2,0,17,37,4,0,41,47,9,0,56,59,12,0,71,65,14,0,79
126120,149,"CAMIN CULTURAL",BONDREA,OT,188,13,2,0,15,17,4,0,21,20,4,0,24,24,8,0,32,29,9,0,38
126139,150,"CENTRUL SOCIAL",CORLĂTEŞTI,OT,275,6,2,0,8,17,5,0,22,23,6,0,29,30,8,0,38,35,10,0,45
126157,151,"LICEUL TEHNOLOGIC ION POPESCU CILIENI",CILIENI,OT,1289,8,1,0,9,15,3,0,18,29,3,0,32,44,8,0,52,50,10,0,60
126157,152,"LICEUL TEHNOLOGIC ION POPESCU CILIENI",CILIENI,OT,1393,12,2,0,14,24,4,0,28,40,5,0,45,54,6,0,60,63,6,0,69
126175,153,"SCOALA GIMNAZIALĂ CÎRLOGANI",CÎRLOGANI,OT,1182,7,3,0,10,14,6,0,20,17,8,0,25,25,9,0,34,30,11,0,41
126193,154,"SCOALA GIMNAZIALĂ CEPARI",CEPARI,OT,744,6,1,0,7,12,4,0,16,16,7,0,23,31,7,0,38,34,15,0,49
126237,155,"CAMINUL CULTURAL ILIE MARTIN",COLONEŞTI,OT,595,7,1,0,8,65,10,0,75,85,11,0,96,90,16,17,123,117,21,17,155
126255,156,"GRADINITA CU PROGRAM NORMAL BATARENI",BĂTĂRENI,OT,158,18,9,0,27,24,18,0,42,33,22,0,55,43,32,12,87,51,41,12,104
126291,157,"SCOALA GENERALA MARIA TUDORACHE",MĂRUNŢEI,OT,351,3,1,0,4,8,2,0,10,27,5,15,47,34,11,16,61,59,12,16,87
126317,158,"GRADINITA CU PROGRAM NORMAL VLAICI",VLAICI,OT,281,32,21,0,53,67,43,0,110,98,63,0,161,125,75,0,200,133,77,0,210
126335,159,"ŞCOALA GIMNAZIALĂ CORBU",CORBU,OT,851,14,1,0,15,42,4,0,46,57,9,25,91,99,12,25,136,100,12,25,137
126353,160,"ŞCOALA GIMNAZIALĂ BUZEŞTI",BUZEŞTI,OT,520,3,4,0,7,20,5,0,25,32,8,0,40,47,12,12,71,51,13,12,76
126371,161,"GRĂDINIŢA MILCOVENI",MILCOVENI,OT,360,9,2,0,11,12,4,0,16,17,5,0,22,30,7,9,46,43,8,9,60
126399,162,"ŞCOALA GIMNAZIALĂ COTEANA",COTEANA,OT,953,6,2,0,8,12,2,0,14,27,5,1,33,40,7,1,48,49,7,1,57
126399,163,"ŞCOALA GIMNAZIALĂ COTEANA",COTEANA,OT,917,16,0,0,16,26,2,0,28,36,13,0,49,57,13,4,74,62,13,4,79
126415,164,"LICEUL TEHNOLOGIC CRÎMPOIA",CRÎMPOIA,OT,1116,39,6,0,45,48,7,0,55,53,9,0,62,66,12,0,78,66,12,0,78
126415,165,"LICEUL TEHNOLOGICCRÎMPOIA",CRÎMPOIA,OT,1180,41,4,0,45,50,5,0,55,60,5,0,65,73,5,0,78,79,6,0,85
126424,166,"SCOALA CU CLASELE I-IV BUTA",BUTA,OT,635,3,0,0,3,4,0,0,4,6,0,0,6,11,0,0,11,11,0,0,11
126512,167,"PRIMĂRIE,STR.PRIMĂRIEI,NR.8",CUNGREA,OT,707,0,0,0,0,1,1,0,2,4,1,0,5,9,1,0,10,9,1,0,10
126521,168,"ŞCOALA GIMNAZIALĂ CEPEŞTI",CEPEŞTI,OT,660,5,3,0,8,5,3,0,8,7,3,0,10,14,4,0,18,14,4,0,18
126576,169,"ŞCOALA GIMNAZIALĂ SPĂTARU",SPĂTARU,OT,238,0,0,0,0,0,3,0,3,1,3,0,4,2,4,0,6,2,5,0,7
126442,170,"ŞCOALA CU CLASELE I-VIII CURTIŞOARA",CURTIŞOARA,OT,1317,6,5,0,11,14,11,0,25,20,14,0,34,22,15,0,37,22,15,0,37
126451,171,"ŞCOALA CU CLASELE I-VIII DOBROTINET",DOBROTINET,OT,1339,16,6,0,22,22,8,0,30,27,9,0,36,40,12,0,52,49,14,0,63
126488,172,"ŞCOALA CU CLASELE I-IV PROASPEŢI",PROASPEŢI,OT,968,7,0,0,7,14,2,0,16,18,3,0,21,32,6,0,38,38,6,0,44
126594,173,"CAMINUL CULTURAL DANEASA",DĂNEASA,OT,1173,16,4,0,20,49,9,0,58,72,16,0,88,117,24,0,141,131,26,0,157
126601,174,"SCOALA BERINDEI",BERINDEI,OT,442,13,4,0,17,40,9,0,49,55,9,0,64,72,19,0,91,77,19,0,96
126610,175,"GRADINITA CIOFLANU",CIOFLANU,OT,513,2,1,0,3,3,1,0,4,10,5,0,15,26,5,0,31,30,7,0,37
126629,176,"CAMINUL CULTURAL",PESTRA,OT,437,4,0,0,4,6,1,0,7,11,7,0,18,16,8,0,24,16,12,0,28
126638,177,"SCOALA ZANOAGA",ZĂNOAGA,OT,349,2,2,0,4,14,2,0,16,26,5,0,31,28,5,0,33,35,6,0,41
126656,178,"CĂMINUL CULTURAL",DEVESELU,OT,1370,24,8,0,32,39,15,0,54,62,15,0,77,102,17,0,119,109,19,0,128
126665,179,"CĂMINUL CULTURAL",COMANCA,OT,1031,15,2,0,17,26,2,0,28,44,5,0,49,72,5,39,116,80,5,39,124
126656,180,"ASOCIAŢIA LOCATARI NR.5",DEVESELU,OT,235,3,2,0,5,6,3,0,9,8,3,0,11,12,4,0,16,15,4,0,19
126692,181,"CĂMINUL CULTURAL CURTIŞOARA",CURTIŞOARA,OT,620,3,3,0,6,5,4,0,9,12,7,0,19,17,11,0,28,20,11,0,31
126709,182,"CĂMINUL CULTURAL HOREZU",HOREZU,OT,400,3,5,0,8,8,12,0,20,13,12,0,25,25,16,0,41,29,17,0,46
126727,183,"SCOALA GIMNAZIALA DOBROSLOVENI",DOBROSLOVENI,OT,1112,6,0,0,6,15,1,0,16,24,1,0,25,30,1,0,31,38,1,0,39
126736,184,"GRADINITA CU PROGRAM NORMAL FRASINETU",FRĂSINETU,OT,335,5,2,0,7,10,2,0,12,20,2,0,22,27,3,0,30,28,5,0,33
126745,185,"GRADINITA CU PROGRAM NORMAL POTOPINU",POTOPINU,OT,549,7,0,0,7,11,0,0,11,14,0,0,14,17,0,0,17,18,0,0,18
126754,186,"SCOALA CU CLASELE I-VIII RESCA",REŞCA,OT,1004,4,4,0,8,9,5,0,14,15,6,0,21,33,6,0,39,38,7,0,45
126781,187,"CLĂDIREA FOSTĂ BAIE COMUNALĂ",DOBROTEASA,OT,1301,11,2,0,13,12,5,0,17,12,6,0,18,19,7,0,26,25,7,0,32
126861,188,"SCOALA DOBRUN",DOBRUN,OT,598,22,1,0,23,62,3,0,65,86,6,0,92,119,8,0,127,126,8,0,134
126870,189,"ȘCOALA ROȘIENII MARI","ROŞIENII MARI",OT,618,12,3,0,15,25,4,0,29,50,5,0,55,101,9,0,110,108,9,0,117
125506,190,"ŞCOALA GENERALĂ CU CLASELE I-VIII DRĂGHICENI",DRĂGHICENI,OT,1519,7,1,0,8,14,2,0,16,25,3,0,28,30,4,0,34,36,7,0,43
126914,191,"ŞCOALA GIMNAZIALĂ FĂGEŢELU",FĂGEŢELU,OT,444,0,2,0,2,6,15,0,21,9,17,0,26,13,19,0,32,13,19,0,32
126932,192,"ŞCOALA CU CLASELE I-VIII CHILIA",CHILIA,OT,254,4,1,0,5,5,2,0,7,7,6,0,13,14,9,0,23,17,11,0,28
126987,193,"ŞCOALA CU CLASELE I-VIII FĂLCOIU",FĂLCOIU,OT,979,5,0,0,5,22,1,0,23,35,1,0,36,53,1,0,54,56,2,0,58
126987,194,"ŞCOALA CU CLASELE I-VIII FĂLCOIU",FĂLCOIU,OT,1051,5,0,0,5,20,4,0,24,25,5,0,30,39,5,0,44,41,5,0,46
127001,195,"ŞCOALA CU CLASELE I-VIII CIOROIU",CIOROIAŞU,OT,1081,9,1,0,10,15,2,0,17,32,2,0,34,49,3,0,52,49,3,0,52
127028,196,"GRADINITA FARCASELE",FĂRCAŞELE,OT,967,14,1,0,15,16,3,0,19,22,5,0,27,31,6,0,37,32,7,0,39
127037,197,"GRADINITA FARCASU DE JOS","FĂRCAŞU DE JOS",OT,1456,8,2,0,10,26,3,0,29,34,4,0,38,53,5,0,58,55,6,0,61
127046,198,"SCOALA GIMNAZIALA FARCASELE",GHIMPAŢI,OT,718,3,0,0,3,12,3,0,15,25,3,0,28,36,5,0,41,41,5,0,46
127055,199,"SCOALA GIMNAZIALA HOTARANI",HOTĂRANI,OT,742,10,1,0,11,15,2,0,17,28,2,0,30,53,5,0,58,58,5,0,63
127073,200,"ŞCOALA GIIMNAZIALĂ GĂNEASA",GĂNEASA,OT,1500,6,0,0,6,14,5,0,19,19,5,0,24,33,8,0,41,42,11,0,53
127082,201,"ŞCOALA GIMNAZIALĂ DRANOVĂŢU",DRANOVĂŢU,OT,905,3,0,0,3,7,2,0,9,17,6,0,23,26,10,0,36,29,11,0,40
127108,202,"ŞCOALA PRIMARĂ IZVORU",IZVORU,OT,571,6,1,0,7,10,5,0,15,11,8,0,19,20,9,0,29,31,10,0,41
125720,203,"CAMIN CULTURAL",GĂVĂNEŞTI,OT,611,9,2,0,11,28,8,0,36,70,12,0,82,102,16,0,118,114,21,0,135
125686,204,"SCOALA CU CLASELE I-VIII BALEASA",BĂLEASA,OT,682,2,7,0,9,5,8,0,13,19,10,0,29,36,12,0,48,44,18,0,62
125702,205,"SCOALA CU CLS.I-IV BROSTENI",BROŞTENI,OT,316,3,3,0,6,12,15,0,27,23,14,0,37,49,16,0,65,58,16,0,74
127741,206,"GRĂDINIŢA CU PROGRAM NORMAL","GHIMPEŢENII NOI",OT,401,4,3,0,7,8,3,0,11,10,3,0,13,11,3,0,14,11,3,0,14
127732,207,"ŞCOALA GIMNAZIALĂ GHIMPEŢENI",GHIMPEŢENI,OT,826,7,4,0,11,11,4,0,15,14,5,0,19,22,6,0,28,26,6,0,32
127135,208,"ŞCOALA CU CLASELE I-VIII GIUVĂRĂŞTI",GIUVĂRĂŞTI,OT,974,11,4,0,15,18,4,0,22,24,5,0,29,33,6,0,39,35,8,0,43
127135,209,"ŞCOALA CU CLASELE I-VIII GIUVĂRĂŞTI",GIUVĂRĂŞTI,OT,917,10,0,0,10,13,0,0,13,20,0,0,20,27,0,0,27,34,0,0,34
125597,210,"GRĂDINIŢA CU PROGRAM NORMAL GÎRCOV",GÎRCOV,OT,1249,11,0,0,11,17,0,0,17,24,0,0,24,41,3,17,61,45,5,17,67
125604,211,"ŞCOALA GENERALĂ URSA",URSA,OT,718,7,1,0,8,17,2,0,19,24,3,5,32,35,3,6,44,36,3,6,45
127153,212,"ŞCOALA GENERALĂ GOSTAVĂŢU",GOSTAVĂŢU,OT,1298,9,1,0,10,20,5,0,25,30,5,0,35,49,8,0,57,50,8,0,58
127162,213,"CĂMINUL CULTURAL SLĂVENI",SLĂVENI,OT,1117,10,3,0,13,21,7,0,28,38,8,0,46,67,14,0,81,74,14,0,88
127180,214,"ŞCOALA GIMNAZIALĂ GRĂDINARI",GRĂDINARI,OT,811,1,1,0,2,12,5,0,17,15,7,0,22,26,7,0,33,35,9,0,44
127199,215,"ŞCOALA PRIMARĂ PETCULEŞTI",PETCULEŞTI,OT,851,9,0,0,9,25,0,0,25,45,0,0,45,96,4,0,100,111,4,0,115
127215,216,"ŞCOALA GENERALĂ I-IV SATU NOU","SATU NOU",OT,229,3,0,0,3,10,1,0,11,12,1,0,13,13,2,0,15,18,9,0,27
129219,217,"CENTRUL SOCIAL GRĂDINILE",GRĂDINILE,OT,1227,7,0,0,7,20,6,0,26,36,6,0,42,62,6,0,68,104,6,0,110
127233,218,"GRĂDINIȚA CU PROGRAM NORMAL",GROJDIBODU,OT,868,6,0,0,6,16,2,0,18,21,4,0,25,28,4,0,32,31,4,0,35
127233,219,"GRĂDINIȚA CU PROGRAM NORMAL",GROJDIBODU,OT,895,6,1,0,7,14,2,0,16,15,2,0,17,19,3,0,22,20,3,0,23
127242,220,"GRĂDINIŢA HOTARU",HOTARU,OT,601,0,0,0,0,2,2,0,4,16,2,0,18,22,6,0,28,27,6,0,33
127956,221,"CĂMIN CULTURAL","GURA PADINII",OT,1459,55,0,0,55,150,5,0,155,180,7,50,237,300,11,53,364,338,17,53,408
127260,222,"SCOALA GIMNAZIALA ADA UMBRA IANCA",IANCA,OT,769,4,0,0,4,15,0,0,15,27,0,0,27,36,0,0,36,37,0,0,37
127260,223,"SCOALA GIMNAZIALA ADA UMBRA IANCA",IANCA,OT,1378,22,0,0,22,61,4,0,65,72,4,0,76,84,12,0,96,107,12,5,124
127279,224,"SCOALA GIMNAZIALA GEORGE VISAN POTELU",POTELU,OT,1014,26,4,0,30,77,10,0,87,126,17,0,143,136,22,0,158,142,25,0,167
127297,225,"SCOALA GENERALA NR 1 IANCU JIANU","IANCU JIANU",OT,1463,9,1,0,10,16,2,0,18,28,3,0,31,46,6,0,52,48,6,0,54
127297,226,"LICEUL IANCU JIANU","IANCU JIANU",OT,1303,8,0,0,8,14,0,0,14,21,0,0,21,25,0,0,25,28,0,0,28
127304,227,"ŞCOALA GIMNAZIALĂ DOBRICENI",DOBRICENI,OT,796,4,0,0,4,12,0,0,12,20,0,0,20,23,3,0,26,28,4,0,32
127331,228,"SCOALA GIMNAZIALA ICOANA",ICOANA,OT,550,13,0,0,13,20,6,0,26,33,12,0,45,58,25,0,83,67,26,0,93
127340,229,"CAMINUL CULTURAL FLORU",FLORU,OT,374,2,3,0,5,14,13,0,27,18,10,0,28,34,15,0,49,35,15,0,50
127359,230,"SCOALA GIMNAZIALA URSOAIA",URSOAIA,OT,558,11,3,0,14,20,6,0,26,32,8,0,40,55,10,0,65,69,20,0,89
127581,231,"BAZA SPORTIVĂ",IPOTEŞTI,OT,1207,15,2,0,17,23,4,0,27,32,4,0,36,42,4,0,46,45,9,0,54
127377,232,"ŞCOALA VECHE",IZBICENI,OT,932,2,0,0,2,3,0,0,3,8,0,0,8,9,0,0,9,10,0,0,10
127377,233,"GRĂDINIŢA CU PROGRAM NORMAL IZBICENI",IZBICENI,OT,1530,4,0,0,4,7,1,0,8,10,1,0,11,15,2,0,17,15,2,0,17
127377,234,"ŞCOALA NOUA",IZBICENI,OT,1404,0,0,0,0,7,1,0,8,16,1,0,17,24,3,0,27,24,3,0,27
127395,235,"LICEUL TEHNOLOGIC IZVOARELE",IZVOARELE,OT,940,3,2,0,5,8,2,0,10,8,2,0,10,12,2,0,14,12,2,0,14
127402,236,"SCOALA GENERALA CU CLASELE I-VIII ALIMANESTI",ALIMĂNEŞTI,OT,1894,5,1,0,6,9,1,0,10,12,1,0,13,17,1,0,18,20,1,0,21
127420,237,CAMINCULTURALLELEASCA,LELEASCA,OT,456,5,3,0,8,13,5,0,18,19,8,0,27,28,8,0,36,29,9,0,38
127466,238,SCOALAGENERALATONESTI,TONEŞTI,OT,295,5,8,0,13,6,8,0,14,7,8,0,15,8,8,0,16,8,8,0,16
127484,239,CAMINULCULTURALURSI,URŞI,OT,398,2,0,0,2,8,1,0,9,10,4,0,14,10,4,0,14,12,4,0,16
127509,240,"ŞCOALA PRIMARĂ VIIŞOARA",MĂRUNŢEI,OT,837,9,4,0,13,10,5,0,15,15,5,0,20,31,7,0,38,31,7,0,38
127509,241,"ŞCOALA CU CLASELE I-VIII MĂRUNŢEI",MĂRUNŢEI,OT,1180,9,0,0,9,13,6,0,19,20,6,0,26,34,6,0,40,34,6,0,40
127518,242,"ŞCOALA CU CLASELE I-VIII BĂLĂNEŞTI",BĂLĂNEŞTI,OT,1150,7,2,0,9,13,2,0,15,15,3,0,18,21,4,0,25,25,6,0,31
127527,243,"ŞCOALA PRIMARĂ MALU-ROŞU","MALU ROŞU",OT,115,1,1,0,2,2,2,0,4,4,4,0,8,5,5,0,10,7,5,0,12
127545,244,"ŞCOALA MIHĂEŞTI",MIHĂEŞTI,OT,688,10,13,0,23,20,22,0,42,26,22,0,48,35,26,0,61,35,26,0,61
127554,245,"ŞCOALA BUSCA",BUŞCA,OT,551,5,0,0,5,7,1,0,8,17,3,0,20,35,8,0,43,35,10,0,45
127607,246,"ŞCOALA GENERALĂ","MILCOVU DIN VALE",OT,199,7,4,0,11,14,4,0,18,22,13,0,35,38,14,0,52,47,14,0,61
127572,247,"CĂMINUL CULTURAL ULMI",ULMI,OT,552,9,3,0,12,21,9,0,30,27,10,0,37,44,12,0,56,45,12,0,57
127590,248,"ŞCOALA GENERALĂ CU CLASELE I-VIII","MILCOVU DIN DEAL",OT,492,1,0,0,1,4,3,0,7,8,4,0,12,17,9,0,26,18,11,0,29
127634,249,"CAMINUL CULTURAL",MORUNGLAV,OT,1217,7,0,0,7,20,3,0,23,23,5,0,28,30,9,0,39,32,9,0,41
127643,250,"SCOALA GENERALA BARASTI",BĂRĂŞTI,OT,287,3,3,0,6,6,3,0,9,9,3,0,12,14,3,0,17,15,3,0,18
127661,251,"SCOALA GENERALA MORUNESTI",MORUNEŞTI,OT,501,6,3,0,9,14,3,0,17,15,3,0,18,25,3,0,28,26,4,0,30
127698,252,"ŞCOALA MOVILENI",MOVILENI,OT,1220,46,4,0,50,229,11,0,240,251,14,0,265,265,20,10,295,323,20,10,353
127705,253,"ŞCOALA BACEA",BACEA,OT,1078,32,0,0,32,73,5,0,78,121,10,0,131,191,18,0,209,192,18,0,210
127698,254,"SCOALA GENERALA MOVILENI ( GRADINITA)",MOVILENI,OT,536,11,0,0,11,72,4,0,76,146,5,0,151,196,6,4,206,210,6,4,220
127723,255,"SCOALA GIMNAZIALA","NICOLAE TITULESCU",OT,996,20,5,0,25,72,6,0,78,85,9,7,101,90,13,28,131,90,15,39,144
127769,256,"ŞCOALA CU CLASELE I-IV OBÎRŞIA",OBÎRŞIA,OT,565,7,1,0,8,16,2,0,18,24,4,0,28,30,4,0,34,37,5,11,53
127778,257,"ŞCOALA CU CLASELE I-IV CÎMPU PĂRULUI","CÎMPU PĂRULUI",OT,258,9,2,0,11,24,4,0,28,35,6,0,41,45,12,0,57,46,12,0,58
127803,258,"ŞCOALA CU CLASELE I-IV TABONU",TABONU,OT,116,4,3,0,7,9,4,0,13,14,4,0,18,18,4,0,22,20,4,0,24
127787,259,"ŞCOALA CU CLASELE I-IV COTENI",COTENI,OT,177,3,1,0,4,5,1,0,6,14,1,0,15,20,1,0,21,23,1,0,24
127796,260,"SCOALA CU CLASELE I-VIII OBARSIA NOUA","OBÎRŞIA NOUĂ",OT,977,6,3,0,9,7,4,0,11,14,8,0,22,24,9,0,33,25,11,10,46
127821,261,"ŞCOALA GIMNAZIALĂ OBOGA",OBOGA,OT,985,12,0,0,12,35,0,0,35,56,8,0,64,128,10,0,138,128,10,0,138
127821,262,"ŞCOALA OBOGA DE JOS",OBOGA,OT,396,16,6,0,22,28,7,0,35,34,11,0,45,74,18,4,96,84,24,4,112
127867,263,"CĂMINUL CULTURAL OPORELU",OPORELU,OT,877,7,1,0,8,14,8,0,22,24,8,0,32,32,10,0,42,36,11,0,47
127910,264,"ŞCOALA GIMNAZIALĂ OPTAŞI MĂGURA",OPTAŞI,OT,1019,26,5,0,31,38,10,0,48,53,17,0,70,83,28,0,111,98,31,0,129
127947,265,"CĂMINUL CULTURAL",ORLEA,OT,1275,13,0,0,13,20,1,0,21,37,4,0,41,52,5,0,57,56,5,0,61
127947,266,"CĂMINUL CULTURAL",ORLEA,OT,614,2,0,0,2,6,0,0,6,9,0,0,9,18,0,0,18,21,0,0,21
126834,267,"ŞCOALA GIMNAZIALĂ OSICA DE JOS","OSICA DE JOS",OT,1274,22,4,0,26,63,10,0,73,90,26,0,116,132,36,0,168,146,47,0,193
127992,268,"CENTRU DE PROMOVARE A SĂNĂTĂŢII",VLĂDULENI,OT,494,3,1,0,4,9,1,0,10,11,2,0,13,14,3,0,17,18,3,0,21
128016,269,"SPATIUL COMERCIAL DUDE GHEORGHE","OSICA DE SUS",OT,975,8,1,0,9,12,2,0,14,17,4,0,21,41,4,0,45,45,5,0,50
128016,270,"ŞCOALA GENERALĂ NR. 2","OSICA DE SUS",OT,1321,1,5,0,6,4,6,0,10,14,7,0,21,41,8,0,49,48,8,0,56
128007,271,"ŞCOALA GENERALĂ GRECI",GRECI,OT,826,5,2,0,7,7,2,0,9,14,4,0,18,29,9,0,38,34,10,0,44
128043,272,"ŞCOALA PRIMARĂ TOMENI",TOMENI,OT,376,2,0,0,2,6,1,0,7,12,1,0,13,26,3,0,29,32,3,0,35
128203,273,"SCOALA GIMNAZIALA OLARI",OLARI,OT,1104,6,5,0,11,11,5,0,16,20,6,0,26,31,6,0,37,31,6,0,37
128187,274,"SCOALA GIMNAZIALA PIRSCOVENI",PÎRŞCOVENI,OT,1346,6,3,0,9,18,7,0,25,31,7,0,38,49,11,0,60,53,12,0,65
128098,275,"CĂMIN CULTURAL","MIERLEŞTII DE SUS",OT,1683,2,1,0,3,3,1,0,4,10,3,0,13,23,5,0,28,30,5,0,35
128230,276,"ŞCOALA GIMNAZIALĂ PLEŞOIU",PLEŞOIU,OT,1314,6,0,0,6,20,5,1,26,25,5,1,31,37,8,1,46,40,8,1,49
128276,277,"ŞCOALA GIMNAZIALĂ DOBA",DOBA,OT,1145,5,2,0,7,14,4,0,18,16,4,0,20,23,8,0,31,28,8,0,36
128310,278,"ŞCOALA GIMNAZIALĂ",POBORU,OT,608,10,3,0,13,21,5,0,26,36,13,0,49,51,20,0,71,57,20,0,77
128338,279,"ŞCOALA GIMNAZIALĂ",CORNĂŢELU,OT,775,7,0,0,7,12,5,0,17,24,5,0,29,34,6,0,40,35,6,0,41
128356,280,"ŞCOALA PRIMARĂ",SEACA,OT,221,0,0,0,0,5,0,0,5,6,0,0,6,26,2,0,28,26,2,0,28
128445,281,"ŞCOALA GENERALĂ CU CLASELE I-IV PRISEACA",PRISEACA,OT,1393,4,0,0,4,12,1,0,13,16,3,0,19,28,6,0,34,28,6,0,34
128481,282,"CĂMIN CULTURAL",RADOMIREŞTI,OT,1074,25,3,0,28,45,11,0,56,101,18,0,119,127,29,0,156,135,31,0,166
128506,283,"ŞCOALĂ VECHE",CRĂCIUNEI,OT,568,14,2,0,16,26,3,0,29,32,6,0,38,44,8,0,52,47,8,0,55
128490,284,"ŞCOALĂ VECHE",CĂLINEŞTI,OT,665,6,1,0,7,17,1,0,18,33,3,0,36,46,5,0,51,49,7,0,56
128515,285,"ŞCOALA POIANA",POIANA,OT,248,14,1,0,15,15,1,0,16,25,8,0,33,39,8,0,47,41,9,0,50
128533,286,"GRĂDINIŢA CU PROGRAM NORMAL REDEA",REDEA,OT,877,10,6,0,16,17,8,0,25,24,8,0,32,36,8,11,55,39,8,11,58
128533,287,"GRĂDINIŢA CU PROGRAM NORMAL REDEA",REDEA,OT,848,6,1,0,7,11,3,0,14,17,4,0,21,30,4,0,34,32,4,20,56
128542,288,"CĂMINUL CULTURAL REDIŞOARA",REDIŞOARA,OT,406,11,5,0,16,24,6,0,30,31,7,0,38,57,11,0,68,65,11,0,76
128551,289,"CĂMINUL CULTURAL VALEA SOARELUI","VALEA SOARELUI",OT,218,4,1,0,5,9,1,0,10,14,1,0,15,21,1,0,22,21,1,0,22
128579,290,"SEDIUL FOSTEI C.A.P.",ROTUNDA,OT,1007,3,1,0,4,10,1,0,11,11,2,0,13,20,2,0,22,28,2,0,30
128579,291,"SEDIUL FOSTEI C.A.P.",ROTUNDA,OT,1262,8,0,0,8,15,2,0,17,23,2,0,25,35,2,0,37,37,3,0,40
128597,292,"ŞCOALA GENERALĂ NR.1",RUSĂNEŞTI,OT,1282,17,2,0,19,38,3,0,41,56,9,0,65,86,12,0,98,96,14,0,110
128597,293,"ŞCOALA GENERALĂ NR.2",RUSĂNEŞTI,OT,1326,15,3,0,18,28,3,0,31,46,6,0,52,54,6,0,60,61,6,0,67
128604,294,"ŞCOALA JIENI",JIENI,OT,971,5,0,0,5,17,0,0,17,25,3,0,28,37,6,0,43,38,6,0,44
127929,295,"ŞCOALA GIMNAZIALĂ FLORIAN DIȚULEASA VITĂNEȘTI",VITĂNEŞTI,OT,873,9,1,0,10,20,2,0,22,36,5,0,41,57,9,0,66,72,13,0,85
127929,296,"ȘCOALA PRIMARĂ BRANIȘTE",VITĂNEŞTI,OT,689,6,1,0,7,20,1,0,21,35,2,0,37,53,8,0,61,60,10,0,70
128622,297,"ŞCOALA GIMNAZIALĂ SCĂRIŞOARA",SCĂRIŞOARA,OT,902,6,0,0,6,10,0,0,10,16,0,0,16,27,0,0,27,28,0,0,28
128622,298,"ŞCOALA GIMNAZIALĂ SCĂRIŞOARA",SCĂRIŞOARA,OT,941,8,0,0,8,20,1,0,21,28,3,0,31,38,5,0,43,45,6,0,51
128631,299,"GRĂDINIŢA CU PROGRAM NORMAL PLĂVICENI",PLĂVICENI,OT,589,6,2,0,8,8,2,0,10,12,4,0,16,21,6,0,27,21,6,0,27
128668,300,"ŞCOALA GIMNAZIALĂ SCHITU",SCHITU,OT,1116,10,1,0,11,22,2,0,24,27,3,0,30,47,8,0,55,65,11,0,76
128686,301,"ŞCOALA GIMNAZIALĂ GRECI",GRECI,OT,733,1,3,0,4,5,4,0,9,9,4,0,13,28,8,0,36,42,9,0,51
128695,302,"ŞCOALA PRIMARĂ LISA",LISA,OT,312,0,0,0,0,4,2,0,6,11,3,0,14,13,4,0,17,14,6,0,20
128873,303,"GRADINITA CU PROGRAM NORMAL SEACA",SEACA,OT,1474,43,9,0,52,53,12,0,65,58,13,0,71,76,13,0,89,80,15,0,95
128891,304,"ŞCOALA GIMNAZIALĂ SÎMBUREŞTI",SÎMBUREŞTI,OT,858,8,5,0,13,18,7,0,25,28,19,0,47,33,25,0,58,38,29,0,67
125383,305,"GRĂDINIŢA SLĂTIOARA",SLĂTIOARA,OT,1109,18,2,0,20,30,2,0,32,47,12,0,59,63,20,0,83,67,20,0,87
125383,306,"GRĂDINIŢA SLĂTIOARA",SLĂTIOARA,OT,1070,10,0,0,10,28,1,0,29,47,5,0,52,77,8,0,85,86,8,0,94
128971,307,"SC GENERALA ALUNISU",ALUNIŞU,OT,373,3,0,0,3,7,5,0,12,12,8,0,20,25,18,0,43,29,20,0,49
129013,308,"SCOALA GENERALA PROFA",PROFA,OT,447,5,4,0,9,11,5,0,16,6,6,0,12,11,6,0,17,13,6,0,19
129022,309,"CAMINUL CULTURAL SPINENI",SPINENI,OT,546,6,3,0,9,22,9,0,31,35,15,0,50,49,18,0,67,54,19,0,73
129059,310,"CAMINUL CULTURAL VIESPESTI",SPRÎNCENATA,OT,1122,5,1,0,6,6,1,0,7,12,3,0,15,19,6,0,25,19,6,0,25
129068,311,"GPN BIRSESTII DE SUS","BÎRSEŞTII DE SUS",OT,339,11,2,0,13,26,4,0,30,28,7,0,35,31,7,0,38,31,7,0,38
129077,312,"SCOALA VECHE FRUNZARU",FRUNZARU,OT,526,2,2,0,4,5,5,0,10,9,8,0,17,13,12,0,25,19,13,0,32
129102,313,"CĂMINUL CULTURAL STOENEŞTI",STOENEŞTI,OT,1046,0,0,1,1,21,2,0,23,30,5,0,35,51,9,0,60,55,11,0,66
129102,314,"ŞCOALA GIMNAZIALĂ DIDU",STOENEŞTI,OT,830,7,3,0,10,18,6,0,24,24,6,0,30,30,6,0,36,34,6,0,40
129120,315,"SCOALA GENERALA",STOICĂNEŞTI,OT,1306,7,0,0,7,23,1,0,24,36,2,0,38,45,3,0,48,48,3,0,51
129120,316,"SCOALA GENERALA",STOICĂNEŞTI,OT,902,9,0,0,9,15,0,0,15,24,0,0,24,29,0,0,29,29,0,0,29
129148,317,"ȘCOALA GIMNAZIALĂ STREJEȘTI",STREJEŞTI,OT,840,7,3,0,10,10,3,0,13,13,4,0,17,29,4,0,33,42,4,0,46
129157,318,"CAMIN C ULTURAL",COLIBAŞI,OT,398,1,3,0,4,4,3,0,7,7,3,0,10,12,6,0,18,18,8,0,26
129175,319,"SCOALA GIMNAZIALA","STREJEŞTII DE SUS",OT,1314,7,1,0,8,15,2,0,17,28,4,0,32,52,7,0,59,61,7,0,68
129193,320,"CAMIN CULTURAL STUDINA",STUDINA,OT,1303,3,3,0,6,14,4,0,18,14,6,0,20,23,7,0,30,28,8,0,36
129237,321,"CAMIN CULTURAL STUDINIȚA",STUDINIŢA,OT,964,11,1,0,12,15,6,0,21,20,7,0,27,31,8,0,39,36,8,0,44
129255,322,"ŞCOALA DUMITRU POPOVICI",ŞERBĂNEŞTI,OT,872,11,0,0,11,20,2,0,22,27,3,0,30,39,9,0,48,47,9,0,56
129255,323,"ŞCOALA DUMITRU POPOVICI",ŞERBĂNEŞTI,OT,850,12,2,0,14,31,12,0,43,33,15,0,48,47,17,0,64,56,20,0,76
129273,324,"GRĂDINIŢA ŞERBĂNEŞTII DE SUS","ŞERBĂNEŞTII DE SUS",OT,630,11,4,0,15,18,5,0,23,18,7,0,25,28,8,0,36,34,8,0,42
128212,325,"ŞCOALA CU CLASELE I-VIII",ŞOPÂRLIŢA,OT,1003,16,0,0,16,27,1,0,28,47,8,0,55,58,9,0,67,62,17,0,79
129291,326,"CĂMIN CULTURAL","ŞTEFAN CEL MARE",OT,971,45,4,0,49,85,11,0,96,105,16,0,121,128,17,0,145,138,18,0,156
129308,327,"GRĂDINIŢA IANCA NOUĂ","IANCA NOUĂ",OT,497,0,0,0,0,5,0,0,5,12,5,0,17,18,5,0,23,28,5,0,33
129326,328,"ŞCOALA GIMNAZIALĂ TĂTULEŞTI",TĂTULEŞTI,OT,430,3,4,0,7,15,10,0,25,35,23,0,58,63,41,0,104,68,44,0,112
129335,329,"ŞCOALA BĂRBĂLAI",BĂRBĂLĂI,OT,180,17,12,0,29,28,15,0,43,35,21,0,56,45,34,0,79,47,34,0,81
129362,330,"ŞCOALA MIRCEŞTI",MIRCEŞTI,OT,136,8,10,0,18,13,19,0,32,19,26,0,45,31,39,0,70,33,40,0,73
129406,331,"ŞCOALA GENERALĂ","CHERLEŞTII DIN DEAL",OT,1328,11,3,0,14,28,8,0,36,39,13,0,52,62,13,0,75,69,17,0,86
129424,332,"ŞCOALA GENERALĂ COMĂNIŢA",COMĂNIŢA,OT,775,11,2,0,13,21,5,0,26,30,5,0,35,32,5,0,37,39,10,0,49
129497,333,GRADINITA,POTLOGENI,OT,1279,5,0,0,5,11,1,0,12,19,1,0,20,33,1,0,34,35,1,0,36
129479,334,GRADINITA,"TIA MARE",OT,1268,12,0,0,12,18,0,0,18,30,1,0,31,50,1,0,51,55,7,0,62
129488,335,"SCOALA GIMNAZIALA",DOANCA,OT,1048,2,0,0,2,12,3,0,15,16,3,0,19,22,5,0,27,27,5,0,32
129512,336,"SCOALA GIMNAZIALA TOPANA",TOPANA,OT,287,6,2,0,8,19,4,0,23,19,8,0,27,21,10,0,31,21,10,0,31
129530,337,"SCOALA CANDELESTI",CÎNDELEŞTI,OT,77,1,2,0,3,1,3,0,4,1,3,0,4,1,3,0,4,5,3,0,8
129549,338,"SCOALA GOJGAREI",COJGĂREI,OT,128,3,3,0,6,6,7,0,13,11,7,0,18,13,7,0,20,15,9,0,24
129558,339,"SCOALA UNGURENI",UNGURENI,OT,99,1,5,0,6,2,5,0,7,2,5,0,7,5,5,0,10,5,5,0,10
129576,340,"ŞCOALA GIMNAZIALĂ TRAIAN",TRAIAN,OT,1170,12,0,0,12,20,0,0,20,36,0,0,36,54,0,0,54,55,0,0,55
129576,341,"ŞCOALA GIMNAZIALĂ TRAIAN",TRAIAN,OT,1342,11,0,0,11,28,0,0,28,37,3,0,40,63,4,0,67,71,6,0,77
129594,342,"LICEUL TEHNOLOGIC TUFENI",TUFENI,OT,1247,2,3,0,5,18,6,0,24,20,7,0,27,28,10,0,38,31,11,0,42
129610,343,"ŞCOALA STOBORĂŞTI",STOBORĂŞTI,OT,962,8,0,0,8,13,2,0,15,20,2,0,22,24,4,0,28,24,5,0,29
129638,344,"SCOALA NOUA CU CLASELE I- VIII URZICA",URZICA,OT,1185,5,2,0,7,11,2,0,13,16,2,0,18,24,2,0,26,28,2,0,30
129647,345,"SEDIUL FOSTEI FERME NR 3 STAVARU",STĂVARU,OT,615,6,0,0,6,14,1,0,15,20,2,0,22,26,4,0,30,31,4,0,35
129665,346,"SCOALA GIMNAZIALA","VALEA MARE",OT,1287,6,2,0,8,14,4,0,18,20,6,0,26,22,7,0,29,28,7,0,35
129683,347,"SCOALA GIMNAZIALA",RECEA,OT,557,7,6,0,13,13,6,0,19,17,6,0,23,26,6,0,32,30,7,0,37
129674,348,"CAMINUL CULTURAL",BÎRCA,OT,649,8,5,0,13,35,12,0,47,38,12,0,50,57,16,0,73,68,16,0,84
129692,349,GRADINITA,TURIA,OT,506,11,3,0,14,29,5,0,34,38,6,0,44,51,10,0,61,55,10,0,65
129736,350,"CĂMINUL CULTURAL",VĂDASTRA,OT,1172,20,0,0,20,50,2,0,52,90,5,0,95,145,15,0,160,173,22,0,195
129754,351,"CĂMINUL CULTURAL",VĂDĂSTRIŢA,OT,1139,7,9,0,16,18,40,0,58,25,56,0,81,43,83,0,126,48,83,0,131
129754,352,"CĂMINUL CULTURAL",VĂDĂSTRIŢA,OT,1559,7,3,0,10,15,14,0,29,22,38,0,60,48,41,0,89,60,41,0,101
129772,353,"ŞCOALA GENERALĂ VĂLENI",VĂLENI,OT,802,10,3,0,13,17,6,0,23,23,7,0,30,39,11,0,50,42,11,0,53
129772,354,"ŞCOALA GENERALĂ VĂLENI",VĂLENI,OT,882,3,1,0,4,14,1,0,15,16,1,0,17,20,2,0,22,22,2,0,24
129781,355,"ŞCOALA GENERALĂ MANDRA",MANDRA,OT,518,11,0,0,11,27,0,0,27,42,0,0,42,55,3,0,58,57,5,0,62
129861,356,"CĂMINUL CULTURAL POGANU",POGANU,OT,875,3,3,0,6,8,4,0,12,18,6,0,24,22,11,0,33,27,14,0,41
129834,357,"SCOALA CU CLASELE I-IV CAZANESTI",CĂZĂNEŞTI,OT,730,1,0,0,1,5,0,0,5,5,0,0,5,12,4,0,16,15,6,0,21
129852,358,"ŞCOALA GENERALĂ I-IV",DUMITREŞTI,OT,623,2,2,0,4,6,3,0,9,8,6,0,14,10,7,0,17,15,8,0,23
129905,359,"GRĂDINIŢA DE COPII",VIŞINA,OT,1115,14,2,0,16,30,2,0,32,36,2,0,38,52,9,0,61,61,11,0,72
129905,360,"GRĂDINIŢA DE COPII",VIŞINA,OT,1302,16,2,0,18,31,3,0,34,52,6,0,58,79,6,0,85,92,10,37,139
129727,361,"BIBLIOTECA COMUNALĂ","VIŞINA NOUĂ",OT,1446,11,0,0,11,20,3,0,23,37,3,0,40,41,6,0,47,45,8,0,53
129923,362,"LICEUL TEHNOLOGIC VITOMIRESTI",VITOMIREŞTI,OT,417,2,1,0,3,6,3,0,9,8,8,2,18,12,15,2,29,12,15,2,29
129932,363,"SCOALA CU CLASELE I-IV BULIMANU",BULIMANU,OT,174,1,1,0,2,1,3,0,4,5,6,0,11,7,8,0,15,8,8,0,16
129941,364,"GRADINITA CU PROGRAM NORMAL DEJESTI",DEJEŞTI,OT,584,9,1,0,10,14,1,0,15,22,2,0,24,33,3,0,36,35,3,0,38
129950,365,"SCOALA CU CLASELE I-IV DONESTI",DONEŞTI,OT,184,1,0,0,1,1,0,0,1,3,0,0,3,3,0,3,6,3,0,3,6
129978,366,"SCOALA CU CLASELE I-IV TREPTENI",TREPTENI,OT,281,3,2,0,5,3,6,0,9,3,6,0,9,11,38,0,49,12,39,0,51
129996,367,"ȘCOALA VÎLCELE",VÎLCELE,OT,1324,12,4,0,16,32,13,0,45,52,18,10,80,62,22,10,94,70,30,10,110
130008,368,"ȘCOALA GENERALĂ",BĂRCĂNEŞTI,OT,620,5,6,0,11,20,7,0,27,24,11,0,35,37,13,0,50,38,13,0,51
130035,369,"GRĂDINIȚA CU PROGRAM NORMAL VLĂDILA(CLASA PREGĂTITOARE)",VLĂDILA,OT,913,6,0,0,6,14,1,0,15,20,2,0,22,34,4,0,38,62,6,0,68
130035,370,"GRĂDINIȚA CU PROGRAM NORMAL VLĂDILA (GRUPA MARE)",VLĂDILA,OT,768,11,1,0,12,16,1,0,17,21,1,0,22,31,1,0,32,37,1,0,38
130071,371,"SCOALA CU CLASELE I-VIII VOINEASA",VOINEASA,OT,707,9,1,0,10,20,3,0,23,70,9,0,79,83,12,0,95,94,12,0,106
130099,372,"SCOALA CU CLASELE I-VIII MARGARITESTI",MĂRGĂRITEŞTI,OT,590,11,4,0,15,49,6,0,55,75,11,0,86,120,16,0,136,129,17,0,146
130106,373,"SCOALA CU CLASELE I-IV RACOVITA",RACOVIŢA,OT,438,8,5,0,13,20,18,0,38,37,24,0,61,63,25,0,88,69,25,0,94
130151,374,"SCOALA GIMNAZIALA VULPENI-STRUCTURA GROPSANI",GROPŞANI,OT,663,4,0,0,4,11,0,0,11,27,3,0,30,47,4,0,51,66,7,0,73
130197,375,"FOSTA SC. CU CLASELE I-IV PRISACA",PRISACA,OT,314,9,5,0,14,16,6,0,22,24,6,0,30,35,6,0,41,42,6,0,48
130222,376,"SCOALA GIMNAZIALA VULPENI","VALEA SATULUI",OT,807,9,1,0,10,20,3,0,23,20,8,0,28,23,17,0,40,39,18,0,57
130240,377,"ŞCOALA CU CLASELE I-VIII VULTUREŞTI",VULTUREŞTI,OT,600,2,1,0,3,7,3,0,10,10,3,0,13,15,3,0,18,21,6,0,27
130268,378,"ŞCOALA CU CLASELE I-IV VALEA LUI ALB","VALEA LUI ALB",OT,483,1,1,0,2,6,2,0,8,9,5,0,14,10,5,0,15,14,6,0,20
130259,379,"FOST SEDIU CAP DIENCI",DIENCI,OT,778,6,2,0,8,9,3,0,12,12,8,0,20,18,8,0,26,21,11,0,32
130543,1,"PALATUL CULTURII",PLOIEŞTI,PH,1279,11,0,0,11,46,0,0,46,75,0,0,75,95,0,0,95,101,0,0,101
130543,2,"PALATUL CULTURII",PLOIEŞTI,PH,895,13,2,0,15,49,2,0,51,75,7,0,82,92,9,0,101,98,9,0,107
130543,3,"PALATUL CULTURII",PLOIEŞTI,PH,1074,9,1,0,10,38,2,0,40,53,2,0,55,70,8,0,78,75,10,0,85
130543,4,"COLEGIUL NAŢIONAL ""ALEXANDRU IOAN CUZA""",PLOIEŞTI,PH,1087,15,2,0,17,58,2,0,60,77,11,0,88,93,14,0,107,94,15,0,109
130543,5,"ŞCOALA GIMNAZIALĂ ""ELENA DOAMNA""",PLOIEŞTI,PH,1364,13,5,0,18,54,5,0,59,78,5,0,83,101,6,0,107,109,6,0,115
130543,6,"ŞCOALA GIMNAZIALĂ""ELENA DOAMNA""",PLOIEŞTI,PH,1293,16,0,0,16,52,1,0,53,69,2,0,71,91,4,0,95,108,5,0,113
130543,7,"ŞCOALAGIMNAZIALĂ ""CANDIANO POPESCU""",PLOIEŞTI,PH,1297,8,0,0,8,32,0,0,32,56,3,0,59,72,3,0,75,77,3,0,80
130543,8,"ŞCOALAGIMNAZIALĂ""CANDIANO POPESCU""",PLOIEŞTI,PH,1240,6,0,0,6,25,0,0,25,40,1,0,41,50,1,0,51,53,1,0,54
130543,9,"COLEGIUL NAŢIONAL ""ION LUCA CARAGIALE""",PLOIEŞTI,PH,1513,13,1,0,14,39,4,0,43,51,7,0,58,69,7,0,76,75,8,0,83
130543,10,"COLEGIUL NAŢIONAL ""ION LUCA CARAGIALE""",PLOIEŞTI,PH,1221,10,0,0,10,29,0,0,29,50,5,0,55,84,8,0,92,96,9,0,105
130543,11,"DIRECŢIA JUDEŢEANĂ PENTRU SPORT ŞI TINERET PRAHOVA",PLOIEŞTI,PH,1222,19,0,0,19,56,5,0,61,76,5,0,81,91,5,0,96,95,5,0,100
130543,12,"DIRECŢIA JUDEŢEANĂ PENTRU SPORT ŞI TINERET PRAHOVA",PLOIEŞTI,PH,1352,17,3,0,20,51,3,0,54,69,3,0,72,80,3,23,106,84,3,23,110
130543,13,"LICEUL TEHNOLOGIC UCECOM ""SPIRU HARET"" (FOST GRUPUL SCOLAR DE ARTE SI MESERII ""SPIRU HARET"")",PLOIEŞTI,PH,1175,9,1,0,10,32,2,0,34,44,2,0,46,65,5,0,70,68,5,0,73
130543,14,"ANEXA ŞCOLII GIMNAZIALE ""SFÂNTA VINERI""",PLOIEŞTI,PH,1021,9,2,0,11,42,3,0,45,63,3,0,66,81,3,0,84,83,4,0,87
130543,15,"MUZEUL JUDEŢEAN DE ISTORIE ŞI ARHEOLOGIE PRAHOVA",PLOIEŞTI,PH,818,14,1,0,15,42,7,0,49,50,8,0,58,55,10,0,65,70,10,0,80
130543,16,"COLEGIUL NAŢIONAL ""MIHAI VITEAZUL""",PLOIEŞTI,PH,702,7,0,0,7,29,10,0,39,51,11,0,62,59,12,0,71,63,12,0,75
130543,17,"CLUBUL SPORTIV ŞCOLAR",PLOIEŞTI,PH,914,10,0,0,10,28,0,0,28,55,1,0,56,78,1,0,79,88,1,0,89
130543,18,"S.C. ""ELECTRICA"" S.A.",PLOIEŞTI,PH,1169,15,5,0,20,38,6,0,44,51,6,0,57,68,9,0,77,77,9,0,86
130543,19,"GRĂDINIŢA CU PROGRAM PRELUNGIT NR. 28 (GRADINITA NR. 28)",PLOIEŞTI,PH,987,7,0,0,7,28,1,0,29,46,4,0,50,54,5,0,59,60,5,0,65
130543,20,"OCOLUL SILVIC",PLOIEŞTI,PH,1436,10,1,0,11,27,3,0,30,42,5,0,47,54,5,0,59,60,5,0,65
130543,21,"OCOLUL SILVIC",PLOIEŞTI,PH,1604,11,0,0,11,41,4,0,45,59,4,0,63,75,4,0,79,80,4,0,84
130543,22,"ŞCOALAGIMNAZIALĂ ""NICOLAE TITULESCU""",PLOIEŞTI,PH,1280,10,0,0,10,42,2,0,44,58,5,0,63,68,5,0,73,70,5,0,75
130543,23,"ŞCOALAGIMNAZIALĂ ""NICOLAE TITULESCU""",PLOIEŞTI,PH,1421,12,3,0,15,46,5,0,51,62,5,0,67,81,5,0,86,85,5,0,90
130543,24,"ANEXA LICEULUI TEHNOLOGIC DE TRANSPORTURI (ANEXA GRUP SCOLAR INDUSTRIAL TRANSPORTURI (FOST LICEUL AUTO))",PLOIEŞTI,PH,1654,19,7,0,26,49,7,0,56,72,7,0,79,100,8,0,108,114,9,0,123
130543,25,"ŞCOALAGIMNAZIALĂ ""SFÂNTUL VASILE""",PLOIEŞTI,PH,1482,14,0,0,14,62,3,0,65,82,5,0,87,107,6,0,113,111,6,0,117
130543,26,"ŞCOALAGIMNAZIALĂ ""SFÂNTUL VASILE""",PLOIEŞTI,PH,1351,13,0,0,13,49,0,0,49,81,2,0,83,97,4,0,101,114,7,0,121
130543,27,"ŞCOALAGIMNAZIALĂ ""SFÂNTUL VASILE""",PLOIEŞTI,PH,1327,15,0,0,15,47,1,0,48,72,3,0,75,94,4,0,98,101,4,0,105
130543,28,"ŞCOALAGIMNAZIALĂ""SFÂNTUL VASILE""",PLOIEŞTI,PH,1279,6,0,0,6,29,0,0,29,47,0,0,47,63,2,0,65,67,5,0,72
130543,29,"ŞCOALA GIMNAZIALĂ NR. 13 (FOSTA ŞCOALĂ GIMNAZIALĂ""DIMITRIE BOLINTINEANU"")",PLOIEŞTI,PH,1167,20,1,0,21,52,3,0,55,53,4,0,57,87,4,0,91,100,4,0,104
130543,30,"ŞCOALA GIMNAZIALĂ NR. 13 (FOSTA ŞCOALĂ GIMNAZIALĂ""DIMITRIE BOLINTINEANU"")",PLOIEŞTI,PH,1025,12,0,0,12,41,0,0,41,63,1,0,64,89,2,0,91,89,2,0,91
130543,31,"S.C. TRANSPORT CĂLĂTORI EXPRESS S.A.",PLOIEŞTI,PH,1627,4,0,0,4,22,0,0,22,35,0,0,35,57,0,0,57,59,0,0,59
130543,32,"S.C. TRANSPORT CĂLĂTORI EXPRESS S.A.",PLOIEŞTI,PH,1207,11,0,0,11,43,4,0,47,58,4,0,62,79,5,0,84,82,6,0,88
130543,33,"S.C. TRANSPORT CĂLĂTORI EXPRESS S.A.",PLOIEŞTI,PH,1067,8,0,0,8,21,0,0,21,42,0,0,42,49,0,0,49,50,0,0,50
130543,34,"ȘCOALA GIMNAZIALĂ ""CANDIANO POPESCU"" PLOIEȘTI",PLOIEŞTI,PH,1601,13,2,0,15,33,3,0,36,49,5,0,54,65,5,0,70,67,5,0,72
130543,35,"ŞCOALA GIMNAZIALĂ ""ANTON PANN""",PLOIEŞTI,PH,1262,6,0,0,6,22,0,0,22,27,0,0,27,36,3,0,39,40,3,0,43
130543,36,"ŞCOALA GIMNAZIALĂ ""ANTON PANN""",PLOIEŞTI,PH,1441,17,1,0,18,24,1,0,25,35,1,0,36,44,1,0,45,47,1,0,48
130543,37,"ŞCOALA GIMNAZIALĂ ""ANTON PANN""",PLOIEŞTI,PH,804,2,5,0,7,5,5,0,10,17,5,0,22,28,5,0,33,30,5,0,35
130543,38,"ȘCOALA GIMNAZIALĂ ""ANTON PANN""",PLOIEŞTI,PH,1547,5,3,0,8,21,4,0,25,31,4,0,35,42,4,0,46,44,4,0,48
130543,39,"BLOCUL 24B PARTER",PLOIEŞTI,PH,1380,9,2,0,11,35,7,0,42,49,12,0,61,70,12,0,82,79,12,0,91
130543,40,"CANTINA DE AJUTOR SOCIAL",PLOIEŞTI,PH,1481,14,1,0,15,50,1,0,51,63,1,0,64,101,1,0,102,111,1,0,112
130543,41,"CANTINA DE AJUTOR SOCIAL",PLOIEŞTI,PH,1514,13,3,0,16,42,3,0,45,59,4,0,63,79,4,0,83,90,4,0,94
130543,42,"CANTINA DE AJUTOR SOCIAL",PLOIEŞTI,PH,1357,17,0,0,17,50,2,0,52,61,2,0,63,74,2,0,76,84,2,0,86
130543,43,"GHIŞEUL NR. 2 - OFICIUL POŞTAL PLOIEŞTI 1",PLOIEŞTI,PH,1479,16,1,0,17,56,1,0,57,93,3,0,96,124,5,0,129,128,5,0,133
130543,44,"LICEUL TEHNOLOGIC ""LUDOVIC MRAZEK"" (FOST GRUP SCOLAR TELEAJEN)",PLOIEŞTI,PH,1135,2,0,0,2,13,4,0,17,17,5,0,22,30,5,0,35,35,5,0,40
130543,45,"GRĂDINIŢA CU PROGRAM NORMAL NR. 4 (FOSTA GRADINITA DE COPII NR. 4)",PLOIEŞTI,PH,802,6,2,0,8,18,3,0,21,32,3,0,35,40,5,0,45,49,5,0,54
130543,46,"ŞCOALAGIMNAZIALĂ ""IOAN GRIGORESCU""",PLOIEŞTI,PH,1208,16,0,0,16,40,5,0,45,52,5,0,57,71,5,0,76,77,5,0,82
130543,47,"ŞCOALAGIMNAZIALĂ ""IOAN GRIGORESCU""",PLOIEŞTI,PH,1128,8,5,0,13,19,5,0,24,28,6,0,34,36,6,0,42,40,6,0,46
130543,48,"ŞCOALAGIMNAZIALĂ""IOAN GRIGORESCU""",PLOIEŞTI,PH,1283,12,0,0,12,36,0,0,36,58,0,0,58,75,1,0,76,81,1,0,82
130543,49,"ŞCOALAGIMNAZIALĂ ""RAREŞ VODĂ""",PLOIEŞTI,PH,1013,8,7,0,15,33,7,0,40,58,9,0,67,80,9,0,89,86,12,0,98
130543,50,"CASA CORPULUI DIDACTIC",PLOIEŞTI,PH,1145,12,3,0,15,36,4,0,40,59,4,0,63,78,7,0,85,97,7,0,104
130543,51,"CASA CORPULUI DIDACTIC",PLOIEŞTI,PH,862,8,0,0,8,27,1,0,28,33,1,0,34,43,1,0,44,49,1,0,50
130543,52,"COLEGIUL NAŢIONAL ""JEAN MONNET""",PLOIEŞTI,PH,1168,11,0,0,11,26,0,0,26,42,0,0,42,69,4,0,73,77,6,0,83
130543,53,"LICEUL TEHNOLOGIC ADMINISTRATIV ŞI DESERVICII ""VICTOR SLĂVESCU"" ( FOSTA SCOALA NR. 32)",PLOIEŞTI,PH,1170,8,0,0,8,35,0,0,35,58,6,0,64,70,9,0,79,82,13,0,95
130543,54,"LICEUL TEHNOLOGIC ADMINISTRATIV ŞI DE SERVICII ""VICTOR SLĂVESCU"" ( FOSTA SCOALA NR. 32)",PLOIEŞTI,PH,1130,13,0,0,13,39,0,0,39,70,6,0,76,91,6,0,97,96,6,0,102
130543,55,"ŞCOALA GIMNAZIALĂ ""GEORGE COŞBUC""",PLOIEŞTI,PH,1254,24,0,0,24,57,6,0,63,86,6,0,92,103,6,0,109,111,8,0,119
130543,56,"ŞCOALA GIMNAZIALĂ ""GEORGE COŞBUC""",PLOIEŞTI,PH,1302,9,3,0,12,30,4,0,34,44,5,0,49,60,5,0,65,70,6,0,76
130543,57,"ŞCOALA GIMNAZIALĂ SPECIALĂ NR. 1",PLOIEŞTI,PH,1181,2,1,0,3,12,2,0,14,17,2,0,19,36,2,0,38,38,2,0,40
130543,58,"ŞCOALA GIMNAZIALĂ SPECIALĂ NR. 1",PLOIEŞTI,PH,839,14,2,0,16,20,3,0,23,30,3,0,33,42,5,0,47,50,6,0,56
130543,59,"LICEUL TEHNOLOGIC""1 MAI""",PLOIEŞTI,PH,1553,12,0,0,12,52,0,0,52,74,1,0,75,88,1,0,89,95,1,0,96
130543,60,"LICEUL TEHNOLOGIC ""1 MAI""",PLOIEŞTI,PH,1681,10,4,0,14,35,5,0,40,51,6,0,57,63,7,0,70,71,11,0,82
130543,61,"COLEGIUL TEHNIC ""LAZĂR EDELEANU""(FOST LICEUL DE CHIMIE)",PLOIEŞTI,PH,1314,14,3,0,17,40,3,0,43,53,3,0,56,86,3,0,89,87,3,0,90
130543,62,"COLEGIUL TEHNIC ""LAZĂR EDELEANU""(FOST LICEUL DE CHIMIE)",PLOIEŞTI,PH,1668,10,4,0,14,40,4,0,44,52,5,0,57,75,5,0,80,86,5,0,91
130543,63,"ŞCOALA GIMNAZIALĂ ""MIHAI EMINESCU""",PLOIEŞTI,PH,1287,23,1,0,24,55,5,0,60,68,9,0,77,81,9,0,90,93,10,0,103
130543,64,"ŞCOALA GIMNAZIALĂ ""MIHAI EMINESCU""",PLOIEŞTI,PH,1396,16,2,0,18,51,5,0,56,74,6,0,80,81,10,0,91,91,14,0,105
130543,65,"ŞCOALA NR. 19",PLOIEŞTI,PH,1349,10,0,0,10,26,0,0,26,50,0,0,50,57,4,0,61,63,4,0,67
130543,66,"ŞCOALA GIMNAZIALĂ""RADU STANIAN""",PLOIEŞTI,PH,1038,16,0,0,16,62,0,0,62,89,2,0,91,119,3,0,122,126,3,0,129
130543,67,"COLEGIUL DE ARTĂ ""CARMEN SYLVA""",PLOIEŞTI,PH,957,5,0,0,5,32,0,0,32,41,0,0,41,59,0,0,59,66,0,0,66
130543,68,"COLEGIUL DE ARTĂ ""CARMEN SYLVA""",PLOIEŞTI,PH,801,6,6,0,12,20,8,0,28,27,9,0,36,42,11,0,53,51,11,0,62
130543,69,"S.C.APA NOVA S.R.L.",PLOIEŞTI,PH,1063,10,0,0,10,34,2,0,36,61,2,0,63,77,2,0,79,81,3,0,84
130543,70,"S.C.APA NOVA S.R.L.",PLOIEŞTI,PH,863,3,6,0,9,8,6,0,14,16,8,0,24,32,9,0,41,32,10,0,42
130543,71,"COLEGIUL ""SPIRU HARET""(FOST LICEUL DE CONSTRUCTII MASINI)",PLOIEŞTI,PH,947,17,1,0,18,33,1,0,34,49,2,233,284,64,4,233,301,64,5,233,302
130543,72,"ŞCOALAGIMNAZIALĂ ""FLORIN COMIŞEL""",PLOIEŞTI,PH,1383,12,0,0,12,45,0,0,45,79,0,0,79,93,0,0,93,99,3,0,102
130543,73,"PALATUL COPIILOR (FOSTA SCOALA NR. 20)",PLOIEŞTI,PH,1567,11,6,0,17,46,10,0,56,71,12,0,83,88,13,0,101,103,13,0,116
130543,74,"PALATUL COPIILOR (FOSTA SCOALA NR. 20)",PLOIEŞTI,PH,1266,10,6,0,16,49,8,0,57,68,8,0,76,92,8,0,100,96,8,0,104
130543,75,"PALATUL COPIILOR (FOSTA SCOALA NR. 20)",PLOIEŞTI,PH,1418,16,0,0,16,50,0,0,50,65,1,0,66,83,1,0,84,91,1,0,92
130543,76,"PALATUL COPIILOR (FOSTA SCOALA NR. 20)",PLOIEŞTI,PH,853,9,1,0,10,20,1,0,21,25,2,0,27,32,2,0,34,33,3,0,36
130543,77,"PALATUL COPIILOR (FOSTA SCOALA NR. 20)",PLOIEŞTI,PH,982,2,1,0,3,15,1,0,16,42,3,0,45,44,4,0,48,47,4,0,51
130543,78,"ŞCOALAGIMNAZIALĂ ""I. A. BASSARABESCU"" (ŞCOALAGIMNAZIALĂ I. A. BASARABESCU)",PLOIEŞTI,PH,1542,21,0,0,21,42,5,0,47,69,5,0,74,93,5,0,98,104,5,0,109
130543,79,"ŞCOALAGIMNAZIALĂ ""I. A. BASSARABESCU"" (ŞCOALAGIMNAZIALĂ I. A. BASARABESCU)",PLOIEŞTI,PH,1423,13,0,0,13,35,1,0,36,43,1,0,44,59,1,0,60,62,1,0,63
130543,80,"ŞCOALAGIMNAZIALĂ ""I. A. BASSARABESCU"" (ŞCOALAGIMNAZIALĂ I. A. BASARABESCU)",PLOIEŞTI,PH,1899,18,2,0,20,45,3,0,48,76,6,0,82,112,8,0,120,121,9,0,130
130543,81,"ŞCOALAGIMNAZIALĂ ""I. A. BASSARABESCU"" (ŞCOALAGIMNAZIALĂ I. A. BASARABESCU)",PLOIEŞTI,PH,1517,12,2,0,14,39,3,0,42,60,4,17,81,89,6,17,112,96,6,17,119
130543,82,"DIRECŢIAGENERALĂ DE ASISTENŢĂ SOCIALĂ ŞI PROTECŢIA COPILULUI PRAHOVA",PLOIEŞTI,PH,1359,6,4,0,10,49,4,0,53,59,5,0,64,78,6,0,84,81,6,0,87
130543,83,"DIRECŢIA GENERALĂ DE ASISTENŢĂ SOCIALĂ ŞI PROTECŢIA COPILULUI PRAHOVA",PLOIEŞTI,PH,1371,20,1,0,21,51,6,0,57,72,6,0,78,101,6,0,107,109,8,0,117
130543,84,"ŞCOALA GIMNAZIALĂ ""GEORGE EMIL PALADE""",PLOIEŞTI,PH,1356,20,0,0,20,48,2,0,50,73,2,0,75,92,3,0,95,100,3,0,103
130543,85,"ŞCOALA GIMNAZIALĂ ""GEORGE EMIL PALADE""",PLOIEŞTI,PH,1297,5,0,0,5,19,0,0,19,39,0,0,39,56,5,0,61,58,5,0,63
130543,86,"ŞCOALA GIMNAZIALĂ ""GEORGE EMIL PALADE""",PLOIEŞTI,PH,1382,11,0,0,11,32,5,0,37,56,5,0,61,67,6,0,73,71,6,0,77
130543,87,"ŞCOALA GIMNAZIALĂ ""GEORGE EMIL PALADE""",PLOIEŞTI,PH,1237,19,0,0,19,37,0,0,37,66,0,0,66,75,0,0,75,79,0,0,79
130543,88,"GRĂDINIŢA CU PROGRAM NORMAL NR. 50 (FOSTA GRĂDINIŢĂ NR. 50)",PLOIEŞTI,PH,1103,8,0,0,8,42,0,0,42,61,1,0,62,92,1,0,93,104,2,0,106
130543,89,"GRĂDINIŢA CU PROGRAM NORMAL NR. 50 (FOSTA GRĂDINIŢĂ NR. 50)",PLOIEŞTI,PH,1232,13,0,0,13,38,0,0,38,51,1,0,52,60,2,0,62,65,2,0,67
130543,90,"GRĂDINIŢA CU PROGRAM PRELUNGIT NR. 40 ( FOSTA GRĂDINIŢĂ NR. 40)",PLOIEŞTI,PH,1191,16,0,0,16,36,0,0,36,52,0,0,52,68,0,0,68,77,0,0,77
130543,91,"GRĂDINIŢA CU PROGRAM PRELUNGIT NR. 40 ( FOSTA GRĂDINIŢĂ NR. 40)",PLOIEŞTI,PH,948,8,3,0,11,53,5,0,58,57,5,0,62,73,5,0,78,77,5,0,82
130543,92,"GRĂDINIŢA CU PROGRAM PRELUNGIT NR. 40 ( FOSTA GRĂDINIŢĂ NR. 40)",PLOIEŞTI,PH,1442,17,3,0,20,53,3,0,56,77,4,0,81,96,5,0,101,105,5,0,110
130543,93,"ŞCOALA GIMNAZIALĂ ""TOMA CARAGIU""",PLOIEŞTI,PH,1139,7,0,0,7,23,1,0,24,47,2,0,49,63,2,0,65,67,2,0,69
130543,94,"ŞCOALA GIMNAZIALĂ ""TOMA CARAGIU""",PLOIEŞTI,PH,922,9,6,0,15,29,6,0,35,47,7,0,54,59,9,0,68,67,9,0,76
130543,95,"ŞCOALA GIMNAZIALĂ ""TOMA CARAGIU""",PLOIEŞTI,PH,1354,5,4,0,9,59,4,0,63,107,4,0,111,107,4,0,111,110,6,0,116
130543,96,"ŞCOALA GIMNAZIALĂ ""NICOLAE IORGA""",PLOIEŞTI,PH,1436,4,1,0,5,29,2,0,31,46,2,0,48,57,5,0,62,60,5,0,65
130543,97,"ŞCOALA GIMNAZIALĂ ""NICOLAE IORGA""",PLOIEŞTI,PH,1286,20,0,0,20,54,0,0,54,69,0,0,69,86,0,0,86,94,0,0,94
130543,98,"ŞCOALA GIMNAZIALĂ ""NICOLAE IORGA""",PLOIEŞTI,PH,1342,8,6,0,14,15,6,0,21,32,6,0,38,52,6,0,58,53,6,0,59
130543,99,"GRĂDINIŢA CU PROGRAM NORMAL NR. 39 (FOSTA GRĂDINIŢĂ NR. 39)",PLOIEŞTI,PH,876,0,0,0,0,24,0,0,24,43,0,0,43,50,1,0,51,55,1,0,56
130543,100,"GRĂDINIŢA CU PROGRAM NORMAL NR. 39 (FOSTA GRĂDINIŢĂ NR. 39)",PLOIEŞTI,PH,881,15,3,0,18,30,3,0,33,43,3,0,46,54,3,0,57,59,3,0,62
130543,101,"GRĂDINIŢA CU PROGRAM NORMAL NR. 39 (FOSTA GRĂDINIŢĂ NR. 39)",PLOIEŞTI,PH,1446,9,0,0,9,25,1,0,26,48,4,0,52,56,4,0,60,57,4,0,61
130543,102,"GRĂDINIŢA CU PROGRAM PRELUNGIT ""SF. MUCENIC MINA"" (FOSTA GRĂDINIŢĂ NR. 36 ""SF. MUCENIC MINA"")",PLOIEŞTI,PH,1383,19,2,0,21,68,5,0,73,83,6,0,89,92,6,0,98,92,7,0,99
130543,103,"GRĂDINIŢA CU PROGRAM PRELUNGIT ""SF. MUCENIC MINA"" (FOSTA GRĂDINIŢĂ NR. 36 ""SF. MUCENIC MINA"")",PLOIEŞTI,PH,1516,17,0,0,17,57,3,0,60,76,6,0,82,95,7,0,102,101,8,0,109
130543,104,"GRĂDINIŢA CU PROGRAM PRELUNGIT ""SF. MUCENIC MINA"" (FOSTA GRĂDINIŢĂ NR. 36 ""SF. MUCENIC MINA"")",PLOIEŞTI,PH,1191,14,0,0,14,57,0,0,57,71,0,0,71,90,0,0,90,94,0,0,94
130543,105,"GRĂDINIŢA CU PROGRAM PRELUNGIT ""SF. MUCENIC MINA"" (FOSTA GRĂDINIŢĂ NR. 36 ""SF. MUCENIC MINA"")",PLOIEŞTI,PH,1070,7,0,0,7,37,2,0,39,50,2,0,52,64,2,0,66,67,2,0,69
130543,106,"GRĂDINIŢA CU PROGRAM PRELUNGIT NR. 47 (FOSTA GRĂDINIŢĂ NR. 47)",PLOIEŞTI,PH,962,12,2,0,14,38,3,0,41,49,4,0,53,59,4,0,63,70,4,0,74
130543,107,"GRĂDINIŢA CU PROGRAM PRELUNGIT NR. 47 (FOSTA GRĂDINIŢĂ NR. 47)",PLOIEŞTI,PH,840,7,3,0,10,46,4,0,50,65,4,0,69,76,4,0,80,80,4,0,84
130543,108,"GRĂDINIŢA CU PROGRAM PRELUNGIT NR. 47 (FOSTA GRĂDINIŢĂ NR. 47)",PLOIEŞTI,PH,921,6,0,0,6,20,2,0,22,28,2,0,30,43,3,0,46,47,5,0,52
130543,109,"SISTEMUL DE GOSPODĂRIRE A APELOR PRAHOVA",PLOIEŞTI,PH,1121,8,1,0,9,29,3,0,32,49,3,0,52,64,4,0,68,66,4,0,70
130543,110,"AGENŢIA PENTRU PROTECŢIA MEDIULUI PRAHOVA",PLOIEŞTI,PH,1196,9,1,0,10,38,2,0,40,64,3,0,67,83,3,0,86,92,4,0,96
130543,111,"S.C. EXPLOATARE SISTEM ZONAL PRAHOVA S.A.",PLOIEŞTI,PH,1108,8,6,0,14,34,7,0,41,57,7,0,64,68,8,0,76,72,8,0,80
130543,112,"ŞCOALA GIMNAZIALĂ ""IENĂCHIŢĂVĂCĂRESCU""",PLOIEŞTI,PH,1455,20,3,0,23,51,4,0,55,65,5,0,70,83,6,0,89,88,6,0,94
130543,113,"ŞCOALA GIMNAZIALĂ ""IENĂCHIŢĂVĂCĂRESCU""",PLOIEŞTI,PH,1490,17,1,0,18,64,5,0,69,96,7,0,103,109,8,0,117,114,8,0,122
130543,114,"ŞCOALA GIMNAZIALĂ ""IENĂCHIŢĂVĂCĂRESCU""",PLOIEŞTI,PH,1316,13,2,0,15,44,3,0,47,63,4,0,67,85,5,0,90,97,5,0,102
130543,115,"ŞCOALA GIMNAZIALĂ ""IENĂCHŢĂVĂCĂRESCU""",PLOIEŞTI,PH,950,11,0,0,11,32,0,0,32,43,0,0,43,56,0,0,56,64,0,0,64
130543,116,"COLEGIUL TEHNIC ""TOMA N. SOCOLESCU""",PLOIEŞTI,PH,1019,6,0,0,6,24,0,0,24,30,0,0,30,36,0,0,36,49,0,0,49
130543,117,"COLEGIUL TEHNIC ""TOMA N. SOCOLESCU""",PLOIEŞTI,PH,730,3,0,0,3,13,0,0,13,19,3,0,22,32,5,0,37,32,10,0,42
130543,118,"COLEGIUL TEHNIC ""ELIE RADU""",PLOIEŞTI,PH,1409,7,0,0,7,28,0,0,28,45,2,0,47,59,2,0,61,65,2,0,67
130543,119,"COLEGIUL TEHNIC ""ELIE RADU""",PLOIEŞTI,PH,1467,9,0,0,9,33,1,0,34,60,2,0,62,69,2,0,71,89,2,0,91
130543,120,"COLEGIUL TEHNIC ""ELIE RADU""",PLOIEŞTI,PH,887,4,0,0,4,31,0,0,31,39,1,0,40,53,1,0,54,54,1,0,55
130543,121,"ŞCOALA GIMNAZIALĂ PROFESOR ""NICOLAE SIMACHE""",PLOIEŞTI,PH,1196,12,5,0,17,46,5,0,51,63,5,0,68,87,5,0,92,91,5,0,96
130543,122,"ŞCOALA GIMNAZIALĂ PROFESOR ""NICOLAE SIMACHE""",PLOIEŞTI,PH,1389,11,0,0,11,38,0,0,38,60,3,0,63,76,5,0,81,84,5,0,89
130543,123,"ŞCOALA GIMNAZIALĂ PROFESOR ""NICOLAE SIMACHE""",PLOIEŞTI,PH,1255,9,0,0,9,37,0,0,37,55,0,0,55,69,1,0,70,74,1,0,75
130543,124,"ŞCOALA GIMNAZIALĂ ""NICOLAE BĂLCESCU""",PLOIEŞTI,PH,1456,12,1,0,13,31,1,0,32,55,2,0,57,67,2,0,69,69,2,0,71
130543,125,"ŞCOALA GIMNAZIALĂ ""NICOLAE BĂLCESCU""",PLOIEŞTI,PH,1428,7,0,0,7,51,0,0,51,71,0,0,71,85,0,0,85,85,0,0,85
130543,126,"ŞCOALA GIMNAZIALĂ ""NICOLAE BĂLCESCU""",PLOIEŞTI,PH,1504,20,0,0,20,53,3,0,56,76,5,0,81,102,5,0,107,110,6,0,116
130543,127,"ŞCOALA GIMNAZIALĂ ""NICOLAE BĂLCESCU""",PLOIEŞTI,PH,1143,17,4,0,21,44,4,0,48,68,6,0,74,82,7,0,89,91,7,0,98
130543,128,"GRĂDINIŢA CU PROGRAM NORMAL NR. 10 (FOSTA GRRĂDINIŢĂ DE COPII NR. 10)",PLOIEŞTI,PH,1348,9,0,0,9,30,1,0,31,47,1,0,48,62,4,0,66,73,4,0,77
130543,129,"GRĂDINIŢA CU PROGRAM NORMAL NR. 10 (FOSTA GRRĂDINIŢĂ DE COPII NR. 10)",PLOIEŞTI,PH,960,8,2,0,10,16,2,0,18,29,2,0,31,43,3,0,46,48,3,0,51
130543,130,"GRĂDINIŢA CU PROGRAM NORMAL NR. 10 (FOSTA GRRĂDINIŢĂ DE COPII NR. 10)",PLOIEŞTI,PH,1108,6,0,0,6,24,0,0,24,37,3,0,40,46,3,0,49,56,3,0,59
130543,131,"GRĂDINIȚA CU PROGRAM PRELUNGIT NR. 23",PLOIEŞTI,PH,1065,6,0,0,6,31,0,0,31,41,0,0,41,57,0,0,57,63,0,0,63
130543,132,"ŞCOALA GIMNAZIALĂ ""ION CREANGĂ""",PLOIEŞTI,PH,1385,16,0,0,16,47,1,0,48,64,1,0,65,82,1,0,83,90,1,0,91
130543,133,"ŞCOALA GIMNAZIALĂ ""ION CREANGĂ""",PLOIEŞTI,PH,1281,15,0,0,15,48,0,0,48,69,0,0,69,90,1,0,91,99,3,0,102
130543,134,"ŞCOALA GIMNAZIALĂ ""ION CREANGĂ""",PLOIEŞTI,PH,1257,5,2,0,7,46,2,0,48,64,2,0,66,86,2,0,88,88,4,0,92
130543,135,"ŞCOALA GIMNAZIALĂ ""ION CREANGĂ""",PLOIEŞTI,PH,1208,19,1,0,20,63,5,0,68,82,7,0,89,109,7,0,116,121,8,0,129
130543,136,"ŞCOALA GIMNAZIALĂ ""ION CREANGĂ""",PLOIEŞTI,PH,1324,9,2,0,11,35,2,0,37,63,2,0,65,87,2,0,89,98,2,0,100
130543,137,"ŞCOALA GIMNAZIALĂ ""ANDREI MUREŞANU"" (ŞCOALA GIMNAZIALĂ ""ANDREI MUREŞEANU"")",PLOIEŞTI,PH,1542,15,1,0,16,57,3,0,60,78,6,0,84,107,6,0,113,118,7,0,125
130543,138,"ŞCOALA GIMNAZIALĂ ""ANDREI MUREŞANU"" (ŞCOALA GIMNAZIALĂ ""ANDREI MUREŞEANU)",PLOIEŞTI,PH,1268,10,0,0,10,41,2,0,43,63,3,0,66,77,3,0,80,83,3,0,86
130543,139,"ŞCOALA GIMNAZIALĂ ""ANDREI MUREŞANU"" (ŞCOALA GIMNAZIALĂ ""ANDREI MUREŞEANU)",PLOIEŞTI,PH,986,6,0,0,6,27,0,0,27,38,0,0,38,52,0,0,52,60,0,0,60
130543,140,"ŞCOALA GIMNAZIALĂ ""HENRI MATHIAS BERTHELOT""",PLOIEŞTI,PH,902,22,4,0,26,55,6,0,61,75,7,0,82,89,7,0,96,95,7,0,102
130543,141,"ŞCOALA GIMNAZIALĂ ""HENRI MATHIAS BERTHELOT""",PLOIEŞTI,PH,1196,18,0,0,18,71,0,0,71,83,1,0,84,96,1,0,97,106,1,0,107
130543,142,"ŞCOALA GIMNAZIALĂ ""HENRI MATHIAS BERTHELOT""",PLOIEŞTI,PH,1150,13,1,0,14,41,2,0,43,53,2,0,55,62,4,0,66,68,6,0,74
130543,143,"ŞCOALA GIMNAZIALĂ ""GRIGORE MOISIL""",PLOIEŞTI,PH,1103,14,1,0,15,45,2,0,47,58,2,0,60,65,3,0,68,71,3,0,74
130543,144,"ŞCOALA GIMNAZIALĂ ""GRIGORE MOISIL""",PLOIEŞTI,PH,1115,4,4,0,8,41,4,0,45,52,4,0,56,65,4,0,69,68,4,0,72
130543,145,"COLEGIUL NAŢIONAL ""NICHITA STĂNESCU""",PLOIEŞTI,PH,891,12,0,0,12,36,3,0,39,55,6,0,61,56,7,0,63,70,8,0,78
130543,146,"COLEGIUL NAŢIONAL ""NICHITA STĂNESCU""",PLOIEŞTI,PH,974,14,8,0,22,37,8,0,45,46,10,0,56,54,11,0,65,56,11,0,67
130543,147,"COLEGIUL NAŢIONAL ""NICHITA STĂNESCU""",PLOIEŞTI,PH,977,15,3,0,18,31,6,0,37,50,6,0,56,63,6,0,69,68,6,0,74
130543,148,"COLEGIUL NAŢIONAL ""NICHITA STĂNESCU""",PLOIEŞTI,PH,1322,15,2,0,17,38,3,0,41,60,3,0,63,90,3,0,93,97,3,0,100
130543,149,"ȘCOALA GIMNAZIALĂ ""ANDREI MUREȘANU""",PLOIEŞTI,PH,1395,27,0,0,27,51,0,0,51,66,0,0,66,92,2,0,94,111,2,0,113
130543,150,"ȘCOALA GIMNAZIALĂ ""ANDREI MUREȘANU""",PLOIEŞTI,PH,1386,13,0,0,13,73,0,0,73,94,0,0,94,116,1,0,117,121,1,0,122
130543,151,"LICEUL TEHNOLOGIC DE SERVICII ""SFÂNTUL APOSTOL ANDREI""",PLOIEŞTI,PH,1394,11,0,0,11,45,0,0,45,60,1,0,61,68,1,0,69,73,1,0,74
130543,152,"LICEUL TEHNOLOGIC DE SERVICII ""SFÂNTUL APOSTOL ANDREI""",PLOIEŞTI,PH,1415,11,0,0,11,38,1,0,39,64,2,0,66,82,4,0,86,87,4,0,91
130543,153,"LICEUL TEHNOLOGIC DE SERVICII ""SFÂNTUL APOSTOL ANDREI""",PLOIEŞTI,PH,1374,13,0,0,13,36,0,0,36,54,0,0,54,74,0,0,74,77,0,0,77
130543,154,"LICEUL TEHNOLOGIC DE SERVICII ""SFÂNTUL APOSTOL ANDREI""",PLOIEŞTI,PH,1353,17,1,0,18,58,1,0,59,83,1,0,84,103,1,0,104,113,1,0,114
130543,155,"LICEUL TEHNOLOGIC DE SERVICII ""SFÂNTUL APOSTOL ANDREI""",PLOIEŞTI,PH,1328,23,4,0,27,57,6,0,63,69,6,0,75,87,6,0,93,94,7,0,101
130543,156,"ŞCOALA PRIMARĂ NR. 22 (FOSTA ŞCOALĂ GIMNAZIALĂ ""MITICĂAPOSTOL"")",PLOIEŞTI,PH,1371,6,2,0,8,28,3,0,31,38,3,0,41,54,3,0,57,55,3,0,58
130543,157,"GARA PLOIEŞTI TRIAJ",PLOIEŞTI,PH,172,2,3,0,5,8,7,0,15,10,7,0,17,10,7,0,17,10,8,0,18
131265,158,"CASA DE CULTURĂ ”GEO BOGZA”-(HOL)",CÂMPINA,PH,1364,7,7,0,14,44,9,0,53,67,11,0,78,80,11,0,91,97,12,0,109
131265,159,"COLEGIUL NAŢIONAL“NICOLAE GRIGORESCU” - (SALA DE CLASA)",CÂMPINA,PH,1168,11,3,0,14,40,5,0,45,68,9,0,77,77,9,0,86,85,11,0,96
131265,160,"COLEGIUL NAŢIONAL“NICOLAE GRIGORESCU” - (SALA DE CLASA)",CÂMPINA,PH,1282,8,3,0,11,32,11,0,43,58,16,0,74,70,22,0,92,79,22,0,101
131265,161,"CASA TINERETULUI (HOL MARE)",CÂMPINA,PH,1037,10,0,0,10,40,8,0,48,52,11,0,63,56,11,0,67,59,14,0,73
131265,162,"ŞCOALA GIMNAZIALĂ CENTRALĂ - (SALA DE CLASA)",CÂMPINA,PH,1085,12,4,0,16,34,5,0,39,47,6,0,53,63,12,30,105,67,15,30,112
131265,163,"LICEUL TEHNOLOGIC ENERGETIC-(CORP A-SALA DE CLASA NR.5-INTRAREA SECUNDARA)",CÂMPINA,PH,1086,10,3,0,13,39,3,0,42,54,3,0,57,62,5,0,67,67,5,0,72
131265,164,"LICEUL TEHNOLOGIC ENERGETIC - (CORP A SALA DE CLASA NR.3-INTRAREA PRINCIPALA)",CÂMPINA,PH,906,13,2,0,15,35,3,0,38,39,4,0,43,50,5,0,55,53,5,0,58
131265,165,"ȘCOALA GIMNAZIALĂ ”B.P.HASDEU” - (SALA DE SPORT)",CÂMPINA,PH,1346,15,2,0,17,39,7,0,46,50,8,0,58,68,10,0,78,69,10,0,79
131265,166,"CASA TINERETULUI (HOL MIC)",CÂMPINA,PH,1448,11,0,0,11,35,3,0,38,64,6,0,70,86,8,0,94,92,8,0,100
131265,167,"SC STEAUA ROMÂNĂ S.A. - (CANTINA)",CÂMPINA,PH,1260,8,3,0,11,50,4,0,54,65,6,0,71,78,7,0,85,81,9,0,90
131265,168,"COLEGIUL TEHNIC FORESTIER - (SALA DE SPORT)",CÂMPINA,PH,1240,14,4,0,18,55,5,0,60,82,10,0,92,106,10,0,116,111,11,0,122
131265,169,"COLEGIUL TEHNIC FORESTIER - (SALA DE SPORT)",CÂMPINA,PH,1294,26,0,0,26,57,2,0,59,71,4,0,75,98,4,0,102,108,5,0,113
131265,170,"COLEGIUL TEHNIC CONSTANTIN ISTRATI (CAMIN)",CÂMPINA,PH,1617,15,0,0,15,33,2,0,35,50,2,0,52,80,4,0,84,87,4,0,91
131265,171,"COLEGIUL TEHNIC CONSTANTIN ISTRATI - SALA DE CLASA)",CÂMPINA,PH,1594,8,4,0,12,31,8,21,60,46,13,21,80,72,16,21,109,82,19,21,122
131265,172,"ȘCOALA GENERALĂ NR.5 - (SALA DE CLASA)",CÂMPINA,PH,1207,16,1,0,17,37,3,0,40,53,4,0,57,71,4,0,75,79,4,0,83
131265,173,"LICEUL TEHNOLOGIC MECANIC - (SALA DE SPORT)",CÂMPINA,PH,1574,7,0,0,7,33,0,0,33,61,2,0,63,77,2,0,79,85,2,0,87
131265,174,"LICEUL TEHNOLOGIC MECANIC - (CORP A SALA2)",CÂMPINA,PH,1342,8,0,0,8,38,0,0,38,61,0,0,61,75,0,0,75,86,0,0,86
131265,175,"LICEUL TEHNOLOGIC MECANIC - (CORP A SALA 3)",CÂMPINA,PH,1508,12,2,0,14,39,4,0,43,47,4,0,51,61,6,0,67,66,8,0,74
131265,176,"ȘCOALA GENERALĂ NR.6 - (SALA DE CLASA)",CÂMPINA,PH,1583,14,1,0,15,54,2,0,56,84,7,0,91,101,8,0,109,111,8,0,119
131265,177,"ȘCOALA GIMNAZIALĂ ”ALEXANDRU IOAN CUZA” -(SALA DE CLASA-ETAJ 1)",CÂMPINA,PH,1559,12,3,0,15,42,16,0,58,56,23,0,79,87,27,0,114,96,29,0,125
131265,178,"ȘCOALA GIMNAZIALĂ ”ALEXANDRU IOAN CUZA” - (SALA DE SPORT)",CÂMPINA,PH,1622,18,0,0,18,56,2,0,58,72,9,0,81,88,10,0,98,100,10,0,110
131265,179,"SC ELECTROUTILAJ SA - (CANTINA - SALA DE PROTOCOL)",CÂMPINA,PH,1710,15,0,0,15,31,10,0,41,55,11,0,66,72,11,0,83,91,11,0,102
131265,180,"ȘCOALA GENERALĂ NR.3 - (SALA DE SPORT)",CÂMPINA,PH,1689,18,1,0,19,44,4,0,48,76,5,0,81,87,6,0,93,89,6,0,95
130963,181,"LICEUL TEORETIC AZUGA",AZUGA,PH,1726,11,1,0,12,27,4,0,31,42,9,0,51,68,17,28,113,71,17,28,116
130963,182,"LICEUL TEORETIC AZUGA",AZUGA,PH,1053,3,2,0,5,19,14,0,33,30,15,0,45,33,17,0,50,34,22,0,56
130963,183,"GRĂDINIŢA DE COPII",AZUGA,PH,1234,6,3,0,9,33,6,0,39,45,11,0,56,65,23,0,88,69,25,0,94
130990,184,"SALA DE SPORT TINERETULUI",BĂICOI,PH,1110,16,4,0,20,37,5,18,60,50,5,18,73,61,5,18,84,66,5,18,89
130990,185,"GRADINITA CU PROGRAM NORMAL TUFENI",BĂICOI,PH,1249,14,2,0,16,25,4,0,29,44,7,0,51,58,9,0,67,60,10,0,70
130990,186,"CLUBUL ELEVILOR",BĂICOI,PH,1462,9,0,0,9,34,3,0,37,45,4,0,49,56,5,0,61,59,6,0,65
130990,187,"GR. SC. C-TIN CANTACUZINO",BĂICOI,PH,1137,13,2,0,15,27,2,0,29,37,2,0,39,46,2,0,48,47,2,0,49
130990,188,"GR. SC. C-TIN CANTACUZINO",BĂICOI,PH,1092,7,4,0,11,25,6,0,31,30,6,0,36,44,8,1,53,47,8,1,56
130990,189,"GRADINITA LILIESTI",BĂICOI,PH,1055,8,2,0,10,36,2,0,38,46,4,0,50,54,4,0,58,63,8,0,71
130990,190,"GRADINITA LILIESTI",BĂICOI,PH,1008,8,2,0,10,28,5,0,33,39,5,0,44,63,7,0,70,68,7,0,75
130990,191,"SCOALA NUMARUL 3 LILIESTI",BĂICOI,PH,1491,19,2,0,21,51,2,0,53,66,4,0,70,85,5,0,90,90,6,0,96
130990,192,"SCOALA NUMARUL 3 LILIESTI SALA NR. 2",BĂICOI,PH,1591,19,2,0,21,54,6,0,60,65,7,0,72,80,10,0,90,92,10,0,102
130990,193,"CASA DE CULTURA LILIESTI",BĂICOI,PH,1303,19,7,0,26,43,11,18,72,50,12,18,80,72,13,18,103,78,13,18,109
130990,194,"SCOALA GENERALA DAMBU",BĂICOI,PH,1121,6,0,0,6,22,0,0,22,32,0,0,32,45,0,0,45,50,0,0,50
130990,195,"SCOALA GENERALA TINTEA",BĂICOI,PH,1286,12,1,0,13,25,1,0,26,39,3,0,42,50,3,0,53,62,3,0,65
130990,196,"CASA DE CULTURA TINTEA",BĂICOI,PH,1036,14,5,0,19,33,6,0,39,41,7,0,48,55,9,0,64,57,9,0,66
131078,197,"ȘCOALA GIMNAZIALĂ ""MIHAI VITEAZUL""",BOLDEŞTI-SCĂENI,PH,999,2,1,0,3,24,8,0,32,36,9,0,45,46,9,0,55,50,11,0,61
131078,198,"ȘCOALA GIMNAZIALĂ ""MIHAI VITEAZUL""",BOLDEŞTI-SCĂENI,PH,1191,12,2,0,14,40,5,0,45,52,5,0,57,76,7,1,84,87,7,1,95
131078,199,"ȘCOALA GIMNAZIALĂ ""MIHAI VITEAZUL""",BOLDEŞTI-SCĂENI,PH,1224,5,0,0,5,26,0,0,26,33,0,0,33,47,0,0,47,49,0,0,49
131078,200,"GRĂDINIŢA CU PROGRAM NORMAL, NR.1",BOLDEŞTI-SCĂENI,PH,1367,5,0,0,5,16,0,0,16,31,2,0,33,41,2,0,43,43,2,0,45
131078,201,"ȘCOALA GIMNAZIALĂ NR.2",BOLDEŞTI-SCĂENI,PH,866,9,2,0,11,16,2,0,18,23,3,0,26,37,6,0,43,37,6,0,43
131078,202,"ȘCOALA GIMNAZIALĂ NR.2",BOLDEŞTI-SCĂENI,PH,1045,2,5,0,7,17,8,0,25,31,8,0,39,43,9,0,52,51,12,0,63
131078,203,"CASA DE CULTURĂ ""MIHAI EMINESCU""",BOLDEŞTI-SCĂENI,PH,882,4,0,0,4,15,0,0,15,19,0,0,19,30,2,0,32,34,2,0,36
131078,204,"LICEUL TEHNOLOGIC ""TEODOR DIAMANT""",BOLDEŞTI-SCĂENI,PH,1005,4,4,0,8,15,4,0,19,19,4,0,23,37,6,0,43,39,6,0,45
131087,205,"ȘCOALA PRIMARĂ SECIU",SECIU,PH,813,12,3,0,15,24,3,0,27,34,3,0,37,41,3,0,44,43,3,0,46
131176,206,"GRĂDINIȚA CU PROGRAM NORMAL PODU VADULUI","PODU VADULUI",PH,1395,26,1,0,27,79,20,0,99,98,26,0,124,112,29,0,141,116,31,0,147
131112,207,"ȘCOALA GIMNAZIALĂ BREAZA DE JOS","BREAZA DE JOS",PH,967,6,2,0,8,30,7,0,37,39,10,0,49,51,10,0,61,58,11,0,69
131112,208,"ȘCOALA GIMNAZIALĂ BREAZA DE JOS","BREAZA DE JOS",PH,1038,7,3,0,10,20,11,0,31,27,15,0,42,36,18,0,54,37,20,0,57
131121,209,"LICEUL TEORETIC ""AUREL VLAICU"" BREAZA","BREAZA DE SUS",PH,1468,3,6,0,9,18,19,0,37,27,23,0,50,39,30,0,69,42,33,0,75
131121,210,"LICEUL TEORETIC ""AUREL VLAICU"" BREAZA","BREAZA DE SUS",PH,1097,8,0,0,8,25,1,0,26,35,1,27,63,50,4,27,81,55,6,27,88
131121,211,"LICEUL TEORETIC ,,AUREL VLAICU"" BREAZA","BREAZA DE SUS",PH,1597,10,3,0,13,42,8,0,50,57,11,0,68,64,12,0,76,70,13,0,83
131121,212,"LICEUL TEORETIC ,,AUREL VLAICU"" BREAZA","BREAZA DE SUS",PH,897,8,2,0,10,37,23,0,60,48,37,0,85,59,46,0,105,59,49,0,108
131121,213,"GRĂDINIŢA CU PROGRAM PRELUNGIT ȘI PROGRAM NORMAL ,,CASTELUL FERMECAT""","BREAZA DE SUS",PH,908,17,0,0,17,38,5,0,43,54,6,0,60,61,7,0,68,62,7,0,69
131121,214,"ȘCOALA GIMNAZIALĂ ,,CONSTANTIN BRÂNCOVEANU"" BREAZA","BREAZA DE SUS",PH,1305,12,0,0,12,30,9,0,39,41,12,0,53,49,17,0,66,54,17,0,71
136232,215,"GRĂDINIŢA CU PROGRAM NORMAL GURA BELIEI ""ALBINUŢA""","GURA BELIEI",PH,1104,7,2,0,9,16,4,0,20,23,9,0,32,33,12,0,45,33,12,0,45
131158,216,"ȘCOALA GIMNAZIALĂ NISTOREȘTI",NISTOREŞTI,PH,1104,11,1,0,12,14,2,0,16,18,6,0,24,23,7,0,30,24,9,0,33
131194,217,"ȘCOALA GIMNAZIALĂ VALEA TÂRSEI","VALEA TÎRSEI",PH,1225,4,1,0,5,18,1,0,19,21,3,0,24,27,5,0,32,27,5,0,32
131229,218,"COLEGIUL ION KALINDERU",BUŞTENI,PH,904,11,3,0,14,28,10,0,38,49,19,0,68,58,24,0,82,60,26,0,86
131229,219,"ŞCOALA GIMNAZIALĂ ,,NESTOR URECHIA”",BUŞTENI,PH,1003,9,0,0,9,33,24,0,57,41,40,0,81,46,53,0,99,48,53,0,101
131229,220,"ŞCOALA GIMNAZIALĂ,,NESTOR URECHIA”",BUŞTENI,PH,874,5,4,0,9,33,15,0,48,48,35,0,83,58,52,0,110,66,58,0,124
131229,221,"GRĂDINIŢA CU PP SI PN,,FRAM - URSUL POLAR”",BUŞTENI,PH,616,8,5,0,13,37,6,0,43,48,9,0,57,59,9,0,68,59,9,0,68
131229,222,"SEDIUFIRMĂ PAZĂ",BUŞTENI,PH,1392,8,13,0,21,31,43,0,74,33,59,0,92,43,67,0,110,50,76,0,126
131229,223,"ŞCOALA GIMNAZIALĂ ,,REGINA ELISABETA”",BUŞTENI,PH,1308,9,3,0,12,40,13,0,53,46,21,0,67,57,30,0,87,63,30,0,93
131229,224,"ŞCOALA GIMNAZIALĂ,,CEZAR PETRESCU”",BUŞTENI,PH,1295,14,5,0,19,35,24,0,59,45,25,0,70,61,42,0,103,68,47,0,115
131229,225,"ŞCOALA GIMNAZIALĂ,,CEZAR PETRESCU”",BUŞTENI,PH,930,10,0,0,10,43,7,0,50,55,17,0,72,69,27,0,96,69,29,0,98
131345,226,"LICEUL SIMION STOLNICU",COMARNIC,PH,1553,7,2,0,9,20,3,0,23,31,5,0,36,40,6,0,46,40,8,0,48
131345,227,"SCOALA GIMNAZIALA COMARNIC NR.2",COMARNIC,PH,859,1,0,0,1,9,2,0,11,13,3,0,16,18,3,0,21,22,3,0,25
131345,228,"SCOALA GIMNAZIALA COMARNIC NR.2",COMARNIC,PH,1313,5,2,0,7,10,2,0,12,27,2,0,29,28,4,0,32,30,4,0,34
131372,229,"SCOALA GIMNAZIALA COMARNIC",POIANA,PH,1479,5,0,0,5,7,4,0,11,8,5,0,13,13,10,0,23,16,10,0,26
131372,230,"GRADINITA CU PROGRAM NORMALPOIANA",POIANA,PH,881,1,0,0,1,4,0,0,4,10,0,0,10,14,0,0,14,16,0,0,16
131363,231,"GRADINITA CU PROGRAM NORMALPODUL LUNG","PODU LUNG",PH,500,1,0,0,1,3,1,0,4,4,3,0,7,9,4,0,13,9,4,0,13
131354,232,"GRADINITA CU PROGRAM NORMAL GHIOȘEȘTI",GHIOŞEŞTI,PH,1595,10,0,0,10,17,5,0,22,25,8,0,33,43,9,0,52,44,10,0,54
131345,233,"SCOALA PRIMARA GHIOȘEȘTI",COMARNIC,PH,1126,2,0,0,2,9,2,0,11,12,2,0,14,16,4,0,20,22,4,0,26
131381,234,"GRADINITA CU PROGRAM NORMALPOSADA",POSADA,PH,1171,6,3,0,9,16,8,0,24,22,10,0,32,34,10,0,44,41,10,0,51
131416,235,"SALA DE SPORT MIZIL",MIZIL,PH,1554,10,0,0,10,36,1,0,37,52,1,0,53,67,5,0,72,74,5,0,79
131416,236,"ŞCOALA GIMNAZIALĂ "" SFÂNTUL NICOLAE ""MIZIL",MIZIL,PH,1277,6,5,0,11,24,6,0,30,34,6,0,40,41,6,0,47,47,6,0,53
131416,237,"ŞCOALA GIMNAZIALĂ NR.1 MIZIL",MIZIL,PH,1035,13,0,0,13,39,5,0,44,51,5,0,56,63,5,0,68,66,5,0,71
131416,238,"LICEUL TEHNOLOGIC ""TASE DUMITRESCU"" MIZIL",MIZIL,PH,965,11,0,0,11,27,2,0,29,44,5,0,49,62,7,0,69,67,7,0,74
131416,239,"PRIMĂRIA ORAŞMIZIL",MIZIL,PH,1030,7,2,0,9,21,2,0,23,22,4,0,26,31,4,0,35,35,4,0,39
131416,240,"PRIMĂRIA ORAŞ MIZIL",MIZIL,PH,1042,17,1,0,18,47,5,0,52,61,8,0,69,76,14,0,90,80,15,0,95
131416,241,"PRIMĂRIA ORAŞ MIZIL",MIZIL,PH,1108,12,0,0,12,35,0,0,35,43,0,0,43,57,0,0,57,58,0,0,58
131416,242,"CENTRUL CULTURAL""ADRIAN PĂUNESCU""",MIZIL,PH,1412,13,5,0,18,33,5,0,38,41,5,0,46,49,6,0,55,55,6,0,61
131416,243,"ŞCOALA GIMNAZIALĂ "" SFÂNTAMARIA ""MIZIL",MIZIL,PH,1015,9,0,0,9,17,0,0,17,35,6,0,41,53,6,0,59,53,9,0,62
131416,244,"ŞCOALA GIMNAZIALĂ "" SFÂNTA MARIA ""MIZIL",MIZIL,PH,1139,5,0,0,5,22,3,0,25,39,3,0,42,62,4,0,66,65,5,0,70
131416,245,"LICEUL TEORETIC "" GRIGORETOCILESCU"" MIZIL",MIZIL,PH,1013,13,0,0,13,24,2,0,26,29,2,0,31,40,5,15,60,50,9,15,74
131452,246,"CASA DE CULTURĂ PLOPENI",PLOPENI,PH,1276,18,1,0,19,53,7,0,60,74,7,0,81,92,7,0,99,104,7,0,111
131452,247,"SALA POLIVALENTĂ PLOPENI",PLOPENI,PH,1229,15,0,0,15,39,2,0,41,47,6,0,53,62,6,0,68,64,6,0,70
131452,248,"SALA POLIVALENTĂ PLOPENI",PLOPENI,PH,1102,8,2,0,10,36,4,0,40,47,4,0,51,67,4,0,71,71,4,0,75
131452,249,"COLEGIUL TEHNIC ""GHEORGHE LAZĂR"" PLOPENI",PLOPENI,PH,1156,13,0,0,13,40,1,0,41,60,1,0,61,79,1,0,80,81,1,0,82
131452,250,"COLEGIUL TEHNIC""GHEORGHE LAZĂR"" PLOPENI",PLOPENI,PH,1501,10,0,0,10,32,1,0,33,47,1,0,48,57,1,0,58,58,1,0,59
131452,251,"ŞCOALA GIMNAZIALA ""CAROL I"" PLOPENI",PLOPENI,PH,1400,8,0,0,8,29,0,0,29,40,1,0,41,58,1,0,59,59,1,0,60
131559,252,"COLEGIUL ""MIHAIL CANTACUZINO"" SALA AP.1",SINAIA,PH,1321,6,2,0,8,34,3,0,37,61,6,0,67,71,6,0,77,78,6,0,84
131559,253,"COLEGIUL ""MIHAIL CANTACUZINO"" SALA AP.2",SINAIA,PH,1066,7,1,0,8,36,2,0,38,48,2,0,50,57,2,0,59,58,2,0,60
131559,254,"SCOALA GIMNAZIALA ""PRINCIPESA MARIA""CORP B",SINAIA,PH,776,12,3,0,15,35,5,0,40,46,8,0,54,55,11,0,66,56,11,0,67
131559,255,"SCOALA GIMNAZIALA ""PRINCIPESA MARIA""CORP A",SINAIA,PH,699,6,0,0,6,25,3,0,28,43,3,0,46,68,13,0,81,68,13,0,81
131559,256,"SCOALA GIMNAZIALA ""PRINCIPESA MARIA""CORP A",SINAIA,PH,1048,9,2,0,11,22,5,0,27,39,8,0,47,51,18,0,69,55,18,0,73
131559,257,"IMOBIL PROPRIETATE ORAS SINAIA",SINAIA,PH,946,17,0,0,17,57,7,0,64,79,7,0,86,94,12,0,106,103,12,0,115
131559,258,"CLUBUL SPORTIV CARPAŢI - SALA DE SPORT",SINAIA,PH,811,2,1,0,3,25,4,0,29,43,13,0,56,50,16,0,66,55,17,0,72
131559,259,"ŞCOALA GIMNAZIALA ""GEORGE ENESCU"" SALA 3 B",SINAIA,PH,520,8,10,0,18,21,54,0,75,33,82,0,115,37,109,0,146,39,127,0,166
131559,260,"ŞCOALA GIMNAZIALA ""GEORGE ENESCU"" SALA I B",SINAIA,PH,891,4,6,0,10,30,21,0,51,59,39,0,98,68,57,0,125,80,64,0,144
131559,261,"CENTRUL CULTURAL ""CARMEN SYLVA""",SINAIA,PH,565,9,6,0,15,26,10,0,36,36,11,0,47,43,16,0,59,43,16,0,59
131559,262,"CENTRUL DE ACŢIUNE SI INFORMARE COMUNITARA",SINAIA,PH,588,6,2,0,8,17,8,0,25,22,23,0,45,27,40,0,67,33,45,0,78
131559,263,"CENTRUL INTERNATIONAL DE CONFERINŢE CASINO",SINAIA,PH,653,3,5,0,8,16,18,0,34,23,32,0,55,34,49,0,83,38,54,0,92
131602,264,"ŞCOALA PRĂJANI",PRĂJANI,PH,1035,11,4,0,15,23,5,0,28,34,7,0,41,60,11,0,71,62,11,0,73
131586,265,"LICEUL TEORETIC ,,ŞERBAN VODĂ,,",SLĂNIC,PH,1169,7,5,0,12,33,22,0,55,40,28,0,68,48,48,0,96,50,55,0,105
131586,266,"LICEUL TEORETIC ,,ŞERBAN VODĂ,,",SLĂNIC,PH,1271,8,4,0,12,25,14,0,39,42,18,0,60,51,18,0,69,53,18,0,71
131595,267,"SCOALA GROSANI",GROŞANI,PH,1401,10,1,0,11,16,2,0,18,23,3,0,26,34,4,0,38,39,5,0,44
131639,268,"GRĂDINIŢA DE COPII CU PROGRAM PRELUNGIT ""CLOPOȚICA"" ORAȘUL URLAȚI",URLAŢI,PH,1528,13,1,0,14,35,3,0,38,53,7,0,60,68,9,0,77,75,9,0,84
131639,269,"LICEUL TEORETIC ""BRÂNCOVEANU VODĂ""ORAȘUL URLATI (CLADIREA VECHE)",URLAŢI,PH,1548,8,0,0,8,28,3,0,31,44,7,0,51,63,7,0,70,71,9,0,80
131639,270,"LICEUL TEORETIC ""BRÂNCOVEANU VODĂ"" ORAȘUL URLAȚI",URLAŢI,PH,1492,4,0,0,4,9,0,0,9,18,1,0,19,23,1,0,24,34,2,0,36
131639,271,"ŞCOALA GIMNAZIALĂ""CĂNUŢĂ IONESCU"" ORAȘULURLATI",URLAŢI,PH,1640,8,0,0,8,22,2,0,24,34,5,0,39,45,5,0,50,56,5,0,61
131639,272,"CASA DE CULTURĂ ORAȘUL URLAŢI",URLAŢI,PH,1487,13,0,0,13,44,3,0,47,52,6,0,58,68,6,0,74,84,6,0,90
131639,273,"GRĂDINIȚA CU PROGRAM NORMAL ""JERCĂLĂI"" ORAȘUL URLAȚI",URLAŢI,PH,820,2,2,0,4,6,3,0,9,6,6,0,12,13,6,0,19,13,6,0,19
131639,274,"GRĂDINIȚA CU PROGRAM NORMAL ""VALEA URLOI"" ORAȘUL URLAȚI",URLAŢI,PH,875,6,0,0,6,7,1,0,8,18,3,0,21,24,4,0,28,35,4,0,39
131826,275,"PRIMĂRIA VĂLENII DE MUNTE (CASA CĂSĂTORIILOR)","VĂLENII DE MUNTE",PH,1038,18,4,0,22,35,13,0,48,44,15,0,59,55,16,0,71,62,21,0,83
131826,276,"CASA DE CULTURĂ (SALA MICĂ)","VĂLENII DE MUNTE",PH,1309,30,7,0,37,69,17,0,86,81,26,0,107,100,27,0,127,106,27,0,133
131826,277,"CASA DE CULTURĂ (FOAIER)","VĂLENII DE MUNTE",PH,1107,8,2,0,10,37,12,0,49,51,15,0,66,67,16,0,83,77,17,0,94
131826,278,"CLUBUL COPIILOR","VĂLENII DE MUNTE",PH,894,9,1,0,10,34,1,0,35,47,3,0,50,57,5,0,62,58,5,0,63
131826,279,"ȘCOALA GIMNAZIALĂ ""INGINER GHEORGHE PĂNCULESCU""","VĂLENII DE MUNTE",PH,1283,23,2,0,25,64,7,0,71,82,10,0,92,99,11,0,110,106,11,0,117
131826,280,"GRĂDINIȚA CU PROGRAM NORMAL NR. 1","VĂLENII DE MUNTE",PH,1427,17,4,0,21,44,5,0,49,58,9,0,67,78,11,0,89,80,11,0,91
131826,281,"GRĂDINIȚA CU PROGRAM NORMAL NR. 4","VĂLENII DE MUNTE",PH,1020,20,2,0,22,39,2,0,41,54,2,0,56,63,2,0,65,70,2,0,72
131826,282,"LICEUL TEHNOLOGIC AGROMONTAN ""ROMEO CONSTANTINESCU""","VĂLENII DE MUNTE",PH,961,13,1,0,14,36,6,0,42,50,8,0,58,62,8,0,70,67,12,0,79
131826,283,"ȘCOALA PRIMARĂ NR.4 (MIULEȘTI)","VĂLENII DE MUNTE",PH,1201,13,1,0,14,54,6,0,60,67,10,0,77,77,15,0,92,104,19,0,123
131826,284,"ȘCOALA PRIMARĂ NR.2 (VALEA GARDULUI)","VĂLENII DE MUNTE",PH,901,14,0,0,14,25,7,0,32,31,8,0,39,35,10,0,45,40,10,0,50
131906,285,"CĂMIN CULTURAL",ADUNAŢI,PH,904,0,2,0,2,9,2,0,11,20,2,0,22,22,5,0,27,25,5,0,30
131906,286,"GRĂDINIȚA „CASTELUL PITICILOR”",ADUNAŢI,PH,791,2,0,0,2,8,0,0,8,17,0,0,17,24,0,0,24,27,0,0,27
131942,287,"SCOALA GIMNAZIALA CLASELE I-VIII ALBESTI PALEOLOGU",ALBEŞTI-PALEOLOGU,PH,1455,6,0,0,6,17,2,0,19,25,3,0,28,28,5,0,33,34,5,0,39
131979,288,"SCOALA GIMNAZIALA CLASELE I-VIII SAT VADU PĂRULUI","VADU PĂRULUI",PH,1556,6,1,0,7,10,4,0,14,17,4,0,21,23,4,0,27,26,4,0,30
131951,289,"SCOALA GIMNAZIALA CU CLASELE I-IV SAT ALBESTI MURU",ALBEŞTI-MURU,PH,897,5,2,0,7,12,3,0,15,22,3,0,25,29,5,0,34,31,5,0,36
131960,290,"SCOALA GIMNAZIALA CU CLASELE I-VIII CIOCENI",CIOCENI,PH,706,2,1,0,3,5,3,0,8,7,3,0,10,9,3,0,12,12,3,0,15
131997,291,"SCOALA GIMNAZIALA GHEORGHE COSTESCU ALUNIS",ALUNIŞ,PH,1210,7,1,0,8,17,2,0,19,28,4,0,32,41,13,0,54,46,14,0,60
131997,292,"SCOALA CU CLS. I-IV ALUNIS VALE",ALUNIŞ,PH,722,5,3,0,8,7,8,0,15,21,8,0,29,25,9,0,34,27,9,0,36
132002,293,"SCOALA GIMNAZIALASAT OSTROVU",OSTROVU,PH,799,6,0,0,6,10,1,0,11,15,4,0,19,24,5,0,29,25,6,0,31
132020,294,"CONSILIUL LOCAL APOSTOLACHE",APOSTOLACHE,PH,864,4,0,0,4,7,1,0,8,16,4,0,20,20,7,0,27,20,7,0,27
132020,295,"CONSILIUL LOCAL APOSTOLACHE",APOSTOLACHE,PH,800,5,1,0,6,7,1,0,8,16,1,0,17,18,1,0,19,20,2,0,22
132084,296,"ȘCOALAGIMNAZIALĂ COMUNA ARICEȘTII RAHTIVANI NR. 96A","ARICEŞTII RAHTIVANI",PH,1186,4,0,0,4,18,1,0,19,26,1,0,27,35,2,0,37,44,6,0,50
132084,297,"CĂMINUL CULTURAL ARICEȘTII RAHTIVANI, NR. 527A","ARICEŞTII RAHTIVANI",PH,1067,8,3,0,11,17,4,0,21,24,4,0,28,29,4,0,33,33,4,0,37
132100,298,"GRĂDINIȚA CU PROGRAM NORMAL NEDELEA NR. 47A",NEDELEA,PH,790,2,1,0,3,5,1,0,6,10,7,0,17,14,8,0,22,15,8,0,23
132100,299,"ȘCOALA GIMNAZIALĂ SAT NEDELEA, COMUNA ARICEȘTII RAHTIVANI, NR. 491",NEDELEA,PH,1168,3,0,0,3,10,0,0,10,15,0,0,15,22,0,0,22,26,0,0,26
132119,300,"ȘCOALA GIMNAZIALĂ SAT STOENEȘTI NR. 14",STOENEŞTI,PH,1150,3,1,0,4,29,5,0,34,38,6,0,44,47,6,0,53,49,6,0,55
132128,301,"GRĂDINIȚA CU PROGRAM NORMAL TÎRGȘORU NOU, NR. 175","TÎRGŞORU NOU",PH,904,5,1,0,6,12,3,0,15,17,5,0,22,23,8,0,31,28,10,0,38
132093,302,"GRĂDINIȚA CU PROGRAM NORMAL BUDA NR. 46 A",BUDA,PH,421,7,2,0,9,13,3,0,16,19,3,0,22,24,8,0,32,29,10,0,39
132146,303,"ŞCOALA GIMNAZIALĂ ATHANASIE JAN STOICESCU","ARICEŞTII ZELETIN",PH,955,7,1,0,8,19,3,0,22,25,4,0,29,31,7,0,38,33,8,0,41
132173,304,"SCOALA GIMNAZIALĂ BABA ANA","BABA ANA",PH,1555,6,0,0,6,18,3,0,21,22,3,0,25,30,4,0,34,32,4,0,36
132191,305,"SCOALA GIMNAZIALĂ CONDURATU",CONDURATU,PH,987,4,0,0,4,19,6,0,25,29,11,0,40,38,12,0,50,46,12,0,58
132182,306,"SCOALA GIMNAZIALĂ CIREŞANU",CIREŞANU,PH,670,2,3,0,5,14,4,0,18,23,5,0,28,39,9,0,48,42,9,0,51
132217,307,"SCOALA CU CLS. I-IV SATU NOU","SATU NOU",PH,94,1,0,0,1,3,0,0,3,4,0,0,4,4,0,0,4,5,0,0,5
132235,308,"ȘCOALA GIMNAZIALĂ SFINȚII ÎMPĂRAȚI BALTA DOAMNEI","BALTA DOAMNEI",PH,1183,3,0,0,3,18,2,0,20,36,6,0,42,42,10,1,53,50,11,1,62
132244,309,"ȘCOALA PRIMARĂ DIN BÎRA",BÎRA,PH,768,1,0,0,1,2,0,0,2,7,1,0,8,13,2,0,15,16,4,0,20
132280,310,"ŞCOALA CU CLASELE I-IV",BĂLŢEŞTI,PH,1517,13,0,0,13,25,0,0,25,37,0,0,37,51,2,0,53,54,3,0,57
132306,311,"ŞCOALA PODENII VECHI","PODENII VECHI",PH,1414,6,4,0,10,8,4,0,12,11,4,0,15,29,4,0,33,36,5,0,41
132324,312,"ŞCOALA GIMNAZIALĂ ""IOAN DUHOVNICUL"" BĂNEŞTI",BĂNEŞTI,PH,1413,9,0,0,9,27,9,0,36,40,15,0,55,56,15,15,86,61,17,15,93
132324,313,"DISPENSAR UMAN BĂNEŞTI",BĂNEŞTI,PH,1342,6,2,0,8,27,2,0,29,37,2,9,48,52,3,9,64,60,3,9,72
132333,314,"ŞCOALA GIMNAZIALĂ ""IOAN DUHOVNICUL"" BĂNEŞTI",URLETA,PH,1085,10,0,0,10,25,0,0,25,27,0,0,27,55,0,0,55,71,6,17,94
132333,315,"ŞCOALA GIMNAZIALĂ ""IOAN DUHOVNICUL"" BĂNEŞTI",URLETA,PH,983,8,1,0,9,25,3,0,28,32,7,0,39,38,7,0,45,43,7,0,50
130561,316,"ŞCOALA GIMNAZIALĂ ""GHEORGHE LAZĂR"" COMUNABĂRCĂNEŞTI",BĂRCĂNEŞTI,PH,1287,10,0,0,10,24,2,0,26,27,2,0,29,36,2,0,38,44,3,0,47
130561,317,"ŞCOALA GIMNAZIALĂ ""GHEORGHE LAZĂR"" COMUNABĂRCĂNEŞTI",BĂRCĂNEŞTI,PH,1433,5,4,0,9,15,4,0,19,18,4,0,22,31,5,0,36,34,6,0,40
130570,318,"SEDIUL FOSTEI ŞCOLI CU CLASELEI-IV GHIGHIU",GHIGHIU,PH,613,1,0,0,1,12,2,0,14,40,7,0,47,45,7,0,52,47,9,0,56
130589,319,"SEDIUL FOSTEIŞCOLI CU CLASELEI-IV PUŞCAŞI",PUŞCAŞI,PH,338,2,0,0,2,8,0,0,8,12,0,0,12,18,1,0,19,18,1,0,19
130598,320,"ŞCOALA GIMNAZIALĂROMÂNEŞTI",ROMÂNEŞTI,PH,1590,12,1,0,13,18,3,0,21,36,3,0,39,43,3,0,46,43,3,0,46
130605,321,"ŞCOALA GIMNAZIALĂTĂTĂRANI",TĂTĂRANI,PH,1235,5,2,0,7,14,5,0,19,26,6,0,32,35,10,0,45,35,10,0,45
130605,322,"ŞCOALA GIMNAZIALĂTĂTĂRANI",TĂTĂRANI,PH,1314,6,0,0,6,19,0,0,19,30,2,0,32,33,2,0,35,37,3,0,40
135333,323,"SCOALA GIMNAZIALA, COMUNA BATRANI",BĂTRÂNI,PH,915,10,2,0,12,23,4,0,27,32,4,0,36,41,6,0,47,46,6,0,52
135333,324,"GRADINITA DE COPII",BĂTRÂNI,PH,766,2,0,0,2,4,0,0,4,10,0,0,10,19,0,0,19,22,1,0,23
130623,325,"SCOALA GIMNAZIALA BERCENI,SALA DE SPORT PARTER",BERCENI,PH,1306,12,4,0,16,37,11,0,48,45,11,0,56,53,13,0,66,62,14,0,76
130623,326,"GRADINITA CU PROGRAM NORMAL-SALA MICA PARTER,COM.BERCENI,SAT BERCENI,STR.GRADINITEI NR. 358 A",BERCENI,PH,760,5,2,0,7,9,2,0,11,16,2,0,18,25,3,0,28,30,3,0,33
130650,327,"SCOALA CU CLASELE I-VIII-SALA DE SPORT PARTER,COM.BERCENI,SAT CORLATESTI,STR.SCOLII,NR.139 A",CORLĂTEŞTI,PH,1194,15,0,0,15,28,2,0,30,41,4,0,45,59,5,0,64,60,6,0,66
130632,328,"CAMINUL CULTURAL -SALA MARE PARTER,COM.BERCENI,SAT DIMBU,STR.PLOPULUI,NR.73 A,","CARTIERUL DÎMBU",PH,389,8,4,0,12,11,6,0,17,15,8,0,23,20,9,0,29,21,9,0,30
130641,329,"GRADINITA CU PROGRAM NORMAL,SALA MICA PARTER,COM.BERCENI,SAT CATUNU.STR.DEMOCRATIEI,NR.148 A",CĂTUNU,PH,536,6,2,0,8,14,3,0,17,20,3,0,23,29,5,0,34,29,6,0,35
130669,330,"GRADINITA CU PROGRAM NORMAL-SALA MARE PARTER,COM.BERCENI,SAT MOARA NOUA,STR.SCOLII,NR.106 C","MOARA NOUĂ",PH,855,2,4,0,6,13,6,37,56,18,8,37,63,31,8,37,76,33,8,37,78
132351,331,"GRADINITA DE COPII NR.1",BERTEA,PH,1386,7,0,0,7,17,0,0,17,27,0,0,27,35,1,0,36,37,1,0,38
132351,332,"GRADINITA DE COPII NR.2",BERTEA,PH,1164,1,2,0,3,2,2,0,4,9,5,0,14,19,9,0,28,26,12,0,38
130687,333,"ȘCOALA GIMNAZIALĂ ,,RADU TUDORAN'' BLEJOI, SAT BLEJOI, NR. 510",BLEJOI,PH,1631,18,0,0,18,41,4,0,45,47,5,0,52,68,5,0,73,87,6,0,93
130687,334,"GRĂDINIȚA CU PROGRAM NORMAL BLEJOI, SAT BLEJOI, NR. 511",BLEJOI,PH,1548,6,1,0,7,14,3,0,17,28,3,0,31,40,3,0,43,44,3,0,47
130696,335,"GRĂDINIȚA CU PROGRAM NORMAL PLOIEȘTIORI, SAT PLOIEȘTIORI, NR. 537",PLOIEŞTIORI,PH,1097,11,0,0,11,13,0,0,13,26,2,0,28,36,3,0,39,44,3,0,47
130696,336,"CĂMINUL CULTURAL ,,GEO BOGZA'', SAT PLOIEȘTIORI, NR. 174 B",PLOIEŞTIORI,PH,1754,14,4,0,18,42,6,0,48,54,7,0,61,75,8,0,83,79,8,0,87
130703,337,"GRĂDINIȚA CU PROGRAM NORMAL ȚÎNȚĂRENI, SAT ȚÎNȚĂRENI, NR. 232 E",ŢÎNŢĂRENI,PH,1402,2,0,0,2,20,3,0,23,26,5,0,31,36,5,0,41,37,5,0,42
132388,338,"CĂMİN CULTURAL BOLDEŞTİ",BOLDEŞTI,PH,670,10,0,0,10,20,1,0,21,31,1,0,32,36,1,0,37,41,1,0,42
132397,339,"ŞCOALA GİMNAZİALĂ COMUNA BOLDEŞTİ-GRADİŞTEA,CORP B",GRADIŞTEA,PH,723,3,2,0,5,6,2,0,8,10,4,0,14,13,4,0,17,14,4,0,18
130730,340,"SALA DE SPORT A ŞCOLII GIMNAZIALE ""DUMITRU HERA"" BĂTEŞTI",BĂTEŞTI,PH,1442,16,3,0,19,41,5,0,46,52,11,0,63,79,13,0,92,94,13,9,116
130749,341,"SALA DE FESTIVITĂŢI A PRIMĂRIEI COMUNEI BRAZI","BRAZII DE JOS",PH,626,3,2,0,5,15,6,0,21,19,6,0,25,23,6,0,29,26,8,0,34
130721,342,"ŞCOALA GIMNAZIALĂBRAZI","BRAZII DE SUS",PH,1030,13,1,0,14,37,1,0,38,38,2,0,40,58,4,2,64,68,4,2,74
130767,343,"PUNCTUL DE LUCRU AL PRIMĂRIEI BRAZI DIN SATUL POPEŞTI",POPEŞTI,PH,1458,19,0,0,19,58,3,0,61,72,3,0,75,96,5,0,101,99,6,0,105
130758,344,"SALA DE SPORT A ŞCOLII GIMNAZIALE ""PROFESOR OPREA MIHAI"" SAT NEGOIEŞTI",NEGOIEŞTI,PH,1552,22,0,0,22,31,7,0,38,49,10,0,59,69,11,0,80,78,11,0,89
130721,345,"FOSTUL SEDIU AL GRADINŢEI DE COPII DIN COLONIA BRAZI","BRAZII DE SUS",PH,330,5,1,0,6,9,1,0,10,16,2,0,18,18,2,0,20,23,2,0,25
130776,346,"FOSTUL SEDIU AL ŞCOLII GIMNAZIALE DIN SATUL STEJARU",STEJARU,PH,499,8,1,0,9,15,1,0,16,26,1,0,27,33,3,0,36,38,4,0,42
132413,347,"ŞCOALA GIMNAZIALĂ MATEI BASARAB CORP B, SAT BREBU MÎNĂSTIREI, NR.803","BREBU MÎNĂSTIREI",PH,878,0,8,0,8,8,18,0,26,15,24,0,39,23,29,0,52,25,29,0,54
132413,348,"ŞCOALA GIMNAZIALĂ MATEI BASARAB CORP A, SAT BREBU MÎNĂSTIREI, NR.799","BREBU MÎNĂSTIREI",PH,1498,7,5,0,12,14,5,0,19,26,8,0,34,34,8,0,42,43,11,0,54
132422,349,"ŞCOALA GIMNAZIALĂ MATEI BASARAB, ŞCOALĂ PRIMARĂ STRUCTURĂ, NR.2, SAT BREBU MEGIEŞESC, NR.53","BREBU MEGIEŞESC",PH,1472,8,0,0,8,20,2,0,22,30,7,0,37,42,9,0,51,47,9,0,56
132422,350,"ŞCOALA GIMNAZIALĂ MATEI BASARAB, ŞCOALĂ PRIMARĂ STRUCTURĂ, SAT BREBU MEGIEŞESC, NR.278","BREBU MEGIEŞESC",PH,1067,3,0,0,3,11,1,0,12,17,3,0,20,25,4,0,29,28,4,0,32
132431,351,"ŞCOALA GIMNAZIALĂ MATEI BASARAB, ŞCOALĂ GIMNAZIALĂ PIETRICEAUA, SAT PIETRICEAUA, NR.1",PIETRICEAUA,PH,947,6,1,0,7,10,2,0,12,13,2,0,15,21,7,0,28,22,8,0,30
132440,352,"ŞCOALA GIMNAZIALĂ MATEI BASARAB, ŞCOALĂ PRIMARĂ STRUCTURĂ, SAT PODU CHEII, NR.12","PODU CHEII",PH,147,2,1,0,3,4,1,0,5,6,2,0,8,7,3,0,10,7,3,0,10
130794,353,"CAMIN CULTURAL BUCOV",BUCOV,PH,1464,8,1,0,9,27,5,9,41,36,7,9,52,44,11,9,64,47,13,9,69
130794,354,"CAMIN CULTURAL BUCOV",BUCOV,PH,1541,9,0,0,9,18,0,1,19,24,0,1,25,30,0,1,31,33,0,1,34
130794,355,"CAMIN CULTURAL BUCOV",BUCOV,PH,1308,5,3,0,8,23,4,0,27,31,7,0,38,39,8,0,47,48,8,0,56
130810,356,"CAMIN CULTURAL CHITORANI",CHIŢORANI,PH,1322,4,0,0,4,19,5,0,24,34,5,0,39,45,7,0,52,49,8,0,57
130829,357,"CAMIN CULTURAL PLEASA",PLEAŞA,PH,1198,13,3,0,16,28,4,0,32,39,6,0,45,52,9,0,61,54,9,0,63
130829,358,"CAMIN CULTURAL PLEASA",PLEAŞA,PH,1352,13,0,0,13,36,0,0,36,46,0,0,46,65,0,0,65,70,0,0,70
130829,359,"CLUB PLEASA",PLEAŞA,PH,1092,1,0,0,1,9,0,0,9,13,0,0,13,22,0,0,22,26,0,0,26
132468,360,"VECHIUL SEDIU AL PRIMARIEI",CĂLUGĂRENI,PH,953,9,1,0,10,22,4,1,27,33,4,1,38,46,4,1,51,54,5,1,60
132495,361,"ŞCOALA GIMNAZIALĂCĂRBUNEŞTI",CĂRBUNEŞTI,PH,1408,7,2,0,9,11,2,0,13,13,6,0,19,24,10,0,34,29,11,0,40
132529,362,"SCOALA CU CLASELE I-VIII ""NICHITA STANESCU"" CEPTURA","CEPTURA DE JOS",PH,942,6,0,0,6,16,4,0,20,25,4,0,29,39,9,0,48,40,10,0,50
132529,363,"SCOALA CU CLASELEI-VIII ""NICHITA STANESCU"" CEPTURA","CEPTURA DE JOS",PH,904,9,0,0,9,16,1,0,17,20,1,0,21,31,7,0,38,34,7,0,41
132538,364,"SEDIUL SERVICIULUI PUBLIC DE GOSPODARIE COMUNALA CEPTURA","CEPTURA DE SUS",PH,498,2,0,0,2,10,2,0,12,15,2,0,17,21,2,0,23,27,5,0,32
132565,365,"GRADINITA DE COPII SOIMESTI",ŞOIMEŞTI,PH,632,6,0,0,6,9,3,0,12,12,3,0,15,21,4,0,25,22,4,0,26
132556,366,"SCOALA CU CLASELE I - VIII ROTARI",ROTARI,PH,636,6,0,0,6,11,1,0,12,17,1,0,18,19,1,0,20,19,1,0,20
132547,367,"SCOALA CU CLASELEI - IV","MALU ROŞU",PH,135,2,0,0,2,4,0,0,4,7,1,0,8,10,1,0,11,11,1,0,12
132583,368,"LICEUL TEHNOLOGIC CERAŞU",CERAŞU,PH,1262,4,0,0,4,10,4,0,14,13,4,0,17,20,4,1,25,23,4,1,28
132609,369,"ŞCOALA GIMNAZIALĂ VALEA BORULUI","VALEA BORULUI",PH,696,3,2,0,5,4,2,0,6,7,2,0,9,12,2,0,14,14,3,0,17
132592,370,"ŞCOALA GIMNAZIALĂ SLON",SLON,PH,803,4,1,0,5,14,1,0,15,21,1,0,22,30,1,0,31,30,1,0,31
132592,371,"ŞCOALA GIMNAZIALĂ SLON",SLON,PH,916,13,0,0,13,19,1,0,20,32,1,0,33,38,4,0,42,39,4,0,43
132654,372,"GRADINITA CHIOJDEANCA",CHIOJDEANCA,PH,784,10,1,0,11,12,1,0,13,17,1,0,18,20,1,0,21,27,2,0,29
132672,373,"SCOALA TRENU",TRENU,PH,466,3,0,0,3,5,0,0,5,6,0,0,6,7,3,0,10,7,3,0,10
132690,374,"LICEUL CIORANI","CIORANII DE JOS",PH,977,3,3,0,6,13,6,0,19,23,9,0,32,27,10,0,37,31,11,0,42
132690,375,"LICEUL CIORANI","CIORANII DE JOS",PH,1514,10,0,0,10,35,0,0,35,38,2,0,40,42,6,0,48,44,8,0,52
132690,376,"ȘCOALA CU CLASELE I-IV","CIORANII DE JOS",PH,980,4,0,0,4,10,1,0,11,25,1,0,26,36,1,0,37,38,1,0,39
132707,377,"ȘCOALA GENERALĂ CIORANII DE SUS","CIORANII DE SUS",PH,885,2,2,0,4,5,3,0,8,7,3,0,10,15,3,0,18,17,7,0,24
132707,378,PRIMĂRIA,"CIORANII DE SUS",PH,972,2,2,0,4,16,3,0,19,19,3,0,22,32,3,0,35,32,3,0,35
134247,379,"CASA DE CULTURA RURALA","COCORĂŞTII COLŢ",PH,1410,2,0,0,2,8,1,0,9,14,1,0,15,25,1,0,26,41,4,0,45
134256,380,"SCOALA PRIMARACOCORASTII GRIND","COCORĂŞTII GRIND",PH,959,3,1,0,4,6,6,0,12,16,7,0,23,29,7,0,36,42,8,0,50
132725,381,"CĂMIN CULTURAL","COCORĂŞTII MISLII",PH,1575,17,2,0,19,36,2,0,38,46,2,0,48,69,6,0,75,71,6,0,77
132734,382,"CĂMIN CULTURAL",GORUNA,PH,1253,12,0,0,12,21,1,0,22,28,4,0,32,42,4,0,46,50,5,0,55
132761,383,"SCOALA GIMNAZIALA, COMUNA COLCEAG PJ",COLCEAG,PH,1108,4,3,0,7,15,3,0,18,25,5,0,30,45,8,0,53,52,8,0,60
132798,384,"SCOALA PRIMARA VILCELELE - COLCEAG - STRUCTURA",VÎLCELELE,PH,422,4,0,0,4,8,0,0,8,10,0,0,10,15,1,0,16,15,1,0,16
132770,385,"SCOALA GIMNAZIALA INOTESTI-COLCEAG-STRUCTURA",INOTEŞTI,PH,1467,5,0,0,5,18,2,0,20,23,2,0,25,44,3,0,47,45,4,0,49
132789,386,"SCOALA GIMNAZIALA PAREPA-RUSANI-COLCEAG-STRUCTURA",PAREPA-RUŞANI,PH,790,16,4,0,20,22,7,0,29,27,8,0,35,30,11,0,41,32,11,0,43
132814,387,"GRĂDINIŢA CU PROGRAM NORMAL","CORNU DE JOS",PH,1393,17,2,0,19,47,12,0,59,58,20,0,78,90,32,0,122,93,33,0,126
132823,388,"GRĂDINIŢA CU PROGRAM NORMAL","CORNU DE SUS",PH,864,2,0,0,2,12,5,0,17,18,9,0,27,25,11,0,36,31,11,0,42
132814,389,"ŞCOALA GIMNAZIALĂ ""PROFESOR CRISTEA STĂNESCU""","CORNU DE JOS",PH,1440,19,4,0,23,40,26,0,66,81,62,0,143,105,71,0,176,106,72,0,178
132850,390,"BIBLIOTECA COMUNALĂ COSMINELE","COSMINA DE JOS",PH,850,6,3,0,9,12,3,0,15,13,8,0,21,19,9,0,28,23,10,0,33
132930,391,"ȘCOALA GIMNAZIALĂ ""PLATON MOCANU""","DRAJNA DE JOS",PH,1430,12,5,0,17,43,17,31,91,46,19,31,96,63,19,31,113,66,24,31,121
132930,392,"GRĂDINIȚA PLĂIȘANI","DRAJNA DE JOS",PH,715,10,5,0,15,18,6,0,24,22,6,0,28,31,9,0,40,32,9,0,41
132903,393,"ȘCOALA GIMNAZIALĂ DRAJNA DE SUS","DRAJNA DE SUS",PH,1240,4,1,0,5,8,8,0,16,16,10,0,26,21,17,0,38,28,18,0,46
132958,394,"ȘCOALA GIMNAZIALĂ OGRETIN",OGRETIN,PH,1066,3,4,0,7,9,4,0,13,13,6,0,19,16,9,0,25,17,9,0,26
133027,395,"GRĂDINIȚA DRĂGĂNEȘTI",DRĂGĂNEŞTI,PH,1015,5,4,0,9,15,4,1,20,21,8,1,30,30,9,1,40,33,9,1,43
133036,396,"GRĂDINIȚA BĂRĂITARU",BĂRĂITARU,PH,688,6,2,0,8,15,2,0,17,16,3,0,19,19,4,0,23,21,6,0,27
133045,397,"ȘCOALA CU CLASELE I-IV BELCIUG",BELCIUG,PH,438,4,2,0,6,17,4,0,21,17,4,0,21,18,5,0,23,23,7,0,30
133054,398,"ȘCOALA CU CLASELE I-IV CORNU DE JOS","CORNU DE JOS",PH,494,3,0,0,3,6,1,0,7,10,4,0,14,15,4,0,19,15,4,0,19
133072,399,"ȘCOALA PRIMARĂMERI",MERI,PH,839,3,0,0,3,7,1,0,8,14,1,0,15,23,2,0,25,28,2,0,30
133063,400,"COOPERATIVA DE CONSUM",HĂTCĂRĂU,PH,363,5,2,0,7,12,4,0,16,17,4,0,21,19,5,0,24,22,5,0,27
133107,401,"CĂMIN CULTURAL LOCALITATEA DUMBRAVA",DUMBRAVA,PH,1329,7,5,0,12,31,9,0,40,65,14,0,79,86,14,0,100,96,14,0,110
133152,402,"CĂMIN CULTURAL LOCALITATEA ZĂNOAGA",ZĂNOAGA,PH,808,6,0,0,6,21,0,0,21,40,4,0,44,52,11,0,63,58,11,0,69
133116,403,"CĂMIN CULTURAL LOCALITATEA CIUPELNIŢA",CIUPELNIŢA,PH,1370,10,3,0,13,43,5,0,48,60,6,0,66,86,8,0,94,92,8,0,100
131470,404,"CĂMIN CULTURAL",DUMBRĂVEŞTI,PH,1184,16,0,0,16,24,0,0,24,32,0,0,32,40,1,0,41,46,1,0,47
131513,405,"SALA DE UTILITATE PUBLICĂ",PLOPENI,PH,1317,9,0,0,9,26,1,0,27,36,1,0,37,51,1,0,52,53,1,0,54
131522,406,"FOSTA ŞCOALĂ SAT SFÂRLEANCA",SFÎRLEANCA,PH,507,4,1,0,5,10,1,0,11,11,1,0,12,25,2,0,27,26,2,0,28
133287,407,"CAMINUL CULTURAL",FÂNTÂNELE,PH,811,10,1,0,11,22,1,0,23,27,3,0,30,40,11,0,51,43,11,0,54
133287,408,"CAMINUL CULTURAL",FÂNTÂNELE,PH,817,12,1,0,13,26,2,0,28,35,3,0,38,38,3,0,41,38,3,0,41
133170,409,"CLUBUL ""MINERUL""","FILIPEŞTII DE PĂDURE",PH,1017,5,2,0,7,14,2,0,16,21,2,0,23,26,2,0,28,28,2,0,30
133170,410,"ȘCOALA VECHE","FILIPEŞTII DE PĂDURE",PH,1607,13,1,0,14,42,3,0,45,63,5,0,68,70,5,0,75,75,5,0,80
133170,411,"LICEUL TEORETIC","FILIPEŞTII DE PĂDURE",PH,1513,13,1,0,14,34,1,0,35,48,3,0,51,64,6,0,70,71,7,0,78
133189,412,"ȘCOALA GIMNAZIALĂ ""IOAN MOGA""",DIŢEŞTI,PH,1162,9,2,0,11,18,3,0,21,42,3,0,45,42,3,0,45,48,3,0,51
133189,413,"GRADINIȚA NR.1",DIŢEŞTI,PH,1038,5,2,0,7,19,2,0,21,42,3,0,45,71,6,0,77,76,6,0,82
133189,414,"GRADINIȚA NR. 2",DIŢEŞTI,PH,936,2,2,0,4,10,2,0,12,16,6,0,22,24,8,0,32,29,8,0,37
133198,415,"LICEUL TEHNOLOGIC",MINIERI,PH,1113,15,3,0,18,33,4,0,37,48,4,0,52,72,6,0,78,78,6,0,84
133223,416,"CǍMIN FILIPEŞTII DE TÎRG (SALĂ ȘEDINȚĂ VIDEOCLUB)","FILIPEŞTII DE TÎRG",PH,1047,5,1,0,6,14,3,0,17,18,4,0,22,26,7,0,33,28,7,0,35
133223,417,"ṢCOALA FILIPEṢTII DE TȊRG","FILIPEŞTII DE TÎRG",PH,1167,6,1,0,7,16,3,0,19,21,3,0,24,35,3,0,38,37,3,0,40
133232,418,"ṢCOALAGENERALǍ BRǍTǍṢANCA",BRĂTĂŞANCA,PH,1658,4,5,0,9,15,5,0,20,25,7,0,32,43,8,0,51,47,8,0,55
133250,419,"ṢCOALAGENERALǍ MǍRGINENII DE JOS (ṢCOALA NOUǍ)","MĂRGINENII DE JOS",PH,1560,4,2,0,6,9,2,0,11,11,2,0,13,21,2,0,23,21,2,0,23
133250,420,"ṢCOALA GENERALǍ MǍRGINENII DE JOS (ṢCOALA VECHE)","MĂRGINENII DE JOS",PH,1180,3,2,0,5,7,3,0,10,8,6,0,14,13,8,0,21,24,10,0,34
133349,421,"GRADINITA DE COPII FLORESTI",FLOREŞTI,PH,1265,10,2,0,12,31,5,0,36,42,8,0,50,71,8,0,79,82,8,0,90
133349,422,"SCOALA CU CLASELE I - VIII FLORESTI (LOCALUL NOU)",FLOREŞTI,PH,1528,17,2,0,19,45,2,0,47,69,2,0,71,93,3,0,96,95,3,0,98
133349,423,"SCOALA CU CLASELE I-VIII FLORESTI (LOCALUL VECHI)",FLOREŞTI,PH,1501,15,4,0,19,48,5,0,53,65,5,0,70,81,7,0,88,86,7,0,93
133376,424,"SCOALA CU CLASELE I-VIIICATINA",CĂTINA,PH,869,13,0,0,13,17,1,0,18,17,1,0,18,19,2,0,21,19,2,0,21
133376,425,"CAMINUL CULTURAL CALINESTI",CĂTINA,PH,1093,7,0,0,7,12,0,0,12,25,6,0,31,28,6,0,34,30,8,0,38
133401,426,"CAMINUL CULTURAL FULGA DE JOS","FULGA DE JOS",PH,1203,15,0,0,15,30,2,0,32,40,2,0,42,58,4,0,62,60,5,0,65
133410,427,"SCOALA GIMNAZIALA ""LAURENTIU FULGA""","FULGA DE SUS",PH,1410,2,0,0,2,6,1,0,7,7,1,0,8,12,2,0,14,14,3,0,17
133438,428,"ŞCOALA GIMAZIALĂ GHERGHIŢA, NUMĂRUL 125",GHERGHIŢA,PH,990,4,1,0,5,6,2,0,8,14,3,0,17,25,5,0,30,33,5,0,38
133465,429,"GRĂDINIŢA CU PROGRAM NORMAL MALAMUC, NUMĂRUL 149C",MALAMUC,PH,324,5,2,0,7,8,3,0,11,9,4,0,13,13,6,0,19,21,6,0,27
133456,430,"ŞCOALA PRIMARĂ INDEPENDENŢA, NUMĂRUL 23",INDEPENDENŢA,PH,191,1,0,0,1,1,0,0,1,3,1,0,4,4,3,0,7,4,3,0,7
133517,431,"GRĂDINIȚA CU PROGRAM NORMAL SAT GORGOTA, COMUNA GORGOTA",GORGOTA,PH,1204,10,0,0,10,23,0,0,23,32,0,0,32,36,0,0,36,36,0,0,36
133553,432,"ȘCOALA GIMNAZIALĂ SAT POTIGRAFU, COMUNA GORGOTA",POTIGRAFU,PH,1059,11,0,0,11,18,2,0,20,23,2,0,25,29,5,0,34,37,6,0,43
133544,433,"ȘCOALA GIMNAZIALĂ SAT POIENARII APOSTOLI, COMUNA GORGOTA","POIENARII APOSTOLI",PH,1143,7,1,0,8,17,1,0,18,22,2,0,24,36,3,0,39,42,4,0,46
133526,434,"ȘCOALA PRIMARĂ SAT CRIVINA, COMUNA GORGOTA",CRIVINA,PH,794,9,0,0,9,18,2,0,20,29,3,0,32,38,3,0,41,41,3,0,44
133571,435,"SCOALA GIMNAZIALA GORNET",GORNET,PH,970,7,3,0,10,14,3,0,17,27,5,0,32,40,5,0,45,43,5,0,48
133571,436,"ȘCOALA GIMNAZIALĂ GORNET",GORNET,PH,984,6,2,0,8,8,2,0,10,13,2,0,15,32,3,0,35,42,4,0,46
133599,437,"SCOALA PRIMARA CUIB",CUIB,PH,261,10,4,0,14,12,5,0,17,12,5,0,17,24,8,0,32,28,8,0,36
133606,438,"SCOALA PRIMARA NUCET",NUCET,PH,150,5,3,0,8,13,3,0,16,17,4,0,21,18,4,0,22,20,4,0,24
133624,439,"CĂMIN CULTURAL GORNET-CRICOV",GORNET-CRICOV,PH,784,0,0,0,0,4,3,0,7,9,3,0,12,17,3,0,20,18,3,0,21
133633,440,"GRĂDINIȚA COȘERELE",COŞERELE,PH,653,1,2,0,3,1,2,0,3,3,4,0,7,12,6,0,18,12,6,0,18
133642,441,"GRĂDINIȚA DOBROTA",DOBROTA,PH,381,0,7,0,7,1,7,0,8,2,8,0,10,2,8,0,10,5,8,0,13
133697,442,"CĂMINUL CULTURAL, NR. 212","GURA VADULUI",PH,1169,5,3,0,8,16,4,0,20,17,5,0,22,24,6,0,30,28,6,0,34
133704,443,"CĂMIN CULTURAL",PERŞUNARI,PH,663,2,0,0,2,6,1,0,7,7,1,0,8,15,2,0,17,15,2,0,17
131844,444,"SCOALA GIMNAZIALA GURA VITIOAREI","GURA VITIOAREI",PH,1672,9,1,0,10,16,1,0,17,20,2,0,22,39,5,0,44,40,5,0,45
131862,445,"SCOALA PRIMARA FAGETU",FĂGETU,PH,957,9,0,0,9,24,0,0,24,28,2,0,30,34,2,0,36,37,2,0,39
131880,446,"SCOALA GIMNAZIALA POIANA COPACENI","POIANA COPĂCENI",PH,845,10,2,0,12,17,4,0,21,27,6,0,33,39,6,0,45,45,7,0,52
131853,447,"SCOALA GIMNAZIALA BUGHEA DE JOS","BUGHEA DE JOS",PH,864,2,5,0,7,6,5,0,11,10,5,0,15,16,9,0,25,16,10,0,26
131871,448,"GRADINITA CU PROGRAM NORMAL FUNDENI",FUNDENI,PH,519,4,8,0,12,15,13,0,28,22,13,0,35,28,13,0,41,28,13,0,41
133731,449,"GRǍDINIȚA IORDǍCHEANU",IORDĂCHEANU,PH,1006,5,2,0,7,13,2,0,15,16,4,0,20,23,5,0,28,27,5,0,32
133740,450,"ŞCOALA MOCEŞTI",MOCEŞTI,PH,970,6,0,0,6,8,0,0,8,15,0,0,15,19,1,0,20,25,1,0,26
133777,451,"CLǍDIRE NOUǍ - FOST SEDIU C.A.P.","VALEA CUCULUI",PH,1051,2,2,0,4,4,3,0,7,8,4,0,12,13,6,0,19,14,7,0,21
133786,452,"ŞCOALA VǍRBILA",VĂRBILA,PH,1169,3,2,0,5,5,3,0,8,12,3,0,15,22,5,0,27,27,7,0,34
133802,453,"ŞCOALA GIMNAZIALĂ TRAIAN SĂVULESCU IZVOARELE",IZVOARELE,PH,1025,3,5,0,8,14,7,0,21,25,9,0,34,30,9,0,39,31,9,0,40
133802,454,"ŞCOALA GIMNAZIALĂ TRAIAN SĂVULESCU IZVOARELE",IZVOARELE,PH,948,3,0,0,3,8,1,0,9,10,1,0,11,16,5,0,21,19,5,0,24
133839,455,"ŞCOALA GIMNAZIALĂ HOMORÎCIU",HOMORÎCIU,PH,944,1,0,0,1,9,1,0,10,20,1,0,21,25,5,0,30,29,5,0,34
133839,456,"ŞCOALA GIMNAZIALĂ HOMORÎCIU",HOMORÎCIU,PH,793,2,0,0,2,3,0,0,3,4,0,0,4,7,0,0,7,7,0,0,7
133857,457,"ŞCOALA GIMNAZIALĂSCHIULEȘTI",SCHIULEŞTI,PH,1007,8,4,0,12,19,8,0,27,39,10,0,49,54,11,0,65,58,13,0,71
133848,458,"ŞCOALA PRIMARĂ MALU-VÎNĂT","MALU VÎNĂT",PH,690,9,0,0,9,14,5,0,19,15,5,0,20,26,8,0,34,34,8,0,42
133875,459,"CĂMINUL CULTURAL",JUGURENI,PH,405,3,0,0,3,7,2,0,9,13,6,0,19,20,8,0,28,20,8,0,28
133928,460,"CĂMINUL CULTURAL",LAPOŞ,PH,928,24,2,0,26,37,2,0,39,75,7,0,82,101,9,0,110,115,9,0,124
133973,461,"BAZA SPORTIVA",LIPĂNEŞTI,PH,679,5,1,0,6,20,8,0,28,34,11,0,45,48,16,0,64,56,19,0,75
133991,462,"SCOALA GIMNAZIALA ""EROILOR"" LIPANESTI",ŞIPOTU,PH,840,4,1,0,5,9,2,0,11,21,7,0,28,24,12,0,36,31,12,0,43
133991,463,"SCOALA GIMNAZIALA ""EROILOR"" LIPANESTI",ŞIPOTU,PH,1010,1,1,0,2,7,1,0,8,20,2,0,22,33,3,0,36,35,3,0,38
134005,464,"SCOALA GIMNAZIALA ""SPIREA SORESCU""ZAMFIRA",ZAMFIRA,PH,919,19,1,0,20,43,3,0,46,63,15,0,78,74,19,0,93,79,22,0,101
133973,465,"BAZA SPORTIVA 1",LIPĂNEŞTI,PH,752,11,0,0,11,27,0,0,27,36,3,0,39,44,5,0,49,50,5,0,55
134023,466,"CĂMINUL CULTURAL MĂGURELE",MĂGURELE,PH,1297,12,0,0,12,23,0,0,23,34,4,0,38,45,5,0,50,51,5,0,56
134023,467,"GRĂDINIŢA DE COPII ""MICUL PRINŢ"" MĂGURELE",MĂGURELE,PH,1428,5,0,0,5,15,4,0,19,24,4,0,28,30,5,0,35,30,5,0,35
134032,468,"GRĂDINIŢA DE COPII SAT COADA MALULUI","COADA MALULUI",PH,676,5,2,0,7,14,2,0,16,21,3,0,24,32,9,0,41,33,10,0,43
134041,469,"GRĂDINIŢA DE COPII SAT IAZU",IAZU,PH,523,5,2,0,7,12,2,0,14,13,2,0,15,21,2,0,23,28,2,0,30
134069,470,"ȘCOALAPRIMARĂMĂGURENI, CORP B, SAT MĂGURENI, NR.201",MĂGURENI,PH,1384,11,1,0,12,27,3,0,30,35,3,0,38,44,3,0,47,47,8,0,55
134069,471,"ȘCOALA PRIMARĂ SATUL BANULUI, SAT MĂGURENI, NR.541",MĂGURENI,PH,967,2,0,0,2,14,1,0,15,16,1,0,17,20,2,0,22,24,2,0,26
134069,472,"ȘCOALAGIMNAZIALĂMĂGURENI,CORP A, SAT MĂGURENI, NR.982",MĂGURENI,PH,1319,3,1,0,4,5,2,0,7,11,2,0,13,20,3,0,23,25,6,0,31
134087,473,"ȘCOALA PRIMARĂLUNCA PRAHOVEI, SAT LUNCA PRAHOVEI, NR.39","LUNCA PRAHOVEI",PH,926,5,4,0,9,19,4,0,23,21,4,0,25,31,4,0,35,38,4,0,42
134078,474,"CĂMIN CULTURAL COCORĂȘTII CAPLII, SAT COCORĂȘTII CAPLII, NR.130","COCORĂŞTII CAPLII",PH,683,16,6,0,22,17,7,0,24,22,11,0,33,29,14,0,43,29,14,0,43
134103,475,"GRĂDINIȚA CU PROGRAM NORMAL NR.3",MĂNECIU-UNGURENI,PH,1399,7,2,0,9,18,2,0,20,20,4,0,24,26,4,0,30,30,4,0,34
134103,476,"GRĂDINIȚA CU PROGRAM NORMAL NR.3",MĂNECIU-UNGURENI,PH,1322,5,1,0,6,12,1,0,13,19,1,0,20,26,2,0,28,32,2,0,34
134158,477,"LICEUL TEHNOLOGIC MĂNECIU NR.5",GHEABA,PH,1251,4,4,0,8,9,12,0,21,18,13,0,31,23,15,0,38,30,15,0,45
134158,478,"LICEUL TEHNOLOGIC MĂNECIU NR.5",GHEABA,PH,1117,6,0,0,6,14,3,0,17,19,3,0,22,31,4,0,35,33,4,0,37
134176,479,"ŞCOALA GIMNAZIALĂ MĂNECIU-PĂMÎNTENI, NR.267",MĂNECIU-PĂMÎNTENI,PH,880,4,5,0,9,6,5,0,11,10,5,0,15,15,5,0,20,15,5,0,20
134176,480,"ŞCOALA GIMNAZIALĂ MĂNECIU-PĂMÎNTENI, NR.267",MĂNECIU-PĂMÎNTENI,PH,945,2,3,0,5,11,6,0,17,18,6,0,24,20,6,0,26,21,6,0,27
134176,481,"ŞCOALA GIMNAZIALĂ MĂNECIU-PĂMÎNTENI, NR.1229",MĂNECIU-PĂMÎNTENI,PH,1558,7,1,0,8,23,3,0,26,30,5,0,35,41,7,0,48,47,7,0,54
134112,482,"ŞCOALA PRIMARĂ CHEIA, NR.1",CHEIA,PH,324,3,5,0,8,18,19,0,37,26,34,0,60,32,42,0,74,32,46,0,78
134201,483,"CĂMIN CULTURAL",MĂNEŞTI,PH,879,4,0,0,4,13,1,0,14,15,10,0,25,21,10,0,31,24,10,0,34
134327,484,"SALĂ MULTIFUNCȚIONALĂ ZALHANAUA",ZALHANAUA,PH,799,4,3,0,7,10,4,0,14,14,4,0,18,24,5,0,29,25,5,0,30
134238,485,"ȘCOALA COADA IZVORULUI","COADA IZVORULUI",PH,767,4,0,0,4,11,2,0,13,15,3,0,18,27,4,0,31,31,6,0,37
134210,486,SALĂMULTIFUNCȚIONALĂBĂLTIȚA,BĂLTIŢA,PH,720,2,5,0,7,3,5,0,8,9,5,0,14,18,6,0,24,26,8,0,34
133483,487,"ȘCOALA PRIMARӐOLARII-VECHI, SAT OLARII-VECHI","OLARII VECHI",PH,608,5,4,0,9,11,6,0,17,20,6,0,26,36,6,0,42,46,6,0,52
133474,488,"ȘCOALAGIMNAZIALӐ OLARI, SAT OLARI",OLARI,PH,588,3,5,0,8,10,7,0,17,19,7,0,26,32,9,0,41,36,11,0,47
133447,489,"ȘCOALAPRIMARӐFȂNARI, SATFȂNARI",FÂNARI,PH,325,6,2,0,8,15,2,0,17,17,3,0,20,27,4,0,31,28,6,0,34
134345,490,"GRĂDINIŢA CU PROGRAM NORMAL PĂCUREŢI",PĂCUREŢI,PH,1036,10,0,0,10,19,5,0,24,29,8,0,37,43,10,0,53,47,11,0,58
134372,491,"ŞCOALA GIMNAZIALĂ",MATIŢA,PH,654,7,1,0,8,9,2,0,11,12,2,0,14,20,5,0,25,25,6,0,31
130856,492,"SCOALA GENERALA CU CL.I-VIII ARH.TOMA T.SOCOLESCU PAULESTI",PĂULEŞTI,PH,1371,4,1,0,5,21,2,0,23,37,3,0,40,60,6,0,66,66,7,0,73
130856,493,"CENTRUL CULTURALARH.TOMA T.SOCOLESCU PAULESTI",PĂULEŞTI,PH,1249,7,1,0,8,18,2,0,20,32,3,0,35,47,5,0,52,54,7,0,61
130865,494,"SALA MULTIFUNCTIONALA COCOSESTI",COCOŞEŞTI,PH,791,5,2,0,7,15,3,0,18,24,3,0,27,31,6,0,37,32,7,0,39
130874,495,"SCOALA GENERALA CU CLS.I-VIIIVLAD MUSATESCU GAGENI",GĂGENI,PH,807,0,0,0,0,12,0,0,12,26,0,0,26,33,3,0,36,43,7,0,50
130874,496,"CAMINUL CULTURAL GAGENI",GĂGENI,PH,1050,17,0,0,17,113,0,0,113,119,0,0,119,127,0,0,127,129,0,0,129
134407,497,"GRADINITA CU PROGRAM NORMAL PLOPU",PLOPU,PH,871,4,2,0,6,15,6,0,21,23,9,0,32,32,11,0,43,36,11,0,47
134434,498,"SCOALA CU CLS. I-IV NISIPOASA",NISIPOASA,PH,676,8,0,0,8,18,0,0,18,23,0,0,23,30,0,0,30,33,0,0,33
134416,499,"FOSTA SCOALA CU CLS. I-IV GALMEIA",GÂLMEIA,PH,199,0,3,0,3,2,5,0,7,8,5,0,13,8,6,0,14,9,6,0,15
134425,500,"FOSTA SCOALA CU CLS. I-IV HARSA",HÂRŞA,PH,209,0,0,0,0,0,0,0,0,1,1,0,2,1,1,0,2,1,1,0,2
134522,501,"SCOALA CU CLASELE I-VIII PODENII NOI",SĂLCIOARA,PH,1263,5,2,0,7,20,3,0,23,28,4,0,32,33,5,0,38,33,7,0,40
134540,502,"GRĂDINIŢA CU PROGRAM NORMAL VALEA-DULCE","VALEA DULCE",PH,807,4,2,0,6,16,2,0,18,20,2,0,22,30,2,0,32,37,2,0,39
134504,503,"GRADINITA DE COPII POPESTI",POPEŞTI,PH,472,4,2,0,6,7,2,0,9,12,2,0,14,15,4,0,19,15,4,0,19
134470,504,"SCOALA CU CLASELE I-VIII MEHEDINTA",MEHEDINŢA,PH,1321,1,3,0,4,10,3,0,13,20,4,0,24,24,6,0,30,25,6,0,31
131283,505,"ŞCOALA GIMNAZIALĂ ""ÎNVĂŢĂTOR ION MATEESCU"" POIANA-CĂMPINA","POIANA CÂMPINA",PH,1038,13,0,0,13,38,10,0,48,52,14,0,66,59,18,0,77,60,18,0,78
131283,506,"PRIMARIA COMUNEI POIANA-CÂMPINA","POIANA CÂMPINA",PH,1255,9,1,0,10,26,2,0,28,41,2,0,43,53,3,0,56,56,3,0,59
131283,507,"BIBLIOTECA ""DIMITRIE GUSTI"" COMUNA POIANA-CĂMPINA","POIANA CÂMPINA",PH,631,4,0,0,4,13,0,0,13,15,0,0,15,20,0,0,20,23,0,0,23
131309,508,"ŞCOALA GENERALĂ PIETRIŞU",PIETRIŞU,PH,477,5,0,0,5,8,0,0,8,11,1,0,12,16,2,0,18,16,2,0,18
131292,509,"CĂMINUL CULTURAL BOBOLIA",BOBOLIA,PH,886,3,2,0,5,14,5,0,19,29,5,0,34,42,7,0,49,47,10,0,57
134568,510,"SCOALA GIMANZIALA POIENARII BURCHII","POIENARII BURCHII",PH,954,1,2,0,3,9,4,0,13,12,5,0,17,18,5,0,23,22,5,0,27
134577,511,"GRADINITA DE COPII SAT CARBUNARI",CĂRBUNARI,PH,612,0,0,0,0,5,1,0,6,7,1,0,8,9,1,0,10,9,1,0,10
134611,512,"SCOALA POIENARII RALI","POIENARII RALI",PH,845,11,1,0,12,19,6,0,25,26,9,0,35,30,11,0,41,34,11,0,45
134586,513,"ANEXA PRIMARIE SAT OLOGENI",OLOGENI,PH,1085,3,0,0,3,10,0,0,10,16,5,0,21,26,8,0,34,30,8,0,38
134639,514,"CAMIN CULTURAL TATARAI",TĂTĂRĂI,PH,454,1,1,0,2,3,1,0,4,7,8,0,15,10,8,0,18,10,8,0,18
134666,515,"CĂMINUL CULTURAL DIN SATUL POSEŞTII-PĂMÂNTENI",BODEŞTI,PH,658,5,0,0,5,7,2,0,9,9,3,0,12,10,5,0,15,12,8,0,20
134693,516,"CLADIREA FOSTEI PRIMARII RANCEZI DIN SATUL NUCSOARA DE JOS","NUCŞOARA DE JOS",PH,1258,4,0,0,4,17,1,0,18,20,2,0,22,31,8,0,39,40,13,0,53
134728,517,"ŞCOALA GENERALĂ CU CLASELE I-VIII DIN SATUL VALEA PLOPULUI","VALEA PLOPULUI",PH,776,8,3,0,11,24,15,0,39,35,26,0,61,59,41,0,100,61,41,0,102
134719,518,"FOSTA ŞCOALĂ GENERALĂ CU CLASELE I-IV DIN SATUL TÂRLEŞTI",TÎRLEŞTI,PH,479,2,0,0,2,6,0,0,6,9,0,0,9,14,0,0,14,16,0,0,16
134764,519,"ȘCOALA GIMNAZIALĂ ,,MĂNĂSTIREANU MIHAI” PREDEAL",PREDEAL,PH,734,3,0,0,3,9,1,0,10,11,1,0,12,19,1,0,20,19,1,0,20
134844,520,"ȘCOALA ELEMENTARĂ ZÎMBROAIA",ZÎMBROAIA,PH,143,0,3,0,3,2,3,0,5,7,4,0,11,8,4,0,12,8,4,0,12
134835,521,"ȘCOALA GIMNAZIALĂVITIOARA DE SUS","VITIOARA DE SUS",PH,998,11,4,0,15,42,7,0,49,51,14,0,65,54,15,0,69,56,15,0,71
134862,522,"SCOALA GIMNAZIALA PROVITA DE JOS","PROVIŢA DE JOS",PH,920,18,2,0,20,28,7,0,35,30,12,0,42,50,20,0,70,50,20,0,70
134871,523,"GRADINITA CU PROGRAM NORMAL DRAGANEASA",DRĂGĂNEASA,PH,930,6,7,0,13,13,9,0,22,31,15,0,46,50,15,0,65,57,15,0,72
134906,524,"ŞCOALAGIMNAZIALĂ CU CLASELE I-VIII,,MITROPOLIT PIMEN GEORGESCU"" PROVIŢA DE SUS","PROVIŢA DE SUS",PH,1364,14,0,0,14,21,8,0,29,33,9,0,42,46,9,0,55,55,12,0,67
134915,525,"GRĂDINŢA CU PROGRAM NORMAL IZVORU",IZVORU,PH,308,1,2,0,3,1,3,0,4,1,5,0,6,2,5,0,7,3,5,0,8
134951,526,"SCOALA GIMNAZIALA,COMUNA PUCHENII MARI","PUCHENII MARI",PH,1045,3,0,0,3,14,1,0,15,19,1,0,20,24,5,0,29,25,7,0,32
134997,527,"SCOALA GIMNAZIALA PIETROSANI",PIETROŞANI,PH,987,9,0,0,9,14,0,0,14,17,1,0,18,21,1,0,22,27,3,0,30
134997,528,"GRADINITA CU PROGRAM NORMALPIETROSANI",PIETROŞANI,PH,947,1,0,0,1,2,0,0,2,6,0,0,6,10,0,0,10,12,0,0,12
135011,529,"SCOALA GIMNAZIALA PUCHENII MOSNENI","PUCHENII MOŞNENI",PH,1202,14,0,0,14,20,2,0,22,30,2,0,32,39,6,0,45,40,6,0,46
134960,530,"SCOALA PRIMARA MIROSLAVESTI",MIROSLĂVEŞTI,PH,1525,11,0,0,11,23,0,0,23,33,0,9,42,38,3,9,50,46,4,9,59
134988,531,"GRADINITA CU PROGRAM NORMAL ODAILE",ODĂILE,PH,1316,3,0,0,3,8,2,0,10,17,4,0,21,26,4,0,30,26,4,0,30
135084,532,"SCOALA PRIMARA MALAIESTI",MĂLĂIEŞTI,PH,655,5,3,0,8,15,3,0,18,24,3,0,27,27,3,0,30,33,3,0,36
135093,533,"SCOALA PRIMARA MOARA DOMNEASCA","MOARA DOMNEASCĂ",PH,799,0,0,0,0,6,1,0,7,7,1,0,8,17,1,0,18,19,1,0,20
135066,534,"SCOALA GIMNAZILABUDA",BUDA,PH,847,3,5,0,8,4,5,0,9,10,5,0,15,12,5,0,17,17,5,0,22
135100,535,"SCOALA PRIMARA PALANCA",PALANCA,PH,863,8,0,0,8,12,1,0,13,17,2,0,19,23,2,0,25,25,2,0,27
135075,536,"SCOALA PRIMARA GOGA",GOGA,PH,374,0,0,0,0,6,1,0,7,8,1,0,9,14,1,0,15,16,2,0,18
135119,537,"SCOALA PRIMARA SICRITA",SICRITA,PH,400,3,0,0,3,3,1,0,4,5,3,0,8,10,4,0,14,10,4,0,14
135039,538,"FOSTUL SEDIU AL PRIMARIEI",RÎFOV,PH,289,1,0,0,1,3,0,0,3,7,0,0,7,11,0,0,11,12,0,0,12
135057,539,"SCOALA DEZAFECTATA BUCHILASI",BUCHILAŞI,PH,123,1,2,0,3,3,3,0,6,4,3,0,7,6,3,0,9,7,3,0,10
135137,540,"SCOALA GIMNAZIALA",SALCIA,PH,812,5,0,0,5,15,1,0,16,20,3,0,23,26,3,0,29,28,3,0,31
135155,541,"SCOALA NOUA",SĂLCIILE,PH,763,3,0,0,3,14,6,12,32,27,6,12,45,36,11,12,59,37,12,12,61
135155,542,CAMINULCULTURAL,SĂLCIILE,PH,717,3,1,0,4,12,4,15,31,21,8,15,44,30,11,15,56,31,15,15,61
135173,543,"SCOALA GIMNAZIALA SCORTENI",SCORŢENI,PH,1212,10,1,0,11,21,3,0,24,35,6,0,41,45,7,0,52,47,7,0,54
135208,544,"SCOALA GIMNAZIALA MISLEA",MISLEA,PH,1527,6,0,0,6,12,0,0,12,20,1,0,21,33,2,0,35,33,2,0,35
135182,545,"GRADINITA BORDENII MARI","BORDENII MARI",PH,1200,10,1,0,11,29,3,0,32,46,3,0,49,70,4,0,74,78,6,0,84
135217,546,"SCOALA GIMNAZIALA BORDENI",SÎRCA,PH,825,9,0,0,9,16,0,0,16,33,0,0,33,47,0,0,47,50,0,0,50
135235,547,"ŞCOALA GIMNAZIALĂ COMUNA SECĂRIA",SECĂRIA,PH,1031,10,0,0,10,23,1,0,24,31,1,0,32,36,1,24,61,37,1,24,62
135253,548,"LICEUL TEHNOLOGIC",SÎNGERU,PH,1262,9,0,0,9,11,0,0,11,14,1,0,15,14,1,0,15,15,3,0,18
135253,549,"LICEUL TEHNOLOGIC",SÎNGERU,PH,689,10,1,0,11,17,2,0,19,24,4,0,28,28,4,0,32,36,4,0,40
135271,550,"ŞCOALA GIMNAZIALĂ","MIREŞU MARE",PH,1187,4,2,0,6,8,2,0,10,11,3,0,14,17,5,0,22,20,6,0,26
135262,551,"GRĂDINIŢACU PROGRAM NORMAL",BUTUCI,PH,417,3,1,0,4,5,5,0,10,9,5,0,14,11,6,0,17,17,6,0,23
135306,552,"GRĂDINIŢACU PROGRAM NORMAL",TISA,PH,556,8,3,0,11,11,4,0,15,12,4,0,16,16,4,0,20,18,4,0,22
135324,553,"GRĂDINIŢA DE COPII DIN SATUL STARCHIOJD",STARCHIOJD,PH,1370,5,1,0,6,15,2,0,17,24,2,0,26,34,2,0,36,35,3,0,38
135324,554,"GRĂDINIŢA DE COPII DIN GÎRBEASCA",STARCHIOJD,PH,1189,5,0,0,5,7,0,0,7,11,0,0,11,15,1,0,16,16,1,0,17
135388,555,"ŞCOALA DIN SATUL VALEA ANEI","VALEA ANEI",PH,444,0,1,0,1,3,1,0,4,5,1,0,6,5,1,0,6,5,1,0,6
135413,556,"ŞCOALA PRIMARĂ",SURANI,PH,1418,13,0,0,13,27,13,0,40,42,14,0,56,49,14,0,63,55,16,0,71
135486,557,"ŞCOALA GIMNAZIALĂ, SAT TĂRICENI",TĂRICENI,PH,884,5,0,0,5,16,5,0,21,18,6,0,24,27,7,0,34,28,8,0,36
135486,558,"ŞCOALA GIMNAZIALĂ, SAT TĂRICENI",TĂRICENI,PH,671,9,2,0,11,11,2,0,13,19,2,0,21,26,2,0,28,27,2,0,29
135440,559,"ŞCOALA PRIMARĂ, SAT ŞIRNA",ŞIRNA,PH,615,2,2,0,4,9,2,0,11,12,3,0,15,16,4,0,20,21,4,0,25
135495,560,"ŞCOALA GIMNAZIALĂ, SAT VARNIŢA",VARNIŢA,PH,749,3,0,0,3,9,0,0,9,14,0,0,14,26,1,0,27,28,1,0,29
135477,561,"ŞCOALA GIMNAZIALĂ, SAT HĂBUD",HĂBUD,PH,645,6,1,0,7,16,1,0,17,19,1,0,20,27,4,0,31,32,4,0,36
135459,562,"ŞCOALA PRIMARĂ,SAT BRĂTEŞTI",BRĂTEŞTI,PH,412,9,1,0,10,17,1,0,18,29,6,0,35,39,7,0,46,40,7,0,47
135538,563,"CĂMIN CULTURAL",MĂGURA,PH,429,1,0,0,1,2,0,0,2,5,0,0,5,14,0,0,14,14,6,0,20
135510,564,"ȘCOALA GIMNAZIALĂ ""MINERVA ALEXANDRESCU""",ŞOIMARI,PH,1408,2,1,0,3,6,4,0,10,18,5,0,23,24,5,0,29,27,7,0,34
135529,565,"GRĂDINIȚA CU PROGRAM NORMAL",LOPATNIŢA,PH,570,4,0,0,4,8,0,0,8,10,0,0,10,13,1,0,14,14,1,0,15
135574,566,"SCOALA SAT PLAIU CAMPINEI, NR 35","PLAIU CÂMPINEI",PH,662,0,1,0,1,1,1,0,2,4,1,0,5,17,1,0,18,17,1,0,18
135592,567,"ŞCOALA SAT SECIURI, NR 17",SECIURI,PH,297,0,2,0,2,0,2,0,2,2,2,0,4,3,4,0,7,4,4,0,8
135565,568,"ŞCOALA SAT LUNCA-MARE, NR 166","LUNCA MARE",PH,385,3,1,0,4,6,1,0,7,7,1,0,8,13,1,0,14,16,2,0,18
135609,569,"ŞCOALA SAT VISTIERU, NR 25",VISTIERU,PH,475,1,0,0,1,3,2,0,5,4,6,0,10,6,7,0,13,7,7,0,14
135556,570,"ŞCOALA GIMNAZIALĂ, SAT SOTRILE, NR 364",ŞOTRILE,PH,844,4,0,0,4,6,1,0,7,7,2,0,9,13,2,0,15,17,3,0,20
135636,571,"GRĂDINIŢA DE COPII",SCURTEŞTI,PH,635,9,0,0,9,14,2,0,16,20,2,0,22,25,2,0,27,28,2,0,30
135627,572,"SCOALA GIMNAZIALA STEFESTI",ŞTEFEŞTI,PH,1276,10,1,0,11,15,4,0,19,27,9,0,36,41,9,0,50,48,9,0,57
135663,573,"SCOALA GIMNAZIALA TALEA",TALEA,PH,870,12,0,0,12,18,1,0,19,23,1,0,24,33,2,0,35,46,4,0,50
135690,574,"CAMIN CULTURAL",TĂTARU,PH,242,3,3,0,6,7,3,0,10,9,3,0,12,9,3,0,12,11,3,0,14
135707,575,"CAMIN CULTURAL",PODGORIA,PH,496,2,3,0,5,3,4,0,7,5,4,0,9,5,6,0,11,6,6,0,12
135734,576,"ȘCOALA GIMNAZIALĂ""DUMITRU BREZEANU"",SATTEIȘANI,NR.160",TEIŞANI,PH,1460,10,3,0,13,23,8,0,31,30,8,0,38,40,9,0,49,42,9,0,51
135770,577,"SC.MALI AUTO EXPRES SRL, SAT VALEA STÎLPULUI,NR.58","VALEA STÎLPULUI",PH,179,3,1,0,4,6,1,0,7,6,2,0,8,8,5,0,13,8,5,0,13
135752,578,"SCOALA GIMNAZIALĂ ""MOISE VASILESCU"", SAT OLTENI, NR.147",OLTENI,PH,1425,5,2,0,7,16,6,0,22,26,8,0,34,45,9,0,54,46,9,0,55
135798,579,"ŞCOALA GIMNAZIALA NR.1 TELEGA",TELEGA,PH,1147,8,3,0,11,25,5,0,30,40,10,0,50,47,15,0,62,47,15,0,62
135798,580,"SCOALA GENERALA NR.2 TELEGA-VALE",TELEGA,PH,1468,7,1,0,8,17,1,0,18,25,1,0,26,35,2,0,37,35,2,0,37
135798,581,"GRĂDINIŢA NR.1 TELEGA",TELEGA,PH,1177,8,4,0,12,22,7,0,29,35,10,0,45,45,15,0,60,45,15,0,60
135814,582,"ŞCOALA GIMNAZIALĂ SAT BUŞTENARI",BUŞTENARI,PH,504,3,1,0,4,9,1,0,10,13,3,0,16,25,4,0,29,25,4,0,29
135832,583,"SCOALA PRIMARA SAT MELICEŞTI",MELICEŞTI,PH,403,2,0,0,2,3,0,0,3,6,0,0,6,13,1,0,14,17,1,0,18
135869,584,"CĂMINUL CULTURAL TINOSU, LOCALITATEA TINOSU",TINOSU,PH,927,10,2,0,12,19,3,0,22,28,3,0,31,42,4,0,46,47,4,0,51
135878,585,"ŞCOALA PRIMARĂ SAT PREDEŞTI, LOCALITATEAPREDEŞTI",PREDEŞTI,PH,544,11,0,0,11,14,1,0,15,17,2,0,19,21,5,0,26,21,5,0,26
135887,586,"ŞCOALA PRIMARĂ SATPISCULEŞTI, LOCALITATEA PISCULEŞTI",PISCULEŞTI,PH,515,6,1,0,7,13,3,0,16,17,3,0,20,22,4,0,26,27,4,0,31
130909,587,"BAZA SPORTIVA CONPET",STREJNICU,PH,1817,11,0,0,11,40,3,0,43,56,3,0,59,79,5,0,84,80,7,0,87
130909,588,"GRĂDINIŢA CU PROGRAM NORMAL STREJNICU",STREJNICU,PH,1442,15,1,0,16,38,2,0,40,59,2,0,61,74,2,0,76,80,2,0,82
130909,589,"ŞCOALA GIMNAZIALĂ STREJNICU",STREJNICU,PH,1556,13,3,0,16,44,5,0,49,61,8,0,69,75,9,0,84,93,12,0,105
130909,590,"CĂMINUL CULTURAL STREJNICU",STREJNICU,PH,770,4,0,0,4,10,2,0,12,17,2,0,19,30,4,0,34,34,5,0,39
130927,591,"ŞCOALA GIMNAZIALĂ TIRGŞORU VECHI","TÎRGŞORU VECHI",PH,1051,7,6,0,13,13,7,0,20,22,9,0,31,38,9,0,47,39,9,0,48
130927,592,"GRĂDINIŢA CU PROGRAM NORMAL TÎRGŞORU VECHI","TÎRGŞORU VECHI",PH,890,2,0,0,2,10,1,0,11,25,2,0,27,31,5,0,36,37,6,0,43
130918,593,"ŞCOALA GENERALĂ CU CLASELE I-IV STĂNCEŞTI",STĂNCEŞTI,PH,813,5,0,0,5,21,4,0,25,27,5,0,32,39,8,0,47,49,8,0,57
135903,594,"CĂMIN CULTURAL TOMṢANI, SAT MAGULA, NR. 6A",TOMŞANI,PH,1289,4,3,0,7,16,3,0,19,27,4,0,31,41,5,0,46,52,5,0,57
135921,595,"ṢCOALA VECHE MAGULA, SAT MAGULA, NR. 406A",MAGULA,PH,1099,9,2,0,11,23,2,0,25,34,2,0,36,44,4,0,48,49,4,0,53
135912,596,"CĂMIN CULTURAL LOLOIASCA, SAT LOLOIASCA, NR. 6V",LOLOIASCA,PH,1189,15,2,0,17,34,4,0,38,38,4,0,42,47,6,0,53,52,6,0,58
133321,597,"ȘCOALĂ GIMNAZIALĂVADU SĂPAT, COMUNA VADU SĂPAT, SAT VADU SĂPAT","VADU SĂPAT",PH,1354,6,1,0,7,22,6,0,28,25,8,0,33,29,9,0,38,37,9,0,46
135967,598,"CAMIN CULTURAL",ARVA,PH,1106,9,3,0,12,12,7,0,19,17,9,0,26,29,10,0,39,32,10,0,42
135958,599,"SCOALA GIMNAZIALA ION IONESCU VALEA CALUGAREASCA","VALEA CĂLUGĂREASCĂ",PH,1434,21,0,0,21,37,0,0,37,48,3,0,51,62,3,0,65,68,5,0,73
135958,600,"SCOALA GIMNAZIALA ION IONESCU VALEA CALUGAREASCA","VALEA CĂLUGĂREASCĂ",PH,942,9,2,0,11,17,2,0,19,23,3,0,26,30,3,0,33,32,4,0,36
136054,601,"SCOAL GIMNAZIALA NICOVANI","VALEA NICOVANI",PH,1154,7,0,0,7,15,2,0,17,23,4,0,27,30,6,0,36,31,6,0,37
135985,602,"GRADINITA DIRVARI",DÎRVARI,PH,469,5,0,0,5,7,0,0,7,7,0,0,7,17,0,0,17,18,0,0,18
135976,603,"GRADINITA COSLEGI",COSLEGI,PH,539,4,2,0,6,8,3,0,11,9,3,0,12,16,3,0,19,18,3,0,21
136018,604,"GRADINITA RADILA",RADILA,PH,241,6,1,0,7,10,1,0,11,11,2,0,13,23,2,0,25,24,2,0,26
135994,605,"SCOAL PRIMARA PANTAZI",PANTAZI,PH,951,9,2,0,11,9,2,0,11,9,2,0,11,10,2,0,12,11,2,0,13
136009,606,"SCOAL GIMNAZIALA RACHIERI",RACHIERI,PH,1170,5,0,0,5,16,1,0,17,27,1,0,28,50,2,0,52,54,3,0,57
136072,607,"COLEGIUL AGRICOL GHEORGHE IONESCU SISESTI","VALEA POPII",PH,754,0,1,0,1,9,2,0,11,15,2,0,17,18,2,0,20,20,2,0,22
136045,608,"CABANA DE VANATOARE","VALEA MANTEI",PH,91,91,4,0,95,0,4,0,4,0,4,0,4,0,4,0,4,0,4,0,4
136116,609,"LICEUL TEHNOLOGIC ""CAROL I"" VALEA DOFTANEI",TEŞILA,PH,1358,1,0,0,1,10,4,0,14,17,5,0,22,23,7,0,30,25,7,0,32
136125,610,"PRIMĂRIA TRĂISTENI",TRĂISTENI,PH,982,1,0,0,1,6,1,0,7,6,2,0,8,6,2,0,8,6,2,0,8
136125,611,"ŞCOALA CU CLASELE I-VIII ""EROU INV.I.DRĂGĂNESCU""TRĂISTENI",TRĂISTENI,PH,1058,1,0,0,1,4,2,0,6,7,2,0,9,10,2,0,12,11,3,0,14
136116,612,"GRĂDINIŢA NR.1 TEŞILA",TEŞILA,PH,1181,1,0,0,1,4,4,0,8,4,7,0,11,4,9,0,13,5,9,0,14
136116,613,"GRĂDINIŢA NR.2 TEŞILA",TEŞILA,PH,990,0,0,0,0,3,0,0,3,9,0,0,9,15,1,0,16,16,1,0,17
136143,614,"ȘCOALA PRIMARĂ VĂRBILĂU",VĂRBILĂU,PH,902,8,2,0,10,15,2,0,17,22,2,0,24,42,2,0,44,42,2,0,44
136143,615,"ȘCOALA PRIMARĂ VĂRBILĂU",VĂRBILĂU,PH,848,7,2,0,9,18,2,0,20,29,2,0,31,39,4,0,43,43,4,0,47
136143,616,"ȘCOALA GIMNAZIALĂ VĂRBILĂU",VĂRBILĂU,PH,1159,5,1,0,6,23,3,0,26,38,7,0,45,52,10,0,62,62,10,0,72
136161,617,"ȘCOALA PRIMARĂ LIVADEA",LIVADEA,PH,878,2,1,0,3,11,8,0,19,17,8,0,25,27,10,0,37,28,10,0,38
136189,618,"ȘCOALA PRIMARĂ POIANA VĂRBILĂU","POIANA VĂRBILĂU",PH,1056,4,0,0,4,8,1,0,9,12,2,0,14,15,2,0,17,21,2,0,23
136152,619,"ȘCOALA PRIMARĂ COȚOFENEȘTI",COŢOFENEŞTI,PH,711,10,0,0,10,26,6,0,32,28,10,0,38,38,11,0,49,47,11,0,58
136205,620,"CENTRUL CULTURAL VÎLCĂNEŞTI",VÎLCĂNEŞTI,PH,1393,17,2,0,19,29,3,0,32,41,3,0,44,49,5,0,54,57,5,0,62
136205,621,"GRĂDINIŢA CU PROGRAM NORMAL NR.2 VÎLCĂNEŞTI",VÎLCĂNEŞTI,PH,772,11,2,0,13,19,2,0,21,23,2,0,25,28,2,0,30,28,2,0,30
136214,622,"ŞCOALA GIMNAZIALĂ,COMUNA VÎLCĂNEŞTI, SAT CÎRJARI",CÎRJARI,PH,611,2,0,0,2,8,0,0,8,14,1,0,15,15,1,0,16,17,2,0,19
136223,623,"BIBLIOTECA SĂTEASCĂ TRESTIOARA",TRESTIOARA,PH,374,6,2,0,8,9,2,0,11,19,3,0,22,24,4,0,28,25,4,0,29
143469,1,"ŞCOALA GIMNAZIALĂNR. 10 CU STRUCTURA GRADINIŢA CU PROGRAM PRELUNGIT NR. 20",SIBIU,SB,1676,6,3,0,9,23,5,0,28,39,5,0,44,67,7,0,74,77,7,0,84
143469,2,"ŞCOALA GIMNAZIALĂ NR. 10 CU STRUCTURA GRADINIŢA CU PROGRAM PRELUNGIT NR. 20",SIBIU,SB,1648,5,0,0,5,28,3,0,31,41,4,0,45,53,4,0,57,62,4,0,66
143469,3,"ŞCOALA GIMNAZIALĂ NR.10",SIBIU,SB,1407,10,1,0,11,30,4,0,34,52,6,0,58,69,7,0,76,79,7,0,86
143469,4,"ŞCOALA GIMNAZIALĂ NR.10",SIBIU,SB,1349,5,2,0,7,22,7,0,29,40,8,0,48,55,8,0,63,61,9,0,70
143469,5,"ŞCOALA GIMNAZIALĂ NR.10",SIBIU,SB,1710,8,1,0,9,39,8,0,47,47,11,0,58,66,16,0,82,67,16,0,83
143469,6,"ŞCOALA GIMNAZIALĂ NR. 13 CU STRUCTURA ŞCOALA GIMNAZIALĂ NR. 12",SIBIU,SB,1636,8,0,0,8,40,1,0,41,66,4,0,70,86,11,0,97,109,11,0,120
143469,7,"ŞCOALA GIMNAZIALĂ NR. 13 CU STRUCTURA ŞCOALA GIMNAZIALĂ NR. 12",SIBIU,SB,1343,7,0,0,7,39,1,0,40,52,1,0,53,71,2,0,73,83,2,0,85
143469,8,"ŞCOALA GIMNAZIALĂ NR. 13 CU STRUCTURA ŞCOALA GIMNAZIALĂ NR. 12",SIBIU,SB,1535,10,0,0,10,47,2,0,49,63,2,0,65,96,7,0,103,101,7,0,108
143469,9,"LICEUL TEHNOLOGIC CONSTRUCȚII ŞI ARHITECTURĂ CAROL I SIBIU",SIBIU,SB,1705,6,4,0,10,20,4,0,24,39,7,0,46,55,12,0,67,60,12,0,72
143469,10,"ŞCOALA GIMNAZIALĂ NR.13",SIBIU,SB,1044,16,0,0,16,31,1,0,32,39,4,0,43,46,10,0,56,53,10,0,63
143469,11,"ŞCOALA GIMNAZIALĂ NR.13",SIBIU,SB,1212,2,0,0,2,11,0,0,11,19,3,0,22,23,7,0,30,24,7,0,31
143469,12,"ŞCOALA GIMNAZIALĂ NR.13",SIBIU,SB,1307,9,5,0,14,37,6,0,43,37,6,0,43,46,6,0,52,53,7,0,60
143469,13,"ŞCOALA GIMNAZIALĂ NR.23",SIBIU,SB,1818,12,0,0,12,32,0,0,32,50,1,0,51,88,5,0,93,88,5,0,93
143469,14,"ŞCOALA GIMNAZIALĂ NR.23",SIBIU,SB,1392,7,0,0,7,26,1,0,27,35,1,0,36,54,1,0,55,63,2,0,65
143469,15,"ŞCOALA GIMNAZIALĂ NR.23",SIBIU,SB,1182,6,0,0,6,13,0,0,13,21,1,0,22,28,3,0,31,34,3,0,37
143469,16,"COLEGIUL TEHNIC INDEPENDENŢA",SIBIU,SB,1384,9,0,0,9,34,1,0,35,52,2,0,54,70,2,0,72,74,2,0,76
143469,17,"COLEGIUL TEHNIC DE INDUSTRIE ALIMENTARĂ TEREZIANUM SIBIU",SIBIU,SB,1546,5,1,0,6,31,1,0,32,49,4,0,53,62,4,0,66,75,4,0,79
143469,18,"COLEGIUL TEHNIC DE INDUSTRIE ALIMENTARĂ TEREZIANUM SIBIU",SIBIU,SB,1495,7,1,0,8,31,1,0,32,44,1,0,45,59,1,0,60,62,1,0,63
143469,19,"ŞCOALA GIMNAZIALĂ NR.18",SIBIU,SB,1749,10,4,0,14,32,6,0,38,49,6,0,55,74,6,0,80,81,6,0,87
143469,20,"ŞCOALA GIMNAZIALĂ NR.18",SIBIU,SB,1676,12,1,0,13,40,3,0,43,55,5,0,60,68,8,0,76,78,10,0,88
143469,21,"ŞCOALA GIMNAZIALĂ IOAN SLAVICICU STRUCTURA ŞCOALA GIMNAZIALĂ NR. 11",SIBIU,SB,1584,5,2,0,7,14,3,0,17,24,4,0,28,41,6,0,47,43,10,0,53
143469,22,"ŞCOALA GIMNAZIALĂIOAN SLAVICICU STRUCTURA ŞCOALA GIMNAZIALĂ NR. 11",SIBIU,SB,1576,1,1,0,2,19,2,0,21,35,2,0,37,45,2,0,47,56,4,0,60
143469,23,"ŞCOALA GIMNAZIALĂIOAN SLAVICI",SIBIU,SB,1674,15,1,0,16,57,2,0,59,83,2,0,85,105,3,0,108,113,3,0,116
143469,24,"ŞCOALA GIMNAZIALĂ IOAN SLAVICI",SIBIU,SB,1494,8,0,0,8,40,1,0,41,64,1,0,65,95,3,0,98,111,6,0,117
143469,25,"LICEUL TEHNOLOGIC HENRI COANDĂ",SIBIU,SB,1114,2,0,0,2,14,2,0,16,24,4,0,28,32,6,0,38,36,6,0,42
143469,26,"LICEUL TEHNOLOGIC HENRI COANDĂ",SIBIU,SB,993,9,0,0,9,24,2,0,26,35,2,0,37,46,4,0,50,51,4,0,55
143469,27,"LICEUL TEHNOLOGIC HENRI COANDĂ",SIBIU,SB,1704,2,2,0,4,15,2,0,17,29,2,0,31,42,2,0,44,45,2,0,47
143469,28,"ŞCOALA GIMNAZIALĂ NR. 8",SIBIU,SB,1159,13,1,0,14,32,1,0,33,43,1,0,44,66,4,0,70,68,9,0,77
143469,29,"ŞCOALA GIMNAZIALĂ NR. 8",SIBIU,SB,1381,11,1,0,12,34,1,0,35,47,2,0,49,65,2,0,67,75,2,0,77
143469,30,"ŞCOALA GIMNAZIALĂ NR. 8",SIBIU,SB,1267,9,1,0,10,29,1,0,30,45,2,0,47,62,2,0,64,73,3,0,76
143469,31,"ŞCOALA GIMNAZIALĂ NR. 8",SIBIU,SB,1568,6,2,0,8,25,2,0,27,40,2,0,42,52,6,0,58,55,6,0,61
143469,32,"GRĂDINIŢA CU PROGRAM PRELUNGIT NR. 17",SIBIU,SB,1056,4,0,0,4,14,0,0,14,27,3,0,30,40,4,0,44,43,4,0,47
143469,33,"GRĂDINIŢA CU PROGRAM PRELUNGIT NR. 37",SIBIU,SB,1333,10,2,0,12,27,11,0,38,38,12,0,50,62,13,0,75,72,15,0,87
143469,34,"PALATUL COPIILOR",SIBIU,SB,1331,11,3,0,14,36,5,0,41,53,9,0,62,66,10,0,76,76,11,0,87
143469,35,"PALATUL COPIILOR",SIBIU,SB,1117,5,2,0,7,37,2,0,39,52,4,0,56,65,4,0,69,72,81,0,153
143469,36,"ŞCOALA GIMNAZIALĂ NR.2",SIBIU,SB,1153,6,4,0,10,37,29,0,66,49,48,0,97,59,60,0,119,69,74,0,143
143469,37,"COLEGIUL NAŢIONAL GHEORGHE LAZĂR SIBIU",SIBIU,SB,1229,7,4,0,11,30,13,9,52,39,30,9,78,53,65,9,127,60,76,9,145
143469,38,"LICEUL DE ARTĂ SIBIU",SIBIU,SB,844,11,0,0,11,29,12,7,48,34,24,7,65,37,35,7,79,43,38,7,88
143469,39,"LICEUL DE ARTĂ SIBIU",SIBIU,SB,986,5,0,0,5,9,0,22,31,19,1,22,42,26,1,22,49,29,2,22,53
143469,40,"COLEGIUL TEHNIC INDEPENDENŢA SIBIU",SIBIU,SB,1227,8,3,0,11,30,5,0,35,45,5,0,50,60,5,0,65,65,8,0,73
143469,41,"COLEGIUL NAŢIONAL OCTAVIAN GOGA SIBIU",SIBIU,SB,1007,16,4,0,20,31,23,0,54,59,40,0,99,71,75,0,146,76,78,0,154
143469,42,"COLEGIUL NAŢIONALOCTAVIAN GOGA CU STRUCTURĂ ŞCOALA CU CLASELE I-VIII NR. 15",SIBIU,SB,1190,14,5,0,19,40,13,0,53,64,16,0,80,80,19,0,99,84,21,0,105
143469,43,"ŞCOALA GIMNAZIALĂ REGINA MARIA",SIBIU,SB,1214,11,0,0,11,28,4,0,32,60,10,0,70,74,16,0,90,84,19,0,103
143469,44,"ŞCOALA GIMNAZIALĂ REGINA MARIA",SIBIU,SB,1109,13,1,0,14,36,5,0,41,53,12,0,65,66,15,0,81,67,19,0,86
143469,45,"COLEGIUL AGRICOL DANIIL POPOVICI BARCIANU SIBIU",SIBIU,SB,1101,26,6,0,32,57,16,21,94,89,23,21,133,105,30,21,156,114,34,21,169
143469,46,"CASA CORPULUI DIDACTIC",SIBIU,SB,1438,18,5,0,23,32,7,0,39,48,10,0,58,60,15,0,75,70,18,0,88
143469,47,"LICEUL TEORETIC ONISIFOR GHIBU",SIBIU,SB,1254,13,1,0,14,39,1,0,40,51,8,2,61,74,18,2,94,75,18,2,95
143469,48,"ŞCOALA GIMNAZIALĂ NR. 1",SIBIU,SB,1502,8,1,0,9,43,3,0,46,62,7,0,69,84,8,0,92,88,10,0,98
143469,49,"ŞCOALA GIMNAZIALĂ NR. 1",SIBIU,SB,1547,12,1,0,13,50,2,0,52,90,4,0,94,100,5,0,105,105,5,0,110
143469,50,"ŞCOALA GIMNAZIALĂ NR. 1",SIBIU,SB,1609,23,5,0,28,57,6,0,63,76,6,0,82,105,9,0,114,113,9,0,122
143469,51,"ŞCOALA GIMNAZIALĂ NR. 1",SIBIU,SB,1668,7,7,0,14,37,8,0,45,55,8,0,63,73,9,0,82,86,10,0,96
143469,52,"GRĂDINIŢA CU PROGRAM PRELUNGIT NR. 22",SIBIU,SB,1497,10,0,0,10,46,0,0,46,61,0,0,61,93,0,0,93,104,0,0,104
143469,53,"GRĂDINIŢA CU PROGRAM PRELUNGIT NR. 22",SIBIU,SB,1458,15,0,0,15,31,0,0,31,46,0,0,46,72,0,0,72,79,0,0,79
143469,54,"GRĂDINIŢA CU PROGRAM PRELUNGIT NR. 22",SIBIU,SB,1702,9,5,0,14,33,5,0,38,52,10,0,62,83,10,0,93,94,14,0,108
143469,55,"GRĂDINIŢA CU PROGRAM PRELUNGIT NR. 22",SIBIU,SB,1119,10,5,0,15,30,5,0,35,43,6,0,49,60,7,0,67,79,7,0,86
143469,56,"ŞCOALA GIMNAZIALĂ NR. 25",SIBIU,SB,1242,2,2,0,4,23,3,0,26,37,3,0,40,51,3,0,54,58,3,0,61
143469,57,"ŞCOALA GIMNAZIALĂ NR. 25",SIBIU,SB,1348,11,0,0,11,34,0,0,34,46,4,0,50,65,5,0,70,77,5,0,82
143469,58,"ŞCOALA GIMNAZIALĂ NR. 25",SIBIU,SB,1348,11,0,0,11,44,0,0,44,64,0,0,64,88,0,0,88,96,1,0,97
143469,59,"ŞCOALA GIMNAZIALĂ NR. 25",SIBIU,SB,1589,10,2,0,12,27,6,0,33,38,9,0,47,48,11,0,59,53,14,0,67
143469,60,"ŞCOALA GIMNAZIALĂ ION LUCA CARAGIALE",SIBIU,SB,1426,9,2,0,11,42,6,0,48,63,7,0,70,75,8,0,83,82,8,0,90
143469,61,"ŞCOALA GIMNAZIALĂ ION LUCA CARAGIALE",SIBIU,SB,1191,14,4,0,18,36,5,0,41,54,6,0,60,70,8,0,78,70,8,0,78
143469,62,"ŞCOALA GIMNAZIALĂ ION LUCA CARAGIALE",SIBIU,SB,1160,9,0,0,9,33,0,0,33,48,2,0,50,61,3,0,64,67,3,0,70
143469,63,"FACULTATEA DE INGINERIE",SIBIU,SB,1260,11,3,0,14,40,11,0,51,58,21,0,79,75,24,0,99,84,27,0,111
143469,64,"COLEGIU ECONOMIC GEORGE BARIŢIU",SIBIU,SB,1266,17,0,0,17,44,5,0,49,55,12,0,67,60,17,0,77,62,19,0,81
143469,65,"COLEGIU ECONOMIC GEORGE BARIŢIU",SIBIU,SB,1354,15,5,0,20,53,9,0,62,76,11,0,87,104,14,0,118,116,15,0,131
143469,66,"COLEGIUL ECONOMIC GEORGE BARIŢIU, SIBIU",SIBIU,SB,1276,12,3,0,15,32,10,0,42,78,14,0,92,79,15,0,94,90,15,0,105
143469,67,"CLUB SPORTIV ŞCOLAR SIBIU",SIBIU,SB,1381,18,2,0,20,55,4,18,77,76,7,18,101,98,14,18,130,108,16,18,142
143469,68,"ŞCOALA GIMNAZIALĂ NR.4",SIBIU,SB,1386,11,2,0,13,33,3,0,36,42,8,0,50,57,8,0,65,63,8,0,71
143469,69,"ŞCOALA GIMNAZIALĂ NR.4",SIBIU,SB,1177,11,3,0,14,31,7,0,38,42,7,0,49,57,10,0,67,59,10,0,69
143469,70,"ŞCOALA GIMNAZIALĂ NR.4",SIBIU,SB,1442,5,0,0,5,25,2,0,27,42,2,0,44,68,3,0,71,75,3,0,78
143469,71,"COLEGIUL TEHNIC ENERGETIC",SIBIU,SB,1356,16,0,0,16,38,0,0,38,54,0,0,54,68,0,0,68,73,0,0,73
143469,72,"COLEGIUL TEHNIC ENERGETIC",SIBIU,SB,1308,8,7,0,15,19,10,0,29,22,13,0,35,41,16,0,57,43,17,0,60
143469,73,"COLEGIUL TEHNIC ENERGETIC",SIBIU,SB,1523,14,0,0,14,26,0,0,26,41,0,0,41,62,1,0,63,69,1,0,70
143469,74,"COLEGIUL TEHNIC ENERGETIC",SIBIU,SB,1442,6,0,0,6,42,2,0,44,55,2,0,57,66,4,0,70,77,4,0,81
143469,75,"ŞCOALA GIMNAZIALĂ REGELE FERDINAND",SIBIU,SB,1297,9,2,0,11,20,5,0,25,30,9,0,39,45,21,0,66,48,23,0,71
143469,76,"ŞCOALA GIMNAZIALĂ REGELE FERDINAND",SIBIU,SB,1383,2,0,0,2,14,0,0,14,26,0,0,26,35,0,0,35,37,1,0,38
143469,77,"ŞCOALA GIMNAZIALĂ REGELE FERDINAND",SIBIU,SB,1368,7,0,0,7,35,0,0,35,58,2,0,60,76,2,0,78,82,2,0,84
143469,78,"ŞCOALA GIMNAZIALĂ REGELE FERDINAND",SIBIU,SB,1339,16,3,0,19,39,3,0,42,48,4,0,52,78,4,0,82,82,4,0,86
143469,79,"ŞCOALA GIMNAZIALĂ REGELE FERDINAND",SIBIU,SB,1035,10,0,0,10,22,0,0,22,43,0,0,43,52,0,0,52,55,0,0,55
143469,80,"ŞCOALA GIMNAZIALĂ REGELE FERDINAND",SIBIU,SB,1230,10,0,0,10,27,0,0,27,38,0,0,38,48,0,0,48,58,0,0,58
143469,81,"ŞCOALA GIMNAZIALĂ REGELE FERDINAND",SIBIU,SB,1288,6,1,0,7,19,1,0,20,20,1,0,21,34,1,0,35,38,1,0,39
143469,82,"GRĂDINIŢA CU PROGRAM PRELUNGIT NR.29",SIBIU,SB,1173,7,1,0,8,32,3,0,35,46,8,0,54,60,10,0,70,65,11,0,76
143469,83,"ŞCOALA GIMNAZIALĂ RADU SELEJAN",SIBIU,SB,1206,7,3,0,10,22,7,0,29,27,7,0,34,44,8,0,52,50,8,0,58
143469,84,"ŞCOALA GIMNAZIALĂ RADU SELEJAN",SIBIU,SB,995,4,2,0,6,27,2,0,29,38,4,0,42,48,4,0,52,51,4,0,55
143469,85,"GRĂDINIŢA CU PROGRAM PRELUNGIT NR.33",SIBIU,SB,1219,5,6,0,11,28,6,0,34,32,6,0,38,44,8,0,52,49,8,0,57
143469,86,"ŞCOALA GIMNAZIALĂNR. 21",SIBIU,SB,1358,19,3,0,22,42,4,0,46,53,5,0,58,84,6,0,90,92,7,0,99
143469,87,"ŞCOALA GIMNAZIALĂNR. 21",SIBIU,SB,926,3,0,0,3,31,5,0,36,44,9,0,53,54,9,0,63,54,9,0,63
143469,88,"ŞCOALA GIMNAZIALĂNR. 21",SIBIU,SB,1036,10,0,0,10,36,0,0,36,47,2,0,49,64,5,0,69,72,5,0,77
143469,89,"ŞCOALA GIMNAZIALĂNR. 21",SIBIU,SB,1221,8,0,0,8,42,1,0,43,58,1,0,59,80,2,0,82,87,3,0,90
143469,90,"ŞCOALA GIMNAZIALĂ NICOLAE IORGA",SIBIU,SB,1385,20,4,0,24,46,9,0,55,69,10,0,79,80,10,0,90,89,11,0,100
143469,91,"ŞCOALA GIMNAZIALĂ NICOLAE IORGA",SIBIU,SB,1392,14,2,0,16,44,11,0,55,55,16,0,71,76,20,0,96,78,20,0,98
143469,92,"ŞCOALA GIMNAZIALĂ NICOLAE IORGA",SIBIU,SB,1306,7,2,0,9,33,3,0,36,56,5,0,61,71,5,0,76,80,5,0,85
143469,93,"ŞCOALA GIMNAZIALĂ NICOLAE IORGA",SIBIU,SB,1080,2,1,0,3,12,1,0,13,26,4,0,30,32,4,0,36,35,4,0,39
143469,94,"LICEUL TEORETIC CONSTANTIN NOICA",SIBIU,SB,1236,17,4,0,21,43,8,0,51,70,12,0,82,90,16,0,106,96,16,0,112
143469,95,"LICEUL TEORETIC CONSTANTIN NOICA",SIBIU,SB,1385,12,2,0,14,46,3,0,49,58,3,0,61,76,5,0,81,85,7,0,92
143469,96,"LICEUL TEORETIC CONSTANTIN NOICA",SIBIU,SB,1410,5,2,0,7,32,3,0,35,49,5,0,54,68,8,0,76,77,8,0,85
143469,97,"GRĂDINIŢA CU PROGRAM PRELUNGITELEFĂNŢELUL CURIOS",SIBIU,SB,1468,12,0,0,12,47,6,0,53,65,10,0,75,74,18,0,92,78,24,0,102
143469,98,"COLEGIUL NAŢIONAL PEDAGOGIC ANDREI ŞAGUNA",SIBIU,SB,1289,18,0,0,18,54,14,0,68,73,16,1,90,105,16,1,122,113,21,1,135
143469,99,"COLEGIUL NAŢIONAL PEDAGOGIC ANDREI ŞAGUNA",SIBIU,SB,1220,14,1,1,16,48,5,1,54,58,7,1,66,89,7,1,97,92,7,1,100
143469,100,"GRĂDINIŢA CU PROGRAM PRELUNGIT NR. 42",SIBIU,SB,1322,8,0,0,8,43,1,0,44,69,4,0,73,89,5,0,94,93,5,0,98
143469,101,"GRĂDINIŢA CU PROGRAM PRELUNGIT NR. 43",SIBIU,SB,1548,16,10,0,26,47,17,0,64,62,23,0,85,80,29,0,109,87,30,0,117
143469,102,"GRĂDINIŢA CU PROGRAM PRELUNGIT NR. 43",SIBIU,SB,1457,7,0,0,7,29,0,0,29,49,1,0,50,68,3,0,71,73,3,0,76
143469,103,"GRĂDINIŢA CU PROGRAM PRELUNGIT NR. 5",SIBIU,SB,1671,14,2,0,16,40,4,0,44,59,7,0,66,80,8,0,88,84,13,0,97
143469,104,"GRĂDINIŢA CU PROGRAM PRELUNGIT NR. 5",SIBIU,SB,1557,15,1,0,16,36,5,0,41,51,7,0,58,67,13,0,80,81,15,0,96
143478,105,PĂLTINIŞ,PĂLTINIŞ,SB,26,0,0,0,0,0,6,0,6,1,9,0,10,2,12,0,14,2,12,0,14
143469,106,"SCOALA GIMNAZIALA NR.10 SIBIU",SIBIU,SB,1252,7,0,0,7,22,0,0,22,29,3,0,32,36,4,0,40,44,4,0,48
143628,107,"ŞCOALA GIMNAZIALĂ HERMANN OBERTH",MEDIAŞ,SB,1171,8,0,0,8,23,4,0,27,31,12,18,61,38,14,18,70,50,14,18,82
143628,108,"GRĂDINIŢA CU PROGRAM PRELUNGIT NR.12",MEDIAŞ,SB,1065,3,0,0,3,19,5,19,43,20,5,19,44,35,8,19,62,39,8,19,66
143628,109,"ŞCOALA GIMNAZIALĂ MIHAI EMINESCU",MEDIAŞ,SB,1299,3,0,0,3,21,1,0,22,44,1,0,45,49,2,0,51,55,2,0,57
143628,110,"GRĂDINIŢA CU PROGRAM PRELUNGIT BUCURIA COPIILOR",MEDIAŞ,SB,1182,10,1,0,11,24,3,0,27,40,4,0,44,48,6,0,54,50,6,0,56
143628,111,"VESTIAR SPARTA",MEDIAŞ,SB,753,10,0,0,10,18,0,0,18,22,0,0,22,31,0,0,31,38,0,0,38
143628,112,"STADIONUL MUNICIPAL GAZ METAN",MEDIAŞ,SB,853,6,1,0,7,32,3,0,35,36,4,0,40,46,6,0,52,46,7,0,53
143628,113,"SC HULA VECHE SRL",MEDIAŞ,SB,1244,4,3,0,7,16,3,0,19,27,3,0,30,44,6,0,50,49,8,0,57
143628,114,"CLUBUL COPIILOR",MEDIAŞ,SB,1037,11,2,0,13,28,3,0,31,34,3,0,37,53,3,0,56,56,3,0,59
143628,115,"CENTRU ŞCOLAR DE EDUCAŢIE INCLUZIVĂ MEDIAŞ",MEDIAŞ,SB,1124,8,0,0,8,16,0,0,16,23,0,0,23,24,0,0,24,32,0,0,32
143628,116,"ŞCOALA GIMNAZIALĂ NR.7",MEDIAŞ,SB,1329,3,1,0,4,13,2,0,15,23,4,0,27,32,7,0,39,39,7,0,46
143628,117,"ŞCOALA GIMNAZIALĂ NR.7",MEDIAŞ,SB,988,3,4,0,7,18,4,0,22,21,4,0,25,27,4,0,31,32,4,0,36
143628,118,"ŞCOALA GIMNAZIALĂ NR.7",MEDIAŞ,SB,1157,10,0,0,10,27,0,0,27,33,0,0,33,41,0,0,41,41,0,0,41
143628,119,"ŞCOALA GIMNAZIALĂ NR.7",MEDIAŞ,SB,997,6,0,0,6,21,0,0,21,37,1,0,38,43,1,0,44,48,1,0,49
143628,120,"GRĂDINIŢA CU PROGRAM PRELUNGIT RAZĂ DE SOARE",MEDIAŞ,SB,1256,10,1,0,11,37,1,0,38,52,2,0,54,68,2,0,70,69,2,0,71
143628,121,"ŞCOALA GIMNAZIALĂ NR.5 CORP A",MEDIAŞ,SB,991,13,1,0,14,33,2,0,35,43,6,0,49,63,6,0,69,63,10,0,73
143628,122,"ŞCOALA GIMNAZIALĂ NR.5 CORP A",MEDIAŞ,SB,1237,0,0,0,0,15,0,0,15,19,0,0,19,22,0,0,22,24,0,0,24
143628,123,"ŞCOALA GIMNAZIALĂ NR.5",MEDIAŞ,SB,1124,7,1,0,8,26,1,0,27,38,1,0,39,43,1,0,44,46,1,0,47
143628,124,"GRĂDINIŢA CU PROGRAM PRELUNGIT PITICOT",MEDIAŞ,SB,1319,16,0,0,16,41,0,0,41,55,1,4,60,59,1,4,64,61,1,4,66
143628,125,"ŞCOALA GIMNAZIALĂ NR.4",MEDIAŞ,SB,1263,10,6,0,16,40,6,0,46,65,11,0,76,82,12,0,94,82,12,0,94
143628,126,"ŞCOALA GIMNAZIALĂ NR.4",MEDIAŞ,SB,1023,16,0,0,16,34,1,0,35,50,1,0,51,60,1,0,61,62,1,0,63
143628,127,"ŞCOALA GIMNAZIALĂ NR.4",MEDIAŞ,SB,1033,2,0,0,2,12,0,0,12,18,0,0,18,30,1,0,31,30,4,0,34
143628,128,"SPAŢIU CU ALTĂ DETINAŢIE",MEDIAŞ,SB,1175,5,0,0,5,38,0,0,38,49,0,0,49,59,3,0,62,65,3,0,68
143628,129,"SC AUTOMECANICA SA",MEDIAŞ,SB,605,3,0,0,3,7,0,0,7,9,2,0,11,11,2,0,13,11,2,0,13
143628,130,"ŞCOALA GIMNAZIALĂ GEORGE POPA",MEDIAŞ,SB,1209,4,3,0,7,13,8,0,21,24,8,0,32,39,8,0,47,41,8,0,49
143628,131,"COMPLEX COMERCIAL",MEDIAŞ,SB,1334,15,1,0,16,41,1,0,42,67,2,0,69,86,2,0,88,91,2,0,93
143628,132,"ŞCOALA GIMNAZIALĂ GEORGE POPA",MEDIAŞ,SB,1008,6,0,0,6,25,0,0,25,33,0,0,33,53,5,0,58,59,5,0,64
143628,133,"ŞCOALA GIMNAZIALĂ GEORGE POPA",MEDIAŞ,SB,1452,9,3,0,12,16,4,0,20,28,4,0,32,37,8,0,45,37,9,0,46
143628,134,"ŞCOALA GIMNAZIALĂ GEORGE POPA",MEDIAŞ,SB,1200,16,0,0,16,48,0,0,48,56,0,0,56,64,0,0,64,71,2,0,73
143628,135,"LICEUL TEHNOLOGIC ŞCOALA NAŢIONALĂ DE GAZE",MEDIAŞ,SB,1191,15,2,0,17,36,4,0,40,41,4,0,45,58,4,0,62,59,4,0,63
143628,136,"MUZEUL HERMAN OBERTH",MEDIAŞ,SB,1066,3,0,0,3,21,0,0,21,38,0,0,38,44,4,0,48,44,4,0,48
143628,137,"COLEGIUL TEHNIC MEDIENSIS",MEDIAŞ,SB,1276,5,0,0,5,15,0,0,15,25,1,0,26,34,1,0,35,38,1,0,39
143628,138,"ŞCOALA GIMNAZIALĂ CIREŞARII",MEDIAŞ,SB,1182,7,1,0,8,17,3,0,20,26,3,0,29,41,3,0,44,48,3,0,51
143628,139,"GRĂDINIŢA CU PROGRAM PRELUNGIT PINOCCHIO",MEDIAŞ,SB,1239,3,0,0,3,22,1,0,23,30,2,0,32,32,2,0,34,33,2,0,35
143628,140,"ŞCOALA GIMNAZIALĂ CONSTANTIN IOAN MOTAŞ",MEDIAŞ,SB,1256,4,0,0,4,16,2,0,18,30,2,0,32,41,3,0,44,45,3,0,48
143628,141,"ŞCOALA GIMNAZIALĂ CONSTANTIN IOAN MOTAŞ",MEDIAŞ,SB,1356,7,1,0,8,19,1,0,20,36,1,0,37,48,1,0,49,49,1,0,50
143628,142,"ŞCOALA GIMNAZIALĂ CONSTANTIN IOAN MOTAŞ",MEDIAŞ,SB,1356,10,0,0,10,15,0,0,15,24,0,0,24,32,0,0,32,34,0,0,34
143628,143,"ŞCOALA GIMNAZIALĂ CONSTANTIN IOAN MOTAŞ",MEDIAŞ,SB,1188,3,0,0,3,14,0,0,14,26,0,0,26,30,0,0,30,34,0,0,34
143628,144,"ŞCOALA GIMNAZIALĂ CONSTANTIN IOAN MOTAŞ",MEDIAŞ,SB,1318,4,0,0,4,12,0,0,12,19,1,0,20,31,1,0,32,34,1,0,35
143628,145,"ŞCOALA GIMNAZIALĂ CONSTANTIN IOAN MOTAŞ",MEDIAŞ,SB,1093,2,0,0,2,12,0,0,12,14,0,0,14,26,2,0,28,28,2,0,30
143628,146,"UNIVERSITATEA LUCIAN BLAGA",MEDIAŞ,SB,1133,2,0,0,2,9,0,0,9,19,0,0,19,24,0,0,24,24,0,0,24
143628,147,"UNIVERSITATEA LUCIAN BLAGA",MEDIAŞ,SB,1389,3,0,0,3,16,1,0,17,27,1,0,28,27,2,0,29,27,3,0,30
143637,148,"ŞCOALA GIMNAZIALĂ","IGHIŞU NOU",SB,1348,4,1,0,5,9,1,0,10,14,2,0,16,28,2,0,30,35,2,0,37
143691,149,"ŞCOALA GIMNAZIALĂ G.D.TEUTSCH",AGNITA,SB,1249,1,0,0,1,8,0,0,8,13,0,0,13,21,0,0,21,22,4,0,26
143691,150,"ŞCOALA GIMNAZIALĂ G.D.TEUTSCH",AGNITA,SB,1134,1,0,0,1,12,0,0,12,15,0,0,15,29,0,0,29,29,0,0,29
143691,151,"GRĂDINIŢA CU PROGRAM PRELUNGIT",AGNITA,SB,1078,3,0,0,3,7,0,0,7,7,0,0,7,15,0,0,15,15,0,0,15
143691,152,"CASA SENIORILOR",AGNITA,SB,1438,7,1,0,8,14,1,0,15,23,2,0,25,29,3,0,32,30,5,0,35
143691,153,"COLEGIUL TEHNIC A.T. LAUREAN",AGNITA,SB,1060,3,0,0,3,10,0,0,10,13,0,0,13,14,0,0,14,17,0,0,17
143691,154,"CASA DE CULTURĂ ""ILARION COCIȘIU""",AGNITA,SB,1214,4,0,0,4,7,3,0,10,10,4,0,14,16,4,0,20,17,4,0,21
143691,155,"GRĂDINIŢA CU PROGRAM PRELUNGIT NR.2",AGNITA,SB,1159,10,0,0,10,19,3,0,22,21,4,0,25,27,4,0,31,28,4,0,32
143708,156,"ŞCOALA GIMNAZIALĂ COVEŞ",COVEŞ,SB,500,1,2,0,3,1,3,0,4,3,3,0,6,9,4,0,13,9,4,0,13
143717,157,"ŞCOALA GIMNAZIALĂ RUJA",RUJA,SB,974,5,1,0,6,7,1,0,8,9,1,0,10,14,1,0,15,18,1,0,19
144063,158,"GRADINITA NR.3 PROGRAM PRELUNGIT",AVRIG,SB,1391,7,0,0,7,14,0,0,14,18,2,0,20,23,2,0,25,24,2,0,26
144063,159,"SCOALA GIMNAZIALA AVRIG",AVRIG,SB,1389,4,0,0,4,14,7,0,21,16,7,0,23,27,7,0,34,29,7,0,36
144063,160,"ŞCOALA GIMNAZIALA AVRIG",AVRIG,SB,1232,5,2,0,7,19,10,0,29,25,10,0,35,34,10,0,44,39,10,0,49
144063,161,"GRADINITA NR,1 PROGRAM NORMAL",AVRIG,SB,1545,11,1,0,12,19,2,0,21,24,2,0,26,34,2,0,36,36,3,0,39
144063,162,"LICEUL ""GHEORGHE LAZĂR"", AVRIG",AVRIG,SB,1304,3,1,0,4,15,2,0,17,22,3,0,25,25,5,0,30,26,5,0,31
144063,163,"LICEUL ""GHEORGHE LAZĂR"", AVRIG",AVRIG,SB,1351,6,0,0,6,15,0,0,15,21,1,0,22,22,1,0,23,24,1,0,25
144090,164,"ŞCOALA GIMNAZIALA MÎRŞA",MÎRŞA,SB,1294,5,0,0,5,21,0,0,21,25,0,0,25,32,2,0,34,33,2,0,35
144090,165,"LICEUL ""TEHNOLOGIC MÎRŞA",MÎRŞA,SB,1347,7,0,0,7,14,0,0,14,21,2,0,23,27,2,0,29,32,3,0,35
144072,166,"SCOALA GIMNAZIALĂ BRADU",BRADU,SB,889,0,3,0,3,5,4,0,9,6,4,0,10,11,5,0,16,11,5,0,16
144107,167,"SCOALA PRIMARĂ SĂCĂDATE",SĂCĂDATE,SB,504,5,1,0,6,6,1,0,7,7,1,0,8,14,2,0,16,14,2,0,16
144081,168,"SCOALA PRIMARĂ GLÎMBOACA",GLÎMBOACA,SB,182,1,0,0,1,1,0,0,1,3,0,0,3,5,0,0,5,5,0,0,5
143753,169,"GRĂDINIŢA CU PROGRAM NORMAL CISNĂDIOARA",CISNĂDIOARA,SB,645,2,4,0,6,8,8,0,16,10,8,0,18,14,10,0,24,21,11,0,32
143744,170,"GRĂDINIŢA CU PROGRAM PRELUNGIT NR.7",CISNĂDIE,SB,1572,9,1,0,10,46,3,0,49,64,3,0,67,75,3,0,78,82,3,0,85
143744,171,"CLUBUL COPIILOR CISNĂDIE",CISNĂDIE,SB,1435,4,4,0,8,22,4,0,26,38,4,0,42,55,4,0,59,62,5,0,67
143744,172,"GRĂDINIŢA CU PROGRAM PRELUNGIT NR.6",CISNĂDIE,SB,1410,3,2,0,5,35,3,0,38,44,3,0,47,76,3,0,79,88,6,0,94
143744,173,"ŞCOALA GIMNAZIALĂNR.3 CISNĂDIE",CISNĂDIE,SB,1528,7,5,0,12,22,5,0,27,31,5,0,36,50,5,0,55,63,5,0,68
143744,174,"LICEUL TEORETIC ,,GUSTAV GUNDISCH,, CISNĂDIE",CISNĂDIE,SB,1593,10,1,0,11,34,7,0,41,40,7,0,47,51,8,0,59,65,8,0,73
143744,175,"LICEUL TEHNOLOGIC",CISNĂDIE,SB,1495,5,0,0,5,27,0,0,27,40,1,0,41,53,1,0,54,59,1,0,60
143744,176,"ŞCOALA GIMNAZIALĂ NR. 2 CISNĂDIE",CISNĂDIE,SB,1652,8,0,0,8,29,2,0,31,40,2,0,42,41,2,0,43,42,2,0,44
143744,177,"LICEUL TEHNOLOGIC CISNĂDIE",CISNĂDIE,SB,1112,8,1,0,9,20,3,0,23,31,3,0,34,41,3,0,44,47,3,0,50
143744,178,"LICEUL TEHNOLOGIC CISNĂDIE",CISNĂDIE,SB,1088,6,0,0,6,13,1,0,14,20,1,0,21,28,3,0,31,33,3,0,36
143744,179,"GRĂDINIŢA CU PROGRAM NORMAL NR.1",CISNĂDIE,SB,1647,6,0,0,6,16,0,0,16,23,2,0,25,34,2,0,36,39,2,0,41
143744,180,"GRĂDINIŢA CU PROGRAM NORMAL NR.1",CISNĂDIE,SB,1040,7,3,0,10,18,4,0,22,32,4,0,36,49,6,0,55,51,7,0,58
143744,181,"GRĂDINIȚA CU PROGRAM NORMAL NR. 1",CISNĂDIE,SB,1790,7,0,0,7,24,0,0,24,49,4,0,53,50,4,0,54,60,4,0,64
143780,182,"ŞCOALA GIMNAZIALĂ COPŞA MICĂ, STRADA COLONIA LABORATOR, NR.45","COPŞA MICĂ",SB,1445,5,0,0,5,8,5,0,13,10,5,0,15,17,6,0,23,18,6,0,24
143780,183,"LICEUL TEHNOLOGIC ""NICOLAE TECLU"" COPŞA MICĂ, STRADA ŞOSEAUA SIBIULUI, NR.61","COPŞA MICĂ",SB,1486,4,0,0,4,11,3,0,14,18,5,0,23,27,5,0,32,27,5,0,32
143780,184,"ŞCOALA GIMNAZIALĂ NR.1 COPŞA MICĂ,STRADA ŞOSEAUAMEDIAŞULUI, NR.93","COPŞA MICĂ",SB,1260,0,0,0,0,14,0,0,14,17,0,0,17,18,0,0,18,20,0,0,20
143780,185,"ŞCOALA PRIMARĂ NR. 2COPŞA MICĂ, STRADA TÂRNĂVIOARA, NR.76","COPŞA MICĂ",SB,442,1,0,0,1,5,0,0,5,7,0,0,7,8,0,0,8,9,0,0,9
143815,186,"PRIMĂRIA ORAȘULUI DUMBRĂVENI",DUMBRĂVENI,SB,1259,18,0,0,18,31,2,0,33,36,3,0,39,37,4,0,41,45,5,0,50
143815,187,"LICEUL TEORETIC DUMBRĂVENI",DUMBRĂVENI,SB,1084,9,0,0,9,15,0,0,15,20,1,0,21,30,1,0,31,32,1,0,33
143815,188,"LICEUL TEHNOLOGIC ""TIMOTEI CIPARIU"" DUMBRĂVENI",DUMBRĂVENI,SB,1212,1,0,0,1,7,0,0,7,10,0,0,10,14,4,0,18,14,4,0,18
143815,189,"CENTRUL ŞCOLAR PENTRU EDUCAŢIE INCLUZIVĂ DUMBRĂVENI",DUMBRĂVENI,SB,1319,10,0,0,10,25,0,0,25,32,0,0,32,40,0,0,40,42,1,0,43
143833,190,"ŞCOALA GIMNAZIALĂ ŞAROŞ PE TÎRNAVE","ŞAROŞ PE TÎRNAVE",SB,1427,4,0,0,4,12,0,0,12,15,0,0,15,20,0,0,20,23,0,0,23
143824,191,"ŞCOALA PRIMARĂ ERNEA",ERNEA,SB,382,0,0,0,0,4,0,0,4,5,0,0,5,7,0,0,7,11,1,0,12
144937,192,"PRIMĂRIA ORAŞULUI MIERCUREA SIBIULUI","MIERCUREA SIBIULUI",SB,782,6,0,0,6,17,1,0,18,19,1,0,20,22,2,0,24,23,2,0,25
144937,193,"PRIMĂRIA ORAŞULUI MIERCUREA SIBIULUI","MIERCUREA SIBIULUI",SB,938,5,0,0,5,11,0,0,11,17,0,0,17,20,0,0,20,21,0,0,21
144946,194,"CAMIN CULTURAL","APOLDU DE SUS",SB,1464,3,2,0,5,6,2,0,8,9,2,0,11,14,2,0,16,16,2,0,18
144955,195,"CAMIN CULTURAL",DOBÂRCA,SB,658,4,3,0,7,7,5,0,12,7,5,0,12,10,6,0,16,10,6,0,16
143860,196,"ŞCOALA GIMNAZIALA OCNA SIBIULUI","OCNA SIBIULUI",SB,955,5,0,0,5,12,0,0,12,17,0,0,17,21,1,0,22,22,1,0,23
143860,197,"ŞCOALA GIMNAZIALĂ OCNA SIBIULUI","OCNA SIBIULUI",SB,989,9,0,0,9,20,0,0,20,29,0,0,29,38,0,0,38,38,2,0,40
143860,198,"CLĂDIREA PAROHIALĂ ORTODOXĂ NR.1 OCNA SIBIULUI","OCNA SIBIULUI",SB,1404,7,2,0,9,18,2,0,20,21,2,0,23,31,2,0,33,37,2,0,39
143879,199,"CLADIRE (FOST SEDIU PRIMARIE),TOPÎRCEA",TOPÎRCEA,SB,115,0,0,0,0,2,1,0,3,2,2,0,4,4,4,0,8,4,4,0,8
145505,200,"LICEUL TEHNOLOGIC ""IOAN LUPAȘ""",SĂLIŞTE,SB,1222,10,0,0,10,15,4,0,19,23,4,0,27,32,5,0,37,33,5,0,38
145505,201,"LICEUL TEHNOLOGIC ""IOAN LUPAȘ""",SĂLIŞTE,SB,1175,5,3,0,8,13,3,0,16,21,3,0,24,27,3,0,30,28,3,0,31
145541,202,"MUZEUL ETNOGRAFIC ""MARIA COSTACHESCU",GALEŞ,SB,272,3,1,0,4,6,4,0,10,8,5,0,13,9,5,0,14,10,6,0,16
145596,203,"CLĂDIREA FOSTEI PRIMĂRII",VALE,SB,305,6,1,0,7,12,3,0,15,14,8,0,22,18,9,0,27,19,9,0,28
145587,204,"CENTRU DE DOCUMENTARE ȘI INFORMARE SIBIEL",SIBIEL,SB,330,0,3,0,3,2,10,0,12,3,10,0,13,5,10,0,15,5,10,0,15
145550,205,"CĂMIN CULTURAL FÂNTÂNELE",FÂNTÂNELE,SB,150,4,1,0,5,5,1,0,6,5,2,0,7,7,2,0,9,7,2,0,9
145578,206,"ŞCOALA GENERALĂ SĂCEL",SĂCEL,SB,436,6,0,0,6,8,0,0,8,11,0,0,11,14,2,0,16,14,2,0,16
145569,207,"ŞCOALA PRIMARĂ MAG",MAG,SB,365,0,0,0,0,0,0,0,0,0,2,0,2,1,2,0,3,1,2,0,3
145523,208,"ŞCOALA PRIMARĂ AMNAŞ",AMNAŞ,SB,341,1,1,0,2,4,1,0,5,5,1,0,6,8,2,0,10,8,2,0,10
145514,209,"CĂMIN CULTURAL ACILIU",ACILIU,SB,169,2,0,0,2,2,0,0,2,3,0,0,3,5,9,0,14,6,9,0,15
145836,210,"PRIMARIA ORASULUI TALMACIU",TĂLMACIU,SB,1568,6,2,0,8,13,2,0,15,14,2,0,16,21,2,0,23,25,2,0,27
145836,211,"LICEUL TEHNOLOGIC / SCOALA GIMNAZIALA TALMACIU",TĂLMACIU,SB,1087,13,1,0,14,17,1,0,18,21,1,0,22,26,2,0,28,35,2,0,37
145836,212,"LICEUL TEHNOLOGIC TALMACIU",TĂLMACIU,SB,1226,8,1,0,9,16,1,0,17,27,5,0,32,39,5,0,44,39,5,0,44
145836,213,"LICEUL TEHNOLOGIC TALMACIU",TĂLMACIU,SB,1587,10,0,0,10,23,0,0,23,29,0,0,29,43,0,0,43,44,0,0,44
145854,214,"LICEUL TEHNOLOGIC/SCOALA COLONIE TALMACIU II","COLONIA TĂLMACIU",SB,221,1,0,0,1,2,0,0,2,4,0,0,4,4,0,0,4,8,1,0,9
145890,215,"LICEUL TEHNOLOGIC TALMACIU/SCOALA GIMNAZIALA TALMACEL",TĂLMĂCEL,SB,912,1,0,0,1,6,0,0,6,6,2,0,8,9,2,0,11,11,2,0,13
144018,216,"CĂMINUL CULTURAL ALMA",ALMA,SB,656,3,0,0,3,5,0,0,5,8,0,0,8,14,0,0,14,15,0,0,15
144036,217,"ŞCOALA PRIMARĂ GIACĂŞ",GIACĂŞ,SB,202,3,5,0,8,13,6,0,19,15,6,0,21,16,6,0,22,16,6,0,22
144045,218,"CĂMINUL CULTURAL ŞMIG",ŞMIG,SB,724,8,0,0,8,12,0,0,12,13,0,0,13,13,0,0,13,15,2,0,17
143897,219,"SEDIU PRIMARIA",ALŢINA,SB,1069,6,3,0,9,11,4,0,15,18,7,0,25,25,7,0,32,27,7,0,34
143904,220,"FOST SEDIU CAP",BENEŞTI,SB,224,0,4,0,4,11,7,0,18,22,7,0,29,29,7,0,36,33,7,0,40
143913,221,"FOST SEDIU CAP","GHIJASA DE SUS",SB,120,2,0,0,2,8,1,0,9,9,1,0,10,9,2,0,11,9,4,0,13
143931,222,"CĂMIN CULTURAL APOLDU DE JOS","APOLDU DE JOS",SB,857,4,2,0,6,13,4,0,17,18,4,0,22,24,5,0,29,25,9,0,34
143940,223,"ȘCOALA PRIMARĂ - SÎNGĂTIN",SÎNGĂTIN,SB,206,0,1,0,1,1,1,0,2,1,1,0,2,3,2,0,5,3,2,0,5
143968,224,"PRIMĂRIA COMUNEI ARPASU DE JOS","ARPAŞU DE JOS",SB,918,3,0,0,3,19,0,0,19,27,0,0,27,32,0,0,32,33,0,0,33
143977,225,"SCOALA GIMNAZIALA ,, AUREL POPA""","ARPAŞU DE SUS",SB,1017,2,1,0,3,4,1,0,5,5,5,0,10,8,5,0,13,11,6,0,17
143986,226,"GRADINITA, NOU ROMAN","NOUL ROMÂN",SB,303,1,0,0,1,1,2,0,3,2,2,0,4,4,2,0,6,4,2,0,6
144009,227,"PRIMARIA ATEL",AŢEL,SB,1143,6,0,0,6,8,1,0,9,14,1,0,15,20,2,0,22,25,2,0,27
144027,228,"CLADIREA PRIMARIEI (FOSTA SCOALA), DUPUS NR. 107.",DUPUŞ,SB,211,2,0,0,2,6,1,0,7,6,2,0,8,8,2,0,10,10,3,0,13
144134,229,"CĂMIN CULTURAL",AGÎRBICIU,SB,1198,4,0,0,4,11,2,0,13,14,2,0,16,21,2,0,23,23,2,0,25
144143,230,"CĂMIN CULTURAL",ŞOALA,SB,274,2,1,0,3,6,1,0,7,6,1,0,7,12,1,0,13,12,3,0,15
144125,231,"ȘCOALA GIMNAZIALĂ AXENTE SEVER","AXENTE SEVER",SB,996,5,2,0,7,7,2,0,9,12,2,0,14,14,3,0,17,14,3,0,17
144125,232,"SALA DE FESTIVITĂȚI","AXENTE SEVER",SB,1025,4,4,0,8,15,6,0,21,19,7,0,26,22,7,0,29,24,8,0,32
144161,233,"PRIMARIA BAZNA",BAZNA,SB,1456,6,1,0,7,11,7,0,18,15,11,0,26,18,14,0,32,20,16,0,36
144170,234,"SCOALA GIMNAZIALA BOIAN",BOIAN,SB,1172,4,4,0,8,5,4,0,9,6,5,0,11,9,5,0,14,9,7,0,16
144189,235,"SCOALA PRIMARĂVELȚ",VELŢ,SB,456,3,0,0,3,6,5,0,11,9,5,0,14,10,5,0,15,12,5,0,17
144205,236,"PRIMARIA COMUNEI BIERTAN",BIERTAN,SB,1365,9,1,0,10,15,3,16,34,18,8,16,42,21,9,16,46,22,9,16,47
144223,237,"SCOALA PRIMARA RICHIS",RICHIŞ,SB,639,6,1,0,7,9,1,0,10,9,2,0,11,11,3,0,14,11,3,0,14
144214,238,"SCOALA PRIMARA COPSA MARE","COPŞA MARE",SB,396,0,0,0,0,2,0,0,2,4,2,0,6,10,3,0,13,12,3,0,15
144269,239,"CĂMIN CULTURAL IGHIŞU VECHI","IGHIŞU VECHI",SB,199,4,0,0,4,5,2,0,7,5,2,0,7,8,2,0,10,9,2,0,11
144241,240,GRĂDINIȚACUPROGRAMNORMALBÎRGHIȘ,BÎRGHIŞ,SB,646,5,0,0,5,7,1,0,8,12,1,0,13,17,4,0,21,17,4,0,21
144250,241,"ŞCOALA PRIMARĂAPOȘ",APOŞ,SB,268,2,1,0,3,5,1,0,6,5,1,0,6,7,1,0,8,7,1,0,8
144278,242,"ŞCOALA PRIMARĂPELIȘOR",PELIŞOR,SB,401,2,0,0,2,4,0,0,4,4,1,0,5,5,1,0,6,8,1,0,9
144296,243,"ŞCOALA PRIMARĂZLAGNA",ZLAGNA,SB,146,6,2,0,8,8,2,0,10,8,2,0,10,9,2,0,11,9,2,0,11
144287,244,"DISPENSARUMAN VECERD",VECERD,SB,92,5,2,0,7,9,7,0,16,12,8,0,20,16,8,0,24,16,8,0,24
144321,245,"ŞCOALA GIMNAZIALĂ",PĂUCEA,SB,357,2,1,0,3,4,1,0,5,5,1,0,6,6,1,0,7,6,1,0,7
144330,246,"FOSTAŞCOALĂ GENERALĂ",ROMANEŞTI,SB,61,0,3,0,3,0,3,0,3,0,3,0,3,0,3,0,3,0,3,0,3
144312,247,"PRIMĂRIA BLĂJEL",BLĂJEL,SB,1498,6,0,0,6,15,1,0,16,16,1,0,17,21,2,0,23,26,2,0,28
145845,248,"PRIMĂRIA COMUNEI BOIŢA",BOIŢA,SB,1299,17,0,0,17,26,2,0,28,46,6,0,52,61,9,0,70,69,9,0,78
144358,249,"CĂMINUL CULTURAL BRATEIU",BRATEIU,SB,1126,3,4,0,7,6,4,0,10,8,5,0,13,10,5,0,15,10,5,0,15
144358,250,"ŞCOALA GIMNAZIALĂ BRATEIU",BRATEIU,SB,828,1,1,0,2,7,1,0,8,15,1,0,16,25,1,0,26,26,3,0,29
144367,251,"ŞCOALA GIMNAZIALĂ BUZD",BUZD,SB,958,2,3,0,5,2,3,0,5,4,3,0,7,4,3,0,7,4,3,0,7
144385,252,"SALA MARE-PRIMĂRIE",BRĂDENI,SB,746,3,1,0,4,9,1,0,10,16,1,0,17,26,1,0,27,28,1,0,29
144394,253,"SALAMARE FOSTĂ PRIMĂRIE",RETIŞ,SB,375,9,2,0,11,10,3,0,13,12,4,0,16,15,4,0,19,18,4,0,22
144401,254,"FOSTAŞCOALĂ ŢELINE",ŢELINE,SB,96,5,2,0,7,11,2,0,13,11,2,0,13,12,2,0,14,12,2,0,14
144429,255,"PRIMĂRIA BRUIU",BRUIU,SB,416,1,0,0,1,1,0,0,1,1,0,0,1,2,0,0,2,2,0,0,2
144447,256,"ȘCOALA PRIMARĂ ȘOMARTIN",ŞOMARTIN,SB,326,4,0,0,4,4,0,0,4,4,0,0,4,5,0,0,5,5,0,0,5
144465,257,"ŞCOALA GIMNAZIALĂ CHIRPĂR",CHIRPĂR,SB,986,0,1,0,1,3,7,0,10,5,7,0,12,8,9,0,17,11,9,0,20
144483,258,"CĂMINUL CULTURAL VĂRD",VĂRD,SB,285,4,1,0,5,4,1,0,5,5,1,0,6,6,1,0,7,7,1,0,8
144492,259,"ŞCOALA PRIMARĂ VESEUD",VESEUD,SB,152,1,0,0,1,4,3,0,7,4,3,0,7,5,3,0,8,6,3,0,9
144474,260,"CĂMINUL CULTURAL SĂSĂUŞ",SĂSĂUŞ,SB,110,4,5,0,9,4,5,0,9,5,5,0,10,6,7,0,13,6,7,0,13
144517,261,"PRIMARIA CIRTA",CÎRŢA,SB,951,5,1,0,6,10,3,0,13,12,3,0,15,15,5,0,20,22,5,0,27
144544,262,"PRIMĂRIA COMUNEI CÎRȚIȘOARA",CÎRŢIŞOARA,SB,1072,4,5,0,9,30,6,0,36,37,11,0,48,46,15,0,61,46,15,0,61
143496,263,"PRIMARIA COMUNEI CRISTIAN",CRISTIAN,SB,1119,1,1,0,2,11,1,0,12,15,1,0,16,20,1,0,21,21,1,0,22
143496,264,"GRADINITA CU PROGRAM PRELUNGITCRISTIAN",CRISTIAN,SB,1194,4,1,0,5,15,3,0,18,18,4,0,22,28,8,0,36,33,8,0,41
143496,265,"SCOALA GIMNAZIALA , CRISTIAN",CRISTIAN,SB,1068,5,1,0,6,9,2,0,11,14,2,0,16,25,2,0,27,27,2,0,29
144562,266,"CĂMIN CULTURAL DÎRLOS",DÎRLOS,SB,857,9,0,0,9,18,2,0,20,20,3,0,23,27,4,0,31,29,4,0,33
144562,267,"ŞCOALA GIMNAZIALĂ ""IOAN MORARU"" DÎRLOS",DÎRLOS,SB,1047,4,0,0,4,13,0,0,13,22,1,0,23,28,1,0,29,29,1,0,30
144571,268,"ŞCOALA GIMNAZIALĂ CURCIU",CURCIU,SB,718,1,0,0,1,4,5,0,9,9,5,0,14,15,5,0,20,15,5,0,20
144580,269,"CĂMIN CULTURAL VALEA LUNGĂ","VALEA LUNGĂ",SB,206,2,2,0,4,6,2,0,8,8,2,0,10,10,2,0,12,13,2,0,15
144606,270,"ŞCOALA GIMNAZIALĂ ''AUREL DECEI'' GURA RÂULUI","GURA RÂULUI",SB,1393,3,2,0,5,6,7,0,13,16,11,0,27,28,16,0,44,32,18,0,50
144606,271,"GRĂDINIŢA CU PROGRAM NORMAL NR.2 GURA RÂULUI","GURA RÂULUI",SB,1520,4,0,0,4,12,2,0,14,30,5,0,35,51,9,0,60,57,9,0,66
144624,272,"PRIMĂRIA HOGHILAG",HOGHILAG,SB,990,1,0,0,1,2,0,0,2,7,0,0,7,12,0,0,12,16,0,0,16
144633,273,"SCOALA PRIMARĂPROD",PROD,SB,204,1,0,0,1,2,1,0,3,4,2,0,6,7,2,0,9,7,2,0,9
144642,274,"CLADIRE CE APARŢINE PRIMARIEI HOGHILAG",VALCHID,SB,624,0,0,0,0,1,0,0,1,5,0,0,5,7,0,0,7,7,0,0,7
144660,275,"PRIMĂRIA IACOBENI",IACOBENI,SB,832,1,0,0,1,1,0,0,1,2,0,0,2,3,0,0,3,3,0,0,3
144704,276,"ȘCOALA PRIMARĂ STEJĂRIȘU",STEJĂRIŞU,SB,421,4,1,0,5,5,1,0,6,6,2,0,8,7,2,0,9,7,2,0,9
144688,277,"ȘCOALA PRIMARĂ NETUȘ",NETUŞ,SB,397,0,0,0,0,4,1,0,5,12,2,0,14,17,2,0,19,24,2,0,26
144697,278,"ȘCOALA GIMNAZIALĂ NOIȘTAT",NOIŞTAT,SB,452,0,0,0,0,3,0,0,3,5,0,0,5,6,1,0,7,6,1,0,7
144679,279,"ȘCOALA PRIMARĂ MOVILE",MOVILE,SB,284,1,0,0,1,2,0,0,2,7,0,0,7,10,0,0,10,12,0,0,12
144722,280,"PRIMĂRIA COMUNEI JINA",JINA,SB,1515,23,1,0,24,49,5,0,54,64,8,0,72,86,10,0,96,97,10,0,107
144722,281,"ŞCOALA GIMNAZIALĂJINA BĂIEŞI",JINA,SB,1240,3,0,0,3,14,0,0,14,22,0,0,22,39,1,0,40,47,1,0,48
144740,282,"CĂMIN CULTURALLASLEA",LASLEA,SB,1279,4,0,0,4,8,0,0,8,14,0,0,14,14,0,0,14,16,0,0,16
144768,283,"CĂMIN CULTURALMĂLÎNCRAV",MĂLÎNCRAV,SB,992,6,0,0,6,9,2,0,11,10,2,0,12,16,2,0,18,16,2,0,18
144759,284,"CĂMIN CULTURALFLOREŞTI",FLOREŞTI,SB,106,1,0,0,1,7,0,0,7,7,0,0,7,8,0,0,8,8,0,0,8
144786,285,"ȘCOALA PRIMARĂROANDOLA",ROANDOLA,SB,249,0,0,0,0,1,0,0,1,3,0,0,3,3,0,0,3,3,0,0,3
144777,286,"ȘCOALA PRIMARĂ NOU SĂSESC","NOU SĂSESC",SB,606,2,1,0,3,2,2,0,4,6,2,0,8,9,4,0,13,10,4,0,14
144802,287,"CĂMIN CULTURAL LOAMNEŞ",LOAMNEŞ,SB,502,1,0,0,1,9,1,0,10,10,1,0,11,27,1,0,28,27,1,0,28
144848,288,"CĂMIN CULTURAL MÎNDRA",MÎNDRA,SB,282,3,1,0,4,9,4,0,13,9,4,0,13,15,7,0,22,21,8,0,29
144811,289,"CĂMIN CULTURAL ALĂMOR",ALĂMOR,SB,619,1,0,0,1,3,0,0,3,6,0,0,6,10,0,0,10,10,0,0,10
144820,290,ŞCOALAPRIMARĂARMENI,ARMENI,SB,433,1,0,0,1,2,0,0,2,4,0,0,4,4,1,0,5,5,2,0,7
144839,291,ŞCOALAPRIMARĂHAŞAG,HAŞAG,SB,533,3,0,0,3,3,0,0,3,8,0,0,8,10,0,0,10,13,0,0,13
144875,292,"PRIMĂRIA COMUNEI LUDOȘ",LUDOŞ,SB,581,1,0,0,1,5,0,0,5,8,2,0,10,13,2,0,15,17,4,0,21
144900,293,"PRIMĂRIA MARPOD",MARPOD,SB,544,2,0,0,2,8,1,0,9,12,4,0,16,14,4,0,18,14,12,0,26
144919,294,"FOSTĂ ŞCOALĂ GENERALĂ ILIMBAV",ILIMBAV,SB,163,3,2,0,5,7,3,0,10,7,3,0,10,7,3,0,10,7,3,0,10
144973,295,"CLĂDIRE REMIZĂ MERGHINDEAL, NUMARUL 60",MERGHINDEAL,SB,678,3,0,0,3,9,0,0,9,12,0,0,12,15,0,0,15,17,0,0,17
144982,296,"ȘCOALA PRIMARĂ DEALU FRUMOS","DEALU FRUMOS",SB,550,2,0,0,2,7,1,0,8,10,1,0,11,13,2,0,15,17,2,0,19
145006,297,"ȘCOALA GIMNAZIALĂ ""CORNELIU PĂCURARIU"" MICĂSASA",MICĂSASA,SB,1127,4,0,0,4,8,1,0,9,16,1,0,17,25,3,0,28,25,3,0,28
145024,298,"ȘCOALA PRIMARĂ ŢAPU",ŢAPU,SB,645,2,0,0,2,6,0,0,6,7,0,0,7,9,0,0,9,10,0,0,10
145015,299,"DISPENSARUL MEDICAL CHESLER",CHESLER,SB,57,0,1,0,1,0,1,0,1,0,2,0,2,1,2,0,3,1,3,0,4
145051,300,"PRIMĂRIA COMUNEI MIHĂILENI",MIHĂILENI,SB,246,1,0,0,1,1,2,0,3,2,2,0,4,3,2,0,5,3,2,0,5
145060,301,"ȘCOALA PRIMARĂ METIȘ",METIŞ,SB,243,0,0,0,0,0,0,0,0,2,0,0,2,3,0,0,3,3,0,0,3
145088,302,"CĂMINUL CULTURAL RĂVĂȘEL",RĂVĂŞEL,SB,277,0,0,0,0,1,0,0,1,2,3,0,5,2,3,0,5,2,3,0,5
145113,303,"ȘCOALA GIMNAZIALĂ MOȘNA",MOŞNA,SB,1111,4,0,0,4,9,0,1,10,14,0,1,15,19,1,0,20,19,1,0,20
145113,304,"ȘCOALA GIMNAZIALĂ MOȘNA",MOŞNA,SB,944,2,0,0,2,6,0,0,6,13,0,0,13,19,0,0,19,21,0,0,21
145122,305,"GRĂDINIȚA CU PROGRAM NORMAL ALMA VII","ALMA VII",SB,332,3,0,0,3,4,0,0,4,5,1,0,6,9,6,3,18,14,11,3,28
145131,306,"ȘCOALA GIMNAZIALĂ NEMȘA",NEMŞA,SB,471,2,0,0,2,6,0,0,6,14,2,0,16,24,2,0,26,24,2,0,26
145159,307,"CAMINUL CULTURAL NOCRICH",NOCRICH,SB,1121,2,3,0,5,15,4,0,19,16,4,0,20,18,5,0,23,19,5,0,24
145186,308,"SCOALA GIMNAZIALA HOSMAN",HOSMAN,SB,709,0,0,0,0,1,0,0,1,1,0,0,1,2,0,0,2,5,3,0,8
145168,309,"SCOALA PRIMARA FOFELDEA",FOFELDEA,SB,301,2,2,0,4,4,2,0,6,6,3,0,9,13,5,0,18,14,6,0,20
145177,310,"FOSTA SCOALAGHIJASA DE JOS","GHIJASA DE JOS",SB,83,0,1,0,1,0,1,0,1,0,1,0,1,1,1,0,2,1,1,0,2
145195,311,"SCOALA PRIMARA ŢICHINDEAL",ŢICHINDEAL,SB,129,0,0,0,0,0,2,0,2,1,2,0,3,3,2,0,5,3,2,0,5
145211,312,"GRĂDINIŢA CU PROGRAM NORMALORLAT",ORLAT,SB,1302,4,0,0,4,7,0,0,7,8,0,0,8,12,0,0,12,14,0,0,14
145211,313,"GRĂDINIŢA CU PROGRAM NORMAL ORLAT",ORLAT,SB,1342,4,0,0,4,7,1,0,8,11,4,0,15,15,6,0,21,17,8,0,25
145239,314,"PRIMARIA COMUNEI PĂUCA",PĂUCA,SB,663,9,2,0,11,15,2,0,17,22,2,0,24,38,2,0,40,40,2,0,42
145248,315,"ŞCOALA GIMNAZIALA BOGATU-ROMÂN","BOGATU ROMÂN",SB,357,3,0,0,3,5,0,0,5,8,0,0,8,11,0,0,11,11,0,0,11
145257,316,"ŞCOALA PRIMARA BROŞTENI",BROŞTENI,SB,280,9,0,0,9,17,0,0,17,25,0,0,25,32,1,0,33,36,2,0,38
145266,317,"ŞCOALA PRIMARA PRESACA",PRESACA,SB,308,7,0,0,7,18,2,0,20,29,5,0,34,36,6,0,42,44,8,0,52
145284,318,"CĂMINUL CULTURAL POIANA SIBIULUI","POIANA SIBIULUI",SB,908,0,1,0,1,3,1,0,4,4,1,0,5,7,1,0,8,12,5,0,17
145284,319,"ȘCOALA GIMNAZIALĂ""IOAN BAN - DASCĂLU"", POIANA SIBIULUI, NR. 1332","POIANA SIBIULUI",SB,874,0,2,0,2,2,2,0,4,3,2,0,5,8,2,0,10,12,2,0,14
143511,320,"CĂMINUL CULTURAL POPLACA",POPLACA,SB,1420,3,0,0,3,7,1,0,8,10,2,0,12,18,4,0,22,22,4,0,26
145300,321,"PRIMĂRIA PORUMBACU DE JOS","PORUMBACU DE JOS",SB,870,0,1,0,1,7,1,0,8,7,4,0,11,8,4,0,12,9,4,0,13
145328,322,"CĂMINUL CULTURAL PORUMBACU DE SUS","PORUMBACU DE SUS",SB,678,5,3,0,8,12,6,0,18,13,9,0,22,21,11,0,32,25,14,0,39
145346,323,"CĂMINUL CULTURAL SCOREIU",SCOREIU,SB,558,8,3,0,11,13,4,0,17,19,4,0,23,25,4,0,29,25,4,0,29
145337,324,"CĂMINUL CULTURAL SARATA",SĂRATA,SB,283,2,1,0,3,5,1,0,6,9,2,0,11,9,2,0,11,10,2,0,12
145319,325,"CĂMINUL CULTURALCOLUN",COLUN,SB,147,0,0,0,0,0,2,0,2,0,2,0,2,2,3,0,5,3,3,0,6
145373,326,"CĂMINUL CULTURAL SEBEȘU DE SUS","SEBEŞU DE SUS",SB,612,6,0,0,6,8,0,0,8,12,0,0,12,13,0,5,18,14,0,5,19
145364,327,"ŞCOALA GIMNAZIALÃ RACOVIŢA",RACOVIŢA,SB,1717,13,0,0,13,34,0,0,34,47,2,0,49,53,3,0,56,61,3,0,64
143539,328,"ŞCOALA GIMNAZIALĂ OCTAVIAN GOGA RĂŞINARI",RĂŞINARI,SB,1501,6,0,0,6,17,4,0,21,21,4,0,25,24,4,0,28,26,4,0,30
143539,329,"ŞCOALA GIMNAZIALĂ SAVA POPOVICI BARCIANU RĂŞINARI",RĂŞINARI,SB,1462,2,0,0,2,2,0,0,2,13,1,0,14,14,3,0,17,16,3,0,19
143539,330,"CĂMINUL CULTURAL RĂȘINARI",RĂŞINARI,SB,1444,7,1,0,8,21,3,0,24,24,4,0,28,26,4,0,30,32,4,0,36
145391,331,PRIMĂRIA,"RÎU SADULUI",SB,480,8,2,0,10,10,3,0,13,10,3,0,13,17,3,0,20,23,4,0,27
145417,332,"PRIMARIA ROSIA",ROŞIA,SB,1187,7,0,0,7,19,2,0,21,24,3,0,27,46,5,0,51,52,5,0,57
145453,333,"SCOALA GIMNAZIALA NOU",NOU,SB,1315,2,0,0,2,8,1,0,9,16,1,0,17,28,1,0,29,28,1,0,29
145444,334,"SCOALA GIMAZIALA DAIA",DAIA,SB,753,6,1,0,7,12,1,0,13,14,1,0,15,14,1,0,15,14,1,0,15
145426,335,"SCOALA GIMNAZIALA CAŞOLŢ",CAŞOLŢ,SB,595,4,0,0,4,4,0,0,4,5,0,0,5,7,1,0,8,10,1,0,11
145435,336,"SEDIUL ADMINISTRATIV DISPENSAR",CORNĂŢEL,SB,397,6,1,0,7,7,1,0,8,9,1,0,10,12,3,0,15,12,3,0,15
145480,337,"CĂMINUL CULTURAL AL COMUNEI SADU",SADU,SB,946,3,1,0,4,7,1,0,8,13,1,0,14,27,2,0,29,30,2,0,32
145480,338,"CĂMINUL CULTURAL AL COMUNEI SADU",SADU,SB,1136,3,2,0,5,9,4,0,13,12,4,0,16,23,8,0,31,25,9,0,34
145612,339,"ŞCOALA GIMNAZIALĂ SLIMNIC",SLIMNIC,SB,1298,2,1,0,3,14,1,0,15,17,2,0,19,20,2,0,22,21,2,0,23
145612,340,"ŞCOALA GIMNAZIALĂ SLIMNIC",SLIMNIC,SB,1004,6,3,0,9,14,4,0,18,18,4,0,22,24,4,0,28,28,4,0,32
145649,341,"ŞCOALA GIMNAZIALĂ RUŞI",RUŞI,SB,734,7,1,0,8,14,1,0,15,23,1,0,24,33,1,0,34,37,1,0,38
145658,342,"ŞCOALA GIMNAZIALA VESEUD",VESEUD,SB,161,5,2,0,7,7,3,0,10,9,4,0,13,15,7,0,22,17,7,0,24
145676,343,"SCOALA GIMNAZIALASEICA MARE","ŞEICA MARE",SB,950,3,0,0,3,14,3,0,17,27,7,0,34,34,7,0,41,36,8,0,44
145676,344,"SCOALA GIMNAZIALA SEICA MARE","ŞEICA MARE",SB,869,4,0,0,4,6,0,2,8,10,2,2,14,10,2,2,14,10,4,2,16
145676,345,"SCOALA PRIMARA SEICA MARE","ŞEICA MARE",SB,885,3,5,0,8,13,7,0,20,22,8,0,30,31,12,0,43,38,12,0,50
145685,346,"SCOALA PRIMARA BOARTA",BOARTA,SB,340,7,0,0,7,13,0,0,13,16,1,0,17,16,1,0,17,16,1,0,17
145694,347,"SCOALA PRIMARA BUIA",BUIA,SB,487,0,0,0,0,2,0,0,2,2,0,0,2,2,0,0,2,2,0,0,2
145729,348,"ŞCOALAPRIMARA ŞTENEA",ŞTENEA,SB,124,1,0,0,1,1,0,0,1,1,1,0,2,1,1,0,2,3,5,0,8
145710,349,"CASA PAROHIALA CULT ORTODOX",PETIŞ,SB,48,1,0,0,1,2,0,0,2,2,0,0,2,2,0,0,2,2,0,0,2
145747,350,PRIMARIA,"ŞEICA MICĂ",SB,1035,6,0,0,6,10,0,0,10,11,2,0,13,22,3,0,25,26,3,0,29
145756,351,"FOSTUL SEDIU CAP SOROŞTIN",SOROŞTIN,SB,430,1,1,0,2,8,1,0,9,10,1,0,11,21,2,0,23,22,2,0,24
143566,352,"CĂMIN CULTURAL ŞELIMBĂR",ŞELIMBĂR,SB,1555,8,1,0,9,19,7,0,26,26,7,0,33,40,9,0,49,50,9,0,59
143566,353,"ŞCOALA GIMNAZIALĂ `MIHAI VITEAZU~ ŞELIMBĂR",ŞELIMBĂR,SB,1837,4,2,0,6,14,7,0,21,32,7,0,39,46,11,0,57,53,11,0,64
143566,354,"GRĂDINIȚA CU PROGRAM PRELUNGIT",ŞELIMBĂR,SB,1888,6,0,0,6,15,1,0,16,24,1,0,25,33,3,0,36,38,3,0,41
143593,355,"CĂMIN CULTURAL VEȘTEM",VEŞTEM,SB,1393,12,1,0,13,23,6,0,29,35,7,0,42,39,9,0,48,48,10,0,58
143584,356,"CĂMIN CULTURAL MOHU",MOHU,SB,613,2,0,0,2,3,0,0,3,3,0,0,3,7,0,0,7,9,0,0,9
143575,357,"CĂMIN CULTURAL BUNGRAD",BUNGARD,SB,483,3,0,0,3,6,1,0,7,8,1,0,9,9,1,0,10,10,1,0,11
143566,358,"GRĂDINIȚA CU PROGRAM PRELUNGIT ȘELIMBĂR, CORP NOU, PARTER",ŞELIMBĂR,SB,1696,7,1,0,8,26,10,0,36,42,12,0,54,61,16,0,77,69,19,0,88
145774,359,"SALĂ SPORT","ŞURA MARE",SB,1342,9,1,0,10,13,1,0,14,28,1,0,29,40,1,0,41,41,1,0,42
145774,360,"SALĂ SPORT","ŞURA MARE",SB,1669,2,1,0,3,16,2,0,18,23,2,0,25,26,2,0,28,32,2,0,34
145783,361,"CLĂDIRE CU DESTINAȚIE BIROURI APARȚINÂND CONSISTORIULUI EVANGHELIC C.A. SIBIU",HAMBA,SB,698,0,2,0,2,2,2,0,4,7,3,0,10,8,3,0,11,10,3,0,13
145809,362,"SCOALA GIMNAZIALA SURA MICA","ŞURA MICĂ",SB,1950,3,0,0,3,7,0,0,7,14,0,0,14,26,1,0,27,32,2,0,34
145818,363,"SCOALA PRIMARA RUSCIORI",RUSCIORI,SB,583,2,0,0,2,7,1,0,8,7,1,0,8,10,1,0,11,10,3,0,13
145916,364,"PRIMĂRIA TILIŞCA",TILIŞCA,SB,847,6,1,0,7,12,3,0,15,21,9,0,30,21,11,0,32,21,12,0,33
145925,365,"ŞCOALA PRIMARĂ ROD",ROD,SB,325,1,1,0,2,9,3,0,12,11,3,0,14,14,3,0,17,14,3,0,17
143655,366,"GRĂDINIŢA CU ORAR NORMAL TÎRNAVA",TÎRNAVA,SB,1305,0,0,0,0,6,1,0,7,9,1,0,10,16,1,0,17,16,1,0,17
143655,367,"GRĂDINIŢACU ORAR NORMALTÎRNAVA",TÎRNAVA,SB,1213,0,0,0,0,6,0,0,6,9,0,0,9,12,0,0,12,12,0,0,12
145943,368,CLUB,"TURNU ROŞU",SB,1476,7,0,0,7,25,4,0,29,29,4,0,33,37,11,0,48,44,15,0,59
145952,369,DISPENSAR,"SEBEŞU DE JOS",SB,461,6,4,0,10,9,6,0,15,12,8,0,20,14,9,0,23,21,9,0,30
145970,370,"CENTRUDE INFORMARE TURISTICĂ VALEA VIILOR","VALEA VIILOR",SB,1264,6,0,0,6,17,0,0,17,23,0,0,23,32,1,0,33,32,1,0,33
145989,371,CĂMINMOTIȘ,MOTIŞ,SB,553,0,1,0,1,2,1,0,3,5,1,0,6,8,2,0,10,10,2,0,12
146003,372,"SALA SPORT",VURPĂR,SB,1189,10,0,0,10,19,0,0,19,32,1,0,33,35,2,0,37,37,2,0,39
146003,373,"ŞCOALA GIMNAZIALĂ",VURPĂR,SB,852,2,1,0,3,12,1,0,13,14,1,0,15,18,2,0,20,21,2,0,23
139713,1,"COLEGIUL NAŢIONAL ""SILVANIA""",ZALĂU,SJ,2067,19,2,0,21,52,5,0,57,71,6,0,77,99,7,0,106,109,11,0,120
139713,2,"CLUBUL TINERETULUI",ZALĂU,SJ,1573,16,1,0,17,33,2,0,35,48,2,0,50,58,4,0,62,64,9,0,73
139713,3,"GRĂDINIŢA CU PROGRAM PRELUNGIT NR. 1",ZALĂU,SJ,1641,9,1,0,10,37,2,0,39,48,4,0,52,69,4,0,73,78,6,0,84
139713,4,"PRIMĂRIA MUNICIPIULUI ZALĂU",ZALĂU,SJ,1272,8,2,0,10,24,3,0,27,41,3,0,44,50,4,0,54,54,4,0,58
139713,5,"STADIONUL MUNICIPAL SEDIUL CLUBULUI SPORTIV MUNICIPAL",ZALĂU,SJ,993,6,4,0,10,20,4,16,40,27,4,16,47,36,4,28,68,41,4,28,73
139713,6,"LICEUL CU PROGRAM SPORTIV ""AVRAM IANCU""",ZALĂU,SJ,1815,9,0,0,9,47,5,0,52,58,7,0,65,70,7,0,77,74,7,0,81
139713,7,"LICEUL CU PROGRAM SPORTIV ""AVRAM IANCU""",ZALĂU,SJ,1567,8,4,0,12,29,5,0,34,31,6,0,37,43,6,0,49,52,6,0,58
139713,8,"LICEUL CU PROGRAM SPORTIV ""AVRAM IANCU""",ZALĂU,SJ,1755,9,3,0,12,31,5,0,36,50,6,0,56,65,7,0,72,73,7,0,80
139713,9,"DIRECŢIA DE SĂNĂTATE PUBLICĂ SĂLAJ",ZALĂU,SJ,1058,20,0,0,20,46,5,0,51,57,5,0,62,75,7,0,82,79,7,0,86
139713,10,"DIRECŢIA GENERALĂ DE ADMINISTRARE DOMENIUL PUBLIC",ZALĂU,SJ,1278,8,3,0,11,41,3,0,44,63,4,0,67,73,7,0,80,89,7,0,96
139713,11,"ȘCOALA GIMNAZIALĂ ""SIMION BĂRNUȚIU""",ZALĂU,SJ,1732,12,3,0,15,32,7,0,39,58,8,0,66,67,11,0,78,77,13,0,90
139713,12,"ŞCOALA GIMNAZIALĂ ""GHEORGHE LAZĂR""",ZALĂU,SJ,1777,16,1,0,17,62,2,0,64,72,2,0,74,126,3,0,129,113,5,0,118
139713,13,"LICEUL TEHNOLOGIC ""MIHAI VITEAZU""",ZALĂU,SJ,973,6,6,0,12,31,6,0,37,54,6,0,60,75,6,1,82,80,7,1,88
139713,14,"LICEUL TEHNOLOGIC ""MIHAI VITEAZU”",ZALĂU,SJ,1298,4,1,0,5,33,1,0,34,47,1,0,48,68,1,0,69,75,1,0,76
139713,15,"ŞCOALA GIMNAZIALĂ “POROLISSUM""",ZALĂU,SJ,1738,17,1,0,18,55,1,0,56,79,1,0,80,97,1,32,130,112,5,32,149
139713,16,"ŞCOALA GIMNAZIALĂ ""POROLISSUM""",ZALĂU,SJ,1743,15,1,0,16,44,8,0,52,77,11,0,88,92,12,1,105,101,12,1,114
139713,17,"ŞCOALA GIMNAZIALĂ ""IULIU MANIU""",ZALĂU,SJ,1791,22,0,0,22,58,2,0,60,75,3,0,78,91,6,0,97,100,6,0,106
139713,18,"GRĂDINIŢA CU PROGRAM PRELUNGIT ""VOINICEL""",ZALĂU,SJ,999,3,3,0,6,16,3,0,19,24,3,0,27,32,3,0,35,34,3,0,37
139713,19,"GRĂDINIŢA CU PROGRAM PRELUNGIT ""VOINICEL""",ZALĂU,SJ,1177,6,0,0,6,29,2,0,31,41,2,0,43,60,2,0,62,67,3,0,70
139713,20,"SALA SPORTURILOR",ZALĂU,SJ,1796,8,2,0,10,48,4,0,52,67,7,0,74,81,8,0,89,93,9,0,102
139713,21,"SALA SPORTURILOR",ZALĂU,SJ,1684,13,0,0,13,20,1,0,21,34,2,0,36,56,2,0,58,62,4,0,66
139713,22,"ȘCOALA GIMNAZIALĂ ""CORNELIU COPOSU""",ZALĂU,SJ,1337,14,0,0,14,27,0,0,27,36,0,0,36,43,1,0,44,45,2,0,47
139713,23,"ŞCOALA GIMNAZIALĂ ""CORNELIU COPOSU""",ZALĂU,SJ,1618,25,1,0,26,32,4,0,36,39,6,0,45,59,6,0,65,72,6,0,78
139713,24,"ŞCOALA GIMNAZIALĂ ""CORNELIU COPOSU""",ZALĂU,SJ,1480,3,0,0,3,10,0,0,10,15,0,0,15,21,2,0,23,26,2,0,28
139713,25,"ŞCOALA GIMNAZIALĂ ""CORNELIU COPOSU""",ZALĂU,SJ,1210,5,0,0,5,17,1,0,18,24,1,0,25,32,1,0,33,34,2,0,36
139713,26,"LICEUL TEHNOLOGIC ""VOIEVOD GELU""",ZALĂU,SJ,1530,5,0,0,5,15,2,0,17,21,2,0,23,50,3,0,53,50,5,0,55
139713,27,"LICEUL TEHNOLOGIC ""VOIEVOD GELU""",ZALĂU,SJ,1798,9,0,0,9,27,1,0,28,47,1,0,48,57,1,0,58,60,1,0,61
139713,28,"LICEUL TEHNOLOGIC ""VOIEVOD GELU""",ZALĂU,SJ,1543,5,1,0,6,19,2,0,21,30,2,0,32,42,5,0,47,47,5,0,52
139713,29,"GRĂDINIŢA CU PROGRAM NORMAL NR.8",ZALĂU,SJ,1906,10,0,0,10,37,5,0,42,60,5,0,65,85,5,79,169,88,5,79,172
139713,30,"LICEUL DE ARTĂ ""IOAN SIMA""",ZALĂU,SJ,1676,12,0,0,12,36,0,0,36,52,0,0,52,75,4,0,79,88,4,0,92
139713,31,"ŞCOALA POSTLICEALĂ SANITARĂ",ZALĂU,SJ,1450,10,1,0,11,40,1,0,41,66,1,0,67,83,1,0,84,90,1,0,91
139713,32,"GRĂDINIŢA CU PROGRAM PRELUNGIT NR.11",ZALĂU,SJ,1623,13,5,0,18,32,5,0,37,48,5,0,53,67,6,0,73,75,7,0,82
139713,33,"COLEGIUL TEHNIC ""ALESANDRU PAPIU ILARIAN""",ZALĂU,SJ,1176,8,1,0,9,33,3,0,36,54,3,0,57,62,3,0,65,70,7,0,77
139713,34,"COLEGIUL TEHNIC ""ALESANDRU PAPIU ILARIAN""",ZALĂU,SJ,1006,9,0,0,9,18,0,0,18,46,0,0,46,57,0,0,57,64,0,0,64
139713,35,"LICEUL TEORETIC ""GHEORGHE ŞINCAI""",ZALĂU,SJ,1414,7,0,0,7,29,2,0,31,42,3,0,45,52,3,0,55,58,3,0,61
139713,36,"ŞCOALA GIMNAZIALĂ ""MIHAI EMINESCU""",ZALĂU,SJ,1707,10,3,0,13,34,6,0,40,52,12,0,64,75,14,0,89,85,18,0,103
139713,37,"CLUB S.C. COMPANIA DE APĂ SOMEŞ S.A. SUCURSALA MUNICIPIULUI ZALĂU",ZALĂU,SJ,1348,10,0,0,10,34,2,0,36,60,4,0,64,72,4,0,76,72,4,0,76
139713,38,"ŞCOALA GENERALĂ ""GEORGE COŞBUC"", CARTIER ORTELEC",ZALĂU,SJ,1634,6,3,0,9,25,4,0,29,43,5,0,48,65,11,0,76,71,11,0,82
139722,39,"ŞCOALA PRIMARĂ STÎNA",STÎNA,SJ,243,2,0,0,2,3,0,0,3,4,0,0,4,8,0,0,8,8,0,0,8
139759,40,"LICEUL TEHNOLOGIC ""GHEORGHE POP DE BĂSEȘTI""","CEHU SILVANIEI",SJ,1475,5,4,0,9,14,5,0,19,17,5,0,22,22,5,0,27,27,6,0,33
139759,41,"ȘCOALA GIMNAZIALĂ ""ANDREI MUREȘANU""","CEHU SILVANIEI",SJ,1524,1,0,0,1,10,2,0,12,13,2,0,15,15,4,0,19,17,4,0,21
139759,42,"PIAȚA TRANDAFIRILOR NR. 29 CLUBUL COPIILOR","CEHU SILVANIEI",SJ,1442,5,0,0,5,17,0,0,17,22,1,0,23,28,1,0,29,30,1,0,31
139768,43,"HOROATU CEHULUI NR. 23 ȘCOALA PRIMARĂ","HOROATU CEHULUI",SJ,142,3,0,0,3,3,2,0,5,3,2,0,5,4,2,0,6,4,2,0,6
139777,44,"SAT MOTIȘ NR. 228 ȘCOALA GIMNAZIALĂ ""GHEORGHE ȘINCAI""",MOTIŞ,SJ,601,2,2,0,4,3,2,0,5,6,2,0,8,6,2,0,8,10,5,0,15
139786,45,"SAT NADIȘ NR.127 ȘCOALA PRIMARĂ",NADIŞ,SJ,424,0,1,0,1,1,1,0,2,3,1,0,4,4,2,0,6,5,2,0,7
139795,46,"SAT ULCIUG NR.6 GRĂDINIȚA DE COPII",ULCIUG,SJ,757,0,0,0,0,0,0,0,0,1,0,0,1,1,0,0,1,7,0,0,7
139820,47,"CASA DE CULTURĂ",JIBOU,SJ,1871,22,2,0,24,39,3,0,42,60,8,0,68,87,8,0,95,103,9,0,112
139820,48,"LICEUL TEHNOLOGIC ""OCTAVIAN GOGA""",JIBOU,SJ,1576,9,0,0,9,23,2,0,25,37,3,0,40,45,4,0,49,49,4,0,53
139820,49,"LICEUL TEHNOLOGIC ""OCTAVIASN GOGA""PARTER,SALA DE CLASA NR.2",JIBOU,SJ,1284,5,0,0,5,31,0,0,31,45,0,0,45,60,0,0,60,77,0,0,77
139820,50,"ȘCOALĂ GIMNAZIALĂ ""LUCIAN BLAGA"" PARTER SALĂ DE CLASĂ NR.1,STR.GAROAFELOR NR.7",JIBOU,SJ,1676,19,5,0,24,46,5,0,51,69,5,0,74,83,7,0,90,93,9,0,102
139820,51,"LICEUL TEORETIC""ION AGÂRBICEANU""",JIBOU,SJ,1750,9,2,0,11,24,2,0,26,34,2,0,36,41,2,0,43,47,3,0,50
139839,52,GRĂDINIȚĂ,CUCEU,SJ,403,5,0,0,5,7,0,0,7,9,1,0,10,10,1,0,11,12,2,0,14
139848,53,"ȘCOALA CU CLASELE I-IV",HUSIA,SJ,206,1,1,0,2,3,1,0,4,3,1,0,4,4,1,0,5,4,1,0,5
139857,54,"ȘCOALA CU CLASELE I-IV",RONA,SJ,308,3,2,0,5,4,5,0,9,6,5,0,11,8,5,0,13,8,5,0,13
139866,55,"ȘCOALA CU CLASELE I-IV",VAR,SJ,431,4,0,0,4,7,0,0,7,7,0,0,7,9,0,0,9,15,2,0,17
139893,56,"ȘCOALA GIMNAZIALĂ ”HOREA”","ŞIMLEU SILVANIEI",SJ,1644,7,1,0,8,35,1,0,36,49,4,0,53,63,7,0,70,83,11,0,94
139893,57,"LICEUL TEHNOLOGIC ”IOAN OSSIAN”","ŞIMLEU SILVANIEI",SJ,1524,10,0,0,10,38,2,0,40,46,2,0,48,57,2,0,59,58,2,0,60
139893,58,"CENTRUL CULTURAL","ŞIMLEU SILVANIEI",SJ,1457,5,1,0,6,15,1,0,16,22,1,0,23,32,4,0,36,34,4,0,38
139893,59,"COLEGIUL TEHNIC ”IULIU MANIU”","ŞIMLEU SILVANIEI",SJ,1538,18,0,0,18,39,1,0,40,48,1,0,49,58,1,0,59,65,1,0,66
139893,60,"CENTRUL ȘCOLAR PENTRU EDUCAȚIE INCLUZIVĂ","ŞIMLEU SILVANIEI",SJ,1907,9,1,0,10,19,1,0,20,36,2,0,38,43,2,0,45,43,2,0,45
139893,61,"CLUBUL COPIILOR","ŞIMLEU SILVANIEI",SJ,1750,10,1,0,11,21,1,0,22,29,1,0,30,57,3,0,60,60,5,0,65
139893,62,"GRĂDINIȚA CU PROGRAM PRELUNGIT NR.3","ŞIMLEU SILVANIEI",SJ,1556,7,4,0,11,13,5,0,18,23,6,0,29,36,6,0,42,40,6,0,46
139919,63,"ŞCOALA PRIMARĂ",CEHEI,SJ,787,3,0,0,3,13,0,0,13,21,0,0,21,42,2,0,44,55,2,0,57
139928,64,"ŞCOALA GIMNAZIALĂ NR.1",PUSTA,SJ,1384,2,0,0,2,9,0,0,9,17,0,0,17,23,0,0,23,23,0,0,23
139946,65,"CĂMINCULTURAL AGRIJ",AGRIJ,SJ,828,1,0,0,1,6,0,0,6,12,0,0,12,18,4,0,22,24,4,0,28
139964,66,"ŞCOALA CU CLASELE I-IV","RĂSTOLŢU- DEŞERT",SJ,278,2,1,0,3,5,2,0,7,8,3,0,11,11,4,0,15,13,6,0,19
139991,67,"PRIMĂRIA COMUNEI ALMAŞU",ALMAŞU,SJ,816,2,1,0,3,6,2,0,8,10,2,0,12,12,2,0,14,12,2,0,14
140020,68,"CĂMINUL CULTURAL JEBUCU",JEBUCU,SJ,287,0,0,0,0,0,4,0,4,0,4,0,4,1,4,0,5,1,4,0,5
140039,69,"CĂMINUL CULTURAL MESTEACĂNU",MESTEACĂNU,SJ,292,1,2,0,3,1,2,0,3,1,2,0,3,1,4,0,5,1,4,0,5
140048,70,"CĂMINUL CULTURAL PETRINZEL",PETRINZEL,SJ,98,2,1,0,3,2,1,0,3,2,2,0,4,3,2,0,5,3,2,0,5
140066,71,"CĂMINUL CULTURAL STANA",STANA,SJ,107,0,0,0,0,0,4,0,4,0,5,0,5,1,5,0,6,2,5,0,7
140075,72,"ŞCOALA CU CLASELE I-IV ŢĂUDU",ŢĂUDU,SJ,103,0,0,0,0,0,0,0,0,1,0,0,1,5,0,0,5,6,0,0,6
140093,73,"CORP B , BIBLIOTECA COMUNALĂ",BĂBENI,SJ,463,12,1,0,13,15,2,0,17,16,2,0,18,18,2,0,20,18,2,0,20
140100,74,ŞCOALAVECHECIOCMANI,CIOCMANI,SJ,469,5,0,0,5,10,0,0,10,19,1,0,20,20,1,0,21,20,1,0,21
140119,75,ŞCOALACLIŢ,CLIŢ,SJ,177,0,2,0,2,0,2,0,2,4,3,0,7,7,5,0,12,7,5,0,12
140128,76,CLĂDIREMULTIFUNCŢIONALĂ,PIROŞA,SJ,82,0,0,0,0,0,1,0,1,3,1,0,4,6,1,0,7,6,1,0,7
140137,77,ŞCOALAPOIENIŢA,POIENIŢA,SJ,177,0,0,0,0,2,1,0,3,2,1,0,3,2,1,0,3,2,1,0,3
140155,78,"ŞCOALA GIMNAZIALĂ BĂLAN",BĂLAN,SJ,767,5,0,0,5,7,3,0,10,9,3,0,12,12,4,0,16,14,4,0,18
140164,79,"ŞCOALA PRIMARĂ CHECHIŞ",CHECHIŞ,SJ,478,6,6,0,12,13,9,0,22,23,11,0,34,27,20,0,47,27,22,0,49
140173,80,"ŞCOALA PRIMARĂ ""IOANICHIE DRUHORA"" CHENDREA",CHENDREA,SJ,668,6,0,0,6,15,2,0,17,22,3,0,25,38,3,0,41,45,5,0,50
140182,81,"ŞCOALA PRIMARĂ GĂLPÎIA",GĂLPÎIA,SJ,336,8,4,0,12,30,7,0,37,35,11,0,46,44,13,0,57,46,13,0,59
140191,82,"ŞCOALA GIMNAZIALĂ GÎLGĂU ALMAŞULUI","GÎLGĂU ALMAŞULUI",SJ,819,10,0,0,10,22,1,0,23,33,5,0,38,45,5,0,50,56,5,0,61
140217,83,"PRIMĂRIA BĂNIȘOR, NR. 29",BĂNIŞOR,SJ,540,5,3,0,8,15,8,0,23,21,10,0,31,22,12,0,34,23,12,0,35
140226,84,"CAMIN CULTURAL BAN, NR. 55",BAN,SJ,364,5,3,0,8,8,5,0,13,10,5,0,15,11,6,0,17,14,6,0,20
140235,85,"ŞCOALA PECEIU, NR. 137",PECEIU,SJ,755,6,2,0,8,13,6,0,19,20,10,0,30,35,12,0,47,36,12,0,48
140253,86,"ŞCOALA PRIMARĂ BENESAT",BENESAT,SJ,351,3,0,0,3,3,1,0,4,3,2,0,5,10,3,0,13,12,3,0,15
140262,87,"ŞCOALA GIMNAZIALĂ ,,AVRAM IANCU""",ALUNIŞ,SJ,458,4,1,0,5,4,1,0,5,4,1,0,5,5,2,0,7,5,2,0,7
140271,88,"ŞCOALA PRIMARĂ BIUŞA",BIUŞA,SJ,397,5,0,0,5,5,0,0,5,6,4,0,10,9,4,0,13,11,4,0,15
140299,89,"GRĂDINIȚA BOBOTA",BOBOTA,SJ,1173,8,0,0,8,16,0,0,16,27,3,0,30,37,3,0,40,39,6,0,45
140306,90,"ȘCOALA DERȘIDA",DERŞIDA,SJ,1489,5,0,0,5,16,2,0,18,24,2,0,26,35,2,0,37,35,2,0,37
140315,91,"ȘCOALA ZALNOC",ZALNOC,SJ,381,1,4,0,5,4,4,0,8,5,4,0,9,6,4,0,10,8,4,0,12
140333,92,"ȘCOALA GIMNAZIALĂ ""SIMION BĂRNUȚIU"" BOCȘA",BOCŞA,SJ,769,5,4,0,9,11,4,0,15,19,4,0,23,24,5,0,29,31,5,0,36
140342,93,"ȘCOALA GIMNAZIALĂ NR.1 BORLA",BORLA,SJ,1320,0,0,0,0,11,0,0,11,18,0,0,18,27,0,0,27,32,0,0,32
140360,94,"ȘCOALA CU CLASELE I-IV SĂLĂJENI",SĂLĂJENI,SJ,442,2,1,0,3,4,1,0,5,7,3,0,10,10,3,0,13,10,3,0,13
140351,95,"ȘCOALA CU CLASELE I-IV CÎMPIA",CÎMPIA,SJ,207,3,3,0,6,3,3,0,6,5,3,0,8,5,3,0,8,8,3,0,11
142266,96,"PRIMĂRIA COMUNEI BOGHIŞ",BOGHIŞ,SJ,1247,7,0,0,7,7,3,0,10,15,3,0,18,16,3,0,19,25,6,0,31
142275,97,"CĂMINUL CULTURAL BOZIEŞ",BOZIEŞ,SJ,209,4,0,0,4,7,0,0,7,10,4,0,14,10,5,0,15,11,5,0,16
140397,98,"ŞCOALA CU CLASELE I-IV",BODIA,SJ,219,2,0,0,2,5,1,0,6,8,4,0,12,13,5,0,18,15,7,0,22
140404,99,"ŞCOALA CU CLASELE I-IV",BOGDANA,SJ,366,7,0,0,7,7,1,0,8,12,4,0,16,17,4,0,21,18,4,0,22
140422,100,"ŞCOALA CU CLASELE I-IV",RĂSTOLŢ,SJ,173,2,2,0,4,7,3,0,10,7,4,0,11,10,6,0,16,15,9,0,24
140431,101,"ŞCOALA CU CLASELE I-IV","SÎNGEORGIU DE MESEŞ",SJ,227,1,0,0,1,1,0,0,1,1,2,0,3,6,6,0,12,6,6,0,12
140388,102,"PRIMĂRIA BUCIUMI",BUCIUMI,SJ,992,5,3,0,8,8,10,0,18,23,12,0,35,32,14,0,46,36,18,0,54
140459,103,"PRIMĂRIA COMUNEI CAMĂR",CAMĂR,SJ,1342,19,0,0,19,31,0,0,31,45,3,0,48,60,4,0,64,62,4,0,66
140495,104,"ŞCOALA PRIMARĂ",DUMUSLĂU,SJ,34,0,0,0,0,3,0,0,3,3,1,0,4,4,2,0,6,4,4,0,8
140486,105,"CENTRUL LOCAL DE INFORMARE TURISTICĂ",CARASTELEC,SJ,826,4,0,0,4,26,2,0,28,42,3,0,45,46,6,0,52,49,6,0,55
140510,106,"SALA DE SPORT CHIEȘD",CHIEŞD,SJ,1577,3,1,0,4,6,2,0,8,9,2,0,11,17,3,0,20,20,3,0,23
140538,107,"ȘCOALA PRIMARĂ SIGHETU SILVANIEI","SIGHETU SILVANIEI",SJ,401,3,1,0,4,5,2,0,7,5,3,0,8,6,3,0,9,7,5,0,12
140556,108,"ŞCOALA GIMNAZIALĂ CIZER",CIZER,SJ,1301,1,2,0,3,4,2,0,6,5,3,0,8,8,4,0,12,11,4,0,15
140565,109,"ŞCOALA GIMNAZIALĂ PLESCA",PLESCA,SJ,163,3,0,0,3,6,1,0,7,7,1,0,8,8,1,0,9,8,1,0,9
140574,110,CĂMINULCULTURAL,PRIA,SJ,327,2,2,0,4,3,2,0,5,6,4,0,10,6,4,0,10,8,7,0,15
140592,111,"PRIMĂRIA COMUNEI COŞEIU",COŞEIU,SJ,358,4,0,0,4,6,0,0,6,9,0,0,9,13,0,0,13,13,0,0,13
140609,112,"ŞCOALA GIMNAZIALĂ ARCHID",ARCHID,SJ,383,3,4,0,7,4,4,0,8,8,4,0,12,10,6,0,16,10,6,0,16
140618,113,"ŞCOALA CU CLASELE I-IV CHILIOARA",CHILIOARA,SJ,242,4,1,0,5,7,4,0,11,8,5,0,13,14,8,0,22,15,10,0,25
140636,114,"CĂMINUL CULTURAL ”PETŐFI SÁNDOR”",CRASNA,SJ,1927,5,0,0,5,25,3,0,28,33,3,0,36,52,3,0,55,71,4,0,75
140636,115,"MUZEUL SATULUI",CRASNA,SJ,1801,7,3,0,10,20,3,0,23,26,3,0,29,35,3,0,38,50,3,0,53
140645,116,"CENTRULDE ZI PENTRU COPII",HUSENI,SJ,414,5,3,0,8,5,3,0,8,6,4,0,10,13,5,0,18,14,5,0,19
140654,117,"CENTRULDE ZI PENTRU COPII",MARIN,SJ,752,0,1,0,1,2,1,0,3,3,3,0,6,3,4,0,7,3,4,0,7
140663,118,"CENTRUL DE ZI PENTRU COPII",RATIN,SJ,406,1,4,0,5,2,4,0,6,3,5,0,8,3,6,0,9,3,6,0,9
140681,119,"ȘCOALA GIMNAZIALĂ MARCUS AURELIUS CREACA",CREACA,SJ,363,6,2,0,8,7,2,0,9,11,5,0,16,15,6,0,21,15,6,0,21
140707,120,"ȘCOALA GENERALĂ BREBI",BREBI,SJ,443,7,0,0,7,7,0,0,7,10,2,0,12,24,4,0,28,25,4,0,29
140734,121,"ȘCOALA GIMNAZIALĂ JAC",JAC,SJ,569,10,3,0,13,33,5,0,38,52,15,1,68,65,16,1,82,73,17,1,91
140716,122,"ȘCOALA GENERALĂ BRUSTURI",BRUSTURI,SJ,132,2,3,0,5,7,6,0,13,11,6,0,17,13,6,0,19,13,6,0,19
140743,123,"ȘCOALA GENERALĂ LUPOAIA",LUPOAIA,SJ,240,8,1,0,9,21,2,0,23,25,4,0,29,28,4,0,32,31,4,0,35
140690,124,"ȘCOALA GENERALĂ BORZA",BORZA,SJ,150,0,2,0,2,6,3,0,9,9,4,0,13,11,7,0,18,11,10,0,21
140752,125,"ȘCOALA GENERALĂ PRODĂNEȘTI",PRODĂNEŞTI,SJ,208,4,1,0,5,5,1,0,6,6,2,0,8,11,2,0,13,12,2,0,14
140725,126,"ȘCOALA GENERALĂ CIGLEAN",CIGLEAN,SJ,119,1,2,0,3,2,2,0,4,2,2,0,4,6,6,0,12,6,6,0,12
140789,127,"CĂMINUL CULTURAL CRISTOLȚ",CRISTOLŢ,SJ,507,1,0,0,1,4,0,0,4,6,0,0,6,7,0,0,7,7,0,0,7
140798,128,"ŞCOALA PRIMARĂ MUNCEL",MUNCEL,SJ,138,1,1,0,2,2,1,0,3,3,1,0,4,4,1,0,5,4,1,0,5
140805,129,"ŞCOALA PRIMARĂ POIANA ONŢII","POIANA ONŢII",SJ,66,1,0,0,1,1,0,0,1,3,0,0,3,5,2,0,7,5,2,0,7
140814,130,"ŞCOALAPRIMARĂ VĂLENI",VĂLENI,SJ,327,7,2,0,9,8,2,0,10,10,2,0,12,11,2,0,13,13,2,0,15
140832,131,"ȘCOALAGIMNAZIALĂ "" VASILEBREBAN '"" CRIȘENI",CRIŞENI,SJ,1454,6,0,0,6,12,2,0,14,25,3,0,28,29,3,0,32,34,3,0,37
140841,132,"ȘCOALAPRIMARĂ CRISTUR-CRIȘENI",CRISTUR-CRIŞENI,SJ,415,4,2,0,6,5,3,0,8,5,3,0,8,7,3,0,10,7,3,0,10
140850,133,"ȘCOALA PRIMARĂGÎRCEIU",GÎRCEIU,SJ,658,4,2,0,6,5,5,0,10,9,5,0,14,11,7,0,18,11,11,0,22
140878,134,"ȘCOALA GIMNAZIALĂ CUZĂPLAC, NR.242",CUZĂPLAC,SJ,446,1,0,0,1,8,0,0,8,12,1,0,13,19,4,0,23,23,5,0,28
140896,135,"CĂMINUL CULTURAL GĂLĂȘENI, NR.50",GĂLĂŞENI,SJ,86,0,2,0,2,2,2,0,4,6,3,0,9,7,3,0,10,9,4,0,13
140903,136,"ŞCOALA CU CLASELE I-IV MIERȚA, NR.97",MIERŢA,SJ,109,2,0,0,2,4,0,0,4,5,0,0,5,6,0,0,6,6,2,0,8
140912,137,"CENTRUL DE ZI PETRINDU, NR.78",PETRINDU,SJ,339,3,2,0,5,6,3,0,9,9,5,1,15,12,5,1,18,14,5,1,20
140921,138,"CĂMINUL CULTURAL RUGINOASA, NR.22",RUGINOASA,SJ,76,0,0,0,0,3,4,0,7,3,6,0,9,5,9,0,14,7,9,0,16
140949,139,"ȘCOALA CU CLASELE I-IV TĂMAȘA, NR.219",TĂMASA,SJ,255,8,3,0,11,12,3,0,15,21,3,0,24,25,3,0,28,27,3,0,30
140967,140,CĂMINULCULTURAL,DOBRIN,SJ,350,3,2,0,5,8,2,0,10,19,5,0,24,36,7,0,43,40,8,0,48
140985,141,"ȘCOALA ELEMENTARĂ",DOBA,SJ,266,0,0,0,0,3,1,0,4,4,3,0,7,4,4,0,8,5,4,0,9
140985,142,"CENTRULDE ZI DOBA",DOBA,SJ,226,5,1,0,6,5,1,0,6,9,1,0,10,11,4,0,15,13,5,0,18
140994,143,"CĂMINUL CULTURAL NAIMON",NAIMON,SJ,119,0,4,0,4,4,4,0,8,6,4,0,10,11,5,0,16,11,5,0,16
141018,144,"ȘCOALA ELEMENTARĂ VERVEGHIU",VERVEGHIU,SJ,379,2,2,0,4,2,3,0,5,5,5,0,10,9,5,0,14,11,5,0,16
141036,145,"PRIMĂRIA DRAGU, NR.120",DRAGU,SJ,519,6,0,0,6,10,2,0,12,13,3,0,16,15,4,0,19,15,4,0,19
141045,146,"ȘCOALA CU CLASELE I-IV, NR.100",ADALIN,SJ,119,4,3,0,7,6,5,0,11,6,5,0,11,9,5,0,14,11,5,0,16
141063,147,"CĂMINUL CULTURAL, NR.20",UGRUŢIU,SJ,19,0,0,0,0,0,2,0,2,0,6,0,6,0,11,0,11,0,11,0,11
141072,148,"ȘCOALA CU CLASELEI-IV, NR.117",VOIVODENI,SJ,242,0,1,0,1,3,1,0,4,4,2,0,6,8,5,0,13,10,6,0,16
141090,149,"ŞCOALA PRIMARĂ FILDU DE JOS","FILDU DE JOS",SJ,185,0,1,0,1,2,2,0,4,3,2,0,5,6,3,0,9,7,3,0,10
141107,150,"CĂMINUL CULTURAL FILDU DE MIJLOC","FILDU DE MIJLOC",SJ,317,3,1,0,4,4,3,0,7,9,3,0,12,13,3,0,16,14,3,0,17
141116,151,"CĂMINUL CULTURAL FILDU DE SUS","FILDU DE SUS",SJ,321,1,2,0,3,3,3,0,6,5,3,0,8,14,3,0,17,14,5,0,19
141125,152,"ŞCOALA PRIMARĂ TETIŞU",TETIŞU,SJ,245,0,0,0,0,3,1,0,4,3,1,0,4,5,1,0,6,6,2,0,8
141152,153,"ȘCOALA CU CLASELEI-IV","BÎRSĂU MARE",SJ,179,8,0,0,8,8,0,0,8,11,1,0,12,13,1,0,14,15,2,0,17
141161,154,"ȘCOALA CU CLASELEI-IV",CĂPÎLNA,SJ,242,4,2,0,6,6,6,0,12,8,7,0,15,10,7,0,17,12,8,0,20
141170,155,"ȘCOALA CU CLASELEI-IV",CHIZENI,SJ,83,2,0,0,2,4,1,0,5,5,2,0,7,10,6,0,16,11,6,0,17
141214,156,"ȘCOALA CU CLASELEI-IV",GLOD,SJ,390,4,0,0,4,10,3,0,13,10,3,0,13,10,11,0,21,10,11,0,21
141143,157,"LICEUL TEHNOLOGIC",GÎLGĂU,SJ,513,13,1,0,14,18,2,0,20,23,2,0,25,30,2,0,32,34,5,0,39
141189,158,"CĂMINUL CULTURAL",DOBROCINA,SJ,140,2,3,0,5,7,3,0,10,9,3,0,12,14,3,0,17,14,5,0,19
141198,159,ȘCOALAGIMNAZIALĂ,FODORA,SJ,351,6,0,0,6,12,1,0,13,15,1,0,16,18,2,0,20,22,4,0,26
141241,160,"PRIMĂRIA GÎRBOU",GÎRBOU,SJ,485,2,0,0,2,4,0,0,4,4,0,0,4,6,5,0,11,8,6,0,14
141303,161,"CĂMINUL CULTURAL",SOLOMON,SJ,286,2,2,0,4,3,2,0,5,5,2,0,7,8,6,0,14,9,6,0,15
141269,162,"ȘCOALA PRIMARĂ",CĂLACEA,SJ,222,0,0,0,0,1,1,0,2,5,3,0,8,8,5,0,13,8,5,0,13
141296,163,"ȘCOALA PRIMARĂ",POPTELEAC,SJ,258,6,3,0,9,8,6,0,14,10,7,0,17,10,7,0,17,11,7,0,18
141278,164,"CĂMINUL CULTURAL CERNUC",CERNUC,SJ,145,0,0,0,0,1,0,0,1,1,5,0,6,3,7,0,10,3,7,0,10
141250,165,"CĂMINUL CULTURAL",BEZDED,SJ,98,0,3,0,3,0,4,0,4,0,4,0,4,1,7,0,8,1,7,0,8
141287,166,"ȘCOALA PRIMARĂ",FABRICA,SJ,83,0,0,0,0,3,0,0,3,3,0,0,3,3,0,0,3,3,0,0,3
141321,167,"CĂMINUL CULTURAL",HALMĂŞD,SJ,879,2,1,0,3,7,1,0,8,13,3,0,16,21,6,0,27,23,7,0,30
141330,168,ȘCOALĂ,ALEUŞ,SJ,239,0,0,0,0,0,0,0,0,3,2,0,5,6,2,0,8,7,4,0,11
141349,169,"ȘCOALA VECHE",CERIŞA,SJ,450,5,0,0,5,6,2,0,8,13,2,0,15,15,2,0,17,15,2,0,17
141358,170,"ȘCOALA NOUĂ DRIGHIU",DRIGHIU,SJ,315,10,2,0,12,10,2,0,12,10,3,0,13,12,3,0,15,13,3,0,16
141385,171,"CĂMINUL CULTURAL HERECLEAN",HERECLEAN,SJ,451,2,2,0,4,7,5,0,12,10,5,0,15,11,5,0,16,13,5,0,18
141394,172,"ŞCOALA PRIMARĂ BADON",BADON,SJ,563,6,1,0,7,16,2,0,18,20,3,0,23,21,4,0,25,23,4,0,27
141401,173,"CĂMINUL CULTURAL BOCȘIȚA",BOCŞIŢA,SJ,67,0,0,0,0,2,1,0,3,4,1,0,5,8,2,0,10,8,2,0,10
141410,174,"ȘCOALA PRIMARĂ DIOȘOD",DIOŞOD,SJ,692,3,0,0,3,7,0,0,7,10,0,0,10,13,0,0,13,14,0,0,14
141429,175,"ŞCOALA GIMNAZIALĂ GURUSLĂU",GURUSLĂU,SJ,521,3,0,0,3,5,0,0,5,13,3,0,16,20,4,0,24,21,5,0,26
141438,176,"ŞCOALA GIMNAZIALĂ PANIC",PANIC,SJ,885,3,0,0,3,7,0,0,7,10,0,0,10,12,0,0,12,14,0,0,14
141465,177,CĂMINULCULTURAL,BAICA,SJ,100,2,4,0,6,6,4,0,10,6,4,0,10,6,5,0,11,8,5,0,13
141474,178,CĂMINULCULTURAL,MILUANI,SJ,21,0,1,0,1,0,2,0,2,0,2,0,2,0,2,0,2,1,2,0,3
141456,179,PRIMĂRIA,HIDA,SJ,885,4,1,0,5,12,3,0,15,20,4,0,24,23,4,0,27,24,4,0,28
141492,180,"ŞCOALA GENERALĂ",RACÎŞ,SJ,410,0,1,0,1,1,3,0,4,3,3,0,6,3,5,0,8,3,7,0,10
141526,181,"ŞCOALA GENERALĂ",TRESTIA,SJ,243,2,0,0,2,2,0,0,2,2,0,0,2,4,1,0,5,4,1,0,5
141508,182,"ŞCOALA GENERALĂ","SÎNPETRU ALMAŞULUI",SJ,337,2,3,0,5,9,3,0,12,14,3,0,17,14,3,0,17,19,3,0,22
141517,183,"CĂMINUL CULTURAL",STUPINI,SJ,106,3,0,0,3,3,0,0,3,3,0,0,3,7,1,0,8,7,1,0,8
141483,184,"ŞCOALA GENERALĂ",PĂDURIŞ,SJ,30,0,0,0,0,3,3,0,6,5,7,0,12,6,8,0,14,6,8,0,14
141562,185,"CĂMINUL CULTURAL",STÎRCIU,SJ,777,5,0,0,5,11,7,0,18,17,8,0,25,34,12,0,46,39,12,0,51
141571,186,"CĂMINUL CULTURAL",ŞEREDEIU,SJ,200,3,4,0,7,5,4,0,9,5,5,0,10,5,5,0,10,5,5,0,10
141544,187,"GRĂDINIȚA HOROATU CRASNEI","HOROATU CRASNEI",SJ,771,1,3,0,4,3,4,0,7,8,6,0,14,12,6,0,18,12,6,0,18
141553,188,"ȘCOALA HUREZ",HUREZ,SJ,280,2,4,0,6,2,9,0,11,2,9,0,11,3,10,0,13,4,12,0,16
141624,189,"ŞCOALA GENERALĂ",DĂBÎCENI,SJ,157,3,0,0,3,5,0,0,5,8,1,0,9,10,1,0,11,13,1,0,14
141660,190,"ŞCOALA GENERALĂ",NEGRENI,SJ,85,0,0,0,0,3,1,0,4,4,1,0,5,7,1,0,8,7,2,0,9
141679,191,"ŞCOALA GENERALĂ","PERII VADULUI",SJ,95,1,0,0,1,4,0,0,4,4,0,0,4,5,0,0,5,7,0,0,7
141688,192,"ŞCOALA GENERALĂ",PODIŞU,SJ,115,0,2,0,2,0,2,0,2,1,2,0,3,2,2,0,4,2,2,0,4
141697,193,"ŞCOALA GENERALĂ",RĂSTOCI,SJ,111,2,1,0,3,2,2,0,4,4,1,0,5,7,1,0,8,9,1,0,10
141704,194,"ŞCOALA GENERALĂ",ROGNA,SJ,60,1,5,0,6,1,6,0,7,1,6,0,7,3,6,0,9,3,6,0,9
141713,195,"ŞCOALA GENERALĂ",ŞASA,SJ,49,0,0,0,0,2,3,0,5,3,4,0,7,3,5,0,8,4,5,0,9
141599,196,"PIATA AGROALIMENTARA ILEANDA",ILEANDA,SJ,1012,8,0,0,8,20,2,0,22,23,7,0,30,28,8,0,36,33,8,0,41
141633,197,"ŞCOALA GENERALĂ DOLHENI",DOLHENI,SJ,78,1,1,0,2,2,1,0,3,3,1,0,4,4,3,0,7,4,3,0,7
141642,198,"ŞCOALA GENERALĂ LUMINIŞU",LUMINIŞU,SJ,75,75,1,0,76,0,1,0,1,0,2,0,2,2,4,0,6,4,4,0,8
141731,199,"CERCUL GOSPODARILOR",IP,SJ,1443,3,0,0,3,10,2,0,12,12,2,0,14,15,3,0,18,17,3,0,20
141740,200,"ȘCOALA GIMAZIALĂ COSNICIU DE JOS","COSNICIU DE JOS",SJ,521,1,2,0,3,4,3,0,7,7,3,0,10,9,4,0,13,14,4,0,18
141759,201,"CĂMINUL CULTURAL","COSNICIU DE SUS",SJ,249,1,0,0,1,3,0,0,3,9,0,0,9,10,0,0,10,10,0,0,10
141768,202,"CĂMINUL CULTURAL ZĂUAN",ZĂUAN,SJ,813,0,0,0,0,3,0,0,3,5,0,0,5,9,0,0,9,10,0,0,10
141795,203,"PRIMĂRIA COMUNEI LETCA",LETCA,SJ,439,1,0,0,1,3,1,0,4,3,1,0,4,4,1,0,5,7,1,0,8
141802,204,"CLĂDIREA FOSTULUI CONSILIU CIULA",CIULA,SJ,79,0,0,0,0,0,2,0,2,3,2,0,5,5,2,0,7,5,2,0,7
141811,205,"ŞCOALA COZLA",COZLA,SJ,200,2,3,0,5,3,5,0,8,3,5,0,8,9,5,0,14,10,5,0,15
141820,206,"ŞCOALA CUCIULAT",CUCIULAT,SJ,141,2,1,0,3,4,1,0,5,6,1,0,7,13,2,0,15,14,2,0,16
141839,207,"ŞCOALA LEMNIU",LEMNIU,SJ,351,2,1,0,3,6,2,0,8,8,2,0,10,15,7,0,22,17,7,0,24
141848,208,"ŞCOALA PURCĂREŢ",PURCĂREŢ,SJ,85,1,0,0,1,1,1,0,2,2,3,0,5,2,4,0,6,5,4,0,9
141857,209,"ŞCOALA ŞOIMUŞENI",ŞOIMUŞENI,SJ,58,0,1,0,1,0,2,0,2,3,6,0,9,8,6,0,14,8,6,0,14
141866,210,"ŞCOALA TOPLIŢA",TOPLIŢA,SJ,96,1,0,0,1,4,0,0,4,4,0,0,4,9,2,0,11,10,3,0,13
141875,211,"ŞCOALA VĂLIŞOARA",VĂLIŞOARA,SJ,22,0,0,0,0,0,0,0,0,0,2,0,2,1,2,0,3,1,2,0,3
141900,212,"ȘCOALA CU CLASELE I-IV CORMENIȘ",CORMENIŞ,SJ,153,0,0,0,0,0,0,0,0,7,5,0,12,15,6,0,21,17,6,0,23
141937,213,"ȘCOALA CU CLASELE I-IVVALEA LOZNEI","VALEA LOZNEI",SJ,153,0,0,0,0,1,0,0,1,3,2,0,5,5,2,0,7,5,2,0,7
141893,214,"PRIMĂRIA COMUNEI LOZNA",LOZNA,SJ,478,4,1,0,5,10,3,0,13,14,5,0,19,18,5,0,23,22,5,0,27
141955,215,"PRIMĂRIA VECHE MARCA",MARCA,SJ,1152,15,2,0,17,18,5,0,23,21,6,0,27,37,8,0,45,42,8,0,50
141982,216,"ŞCOALA PRIMARĂ PORŢ",PORŢ,SJ,234,2,0,0,2,6,1,0,7,6,1,0,7,7,4,0,11,7,5,0,12
141964,217,"ŞCOALA PRIMARĂ LEŞMIR",LEŞMIR,SJ,339,0,1,0,1,1,1,0,2,1,1,0,2,3,1,0,4,3,1,0,4
141991,218,"CĂMINUL CULTURAL ŞUMAL",ŞUMAL,SJ,417,0,0,0,0,2,0,0,2,2,0,0,2,3,0,0,3,3,0,0,3
142015,219,"ŞCOALA GIMNAZIALĂ MĂERIȘTE",MĂERIŞTE,SJ,610,4,2,0,6,5,2,0,7,7,3,0,10,8,4,0,12,8,5,0,13
142042,220,"ŞCOALA GIMNAZIALĂ GIURTELECU ȘIMLEULUI","GIURTELECU ŞIMLEULUI",SJ,715,2,0,0,2,6,2,0,8,7,2,0,9,8,2,0,10,8,3,0,11
142024,221,"ŞCOALA CU CLASELE I-IV CRIȘTELEC",CRIŞTELEC,SJ,419,2,0,0,2,2,0,0,2,3,0,0,3,9,1,0,10,24,3,0,27
142033,222,"ŞCOALA CU CLASELE I-IV DOH",DOH,SJ,176,1,6,0,7,2,6,0,8,2,6,0,8,4,6,0,10,4,6,0,10
142051,223,"ŞCOALA CU CLASELE I-IV MĂLĂDIA",MĂLĂDIA,SJ,157,0,0,0,0,2,0,0,2,2,0,0,2,3,0,0,3,3,0,0,3
142060,224,"ŞCOALA CU CLASELE I-IV UILEACU ȘIMLEULUI","UILEACU ŞIMLEULUI",SJ,373,0,0,0,0,7,1,0,8,9,1,0,10,11,1,0,12,12,1,0,13
142088,225,"PRIMĂRIA COMUNEI MESEŞENII DE JOS","MESEŞENII DE JOS",SJ,545,5,1,0,6,7,1,0,8,13,1,0,14,15,4,0,19,16,4,0,20
142097,226,"CENTRUL AFTER SCHOOL",AGHIREŞ,SJ,1195,6,0,0,6,14,0,0,14,20,0,0,20,32,2,0,34,34,3,0,37
142104,227,"ŞCOALA GIMNAZIALĂ FETINDIA",FETINDIA,SJ,156,4,0,0,4,5,0,0,5,5,1,0,6,6,2,0,8,6,2,0,8
142113,228,"CENTRUL DE ZI","MESEŞENII DE SUS",SJ,660,1,3,0,4,4,3,0,7,6,3,0,9,7,3,0,10,13,3,0,16
142131,229,"SALA DE ŞEDINŢE A PRIMĂRIEI",MIRŞID,SJ,546,6,1,0,7,10,1,0,11,12,2,0,14,18,2,0,20,23,2,0,25
142140,230,"ŞCOALA CU CLASEI-IV",FIRMINIŞ,SJ,121,2,2,0,4,2,3,0,5,2,3,0,5,2,3,0,5,2,3,0,5
142159,231,"ŞCOALA CU CLASEI-IV",MOIGRAD-POROLISSUM,SJ,445,4,2,0,6,5,2,0,7,6,2,0,8,9,2,0,11,9,2,0,11
142168,232,"ŞCOALA CU CLASEI-IV",POPENI,SJ,749,4,1,0,5,10,2,0,12,17,3,0,20,21,5,0,26,24,5,0,29
142186,233,"PRIMĂRIA NĂPRADEA",NĂPRADEA,SJ,653,7,1,0,8,9,1,0,10,12,1,0,13,18,2,0,20,19,3,0,22
142195,234,"ŞCOALA GIMNAZIALĂ""PETRE HOSSU''",CHEUD,SJ,697,7,2,0,9,10,4,0,14,17,4,0,21,22,4,0,26,25,5,0,30
142202,235,ŞCOALASOMEŞGURUSLĂU,SOMEŞ-GURUSLĂU,SJ,359,0,0,0,0,1,1,0,2,1,1,0,2,1,2,0,3,2,6,0,8
142211,236,ŞCOALATRANIŞ,TRANIŞ,SJ,282,4,1,0,5,6,1,0,7,6,4,0,10,7,4,0,11,11,4,0,15
142220,237,ŞCOALAVĂDURELE,VĂDURELE,SJ,164,1,0,0,1,2,0,0,2,2,0,0,2,3,3,0,6,3,3,0,6
142257,238,"CĂMINUL CULTURAL",BILGHEZ,SJ,342,1,1,0,2,1,1,0,2,2,1,0,3,3,1,0,4,12,2,0,14
142248,239,"CENTRUL DE INFORMARE TURISTICĂ",NUŞFALĂU,SJ,1287,2,0,0,2,10,0,0,10,15,0,0,15,20,0,0,20,28,0,0,28
142248,240,"PRIMĂRIA NUȘFALĂU - SALA DE ȘEDINȚE",NUŞFALĂU,SJ,1421,12,1,0,13,20,2,0,22,37,4,0,41,47,18,0,65,53,18,0,71
142293,241,"GRĂDINIȚA CU PROGRAM PRELUNGIT NR.1 PERICEI",PERICEI,SJ,1093,0,0,0,0,0,0,0,0,4,0,0,4,4,0,0,4,4,0,0,4
142293,242,"PRIMĂRIA COMUNEI PERICEI",PERICEI,SJ,1255,5,1,0,6,8,2,0,10,17,4,0,21,19,4,0,23,23,4,0,27
142300,243,"ȘCOALA GENERALĂ BĂDĂCIN",BĂDĂCIN,SJ,586,3,0,0,3,5,2,0,7,9,6,0,15,12,8,0,20,12,8,0,20
142328,244,"CENTRU DE INFORMARE ȘI MARKETING TURISTIC",SICI,SJ,156,7,3,0,10,10,3,0,13,10,6,0,16,11,6,0,17,12,6,0,18
142346,245,"CĂMINUL CULTURAL PLOPIȘ",PLOPIŞ,SJ,823,0,0,0,0,2,0,0,2,4,1,0,5,5,1,0,6,5,1,0,6
142364,246,"CENTRUL CULTURAL IAZ",IAZ,SJ,605,1,0,0,1,3,0,0,3,6,0,0,6,8,1,0,9,11,1,0,12
142355,247,"CĂMINUL CULTURAL FĂGETU",FĂGETU,SJ,533,0,0,0,0,1,2,0,3,22,8,0,30,26,9,0,35,30,10,0,40
142382,248,"ŞCOALA GIMNAZIALĂ POIANA BLENCHII","POIANA BLENCHII",SJ,606,4,0,0,4,8,0,0,8,13,1,0,14,16,1,0,17,19,1,0,20
142408,249,"ŞCOALA CU CLASELE I-IV GOSTILA",GOSTILA,SJ,335,10,2,0,12,12,2,0,14,19,5,0,24,24,6,0,30,25,7,0,32
142435,250,"ȘCOALA CU CLASELE I-VIII ROMÂNAȘI",ROMÂNAŞI,SJ,794,8,3,0,11,11,4,0,15,13,4,0,17,18,7,0,25,25,8,0,33
142444,251,"ȘCOALA CU CLASELE I-IV CHICHIȘA",CHICHIŞA,SJ,186,3,1,0,4,5,1,0,6,7,1,0,8,7,1,0,8,7,3,0,10
142453,252,"ȘCOALA CU CLASELE I-IV CIUMĂRNA",CIUMĂRNA,SJ,339,4,0,0,4,8,1,0,9,13,2,0,15,15,3,0,18,17,5,0,22
142462,253,"ȘCOALA CU CLASELE I-IV PĂUȘA",PĂUŞA,SJ,403,2,0,0,2,8,1,0,9,9,1,0,10,12,3,0,15,14,5,0,19
142471,254,"ȘCOALA CU CLASELE I-IV POARTA SĂLAJULUI","POARTA SĂLAJULUI",SJ,385,0,5,0,5,5,5,0,10,7,6,0,13,9,6,0,15,10,6,0,16
142480,255,"ȘCOALA CU CLASELE I-IV ROMITA",ROMITA,SJ,246,1,0,0,1,2,0,0,2,2,0,0,2,8,0,0,8,9,0,0,9
142505,256,"ŞCOALA GIMNAZIALĂ RUS",RUS,SJ,610,15,1,0,16,40,1,0,41,42,1,0,43,44,1,0,45,44,1,0,45
142523,257,"ŞCOALA PRIMARĂ FÎNTÎNELE-RUS",FÎNTÎNELE-RUS,SJ,151,2,0,0,2,11,5,0,16,11,5,0,16,13,7,0,20,13,8,0,21
142514,258,"ŞCOALA PRIMARĂ BUZAŞ",BUZAŞ,SJ,114,1,0,0,1,5,2,0,7,5,2,0,7,8,2,0,10,8,2,0,10
142569,259,"ȘCOALA GIMNAZIALĂ ”PETRE DULFU” SĂLĂȚIG",SĂLĂŢIG,SJ,407,0,0,0,0,2,0,0,2,4,0,0,4,5,0,0,5,7,0,0,7
142578,260,"ȘCOALA PRIMARĂ BULGARI",BULGARI,SJ,193,0,0,0,0,2,0,0,2,2,0,0,2,4,1,0,5,6,1,0,7
142587,261,"ȘCOALA GIMNAZIALĂ DEJA",DEJA,SJ,989,3,0,0,3,5,0,0,5,6,4,0,10,9,6,0,15,9,6,0,15
142596,262,"ȘCOALA PRIMARĂ MINEU",MINEU,SJ,271,7,1,0,8,8,1,0,9,10,2,0,12,10,5,0,15,12,5,0,17
142603,263,"ȘCOALA PRIMARĂ NOȚIG",NOŢIG,SJ,384,8,0,0,8,9,0,0,9,13,0,0,13,16,1,0,17,16,1,0,17
142621,264,"PRIMĂRIA SÎG",SÎG,SJ,576,3,0,0,3,4,0,0,4,8,0,0,8,8,0,0,8,11,0,0,11
142630,265,"CĂMINUL CULTURAL FIZEȘ",FIZEŞ,SJ,278,1,2,0,3,2,2,0,4,4,2,0,6,5,4,0,9,7,4,0,11
142649,266,"CĂMINUL CULTURAL MAL",MAL,SJ,888,4,3,0,7,5,3,0,8,8,5,0,13,9,5,0,14,11,6,0,17
142658,267,"ȘCOALA PRIMARĂ SÎRBI",SÎRBI,SJ,219,2,0,0,2,2,2,0,4,2,2,0,4,4,3,0,7,7,4,0,11
142667,268,"CĂMINUL CULTURAL TUSA",TUSA,SJ,563,0,0,0,0,5,1,0,6,6,1,0,7,9,2,0,11,10,3,0,13
142685,269,"SEDIUL CONSILIU LOCALSÎNMIHAIU ALMAŞULUI","SÎNMIHAIU ALMAŞULUI",SJ,884,2,1,0,3,10,3,0,13,23,8,0,31,26,9,0,35,28,12,0,40
142694,270,"IMOBIL PROPRIETATE PRIVATA",BERCEA,SJ,131,0,0,0,0,4,0,0,4,5,0,0,5,9,0,0,9,10,0,0,10
142701,271,"ŞCOALA CU CLASELE I - IV SÎNTĂ MĂRIA","SÎNTĂ MĂRIA",SJ,314,1,0,0,1,3,0,0,3,5,0,0,5,6,0,0,6,6,0,0,6
142729,272,"CĂMINUL CULTURALSOMEȘ-ODORHEI",SOMEŞ-ODORHEI,SJ,1110,4,1,0,5,12,2,0,14,16,2,0,18,18,3,0,21,22,3,0,25
142756,273,"CĂMINUL CULTURALINĂU",INĂU,SJ,490,1,4,0,5,2,4,0,6,4,7,0,11,5,7,0,12,7,7,0,14
142765,274,"CĂMINUL CULTURALȘOIMUȘ",ŞOIMUŞ,SJ,255,6,0,0,6,6,2,0,8,9,5,0,14,12,7,0,19,13,7,0,20
142738,275,ȘCOALAPRIMARĂBÎRSA,BÎRSA,SJ,87,1,0,0,1,3,0,0,3,4,4,0,8,4,9,0,13,4,9,0,13
142747,276,ȘCOALAPRIMARĂDOMNIN,DOMNIN,SJ,261,4,0,0,4,9,1,0,10,9,1,0,10,9,1,0,10,12,2,0,14
142783,277,"CĂMINUL CULTURAL SURDUC",SURDUC,SJ,1082,17,2,0,19,27,2,0,29,33,2,0,35,42,6,0,48,46,6,0,52
142792,278,"CĂMINUL CULTURAL BRÎGLEZ",BRÎGLEZ,SJ,225,4,0,0,4,6,0,0,6,6,3,0,9,9,3,0,12,12,3,0,15
142809,279,"ȘCOALA PRIMARĂ CLASELE I-IV CRISTOLȚEL",CRISTOLŢEL,SJ,360,1,0,0,1,5,0,0,5,6,0,0,6,6,1,0,7,9,1,0,10
142818,280,"CĂMINUL CULTURAL SOLONA",SOLONA,SJ,194,0,0,0,0,2,5,0,7,3,5,0,8,3,6,0,9,4,6,0,10
142827,281,"CĂMINUL CULTURAL TEȘTIOARA",TEŞTIOARA,SJ,65,2,1,0,3,5,2,0,7,7,5,0,12,9,6,0,15,9,8,0,17
142836,282,"CĂMINUL CULTURAL TIHĂU",TIHĂU,SJ,888,7,0,0,7,15,1,0,16,20,3,0,23,33,4,0,37,43,7,0,50
142845,283,"ȘCOALA PRIMARĂ CLASELE I-IV TURBUȚA",TURBUŢA,SJ,244,3,3,0,6,3,3,0,6,4,3,0,7,6,3,0,9,6,6,0,12
142863,284,"PRIMĂRIA COMUNEI ŞAMŞUD",ŞAMŞUD,SJ,910,4,0,0,4,15,6,0,21,20,7,0,27,26,8,0,34,27,8,0,35
142872,285,"FOSTA GRĂDINIŢĂ CU PROGRAM NORMAL","VALEA POMILOR",SJ,471,4,0,0,4,10,0,0,10,12,0,0,12,17,3,0,20,17,3,0,20
142890,286,"CENTRUL CULTURAL COMUNITAR ȘĂRMĂȘAG",ŞĂRMĂŞAG,SJ,946,2,5,0,7,2,5,0,7,8,5,0,13,8,5,0,13,11,5,0,16
142890,287,"LICEUL TEHNOLOGIC NR.1 ȘĂRMĂȘAG",ŞĂRMĂŞAG,SJ,834,0,0,0,0,2,0,0,2,4,0,0,4,6,0,0,6,8,0,0,8
142890,288,"GRĂDINIȚADE COPII NR.3 ȘĂRMĂȘAG",ŞĂRMĂŞAG,SJ,886,2,0,0,2,3,0,0,3,5,0,0,5,7,0,0,7,9,0,0,9
142890,289,"ȘCOALA GENERALĂ NR.2 ȘĂRMĂȘAG",ŞĂRMĂŞAG,SJ,1232,6,0,0,6,11,1,0,12,18,1,0,19,24,1,0,25,28,1,0,29
142907,290,"ȘCOALA GENERALĂ ""SELYMES PETER""ILIȘUA",ILIŞUA,SJ,573,2,0,0,2,4,0,0,4,4,0,0,4,5,0,0,5,5,0,0,5
142916,291,"ȘCOALA GENERALĂ ""ADY ENDRE"" LOMPIRT",LOMPIRT,SJ,689,0,0,0,0,1,0,0,1,1,0,0,1,1,0,0,1,4,0,0,4
142925,292,"CĂMINUL CULTURAL MOIAD",MOIAD,SJ,184,2,0,0,2,4,0,0,4,8,0,0,8,9,0,0,9,10,0,0,10
142541,293,"ȘCOALA GIMNAZIALĂ ȘIMIȘNA",ŞIMIŞNA,SJ,719,3,0,0,3,9,1,0,10,13,2,0,15,16,4,0,20,18,4,0,22
142532,294,"CĂMINUL CULTURAL HĂȘMAȘ",HĂŞMAŞ,SJ,238,4,4,0,8,10,5,0,15,11,5,0,16,11,5,0,16,11,6,0,17
139973,295,"ȘCOALA GIMNAZIALĂ TREZNEA",TREZNEA,SJ,640,6,0,0,6,10,0,0,10,12,1,0,13,13,5,0,18,17,5,0,22
139955,296,"ȘCOALA GENERALĂ BOZNA",BOZNA,SJ,191,0,0,0,0,2,1,0,3,4,2,0,6,5,2,0,7,5,2,0,7
142961,297,"ȘCOALA GIMNAZIALĂ CU CLASELE I-VIII","VALCĂU DE JOS",SJ,736,6,1,0,7,12,2,0,14,16,2,0,18,21,2,0,23,29,4,0,33
143012,298,"ȘCOALA GIMNAZIALĂ","VALCĂU DE SUS",SJ,708,3,0,0,3,8,2,0,10,8,2,0,10,15,2,0,17,15,2,0,17
142989,299,"ȘCOALA GIMNAZIALĂ",PREOTEASA,SJ,510,1,0,0,1,2,1,0,3,3,1,0,4,6,1,0,7,9,1,0,10
142970,300,GRĂDINIȚA,LAZURI,SJ,210,0,0,0,0,1,0,0,1,1,0,0,1,3,0,0,3,7,0,0,7
143003,301,"ȘCOALA CU CLASELE I-IV","SUB CETATE",SJ,296,2,0,0,2,3,1,0,4,3,1,0,4,4,1,0,5,7,1,0,8
143030,302,"PRIMĂRIA COMUNEI VÎRȘOLȚ",VÎRŞOLŢ,SJ,1415,2,2,0,4,8,2,0,10,9,4,0,13,10,4,0,14,11,5,0,16
143049,303,"CĂMINUL CULTURAL RECEA",RECEA,SJ,484,5,3,0,8,12,3,0,15,15,3,0,18,17,3,0,20,18,3,0,21
143076,304,"ȘCOALA GIMNAZIALĂ NR.1 ZALHA",ZALHA,SJ,227,4,0,0,4,6,0,0,6,8,0,0,8,9,0,0,9,9,0,0,9
143085,305,"ȘCOALA CU CLASELE I-IV CEACA",CEACA,SJ,175,8,2,0,10,9,2,0,11,12,2,0,14,12,2,0,14,12,2,0,14
143110,306,"ȘCOALA CU CLASELE I-IV VALEA HRANEI","VALEA HRANEI",SJ,66,1,0,0,1,3,0,0,3,3,4,0,7,4,6,0,10,4,6,0,10
143094,307,"ȘCOALA CU CLASELE I-IV CIURENI",CIURENI,SJ,112,1,0,0,1,2,4,0,6,4,5,0,9,4,5,0,9,4,5,0,9
143129,308,"ȘCOALA CU CLASELE I-IV VALEA LUNGĂ","VALEA LUNGĂ",SJ,119,0,0,0,0,0,0,0,0,0,0,0,0,3,0,0,3,3,0,0,3
143174,309,"CĂMINUL CULTURAL DOLU",DOLU,SJ,48,0,0,0,0,0,1,0,1,2,1,0,3,5,1,0,6,5,1,0,6
143183,310,"CĂMINUL CULTURAL SUTORU",SUTORU,SJ,105,4,4,0,8,9,4,0,13,11,4,0,15,15,6,0,21,16,6,0,22
143156,311,"PRIMĂRIA COMUNEI ZIMBOR",ZIMBOR,SJ,504,2,1,0,3,7,4,0,11,8,4,0,12,9,4,0,13,9,4,0,13
143192,312,"ȘCOALA PRIMARĂ SÎNCRAIU ALMAȘULUI","SÎNCRAIU ALMAŞULUI",SJ,145,4,0,0,4,6,0,0,6,7,0,0,7,8,0,0,8,9,0,0,9
136492,1,"GRADINITA CU PROGRAM PRELUNGIT ""DRAGA MEA"" (GRADINITA ""DRAGA MEA""(","SATU MARE",SM,1736,3,2,0,5,19,3,0,22,29,4,0,33,39,5,0,44,43,6,0,49
136492,2,"GRADINITA CU PROGRAM PRELUNGIT ""DRAGA MEA"" (GRADINITA ""DRAGA MEA""(","SATU MARE",SM,1738,6,5,0,11,25,6,0,31,43,7,0,50,50,9,0,59,62,10,0,72
136492,3,"ASOCIAŢIA CARITAS SATU MARE CANTRUL SOCIAL DESCHIS LA CASA PRIETENIEI","SATU MARE",SM,1076,12,1,0,13,21,1,0,22,30,3,0,33,49,3,0,52,54,4,0,58
136492,4,"ȘCOALA GIMNAZIALĂ “ ION CREANGĂ ”(ŞC. CU CLS.I-VIII“ ION CREANGĂ ”)","SATU MARE",SM,1384,8,1,0,9,24,1,0,25,42,1,0,43,48,1,0,49,55,1,0,56
136492,5,"ȘCOALA GIMNAZIALĂ “ ION CREANGĂ ”(ŞC. CU CLS.I-VIII“ ION CREANGĂ ”)","SATU MARE",SM,1250,4,0,0,4,20,0,0,20,35,0,0,35,45,1,0,46,54,1,0,55
136492,6,"ȘCOALA GIMNAZIALĂ “ ION CREANGĂ ”(ŞC. CU CLS.I-VIII“ ION CREANGĂ ”)","SATU MARE",SM,1234,8,0,0,8,23,0,0,23,39,0,0,39,48,0,0,48,55,2,0,57
136492,7,"ȘCOALA GIMNAZIALĂ “ ION CREANGĂ ”(ŞC. CU CLS.I-VIII“ ION CREANGĂ ”)","SATU MARE",SM,1527,10,0,0,10,21,2,0,23,34,2,0,36,42,3,0,45,44,3,0,47
136492,8,"ȘCOALA GIMNAZIALĂ “ LUCIAN BLAGA ” (ŞC. CU CLS.I-VIII “ LUCIAN BLAGA ”)","SATU MARE",SM,1411,15,1,0,16,26,1,0,27,41,2,0,43,45,5,0,50,59,7,0,66
136492,9,"ȘCOALA GIMNAZIALĂ “ LUCIAN BLAGA ” (ŞC. CU CLS.I-VIII “ LUCIAN BLAGA ”)","SATU MARE",SM,1279,7,0,0,7,13,0,0,13,23,0,0,23,34,0,0,34,39,0,0,39
136492,10,"ȘCOALA GIMNAZIALĂ “ LUCIAN BLAGA ” (ŞC. CU CLS.I-VIII “ LUCIAN BLAGA ”)","SATU MARE",SM,1189,9,0,0,9,18,3,0,21,24,3,0,27,37,3,0,40,41,3,0,44
136492,11,"ȘCOALA GIMNAZIALĂ “ LUCIAN BLAGA ” (ŞC. CU CLS.I-VIII “ LUCIAN BLAGA ”)","SATU MARE",SM,1345,6,0,0,6,23,2,0,25,29,2,0,31,42,2,0,44,43,2,0,45
136492,12,"ȘCOALA GIMNAZIALĂ “ OCTAVIAN GOGA “ (ŞC. CU CLS.I-VIII“ OCTAVIAN GOGA ”)","SATU MARE",SM,1293,7,0,0,7,12,0,0,12,21,0,0,21,23,9,0,32,30,9,0,39
136492,13,"ȘCOALA GIMNAZIALĂ “ OCTAVIAN GOGA “ (ŞC. CU CLS.I-VIII“ OCTAVIAN GOGA ”)","SATU MARE",SM,1226,7,0,0,7,30,3,0,33,37,4,0,41,49,4,0,53,53,5,0,58
136492,14,"ȘCOALA GIMNAZIALĂ “ OCTAVIAN GOGA “ (ŞC. CU CLS.I-VIII“ OCTAVIAN GOGA ”)","SATU MARE",SM,1431,10,1,0,11,18,1,0,19,29,1,0,30,44,4,0,48,48,4,0,52
136492,15,"ȘCOALA GIMNAZIALĂ “ OCTAVIAN GOGA “ (ŞC. CU CLS.I-VIII“ OCTAVIAN GOGA ”)","SATU MARE",SM,1548,10,0,0,10,23,0,0,23,31,0,0,31,46,0,0,46,50,0,0,50
136492,16,"GRĂDINIŢA CU PROGRAM NORMAL NR.21","SATU MARE",SM,1375,4,0,0,4,15,0,0,15,28,0,0,28,39,0,0,39,44,0,0,44
136492,17,"GRĂDINIŢA CU PROGRAM NORMAL NR.21","SATU MARE",SM,1679,4,0,0,4,18,0,0,18,23,0,0,23,47,0,0,47,59,0,0,59
136492,18,"UNIVERSITATEA TEHNICĂ CLUJ NAPOCA - FILIALA SATU MARE (GRĂDINIŢA CU PROGRAM NORMAL NR.21)","SATU MARE",SM,1687,11,1,0,12,40,2,0,42,57,3,0,60,84,4,0,88,88,4,0,92
136492,19,"UNIVERSITATEA TEHNICĂ CLUJ NAPOCA - FILIALA SATU MARE (GRĂDINIŢA CU PROGRAM NORMAL NR.21)","SATU MARE",SM,1568,13,4,0,17,25,6,0,31,44,6,0,50,58,7,0,65,61,8,0,69
136492,20,"ŞC. CU CLS.I-VIII NR. 9","SATU MARE",SM,1209,6,2,0,8,24,5,0,29,40,5,1,46,52,7,1,60,61,9,1,71
136492,21,"LICEUL TEORETIC GERMAN“ JOHANN ETTINGER ”","SATU MARE",SM,1807,9,0,0,9,19,3,0,22,28,5,0,33,34,6,0,40,35,6,0,41
136492,22,"COLEGIUL TEHNIC"" ELISA ZAMFIRESCU "" (COL.TEHNIC ELISA ZAMFIRESCU(GRUP ŞC. DE INDUSTRIE UŞOARĂ ))","SATU MARE",SM,1475,9,0,0,9,22,0,0,22,33,5,0,38,50,5,0,55,58,5,0,63
136492,23,"ȘCOALA GIMNAZIALĂ “ MIRCEA ELIADE ” ( ŞC. CU CLS.I-VIII“ MIRCEA ELIADE ”)","SATU MARE",SM,1473,21,0,0,21,56,1,0,57,67,2,0,69,73,3,0,76,75,3,0,78
136492,24,"ȘCOALA GIMNAZIALĂ “ MIRCEA ELIADE ” ( ŞC. CU CLS.I-VIII“ MIRCEA ELIADE ”)","SATU MARE",SM,1676,12,0,0,12,32,0,0,32,39,0,0,39,61,1,0,62,68,1,0,69
136492,25,"ȘCOALA GIMNAZIALĂ “ MIRCEA ELIADE ” ( ŞC. CU CLS.I-VIII“ MIRCEA ELIADE ”)","SATU MARE",SM,1400,3,6,0,9,8,6,0,14,13,6,0,19,33,6,0,39,38,6,0,44
136492,26,"ȘCOALA GIMNAZIALĂ “ MIRCEA ELIADE ” ( ŞC. CU CLS.I-VIII“ MIRCEA ELIADE ”)","SATU MARE",SM,1229,9,1,0,10,30,1,0,31,48,1,1,50,62,1,1,64,63,2,1,66
136492,27,"GRĂDINIŢA CU PROGRAM PRELUNGIT NR. 9","SATU MARE",SM,1311,9,4,0,13,32,4,0,36,52,9,0,61,60,9,0,69,62,9,0,71
136492,28,"GRĂDINIŢA CU PROGRAM PRELUNGIT NR. 9","SATU MARE",SM,1416,13,1,0,14,19,1,0,20,25,1,0,26,37,1,0,38,39,1,0,40
136492,29,"ȘCOALA GIMNAZIALĂ “ BĂLCESCU-PETOFI ” (ŞC. CU CLS.I-VIII “ BĂLCESCU-PETOFI ”)","SATU MARE",SM,1409,14,0,0,14,27,0,0,27,48,2,0,50,57,2,0,59,63,2,0,65
136492,30,"ȘCOALA GIMNAZIALĂ “ BĂLCESCU-PETOFI ” (ŞC. CU CLS.I-VIII “ BĂLCESCU-PETOFI ”)","SATU MARE",SM,1924,14,0,0,14,26,0,0,26,36,0,0,36,51,0,0,51,53,0,0,53
136492,31,"ȘCOALA GIMNAZIALĂ “ BĂLCESCU-PETOFI ” (ŞC. CU CLS.I-VIII “ BĂLCESCU-PETOFI ”)","SATU MARE",SM,1359,11,4,0,15,29,4,0,33,49,4,0,53,61,4,0,65,66,4,0,70
136492,32,"GRĂDINIŢA CU PROGRAM PRELUNGIT NR.13","SATU MARE",SM,1296,5,0,0,5,20,2,0,22,34,2,0,36,57,3,0,60,63,5,0,68
136492,33,"GRĂDINIŢA CU PROGRAM PRELUNGIT NR. 5","SATU MARE",SM,1166,7,0,0,7,16,2,0,18,23,3,0,26,31,5,0,36,31,5,0,36
136492,34,"GRĂDINIŢA CU PROGRAM PRELUNGIT NR. 5","SATU MARE",SM,1352,10,1,0,11,18,1,0,19,28,1,0,29,40,3,0,43,45,4,0,49
136492,35,"ȘCOALA GIMNAZIALĂ “ AVRAM IANCU ”(ŞC. CU CLS.I-VIII“ AVRAM IANCU ”) (GRĂDINIŢA CU PROGRAM PRELUNGIT ""VOINICELUL"" CORP “ B “)","SATU MARE",SM,1223,12,0,0,12,20,0,0,20,30,0,0,30,50,0,0,50,56,0,0,56
136492,36,"ȘCOALA GIMNAZIALĂ “ AVRAM IANCU ” ( ŞC. CU CLS.I-VIII “ AVRAM IANCU ”)","SATU MARE",SM,1216,10,0,0,10,32,3,0,35,52,3,0,55,65,7,0,72,71,8,0,79
136492,37,"ȘCOALA GIMNAZIALĂ “ AVRAM IANCU ”(ŞC. CU CLS.I-VIII“ AVRAM IANCU ”)","SATU MARE",SM,1339,4,0,0,4,24,0,0,24,32,1,0,33,49,1,0,50,54,5,0,59
136492,38,"ȘCOALA GIMNAZIALĂ “ AVRAM IANCU ”(ŞC. CU CLS.I-VIII“ AVRAM IANCU ”)","SATU MARE",SM,1495,6,0,0,6,31,1,0,32,50,1,0,51,61,1,0,62,65,1,0,66
136492,39,"ȘCOALA GIMNAZIALĂ “ AVRAM IANCU ”(ŞC. CU CLS.I-VIII“ AVRAM IANCU ”)","SATU MARE",SM,1323,6,0,0,6,15,1,0,16,27,1,0,28,39,2,0,41,39,2,0,41
136492,40,"ȘCOALA GIMNAZIALĂ “ AVRAM IANCU ”(ŞC. CU CLS.I-VIII“ AVRAM IANCU ”) (GRĂDINIŢA CU PROGRAM PRELUNGIT ''VOINICELUL"")","SATU MARE",SM,1358,7,0,0,7,15,0,0,15,21,0,0,21,32,0,0,32,33,0,0,33
136492,41,"LICEUL TEHNOLOGIC IND.ALIM "" GEORGE EMIL PALADE "". ( GRUPUL ŞCOLAR DE IND. ALIMENTARĂ ""GEORGE EMIL PALADE"" )","SATU MARE",SM,1395,9,0,0,9,29,0,0,29,43,3,0,46,58,3,0,61,61,3,0,64
136492,42,"LICEUL TEHNOLOGIC IND.ALIM "" GEORGE EMIL PALADE "". ( GRUPUL ŞCOLAR DE IND. ALIMENTARĂ ""GEORGE EMIL PALADE"" )","SATU MARE",SM,1452,9,0,0,9,13,1,0,14,22,2,0,24,37,3,0,40,53,3,0,56
136492,43,"LICEUL TEHNOLOGIC IND.ALIM "" GEORGE EMIL PALADE "". ( GRUPUL ŞCOLAR DE IND. ALIMENTARĂ ""GEORGE EMIL PALADE"" )","SATU MARE",SM,1325,6,0,0,6,18,0,0,18,25,0,0,25,31,0,0,31,32,0,0,32
136492,44,"LICEUL TEHNOLOGIC IND.ALIM "" GEORGE EMIL PALADE "". ( GRUPUL ŞCOLAR DE IND. ALIMENTARĂ ""GEORGE EMIL PALADE"" )","SATU MARE",SM,1566,10,0,0,10,18,0,0,18,35,0,0,35,61,0,0,61,61,0,0,61
136492,45,"LICEUL TEHNOLOGIC IND.ALIM "" GEORGE EMIL PALADE "". ( GRUPUL ŞCOLAR DE IND. ALIMENTARĂ ""GEORGE EMIL PALADE"" )","SATU MARE",SM,1379,4,0,0,4,18,0,0,18,37,0,0,37,52,0,0,52,58,0,0,58
136508,46,"ȘCOALA GIMNAZIALĂ - SĂTMĂREL ( ŞC. CU CLS.I-VIII - SĂTMĂREL)",SĂTMĂREL,SM,1172,2,1,0,3,7,1,0,8,10,1,0,11,15,1,0,16,17,2,0,19
136492,47,"ASOCIAŢIA JUDEŢEANĂ DE FOTBAL ( ŞC. NR.15 )","SATU MARE",SM,1947,16,3,0,19,30,4,0,34,45,7,0,52,53,7,0,60,69,7,0,76
136492,48,"SECŢIA DE DRUMURI NAŢIONALE","SATU MARE",SM,1743,8,0,0,8,15,0,0,15,38,0,0,38,48,0,0,48,54,0,0,54
136492,49,"ȘCOALA GIMNAZIALĂ "" DR. VASILE LUCACIU "" ( SC. CU CL. I-VIII ""DR. V. LUCACIU"" )","SATU MARE",SM,1391,8,7,0,15,19,8,0,27,21,9,0,30,30,11,0,41,35,11,0,46
136492,50,"ȘCOALA GIMNAZIALĂ "" DR. VASILE LUCACIU "" ( SC. CU CL. I-VIII ""DR. V. LUCACIU"" )","SATU MARE",SM,1203,14,0,0,14,25,1,0,26,42,1,0,43,60,1,0,61,60,1,0,61
136492,51,"ȘCOALA GIMNAZIALĂ "" DR. VASILE LUCACIU "" ( SC. CU CL. I-VIII ""DR. V. LUCACIU"" )","SATU MARE",SM,1008,14,3,0,17,17,3,0,20,27,3,0,30,37,3,0,40,40,3,0,43
136492,52,"GRĂDINIŢA NR.15","SATU MARE",SM,1233,8,1,0,9,29,1,0,30,45,1,0,46,56,5,0,61,56,5,0,61
136492,53,"LICEUL TEOLOGIC“NICOLAE STEINHARDT ”","SATU MARE",SM,1583,9,0,0,9,18,1,0,19,33,4,0,37,50,5,0,55,62,6,0,68
136492,54,"LICEUL TEOLOGIC“NICOLAE STEINHARDT ”","SATU MARE",SM,1523,7,0,0,7,21,2,0,23,40,2,0,42,56,2,0,58,62,3,0,65
136492,55,"GRĂDINIŢA CU PROGRAM PRELUNGIT NR.12","SATU MARE",SM,1372,6,0,0,6,15,1,42,58,26,1,42,69,30,6,42,78,31,6,42,79
136492,56,"GRĂDINIŢA CU PROGRAM PRELUNGIT – “ 14 MAI ”","SATU MARE",SM,1613,7,2,0,9,25,4,0,29,34,4,0,38,41,9,0,50,44,9,0,53
136492,57,"GRĂDINIŢA CU PROGRAM PRELUNGIT – “ 14 MAI ”","SATU MARE",SM,1104,8,0,0,8,11,5,0,16,26,6,0,32,37,7,0,44,38,7,0,45
136492,58,"LICEUL TEHNOLOGIC "" CONSTANTIN BRÂNCUȘ ""(GRUP SCOLAR ""CONSTANTIN BRANCUS "" SATU MARE)","SATU MARE",SM,1421,9,0,0,9,35,4,0,39,50,6,0,56,64,8,0,72,66,8,0,74
136492,59,"LICEUL CU PROGRAM SPORTIV","SATU MARE",SM,1210,10,1,0,11,17,1,0,18,35,2,0,37,52,2,0,54,59,2,0,61
136492,60,"ȘCOALA GIMNAZIALĂ “ GRIGORE MOISIL ” (ŞC. CU CLS.I-VIII“ GRIGORE MOISIL ”)","SATU MARE",SM,1163,6,1,0,7,31,2,0,33,46,3,0,49,63,5,0,68,68,6,0,74
136492,61,"ȘCOALA GIMNAZIALĂ “ GRIGORE MOISIL ” (ŞC. CU CLS.I-VIII“ GRIGORE MOISIL ”)","SATU MARE",SM,1039,8,3,0,11,28,4,0,32,39,4,0,43,53,4,0,57,57,5,0,62
136492,62,"COLEGIUL TEHNICDE TRANSP. ŞI TELECOMUNICAŢII “ I.C. BRĂTIANU ”","SATU MARE",SM,1338,9,0,0,9,35,1,0,36,43,1,0,44,55,1,21,77,61,1,21,83
136492,63,"LICEUL TEOLOGIC ROMANO-CATOLIC “ HAM JANOS “ (GRUP ŞC. TEOLOGIC ROM.-CAT. “ HAM JANOS “)","SATU MARE",SM,960,12,1,0,13,36,3,0,39,58,7,0,65,69,9,0,78,74,9,0,83
136492,64,"LICEUL REFORMAT ( LICEUL TEOLOGIC REFORMAT)","SATU MARE",SM,976,4,5,0,9,18,5,0,23,23,6,0,29,37,7,0,44,41,7,0,48
136492,65,"GRĂDINIŢA CU PROG. PRELUNGIT “ DUMBRAVA MINUNATĂ “ (GRĂDINIŢA “DUMBRAVA MINUNATĂ“ )","SATU MARE",SM,1285,5,1,0,6,22,1,0,23,49,4,0,53,59,4,0,63,67,4,0,71
136492,66,"COLEGIUL NAŢIONAL” D-NA STANCA ”","SATU MARE",SM,923,3,9,0,12,17,9,0,26,28,10,0,38,28,12,0,40,28,13,0,41
136492,67,"ȘCOALA GIMNAZIALĂ NR. 10(ŞC. CU CLS.I-VIII NR. 10)","SATU MARE",SM,1213,6,2,0,8,21,3,0,24,33,4,0,37,45,4,0,49,50,5,0,55
136492,68,"ȘCOALA GIMNAZIALĂ NR. 10(ŞC. CU CLS.I-VIII NR. 10)","SATU MARE",SM,1607,12,1,0,13,23,3,0,26,40,4,0,44,60,5,0,65,72,5,0,77
136492,69,"ȘCOALA GIMNAZIALĂ “ C. BRÎNCOVEANU“ (ŞC. CU CLS.I-VIII “ C. BRÎNCOVEANU ”)","SATU MARE",SM,1585,15,1,0,16,57,1,0,58,69,3,0,72,90,6,0,96,99,6,0,105
136492,70,"COLEGIUL NAŢIONAL“ MIHAIEMINESCU ”","SATU MARE",SM,1072,15,0,0,15,41,2,0,43,60,5,0,65,83,5,0,88,85,5,0,90
136492,71,"COLEGIUL ECONOMIC “ GHEORGHE DRAGOŞ ” (GRUP ŞC. ECONOMIC“ GHEORGHE DRAGOŞ ”)","SATU MARE",SM,1533,13,1,5,19,37,7,5,49,54,10,5,69,79,13,5,97,89,13,5,107
136492,72,"GRĂDINIŢA CU PROGRAM PRELUNGIT","SATU MARE",SM,1129,11,0,0,11,26,0,0,26,33,0,0,33,45,1,0,46,48,1,0,49
136492,73,"GRĂDINIŢA CU PROGRAM PRELUNGIT","SATU MARE",SM,1202,7,0,0,7,18,4,0,22,25,6,0,31,38,6,0,44,41,6,0,47
136492,74,"GRĂDINIŢA CU PROGRAM PRELUNGIT","SATU MARE",SM,1130,8,2,0,10,16,2,0,18,25,2,0,27,46,5,0,51,47,6,0,53
136535,75,"LICEUL ROMANO-CATOLIC “JOSEPHUS CALASANTIUS”",CAREI,SM,1622,6,6,0,12,14,10,0,24,25,11,0,36,26,11,0,37,29,11,0,40
136535,76,"COLEGIUL TEHNIC “IULIU MANIU”",CAREI,SM,1388,15,0,0,15,25,0,0,25,30,0,0,30,45,0,0,45,45,0,0,45
136535,77,"LICEUL TEHNOLOGIC “SIMION BĂRNUŢIU”",CAREI,SM,1572,9,5,0,14,19,6,0,25,30,7,0,37,36,7,0,43,39,7,0,46
136535,78,"ŞCOALA GIMNAZIALĂ NR.1",CAREI,SM,1665,7,1,0,8,22,1,0,23,27,1,0,28,35,2,0,37,39,2,0,41
136535,79,"ŞCOALA GIMNAZIALĂ “VASILE LUCACIU” NR.2",CAREI,SM,1784,12,0,0,12,25,1,0,26,31,1,0,32,40,3,0,43,45,3,0,48
136535,80,"GRĂDINIŢA CU PROGRAM NORMAL NR.9",CAREI,SM,1209,7,2,0,9,9,2,0,11,16,3,0,19,22,3,0,25,29,3,0,32
136535,81,"GRĂDINIŢA CU PROGRAM NORMAL NR.10",CAREI,SM,1885,8,0,0,8,32,2,0,34,43,4,0,47,58,5,0,63,65,6,0,71
136535,82,"ŞCOALA GIMNAZIALĂ NR.3",CAREI,SM,1634,10,3,0,13,34,5,0,39,54,5,0,59,54,5,0,59,69,6,0,75
136535,83,"LICEUL TEORETIC CAREI",CAREI,SM,1399,10,6,0,16,19,10,0,29,23,12,0,35,33,12,0,45,33,12,0,45
136535,84,"GRĂDINIŢA CU PROGRAM NORMAL NR.5",CAREI,SM,2089,10,0,0,10,33,7,0,40,40,8,0,48,53,8,0,61,54,8,0,62
136535,85,"GRĂDINIŢA CU PROGRAM NORMAL NR.8",CAREI,SM,1131,2,0,0,2,7,0,0,7,13,0,0,13,14,0,0,14,17,0,0,17
136535,86,"MUZEUL MUNICIPAL CAREI",CAREI,SM,2019,3,1,0,4,11,2,0,13,14,2,0,16,25,4,0,29,35,4,0,39
136535,87,"SCOALA GENERALA NR4",CAREI,SM,1027,5,1,0,6,9,2,0,11,13,2,33,48,23,2,33,58,29,3,33,65
136544,88,"GRĂDINIŢA CU PROGRAM NORMAL IANCULEŞTI",IANCULEŞTI,SM,293,5,2,0,7,5,2,0,7,8,2,0,10,12,2,0,14,12,2,0,14
136857,89,"LICEUL TEHNOLOGIC",ARDUD,SM,1987,12,3,0,15,20,3,0,23,31,7,0,38,51,13,0,64,58,13,0,71
136857,90,"BIBLIOTECA ARDUD",ARDUD,SM,1918,7,0,0,7,11,0,0,11,13,0,0,13,14,0,0,14,18,0,0,18
136875,91,"SCOALA GENERALĂ BABA NOVAC","BABA NOVAC",SM,469,7,0,0,7,7,0,0,7,9,1,0,10,19,4,0,23,20,4,0,24
136884,92,"SCOALA GENERALĂ GERĂUŞA",GERĂUŞA,SM,432,0,2,0,2,2,3,0,5,4,3,0,7,5,3,0,8,5,3,0,8
136893,93,"SCOALA GENERALĂ MĂDĂRAS",MĂDĂRAS,SM,959,4,0,0,4,7,0,0,7,10,0,0,10,17,0,0,17,25,3,0,28
138048,94,"SCOALA GIMNAZIALĂ ""PETOFI SANDOR"" LIVADA",LIVADA,SM,1005,0,0,0,0,8,5,0,13,13,5,0,18,15,5,0,20,15,5,0,20
138048,95,"GRADINITA CU PROGRAM NORMAL LIVADA",LIVADA,SM,1430,3,3,0,6,10,3,0,13,12,3,0,15,16,4,0,20,18,4,0,22
138048,96,"ŞCOALA GIMNAZIALĂ PETOFI SANDOR LIVADA",LIVADA,SM,1664,4,3,0,7,8,3,0,11,9,5,0,14,12,5,0,17,13,6,0,19
138057,97,"ŞCOALA PRIMARĂ ADRIAN",ADRIAN,SM,431,1,0,0,1,4,0,0,4,4,0,0,4,4,2,0,6,4,2,0,6
138066,98,"ŞCOALA GIMNAZIALĂ ""IOSIF ŢIPROC"" DUMBRAVA",DUMBRAVA,SM,955,1,0,0,1,7,0,0,7,8,0,0,8,12,0,0,12,16,0,0,16
138075,99,"GRĂDINIŢA LIVADA MICĂ","LIVADA MICĂ",SM,250,0,0,0,0,0,0,0,0,0,0,0,0,2,0,0,2,3,0,0,3
136606,100,"SCOALA GEN.NR,2",NEGREŞTI-OAŞ,SM,1129,3,1,0,4,4,2,0,6,9,2,0,11,15,2,0,17,16,2,0,18
136606,101,"SCOALA GEN.NR,2",NEGREŞTI-OAŞ,SM,1176,3,3,0,6,5,3,0,8,7,3,0,10,9,3,1,13,16,3,1,20
136606,102,"SCOALA GEN.NR,3",NEGREŞTI-OAŞ,SM,1347,6,0,0,6,26,2,0,28,42,2,0,44,51,2,0,53,54,2,0,56
136606,103,"SCOALA GEN.NR.3",NEGREŞTI-OAŞ,SM,1379,2,0,0,2,11,0,0,11,16,0,0,16,18,0,0,18,18,0,0,18
136606,104,"SCOALA GENERALA NR.3",NEGREŞTI-OAŞ,SM,1473,9,1,0,10,25,1,0,26,41,1,0,42,46,1,0,47,53,1,0,54
136606,105,"SCOALA GEN.NR.1",NEGREŞTI-OAŞ,SM,1036,9,1,0,10,20,2,0,22,28,8,0,36,39,11,0,50,51,11,0,62
136606,106,"SCOALA GEN,NR.1",NEGREŞTI-OAŞ,SM,998,5,0,0,5,24,0,0,24,39,0,0,39,45,0,0,45,49,0,0,49
136606,107,"LICEUL TEORETIC",NEGREŞTI-OAŞ,SM,1301,11,1,0,12,16,1,0,17,19,1,0,20,21,1,53,75,26,1,53,80
136606,108,"LICEUL TEORETIC",NEGREŞTI-OAŞ,SM,1241,11,2,0,13,21,2,0,23,27,2,0,29,34,2,0,36,37,7,0,44
136606,109,"LICEUL TEORETIC",NEGREŞTI-OAŞ,SM,1292,3,0,0,3,17,2,0,19,25,2,0,27,39,3,0,42,46,6,0,52
136624,110,"CLADIRE DISPENSAR TUR",TUR,SM,1586,9,0,0,9,17,0,0,17,24,0,0,24,40,2,0,42,41,2,0,43
136651,111,"ŞCOALA GIMNAZIALĂ TĂŞNAD",TĂŞNAD,SM,1223,6,1,0,7,19,1,0,20,35,1,1,37,38,1,1,40,46,1,1,48
136651,112,"ŞCOALA GIMNAZIALĂ TĂŞNAD",TĂŞNAD,SM,1614,5,2,0,7,20,2,0,22,24,5,0,29,33,5,0,38,35,5,0,40
136651,113,"ŞCOALA GIMNAZIALĂ TĂŞNAD",TĂŞNAD,SM,1657,16,0,0,16,39,1,0,40,52,1,0,53,57,3,0,60,61,4,0,65
136651,114,"CASA DE CULTURĂ",TĂŞNAD,SM,1703,8,0,0,8,17,0,0,17,25,2,0,27,30,3,0,33,34,3,0,37
136660,115,"GRĂDINIŢA CU PROGRAM NORMAL BLAJA",BLAJA,SM,169,0,0,0,0,3,0,0,3,6,0,0,6,7,0,0,7,10,2,0,12
136679,116,"GRĂDINIŢA CU PROGRAM NORMAL CIG",CIG,SM,367,2,0,0,2,5,0,0,5,6,0,0,6,6,0,0,6,6,0,0,6
136697,117,"ŞCOALA GIMNAZIALĂ SĂRĂUAD",SĂRĂUAD,SM,839,1,0,0,1,6,0,0,6,10,0,0,10,10,0,0,10,10,0,0,10
136704,118,"GRĂDINIŢA CU PROGRAM NORMAL VALEA MORII","VALEA MORII",SM,145,3,0,0,3,3,1,0,4,3,1,0,4,4,1,0,5,5,1,0,6
136722,119,"PRIMĂRIA COMUNEI ACÂŞ",ACÎŞ,SM,1499,13,1,0,14,16,1,0,17,28,1,0,29,33,2,0,35,33,2,0,35
136740,120,"ŞCOALA GENERALĂ MIHAIENI",MIHĂIENI,SM,360,3,3,0,6,4,3,0,7,4,3,0,7,4,3,0,7,4,3,0,7
136759,121,"ŞCOALA GENERALĂ UNIMĂT",UNIMĂT,SM,334,2,2,0,4,3,3,0,6,6,4,0,10,6,4,0,10,6,4,0,10
137201,122,"PRIMARIA AGRIS",AGRIŞ,SM,903,7,2,0,9,11,2,0,13,16,3,0,19,21,3,0,24,21,3,0,24
137201,123,"GRĂDINIŢA CU PROGRAM NORMAL AGRIŞUL NOU",AGRIŞ,SM,235,0,5,0,5,5,7,0,12,10,7,0,17,15,7,0,22,22,7,0,29
137210,124,"ŞCOALA PRIMARĂ CIUPERCENI",CIUPERCENI,SM,489,0,0,0,0,3,0,0,3,6,4,0,10,6,4,0,10,7,4,0,11
136777,125,"SC. GIMNAZIALA ANDRID",ANDRID,SM,987,4,1,0,5,5,1,0,6,10,2,0,12,18,2,0,20,23,2,0,25
136786,126,"SC. PRIMARA DINDESTI",DINDEŞTI,SM,608,0,0,0,0,1,0,0,1,6,3,0,9,9,3,0,12,9,3,0,12
136795,127,"SC. GIMNAZIALA IRINA",IRINA,SM,420,0,1,0,1,0,2,0,2,0,2,0,2,2,3,0,5,2,3,0,5
136811,128,"CENTRU CULTURAL ""EMIL MATEI"" APA",APA,SM,1065,8,0,0,8,19,1,0,20,32,3,0,35,41,3,0,44,47,4,0,51
136811,129,"SCOALA GIMNAZIALĂ ""VASILE LUCACIU"" APA",APA,SM,840,2,2,0,4,20,4,0,24,30,5,0,35,32,9,0,41,33,11,0,44
136839,130,"GRĂDINIŢA DIN SATUL SOMEŞENI",SOMEŞENI,SM,238,2,4,0,6,4,6,0,10,5,7,0,12,6,9,0,15,7,9,0,16
136928,131,"SCOALA GIMNAZIALA BĂTARCI",BĂTARCI,SM,1870,9,0,0,9,24,0,0,24,38,1,0,39,51,1,0,52,59,2,0,61
136937,132,"SCOALA PRIMARĂ COMLĂUȘA",COMLĂUŞA,SM,896,3,2,0,5,18,3,0,21,27,3,0,30,39,4,0,43,43,4,0,47
136955,133,"ŞCOALA PRIMARĂ TĂMĂŞENI",TĂMĂŞENI,SM,323,0,0,0,0,1,0,0,1,2,0,0,2,5,4,0,9,5,4,0,9
136973,134,"SCOALA GIMNAZIALABELTIUG",BELTIUG,SM,1111,4,0,0,4,6,2,0,8,9,2,0,11,11,2,0,13,13,2,0,15
136982,135,"CĂMINUL CULTURAL BOLDA",BOLDA,SM,51,0,0,0,0,1,0,0,1,2,0,0,2,2,0,0,2,2,4,0,6
136991,136,"ŞCOALA PRIMARĂ GHIRIŞA",GHIRIŞA,SM,572,4,1,0,5,9,1,0,10,14,1,0,15,29,2,0,31,33,2,0,35
137005,137,"CĂMINUL CULTURAL GIUNGI",GIUNGI,SM,110,1,0,0,1,1,0,0,1,1,2,0,3,2,2,0,4,2,2,0,4
137014,138,"ŞCOALA GIMNAZIALĂ RĂTEŞTI",RĂTEŞTI,SM,624,1,2,0,3,1,2,0,3,1,2,0,3,4,2,0,6,4,2,0,6
137023,139,"GRĂDINIŢA DE COPII ŞANDRA",ŞANDRA,SM,216,0,0,0,0,0,0,0,0,0,5,0,5,0,7,0,7,0,7,0,7
137041,140,"SCOALA GENERALA BERVENI",BERVENI,SM,1698,3,0,0,3,9,0,0,9,15,3,0,18,15,3,0,18,16,3,0,19
137050,141,"SCOALA GENERALA LUCACENI",LUCĂCENI,SM,1237,8,2,0,10,23,2,0,25,34,3,0,37,49,5,0,54,49,5,0,54
137078,142,"SCOALA GENERALA BIXAD",BIXAD,SM,1217,1,0,0,1,3,2,0,5,6,2,0,8,11,3,0,14,14,3,0,17
137078,143,"SCOALA GENERALA BIXAD",BIXAD,SM,1140,6,0,0,6,8,0,0,8,13,0,0,13,15,0,0,15,17,0,0,17
137087,144,"BOINESTI SCOALA GENERALA",BOINEŞTI,SM,1420,8,0,0,8,21,0,0,21,24,1,0,25,24,1,0,25,24,1,0,25
137096,145,"TRIP SCOALA GENERALA",TRIP,SM,1333,9,2,0,11,13,2,0,15,21,2,0,23,25,5,0,30,25,5,0,30
137096,146,"TRIP SCOALA GENERALA",TRIP,SM,1141,5,0,0,5,7,0,0,7,11,0,0,11,16,0,0,16,16,0,0,16
137112,147,"PRIMARIA BÂRSĂU","BÎRSĂU DE SUS",SM,1328,2,0,0,2,16,0,0,16,20,0,0,20,27,5,0,32,28,5,0,33
137121,148,"SEDIU ADMINISTRATIV","BÎRSĂU DE JOS",SM,519,5,0,0,5,14,0,0,14,14,5,0,19,20,5,0,25,23,7,0,30
137149,149,"PRIMARIA COMUNEI BOGDAND",BOGDAND,SM,763,3,0,0,3,4,0,0,4,5,1,0,6,7,1,0,8,8,1,0,9
137158,150,"ŞCOALA CU CLASELE I-VIII",BABŢA,SM,524,3,1,0,4,4,1,0,5,5,1,0,6,8,1,0,9,9,2,0,11
137167,151,"ŞCOALA CU CLASELE I-VIII",CORUND,SM,368,6,3,0,9,7,4,0,11,8,7,0,15,10,7,0,17,10,7,0,17
137176,152,"ŞCOALA CU CLASELE I-IV",SER,SM,579,1,3,0,4,1,3,0,4,2,3,0,5,4,3,0,7,5,4,0,9
137194,153,"PRIMARIA BOTIZ",BOTIZ,SM,1436,6,0,0,6,10,0,0,10,17,0,0,17,21,0,0,21,26,0,0,26
137194,154,"SCOALAGIMNAZIALA CU CLASELE I-IV OSVAREU",BOTIZ,SM,1654,5,0,0,5,12,0,0,12,14,0,0,14,18,0,0,18,27,1,0,28
137238,155,"PRIMARIA CALINESTI OAS",CĂLINEŞTI-OAŞ,SM,1350,4,0,0,4,7,0,0,7,12,0,0,12,27,0,0,27,28,4,0,32
137247,156,"SCOALA COCA",COCA,SM,855,4,0,0,4,6,0,0,6,16,1,0,17,23,1,1,25,26,1,1,28
137256,157,"SCOALA LECHINTA",LECHINŢA,SM,657,2,0,0,2,6,0,0,6,7,1,0,8,12,1,0,13,16,1,0,17
137265,158,"SCOALA PASUNEA MARE","PĂŞUNEA MARE",SM,318,2,2,0,4,3,2,0,5,3,2,0,5,9,3,0,12,11,3,0,14
137238,159,"SPCLEP CALINESTI OAS",CĂLINEŞTI-OAŞ,SM,875,8,0,0,8,10,0,0,10,12,0,0,12,20,1,0,21,20,1,0,21
137283,160,"PRIMARIA COM. CAMARZANA",CĂMĂRZANA,SM,1068,6,0,0,6,10,0,0,10,17,0,0,17,25,2,0,27,29,3,0,32
137283,161,"SCOALA GENERALA CAMARZANA",CĂMĂRZANA,SM,929,0,0,0,0,3,1,0,4,5,2,0,7,12,4,0,16,14,4,0,18
136571,162,"SCOALA GIMNAZIALA CAMIN",CĂMIN,SM,1164,0,0,0,0,1,0,0,1,2,0,0,2,3,0,0,3,6,1,0,7
136562,163,"PRIMĂRIA COMUNEI CĂPLENI",CĂPLENI,SM,1202,3,1,0,4,6,1,0,7,11,1,0,12,14,1,0,15,15,1,0,16
136562,164,"ŞCOALA GIMNAZIALĂ"" FÉNYI ISTVÁN "" CĂPLENI",CĂPLENI,SM,1460,4,1,0,5,6,1,0,7,14,1,0,15,16,1,0,17,20,1,0,21
137309,165,"ȘCOALA GIMNAZIALĂ",CĂUAŞ,SM,547,4,1,0,5,5,2,0,7,11,3,0,14,20,4,0,24,24,4,0,28
137336,166,"ȘCOALA GENERALĂ",GHILEŞTI,SM,79,2,0,0,2,5,0,0,5,7,0,0,7,7,3,0,10,8,3,0,11
137354,167,"CASĂ DE LOCUIT",RĂDULEŞTI,SM,95,0,0,0,0,1,0,0,1,2,1,0,3,4,3,0,7,4,3,0,7
137318,168,"CĂMINUL CULTURAL","ADY ENDRE",SM,111,2,0,0,2,2,0,0,2,4,2,0,6,5,2,0,7,6,2,0,8
137345,169,"CĂMINUL CULTURAL",HOTOAN,SM,138,2,2,0,4,4,2,0,6,5,2,0,7,5,3,0,8,6,3,0,9
137327,170,"CĂMINUL CULTURAL",GHENCI,SM,1033,4,0,0,4,7,0,0,7,10,0,0,10,12,0,0,12,12,4,0,16
137372,171,"CAMIN CULTURAL",CEHĂLUŢ,SM,504,1,3,0,4,1,3,0,4,1,3,0,4,4,5,0,9,4,5,0,9
137381,172,"SCOALA CEHAL",CEHAL,SM,659,4,0,0,4,5,0,0,5,7,1,0,8,9,1,0,10,11,1,0,12
137390,173,"CLADIRE PRIMARIE",ORBĂU,SM,181,1,5,0,6,2,5,0,7,7,6,0,13,10,6,0,16,10,6,0,16
137416,174,"SCOALA GIMNAZIALA CERTEZE",CERTEZE,SM,1470,7,2,0,9,20,3,0,23,37,7,0,44,44,7,0,51,45,7,0,52
137416,175,"SCOALA GIMNAZIALA CERTEZE",CERTEZE,SM,1371,16,0,0,16,45,1,0,46,64,6,0,70,86,6,0,92,88,6,0,94
137425,176,"GRĂDINIŢA CU PROGRAM HUTA CERTEZE","HUTA CERTEZE",SM,960,1,0,0,1,14,0,0,14,16,0,0,16,22,0,0,22,23,0,0,23
137434,177,"GRĂDINIŢA CU PROGRAM NORMAL MOIŞENI",MOIŞENI,SM,1134,1,3,0,4,2,5,0,7,8,5,0,13,17,6,0,23,17,6,0,23
138690,178,"CĂMINUL CULTURAL",CIUMEŞTI,SM,1121,3,0,0,3,4,0,0,4,7,1,0,8,7,1,0,8,8,1,0,9
137452,179,"PRIMARIA CRAIDOROLT",CRAIDOROLŢ,SM,848,5,2,0,7,6,2,0,8,11,2,0,13,17,2,0,19,25,5,0,30
137461,180,"ŞCOALA PRIMARĂ CRIŞENI",CRIŞENI,SM,147,2,2,0,4,7,2,0,9,9,3,0,12,12,5,0,17,15,5,0,20
137470,181,"ŞCOALA PRIMARĂ ERIU SÂNCRAI","ERIU SÎNCRAI",SM,495,0,0,0,0,1,0,0,1,5,0,0,5,8,2,0,10,10,2,0,12
137489,182,"ŞCOALA PRIMARĂ SATU MIC","SATU MIC",SM,169,2,1,0,3,5,1,0,6,12,3,0,15,17,5,0,22,17,5,0,22
137513,183,"SCOALA CU CLASELE I-IV CRUCISOR",CRUCIŞOR,SM,466,2,1,0,3,3,2,0,5,3,4,0,7,4,4,0,8,4,4,0,8
137522,184,"SCOALA CU CLS. I-IV IEGHERISTE",IEGHERIŞTE,SM,436,2,0,0,2,3,2,0,5,7,2,0,9,15,3,0,18,16,4,0,20
137531,185,"SCOALA GIMNAZIALA POIANA CODRULUI","POIANA CODRULUI",SM,1226,8,3,0,11,23,3,0,26,33,3,0,36,37,3,0,40,43,3,0,46
137559,186,"SEDIUL CONSILIULUI LOCAL AL COMUNEI CULCIU","CULCIU MARE",SM,676,1,0,0,1,4,0,0,4,5,1,0,6,7,2,0,9,7,2,0,9
137568,187,GRADINIŢAAPATEU,APATEU,SM,273,2,2,0,4,3,2,0,5,6,2,0,8,6,2,0,8,6,2,0,8
137577,188,"ŞCOALA DE GIMNAZIALĂ BEM JOZSEF CĂRĂŞEU",CĂRĂŞEU,SM,934,1,0,0,1,4,0,0,4,4,0,0,4,5,0,0,5,5,0,0,5
137586,189,"GRADINIŢA COROD",COROD,SM,412,0,0,0,0,0,0,0,0,2,0,0,2,2,0,0,2,2,0,0,2
137595,190,"ŞCOALA PRIMARĂ CULCIU-MIC","CULCIU MIC",SM,591,2,1,0,3,5,1,0,6,7,3,0,10,7,3,0,10,7,3,0,10
137602,191,"ŞCOALA PRIMARĂ LIPĂU",LIPĂU,SM,464,3,4,0,7,7,4,0,11,9,4,0,13,10,6,0,16,10,6,0,16
137620,192,"PRIMARIA COMUNEI DOBA",DOBA,SM,998,3,0,0,3,4,0,0,4,7,0,0,7,8,1,0,9,14,3,0,17
137639,193,ŞCOALAGENERALĂBOGHIŞ,BOGHIŞ,SM,658,0,0,0,0,0,0,0,0,0,2,0,2,1,2,0,3,1,3,0,4
137648,194,"CĂMIN CULTURALDACIA",DACIA,SM,132,3,0,0,3,8,0,0,8,10,2,0,12,10,3,0,13,12,3,0,15
137657,195,CAMINULCULTURAL,PAULIAN,SM,414,7,0,0,7,8,2,0,10,10,3,0,13,13,5,0,18,14,5,0,19
137666,196,"CĂMIN CULTURAL TRAIAN",TRAIAN,SM,171,2,1,0,3,6,1,0,7,8,4,0,12,11,5,0,16,12,7,0,19
137684,197,"PRIMARIA COMUNEI DOROLT",DOROLŢ,SM,1442,3,1,0,4,4,1,0,5,4,1,0,5,6,4,0,10,15,5,0,20
137693,198,"CAMIN CULTURAL ATEA",ATEA,SM,315,0,0,0,0,3,4,0,7,4,4,0,8,4,4,0,8,4,4,0,8
137700,199,"SCOALA DARA",DARA,SM,1020,1,0,0,1,1,0,0,1,1,0,0,1,3,1,0,4,3,1,0,4
137719,200,"CAMIN CULTURAL PETEA",PETEA,SM,334,1,0,0,1,1,1,0,2,2,3,0,5,3,3,0,6,3,3,0,6
137737,201,"CONSILIUL LOCAL FOIENI",FOIENI,SM,1614,7,2,0,9,12,2,0,14,17,2,0,19,24,3,0,27,31,4,0,35
137755,202,"PRIMARIA COMUNEI","GHERŢA MICĂ",SM,1558,4,2,0,6,16,2,0,18,29,3,0,32,39,3,0,42,57,4,0,61
137755,203,"SCOALA GIMNAZIALA","GHERŢA MICĂ",SM,1216,5,2,0,7,12,2,0,14,13,2,0,15,14,2,0,16,31,4,0,35
137773,204,"ŞCOALA CU CLS.I-VIII HALMEU",HALMEU,SM,1687,19,2,0,21,30,2,0,32,40,2,0,42,57,7,0,64,70,10,0,80
137773,205,"ŞCOALA CU CLS.I-VIII HALMEU",HALMEU,SM,1344,18,0,0,18,30,1,0,31,48,2,0,50,67,3,0,70,80,3,0,83
137782,206,"GRĂDINIŢA BĂBEŞTI",BĂBEŞTI,SM,332,1,3,0,4,1,3,0,4,1,4,0,5,2,4,0,6,2,4,0,6
137808,207,"GRĂDINIŢA DABOLŢ",DOBOLŢ,SM,343,1,0,0,1,1,0,0,1,1,0,0,1,2,0,0,2,2,0,0,2
137826,208,"GRĂDINIŢA MESTEACĂN",MESTEACĂN,SM,364,2,0,0,2,5,0,0,5,6,0,0,6,7,3,0,10,14,3,0,17
137853,209,"SEDIUL PRIMARIEI COMUNEI HODOD",HODOD,SM,708,4,4,0,8,11,4,0,15,11,5,0,16,13,5,0,18,16,5,0,21
137862,210,"SCOALA GIMNAZIALA GIURTELECU HODODULUI","GIURTELECU HODODULUI",SM,478,1,3,0,4,2,3,0,5,3,3,0,6,4,3,0,7,4,3,0,7
137871,211,"SCOALA PRIMARA LELEI",LELEI,SM,462,1,5,0,6,1,5,0,6,2,5,0,7,2,5,0,7,2,5,0,7
137880,212,"CENTRU SOCIAL NADISU HODODULUI","NADIŞU HODODULUI",SM,625,4,5,0,9,12,5,0,17,21,5,0,26,23,7,0,30,26,7,0,33
137906,213,"SCOALA CLS. I-VIII HOMORODU DE MIJLOC","HOMORODU DE MIJLOC",SM,556,4,0,0,4,5,0,0,5,16,0,0,16,19,2,0,21,21,2,0,23
137915,214,"SCOALA CHILIA",CHILIA,SM,184,1,0,0,1,3,1,0,4,5,3,0,8,6,3,0,9,9,6,0,15
137924,215,"SCOALA CLS I-IV HOMORODU DE JOS","HOMORODU DE JOS",SM,300,1,0,0,1,2,0,0,2,5,2,0,7,5,5,0,10,5,5,0,10
137942,216,"SCOALA NECOPOI",NECOPOI,SM,176,0,0,0,0,1,0,0,1,1,1,0,2,1,1,0,2,4,4,0,8
137951,217,"SCOALA SOLDUBA",SOLDUBA,SM,206,1,1,0,2,2,1,0,3,2,1,0,3,4,3,0,7,8,5,0,13
137979,218,"CAMIN CULTURAL NOU",LAZURI,SM,2423,6,0,0,6,17,0,0,17,36,4,0,40,45,4,0,49,48,4,0,52
137988,219,"SCOALA CU CLASELE I-IV BERCU",BERCU,SM,520,0,0,0,0,0,0,0,0,0,0,0,0,1,0,0,1,3,2,0,5
137997,220,"SCOALA CU CLASELE I-VIII NISIPENI",NISIPENI,SM,737,2,1,0,3,2,1,0,3,3,1,0,4,3,1,0,4,7,1,0,8
138002,221,"SCOALA CU CLASELE I-IV NOROIENI",NOROIENI,SM,332,1,0,0,1,1,0,0,1,2,0,0,2,4,0,0,4,4,0,0,4
138011,222,"SCOALA CU CLASELE I-VIII PELES",PELEŞ,SM,744,2,4,0,6,3,4,0,7,3,4,0,7,3,4,0,7,3,4,0,7
138020,223,"SCOALA CU CLASELE I-IV PELISOR",PELIŞOR,SM,225,0,2,0,2,1,2,0,3,1,2,0,3,1,2,0,3,1,2,0,3
138093,224,"PRIMARIA MEDIESU AURIT","MEDIEŞU AURIT",SM,895,1,4,0,5,10,5,0,15,13,8,0,21,17,8,0,25,17,8,0,25
138093,225,"SCOALA MEDIESU AURIT","MEDIEŞU AURIT",SM,1271,7,3,0,10,15,3,0,18,25,3,0,28,39,3,0,42,42,3,0,45
138119,226,"SCOALA GENERALA",IOJIB,SM,932,3,0,0,3,6,1,0,7,11,1,0,12,14,1,0,15,16,2,0,18
138146,227,"SCOALA GENERALA",POTĂU,SM,844,6,0,0,6,22,0,0,22,35,2,0,37,39,5,0,44,42,6,0,48
138155,228,"SCOALA GENERALA",ROMÂNEŞTI,SM,648,0,0,0,0,6,0,0,6,7,0,0,7,13,1,0,14,13,1,0,14
138100,229,GRADINITA,BĂBĂŞEŞTI,SM,531,1,1,0,2,5,4,0,9,5,4,0,9,6,4,0,10,6,5,0,11
138128,230,"SCOALA GENERALA","MEDIEŞ RÎTURI",SM,234,1,0,0,1,6,0,0,6,12,1,0,13,15,1,0,16,15,1,0,16
138137,231,"SCOALA GENERALA","MEDIEŞ VII",SM,150,1,0,0,1,1,0,0,1,1,0,0,1,3,0,0,3,3,0,0,3
138173,232,"CENTRU CULTURAL TURISTIC",MICULA,SM,1169,8,2,0,10,12,2,0,14,17,4,0,21,20,4,0,24,34,5,0,39
138173,233,"GRADINITA NR. II MICULA",MICULA,SM,1415,14,0,0,14,30,1,0,31,51,1,0,52,60,1,0,61,74,1,0,75
138191,234,"CASĂ DE LOCUIT MICULA NOUA","MICULA NOUĂ",SM,620,4,0,0,4,6,0,0,6,11,0,0,11,24,0,0,24,31,0,0,31
138262,235,"SCOALA GENERALA","MOFTINU MARE",SM,1163,1,0,0,1,3,0,0,3,5,2,0,7,8,4,0,12,8,5,0,13
138217,236,"CAMINUL CULTURAL","MOFTINU MIC",SM,1041,2,1,0,3,7,1,0,8,9,1,0,10,14,2,0,16,15,2,0,17
138226,237,"SCOALAGENERALA CL I-VIIII",DOMĂNEŞTI,SM,898,0,0,0,0,2,0,0,2,7,0,0,7,9,1,0,10,12,1,0,13
138271,238,"GRADINITA DE COPII",SÎNMICLĂUŞ,SM,447,0,0,0,0,0,3,0,3,1,3,0,4,1,3,0,4,1,4,0,5
138299,239,"CĂMINUL CULTURAL ODOREU",ODOREU,SM,1991,5,1,0,6,13,1,0,14,17,4,0,21,19,4,0,23,23,5,0,28
138299,240,"SCOALA GIMNAZIALAODOREU",ODOREU,SM,2012,8,0,0,8,18,1,0,19,30,2,0,32,55,3,0,58,56,3,0,59
138306,241,"CASA DE TIP FAMILIAL"" IRIS""",BERINDAN,SM,105,0,0,0,0,0,0,0,0,0,0,0,0,3,0,0,3,3,1,0,4
138333,242,"AFTER SCHOOL, MARTINESTI NR. 51",MĂRTINEŞTI,SM,714,4,0,0,4,8,0,0,8,10,0,0,10,10,0,0,10,13,0,0,13
138360,243,"SCOALA GIMNAZIALAORASU NOU SALADE CLASĂ 1","ORAŞU NOU",SM,720,1,4,0,5,6,4,0,10,6,4,0,10,8,4,0,12,8,4,0,12
138360,244,"SCOALA GIMNAZIALAORASU NOU SALADE CLASĂ 2","ORAŞU NOU",SM,887,1,0,0,1,3,0,0,3,4,2,0,6,6,2,0,8,8,2,0,10
138379,245,"GRĂDINIȚĂ CU PROGRAM NORMAL","ORAŞU NOU-VII",SM,343,4,2,0,6,8,2,0,10,8,2,0,10,10,2,0,12,10,2,0,12
138388,246,"GRĂDINIȚĂ CU PROGRAM NORMAL",PRILOG,SM,522,2,0,0,2,5,0,0,5,9,0,0,9,12,0,0,12,12,0,0,12
138397,247,"IMOBIL, CASADE LOCUIT","PRILOG VII",SM,137,0,2,0,2,3,2,0,5,9,4,0,13,9,4,0,13,9,4,0,13
138397,248,"CLĂDIREA SCOLII","PRILOG VII",SM,106,0,0,0,0,0,0,0,0,1,3,0,4,1,3,0,4,1,3,0,4
138422,249,"SCOALĂ PRIMARĂ REMETEA OAȘ","REMETEA OAŞULUI",SM,436,4,0,0,4,6,0,0,6,6,1,0,7,10,1,0,11,13,2,0,15
138440,250,CAMINULCULTURALPAULESTI,PĂULEŞTI,SM,1407,14,6,0,20,18,6,0,24,39,10,0,49,48,14,0,62,58,17,0,75
138459,251,"ŞCOALA GENERALĂ AMAŢI",AMAŢI,SM,902,3,0,0,3,7,0,0,7,8,0,0,8,8,0,0,8,9,0,0,9
138468,252,"ŞCOALA SOLTESZ JANOS AMBUD",AMBUD,SM,947,4,2,0,6,9,3,0,12,13,3,0,16,14,3,0,17,19,3,0,22
138477,253,"ŞCOALA GENERALĂ HRIP",HRIP,SM,543,0,0,0,0,0,0,0,0,0,0,0,0,3,0,0,3,3,0,0,3
138486,254,"ŞCOALA GENERALĂ PETIN",PETIN,SM,620,5,2,0,7,6,2,0,8,15,2,0,17,16,2,0,18,16,2,0,18
138495,255,"ŞCOALA GENERALĂ RUŞENI",RUŞENI,SM,196,7,0,0,7,10,0,0,10,13,0,0,13,17,0,0,17,17,0,0,17
138510,256,"ŞCOALA GIMNAZIALĂ DR. STEFAN VONHÁZ",PETREŞTI,SM,1316,3,0,0,3,4,1,0,5,10,3,0,13,10,6,0,16,14,7,0,21
138529,257,"SCOALA GIMNAZIALA DR. STEFAN VONHAZ PETRESTI","DINDEŞTIU MIC",SM,326,1,0,0,1,5,5,0,10,5,5,0,10,12,5,0,17,12,5,0,17
138547,258,"SCOALA CU CLS. I-VIII PIR",PIR,SM,1141,4,0,0,4,5,0,0,5,11,0,0,11,13,1,0,14,14,1,0,15
138565,259,"SCOALA PRIMARA",SĂRVĂZEL,SM,105,0,0,0,0,2,0,0,2,3,1,0,4,3,1,0,4,4,1,0,5
138583,260,"PRIMARIA COMUNEIPISCOLT",PIŞCOLT,SM,905,6,0,0,6,8,1,0,9,9,1,0,10,13,1,0,14,14,3,0,17
138583,261,"PRIMARIA COMUNEIPISCOLT",PIŞCOLT,SM,884,1,0,0,1,3,0,0,3,4,0,0,4,4,0,0,4,4,0,0,4
138592,262,"ȘCOALA GIMNAZIALĂ PIȘCOLT",RESIGHEA,SM,346,6,0,0,6,7,0,0,7,13,8,0,21,15,8,0,23,16,9,0,25
138609,263,"ȘCOALA GIMNAZIALĂ PIȘCOLT","SCĂRIŞOARA NOUĂ",SM,335,8,3,0,11,9,6,0,15,11,9,0,20,11,11,0,22,12,12,0,24
138636,264,"CAMIN CULTURAL",ACIUA,SM,66,6,7,0,13,8,9,0,17,9,9,0,18,10,14,0,24,10,14,0,24
138645,265,"CAMIN CULTURAL",BICĂU,SM,104,0,5,0,5,0,5,0,5,2,5,0,7,3,5,0,8,4,6,0,10
138654,266,"SCOALA GENERALA",BORLEŞTI,SM,624,4,2,0,6,5,2,0,7,7,4,0,11,15,4,0,19,15,4,0,19
138627,267,PRIMARIAPOMI,POMI,SM,719,5,0,0,5,12,0,0,12,14,0,0,14,18,0,0,18,18,0,0,18
137835,268,"ŞCOALA GIMNAZIALĂ PORUMBEŞTI",PORUMBEŞTI,SM,1203,6,0,0,6,10,0,0,10,12,0,0,12,14,0,0,14,17,0,0,17
137791,269,"ŞCOALA GIMNAZIALĂ CIDREAG",CIDREAG,SM,853,2,1,0,3,2,3,0,5,7,3,0,10,12,5,0,17,18,5,0,23
138404,270,"ȘCOALA GENERALĂ",RACŞA,SM,1154,37,3,0,40,77,4,0,81,125,4,0,129,171,6,0,177,254,7,0,261
138404,271,"ȘCOALA GIMNAZIALĂ",RACŞA,SM,1058,26,3,0,29,49,4,0,53,173,4,0,177,204,4,0,208,237,4,0,241
138413,272,"ŞCOALA PRIMARĂ","RACŞA VII",SM,222,2,2,0,4,10,3,0,13,14,3,0,17,19,5,0,24,26,5,0,31
138672,273,"GRĂDINIŢA SANISLĂU",SANISLĂU,SM,1362,2,0,0,2,5,0,0,5,9,0,0,9,9,0,0,9,9,0,0,9
138672,274,"ŞCOALA CU CL. I-VIII GH. BULGĂR-SANISLĂU",SANISLĂU,SM,1234,11,1,0,12,18,2,0,20,22,4,0,26,29,4,0,33,29,4,0,33
138707,275,"CĂMIN CULTURALSAT HOREA",HOREA,SM,121,3,4,0,7,3,4,0,7,3,4,0,7,5,6,0,11,6,6,0,12
138716,276,"CĂMIN CULTURALSAT MARNA NOUĂ","MARNA NOUĂ",SM,288,5,0,0,5,11,1,0,12,12,1,0,13,13,4,0,17,15,4,0,19
138743,277,"SCOALA GIMNAZIALASANTAU",SANTĂU,SM,1422,15,2,0,17,19,2,0,21,24,2,0,26,30,2,0,32,30,2,0,32
138752,278,"SC. PRIM. CHEREUŞA",CHEREUŞA,SM,475,1,0,0,1,4,0,0,4,5,0,0,5,5,0,0,5,6,0,0,6
138761,279,"GRĂDINIŢA SUDURĂU",SUDURĂU,SM,141,3,0,0,3,4,1,0,5,5,1,0,6,6,3,0,9,7,3,0,10
138789,280,"PRIMARIA SACASENI",SĂCĂŞENI,SM,820,1,0,0,1,6,0,0,6,8,0,0,8,9,0,0,9,14,2,0,16
138798,281,"CAMIN CULTURAL CHEGEA",CHEGEA,SM,137,1,1,0,2,2,1,0,3,5,2,0,7,5,2,0,7,5,2,0,7
138814,282,"SCOALA CU CLASELE I-VIII SAUCA",SĂUCA,SM,332,5,0,0,5,6,0,0,6,7,0,0,7,10,0,0,10,12,0,0,12
138823,283,"SCALA CU CLS.I-VIII BECHENI",BECHENI,SM,418,1,2,0,3,8,2,0,10,11,2,0,13,12,3,0,15,12,3,0,15
138832,284,"SCOALA CU CLS.I-IV CEAN",CEAN,SM,223,6,0,0,6,11,0,0,11,12,2,0,14,14,2,0,16,16,5,0,21
138850,285,SCOALASILVAS,SILVAŞ,SM,123,1,3,0,4,3,4,0,7,4,6,0,10,8,9,0,17,8,12,0,20
138878,286,"SCOALA GIMNAZIALASOCOND",SOCOND,SM,532,8,2,0,10,16,2,0,18,19,2,0,21,21,2,0,23,29,6,0,35
138887,287,"CAMINUL CULTURAL CUTA",CUŢA,SM,263,4,2,0,6,4,3,0,7,5,3,0,8,7,3,0,10,12,3,0,15
138903,288,"GRADINITA CU PROGRAM NORMAL",SOCONZEL,SM,241,1,0,0,1,3,0,0,3,6,4,0,10,6,4,0,10,6,4,0,10
138896,289,"CAMINUL CULTURAL HODISA",HODIŞA,SM,183,2,0,0,2,5,2,0,7,7,2,0,9,11,5,0,16,12,5,0,17
138912,290,"SCOALA GIMNAZIALA STANA",STÎNA,SM,794,4,0,0,4,9,0,0,9,15,0,0,15,23,0,0,23,24,0,0,24
138930,291,"PRIMARIA COMUNEISUPUR","SUPURU DE JOS",SM,1012,12,0,0,12,20,3,0,23,22,5,0,27,24,7,0,31,26,7,0,33
138949,292,"ȘCOALA GIMNAZIALĂ DOBRA",DOBRA,SM,768,0,0,0,0,0,0,0,0,0,0,0,0,1,1,0,2,1,3,0,4
138958,293,"ȘCOALA GIMNAZIALĂ GIOROCUTA",GIOROCUTA,SM,585,2,1,0,3,9,2,0,11,12,2,0,14,25,6,0,31,34,7,0,41
138967,294,"ȘCOALA GIMNAZIALĂ ""MOISESORA NOVAC""HUREZU MARE","HUREZU MARE",SM,284,1,0,0,1,12,1,0,13,14,2,0,16,15,2,0,17,16,2,0,18
138976,295,"GRĂDINIȚĂ CU PROGRAM NORMAL",RACOVA,SM,155,1,3,0,4,1,4,0,5,2,5,0,7,4,5,0,9,4,5,0,9
138985,296,"CĂMIN CULTURAL SECHEREȘA",SECHEREŞA,SM,55,0,0,0,0,1,1,0,2,3,1,0,4,7,4,0,11,7,4,0,11
138994,297,"ȘCOALAPRIMARĂ "" IOAN GALU"" SUPURU DE SUS","SUPURU DE SUS",SM,414,0,2,0,2,1,4,0,5,5,6,0,11,14,6,0,20,14,6,0,20
139018,298,"PRIMARIA TARNA MARE","TARNA MARE",SM,1645,12,0,0,12,24,3,0,27,31,3,0,34,41,4,0,45,45,5,0,50
139027,299,"CĂMINUL CULTURAL BOCICĂU",BOCICĂU,SM,485,3,4,0,7,5,4,0,9,6,4,0,10,10,6,0,16,15,6,0,21
139036,300,"GRADINITA VALEA SEACA","VALEA SEACĂ",SM,967,5,3,0,8,7,5,0,12,16,5,0,21,19,5,0,24,24,7,0,31
139063,301,"PRIMARIA TEREBESTI",TEREBEŞTI,SM,607,5,0,0,5,8,1,0,9,8,1,0,9,8,1,0,9,12,1,0,13
139081,302,"CAMINUL CULTURAL GELU",GELU,SM,422,2,0,0,2,5,1,0,6,8,1,0,9,21,3,0,24,25,3,0,28
139090,303,"SCOALA PRIMARA PISCARI",PIŞCARI,SM,387,0,0,0,0,3,0,0,3,6,0,0,6,9,0,0,9,9,0,0,9
139125,304,"GRADINITA CU PROGRAM NORMAL",PORTIŢA,SM,146,2,6,0,8,2,7,0,9,6,7,0,13,6,7,0,13,7,7,0,14
139116,305,"PRIMARIA COMUNEI TIREAM",TIREAM,SM,1395,4,3,0,7,6,3,0,9,10,4,0,14,15,6,0,21,15,6,0,21
139134,306,"SCOALA PRIMARA VEZENDIU",VEZENDIU,SM,373,1,0,0,1,2,0,0,2,4,0,0,4,5,5,0,10,6,5,0,11
139152,307,"SCOALA GIMNAZIALATARSOLT",TÎRŞOLŢ,SM,1341,1,0,0,1,4,0,0,4,4,0,0,4,10,1,0,11,10,1,0,11
139152,308,"SCOALA GIMNAZIALATARSOLT",TÎRŞOLŢ,SM,808,0,0,0,0,2,0,0,2,8,0,0,8,9,0,0,9,11,0,0,11
139161,309,"SCOALA GIMNAZIALAALICENI",ALICENI,SM,340,1,0,0,1,3,2,0,5,4,2,0,6,6,2,0,8,6,2,0,8
139189,310,"LICEUL TEHNOLOGIC ANGHEL SALIGNY TURT, CORPUL A",TURŢ,SM,1480,6,1,0,7,16,1,0,17,25,2,0,27,34,2,0,36,40,4,0,44
139189,311,"LICEUL TEHNOLOGIC ANGHEL SALIGNY TURT, CORPUL B",TURŢ,SM,1289,2,0,0,2,10,3,0,13,14,3,0,17,24,4,1,29,32,4,1,37
139189,312,"SCOALA CU CLASELE I-VIII NR. 2",TURŢ,SM,1407,6,2,0,8,14,2,0,16,19,2,0,21,35,8,0,43,54,9,0,63
139189,313,"GRADINITA CU PROGRAM NORMAL SUSANI",TURŢ,SM,929,6,4,0,10,15,4,0,19,19,4,0,23,21,4,0,25,26,5,0,31
139198,314,"SCOALA CU CLASELE PRIMARE GHERTA MARE","GHERŢA MARE",SM,1344,3,2,0,5,8,2,0,10,11,2,0,13,24,4,0,28,28,5,0,33
139223,315,PRIMĂRIA,TURULUNG,SM,918,0,1,0,1,1,1,0,2,2,5,0,7,2,5,0,7,2,5,0,7
139223,316,"SCOALA GIMNAZIALATURULUNG",TURULUNG,SM,1205,0,2,0,2,0,2,0,2,0,2,0,2,4,2,0,6,4,2,0,6
139232,317,"SCOALA GIMNAZIALADRAGUSENI",DRĂGUŞENI,SM,1125,6,3,0,9,12,3,0,15,21,3,0,24,31,6,0,37,33,6,0,39
139241,318,GRADINITA,"TURULUNG VII",SM,160,0,0,0,0,0,0,0,0,0,1,0,1,0,1,0,1,0,1,0,1
139269,319,"CAMIN CULTURAL URZICENI",URZICENI,SM,1095,0,0,0,0,6,0,0,6,7,0,0,7,11,0,0,11,15,0,0,15
139278,320,"CĂMIN CULTURAL URZICENI PĂDURE","URZICENI PĂDURE",SM,156,1,0,0,1,4,1,0,5,4,4,0,8,7,6,0,13,9,7,0,16
139296,321,"PRIMARIA COMUNIE VALEA VINULUI","VALEA VINULUI",SM,644,4,0,0,4,10,0,0,10,15,0,0,15,21,3,0,24,22,3,0,25
139296,322,"SCOALA CU CLASELE I-IV MARIUS","VALEA VINULUI",SM,189,2,0,0,2,4,6,0,10,4,8,0,12,6,8,0,14,10,8,0,18
139296,323,"SCOALA CU CLASELE I-IV ROSIORI","VALEA VINULUI",SM,341,0,2,0,2,4,6,0,10,7,6,0,13,7,6,0,13,10,7,0,17
139296,324,"SCOALA CU CLASELE I-IV SII","VALEA VINULUI",SM,448,3,1,0,4,6,2,0,8,7,3,0,10,7,4,0,11,23,7,0,30
139349,325,"GRADINITA CU PROGRAM NORMAL VAMA",VAMA,SM,1745,3,0,0,3,10,0,0,10,19,1,0,20,24,1,0,25,26,2,0,28
139349,326,"SCOALA GIMNAZIALA VAMA",VAMA,SM,1584,5,1,0,6,12,1,0,13,25,2,0,27,33,2,0,35,38,3,0,41
139367,327,"CAMINUL CULTURAL VETIS",VETIŞ,SM,1888,2,0,0,2,5,0,0,5,13,0,0,13,16,0,0,16,18,1,0,19
139376,328,"CAMINUL CULTURAL DIN DECEBAL",DECEBAL,SM,1103,3,1,0,4,8,1,0,9,15,1,0,16,22,1,0,23,32,1,0,33
139385,329,"CĂMINUL CULTURAL OAR",OAR,SM,1355,0,0,0,0,2,0,0,2,6,0,0,6,6,0,0,6,6,0,0,6
139401,330,"PRIMĂRIA VIILE SATU MARE","VIILE SATU MARE",SM,1510,5,2,0,7,9,2,0,11,13,2,0,15,18,5,0,23,19,5,0,24
139401,331,"ŞCOALA PRIMARĂ DEALU MARE","VIILE SATU MARE",SM,519,0,0,0,0,2,0,0,2,3,0,0,3,4,0,0,4,4,0,0,4
139410,332,"GRADINITA CIONCHEŞTI",CIONCHEŞTI,SM,237,2,0,0,2,3,1,0,4,5,3,0,8,6,5,0,11,7,5,0,12
139429,333,"ŞCOALA PRIMARĂ MEDIŞA",MEDIŞA,SM,186,1,0,0,1,1,0,0,1,2,0,0,2,2,1,0,3,2,2,0,4
139438,334,"ŞCOALA PRIMARĂ TĂTĂREŞTI",TĂTĂREŞTI,SM,570,3,4,0,7,7,5,0,12,12,5,0,17,16,5,0,21,18,5,0,23
146272,1,"PRIMĂRIA MUNICIPIULUI SUCEAVA",SUCEAVA,SV,1653,24,5,0,29,87,6,0,93,141,9,0,150,161,13,0,174,177,13,0,190
146272,2,"COLEGIUL NAŢIONAL “PETRU RAREŞ” SALA A",SUCEAVA,SV,1744,39,8,0,47,96,9,0,105,143,13,1,157,196,17,1,214,206,18,1,225
146272,3,"COLEGIUL NAŢIONAL “PETRU RAREŞ” SALA B",SUCEAVA,SV,1751,34,3,0,37,105,5,0,110,138,7,0,145,165,7,0,172,178,8,0,186
146272,4,"COLEGIUL NAŢIONAL ” ŞTEFAN CEL MARE”",SUCEAVA,SV,1666,16,7,0,23,74,11,0,85,101,18,0,119,131,24,0,155,145,30,0,175
146272,5,"CENTRUL CULTURAL BUCOVINA",SUCEAVA,SV,1699,19,4,0,23,99,4,0,103,141,6,0,147,178,12,0,190,187,13,0,200
146272,6,"ŞCOALAGIMNAZIALĂ NR .1",SUCEAVA,SV,1313,17,6,0,23,57,7,0,64,100,10,0,110,122,14,0,136,132,14,0,146
146272,7,"COLEGIUL TEHNIC ""SAMUIL ISOPESCU""",SUCEAVA,SV,1226,25,5,0,30,83,6,0,89,109,14,0,123,148,25,0,173,159,25,0,184
146272,8,"COLEGIUL DE ARTĂ „CIPRIAN PORUMBESCU” SALA A",SUCEAVA,SV,713,16,0,0,16,52,5,0,57,69,13,0,82,86,13,0,99,103,13,0,116
146272,9,"COLEGIUL DE ARTĂ „CIPRIAN PORUMBESCU” SALA B",SUCEAVA,SV,1234,18,2,0,20,63,4,0,67,88,5,0,93,112,5,0,117,122,5,0,127
146272,10,"ŞCOALA GIMNAZIALĂ NR.3SALA A",SUCEAVA,SV,1054,14,6,0,20,46,8,0,54,67,9,0,76,93,9,1,103,103,9,1,113
146272,11,"ŞCOALA GIMNAZIALĂ NR.3SALA B",SUCEAVA,SV,1188,24,0,0,24,65,3,1,69,93,8,1,102,121,14,1,136,129,16,1,146
146272,12,"COLEGIUL ECONOMIC ” DIMITRIE CANTEMIR”",SUCEAVA,SV,1166,22,6,0,28,62,9,0,71,87,11,1,99,113,13,1,127,114,13,1,128
146272,13,"CENTRUL PENTRU SUSŢINEREA TRADIŢIILOR BUCOVINENE",SUCEAVA,SV,1567,13,1,0,14,43,1,0,44,81,4,0,85,98,4,0,102,110,4,0,114
146272,14,"UNIVERSITATEA ”ŞTEFAN CEL MARE”",SUCEAVA,SV,875,7,4,0,11,30,18,0,48,47,32,0,79,63,42,0,105,64,42,0,106
146272,15,"DIRECŢIASILVICĂ SUCEAVA",SUCEAVA,SV,1082,21,5,0,26,51,8,8,67,65,12,8,85,89,13,8,110,95,15,48,158
146272,16,"COLEGIUL NAŢIONAL DE INFORMATICĂ ,,SPIRU HARET”, SALA A",SUCEAVA,SV,1162,15,2,0,17,50,6,0,56,68,12,0,80,80,12,0,92,94,14,89,197
146272,17,"COLEGIUL NAŢIONAL DE INFORMATICĂ ” SPIRU HARET”, SALA B",SUCEAVA,SV,1002,7,7,0,14,37,8,0,45,54,8,0,62,90,8,64,162,97,9,64,170
146272,18,"GRĂDINIŢA CU PROGRAM PRELUNGIT NR.7 ""ABC """,SUCEAVA,SV,1652,34,1,0,35,79,3,0,82,103,7,0,110,135,8,0,143,144,8,0,152
146272,19,"ŞCOALAGIMNAZIALĂ NR. 4 SALA A",SUCEAVA,SV,1531,17,5,0,22,57,8,0,65,87,12,0,99,132,14,0,146,146,17,0,163
146272,20,"ŞCOALAGIMNAZIALĂ NR. 4, SALA B",SUCEAVA,SV,1381,21,5,0,26,67,5,0,72,114,5,0,119,137,5,0,142,139,5,0,144
146272,21,"ŞCOALAGIMNAZIALĂ NR. 8",SUCEAVA,SV,1980,27,4,0,31,70,4,0,74,108,4,0,112,145,4,0,149,156,5,0,161
146272,22,"GRADINIŢA CU PROGRAM NORMAL NR. 5",SUCEAVA,SV,1860,20,0,0,20,60,1,0,61,103,1,0,104,147,2,1,150,152,2,1,155
146272,23,"GRADINIŢA CU PROGRAM PRELUNGIT NR.1 ,,GULIVER”",SUCEAVA,SV,1319,22,2,0,24,54,4,0,58,78,6,0,84,107,7,0,114,111,7,0,118
146272,24,"LICEUL CU PROGRAM SPORTIV SALA A",SUCEAVA,SV,1644,13,2,0,15,70,4,0,74,100,13,0,113,132,17,0,149,141,18,0,159
146272,25,"LICEUL CU PROGRAM SPORTIV SALA B",SUCEAVA,SV,1836,25,0,0,25,69,1,0,70,106,2,0,108,130,2,0,132,147,3,0,150
146272,26,"COLEGIUL NAŢIONAL ”MIHAI EMINESCU” CORP B, SALA A",SUCEAVA,SV,2000,5,2,0,7,22,2,0,24,32,2,0,34,47,5,0,52,55,6,0,61
146272,27,"COLEGIUL NAŢIONAL ”MIHAI EMINESCU” CORP B, SALA B",SUCEAVA,SV,1663,14,3,0,17,49,3,0,52,80,3,0,83,109,3,0,112,122,4,0,126
146272,28,"COLEGIUL NAŢIONAL ”MIHAI EMINESCU” CORP B,SALA C",SUCEAVA,SV,1990,29,0,0,29,67,3,0,70,105,4,0,109,133,5,0,138,145,6,0,151
146272,29,"COLEGIUL TEHNIC DE INDUSTRIE ALIMENTARĂ, SALA A",SUCEAVA,SV,1823,22,6,0,28,65,10,0,75,105,21,0,126,139,21,0,160,170,21,0,191
146272,30,"COLEGIUL TEHNIC DE INDUSTRIE ALIMENTARĂ, SALA B",SUCEAVA,SV,1943,11,2,0,13,50,5,0,55,92,9,0,101,135,10,0,145,146,10,0,156
146272,31,"GRĂDINIŢA CU PROGRAM PRELUNGITNR.3""DUMBRAVA MINUNATĂ""",SUCEAVA,SV,645,14,1,0,15,29,1,0,30,38,1,0,39,62,3,0,65,71,3,0,74
146272,32,"COLEGIUL TEHNIC„PETRU MUŞAT”",SUCEAVA,SV,683,8,1,0,9,17,2,0,19,29,4,0,33,40,5,0,45,44,7,0,51
146272,33,"S.C. ROMTELECOMS.A.",SUCEAVA,SV,1885,16,2,0,18,49,3,0,52,80,4,0,84,96,5,0,101,117,7,0,124
146272,34,"INSPECTORATUL TERITORIAL DE MUNCĂ",SUCEAVA,SV,1880,22,6,0,28,51,7,0,58,96,8,0,104,135,11,0,146,143,11,0,154
146272,35,"AGENŢIA PENTRU PROTECŢIA MEDIULUI",SUCEAVA,SV,1944,25,2,0,27,46,2,0,48,70,6,0,76,127,13,0,140,149,15,0,164
146272,36,"ŞCOALA GIMNAZIALĂALĂNR. 9 ,,ION CREANGĂ“ SALA A",SUCEAVA,SV,1877,23,0,0,23,63,1,0,64,115,3,1,119,140,5,1,146,150,10,1,161
146272,37,"ŞCOALA GIMNAZIALĂALĂNR. 9 ,,ION CREANGĂ“ SALA B",SUCEAVA,SV,1943,17,0,0,17,62,6,0,68,95,9,0,104,121,19,0,140,130,22,0,152
146272,38,"ŞCOALA GIMNAZIALĂALĂNR. 9 ,,ION CREANGĂ“, SALA C",SUCEAVA,SV,1719,21,0,0,21,51,0,0,51,82,11,0,93,115,12,0,127,130,15,0,145
146272,39,"SCOALA GIMNAZIALA NR.9 ""ION CREANGA"", SALA D",SUCEAVA,SV,1916,22,2,0,24,63,5,0,68,97,5,0,102,126,10,0,136,139,11,0,150
146272,40,"GRĂDINIŢA CU PROGRAM NORMAL NR. 9 ,,NOROCEL” SALA A",SUCEAVA,SV,1786,11,4,0,15,19,6,0,25,31,8,0,39,47,10,0,57,55,10,0,65
146272,41,"GRĂDINIŢA CU PROGRAM NORMAL NR.9 ""NOROCEL"" SALA B",SUCEAVA,SV,1959,17,5,0,22,49,7,0,56,75,11,0,86,102,13,0,115,117,15,0,132
146272,42,"ATELIER ZONĂ CFR",SUCEAVA,SV,2053,12,13,0,25,47,13,0,60,63,13,0,76,87,16,0,103,90,16,0,106
146272,43,"GARA BURDUJENI, SALA A",SUCEAVA,SV,2260,6,5,0,11,15,6,0,21,26,6,0,32,39,11,0,50,41,15,0,56
146272,44,"ŞCOALAGIMNAZIALĂ NR. 10, SALA A",SUCEAVA,SV,1910,19,4,0,23,52,7,0,59,81,17,0,98,114,19,0,133,148,21,0,169
146272,45,"ŞCOALAGIMNAZIALĂ NR. 10, SALA B",SUCEAVA,SV,2031,26,4,0,30,63,4,0,67,106,4,0,110,138,4,0,142,165,5,0,170
146272,46,"COLEGIUL TEHNIC ""A.I.CUZA""SALA A, CALEA UNIRII, NR.49",SUCEAVA,SV,1868,16,3,0,19,45,6,0,51,68,7,0,75,95,12,0,107,101,14,0,115
146272,47,"COLEGIUL TEHNIC ""A.I.CUZA""SALA B, CALEA UNIRII, NR.49",SUCEAVA,SV,1595,23,5,0,28,60,8,0,68,70,13,0,83,88,17,0,105,95,17,0,112
146272,48,"COLEGIUL TEHNIC ""AL. I. CUZA"" SALA C",SUCEAVA,SV,1348,8,2,0,10,34,3,0,37,45,5,0,50,74,7,0,81,83,7,0,90
146272,49,"ŞCOALAGIMNAZIALĂ NR. 5 ,,JEAN BART”",SUCEAVA,SV,1619,11,5,0,16,43,12,0,55,74,17,0,91,111,18,0,129,132,23,0,155
146272,50,"CENTRULŞCOLAR PENTRU EDUCAŢIE INCLUZIVĂ SUCEAVA, CORP A",SUCEAVA,SV,1953,15,0,0,15,43,3,0,46,71,4,0,75,93,7,0,100,104,9,0,113
146272,51,"CENTRUL ŞCOLAR PENTRU EDUCAŢIE INCLUZIVĂ SUCEAVA- CORP B",SUCEAVA,SV,1799,10,4,0,14,34,4,0,38,66,5,0,71,94,5,0,99,98,5,0,103
146272,52,"GRĂDINIŢA CU PROGRAM NORMAL NR. 12 ""ŢĂNDĂRICĂ""",SUCEAVA,SV,1791,12,0,0,12,49,7,0,56,90,10,0,100,117,13,0,130,136,14,0,150
146272,53,"ŞCOALA GIMNAZIALĂ NR.11, ,,MIRON COSTIN”, SALA A",SUCEAVA,SV,1838,18,6,0,24,43,6,0,49,78,6,0,84,113,7,0,120,134,7,0,141
146272,54,"ŞCOALA GIMNAZIALĂ NR.11, ,,MIRON COSTIN”, SALA B",SUCEAVA,SV,1861,19,4,0,23,47,5,0,52,63,6,0,69,84,6,0,90,93,6,0,99
146272,55,"ŞCOALA GIMNAZIALĂ NR.11, ,,MIRON COSTIN”, SALA C",SUCEAVA,SV,1755,14,0,0,14,48,9,0,57,67,12,0,79,84,12,0,96,99,12,0,111
146272,56,"ŞCOALA GIMNAZIALĂ NR.11, ,,MIRON COSTIN”, SALA D",SUCEAVA,SV,1747,13,2,0,15,41,2,0,43,64,5,0,69,89,5,0,94,101,6,0,107
146272,57,"SCOALA GIMNAZIALA NR.11 ""MIRON COSTIN"", SALA E",SUCEAVA,SV,1691,18,5,0,23,33,5,0,38,49,5,0,54,56,5,0,61,60,5,0,65
146272,58,"PRIMĂRIA BURDUJENI",SUCEAVA,SV,1366,6,4,0,10,17,6,0,23,27,7,0,34,37,10,0,47,44,12,0,56
146272,59,"ŞCOALA GIMNAZIALĂ NR. 6, SALA A",SUCEAVA,SV,1360,10,0,0,10,28,3,0,31,47,3,0,50,54,6,0,60,60,6,0,66
146272,60,"SCOALA GIMNAZIALA NR.6 SALA B",SUCEAVA,SV,1087,13,0,0,13,24,0,0,24,41,0,0,41,55,0,0,55,61,0,0,61
146272,61,"GRĂDINIŢA CU PROGRAM NORMAL NR.7",SUCEAVA,SV,1397,20,3,0,23,27,4,0,31,44,6,0,50,65,9,0,74,72,11,0,83
146272,62,"GRĂDINIŢACU PROGRAM NORMAL NR.8",SUCEAVA,SV,2074,28,4,0,32,58,4,0,62,94,6,0,100,141,10,0,151,161,11,0,172
146272,63,"ŞCOALA GENERALĂNR. 7,,GRIGORE GHICA VOIEVOD”",SUCEAVA,SV,1922,16,2,0,18,50,3,0,53,94,9,0,103,120,11,0,131,139,12,0,151
146272,64,"COLEGIUL NATIONAL ""MIHAI EMINESCU"", CORP A, SALA A",SUCEAVA,SV,1365,17,6,0,23,69,13,0,82,89,17,0,106,113,23,0,136,126,25,0,151
146272,65,"GARA BURDUJENI, SALA CFR CĂLĂTORI",SUCEAVA,SV,1441,6,15,0,21,31,15,0,46,50,17,0,67,75,24,0,99,83,25,0,108
146511,66,"ŞCOALA GIMNAZIALĂ „THEODOR DARIE”","CÂMPULUNG MOLDOVENESC",SV,1523,21,2,0,23,41,2,0,43,53,5,0,58,66,6,0,72,82,7,0,89
146511,67,"LICEUL TEHNOLOGIC NR. 1","CÂMPULUNG MOLDOVENESC",SV,850,7,1,0,8,22,1,48,71,37,2,48,87,49,4,48,101,52,5,48,105
146511,68,"CIRCUMSCRIPŢIA SANITAR-VETERINARĂ","CÂMPULUNG MOLDOVENESC",SV,1417,14,2,0,16,34,5,0,39,54,6,0,60,73,7,0,80,73,7,0,80
146511,69,"ŞCOALA GIMNAZIALĂ „TEODOR ŞTEFANELLI”","CÂMPULUNG MOLDOVENESC",SV,862,6,0,0,6,23,4,0,27,29,5,0,34,40,5,0,45,45,5,0,50
146511,70,"COLEGIUL NAŢIONAL“DRAGOŞ VODĂ”","CÂMPULUNG MOLDOVENESC",SV,1146,11,0,0,11,41,4,0,45,58,7,0,65,72,14,0,86,79,15,0,94
146511,71,"CLUBUL COPIILOR ŞI ELEVILOR","CÂMPULUNG MOLDOVENESC",SV,1347,16,0,0,16,41,0,0,41,77,15,0,92,93,17,0,110,95,18,0,113
146511,72,"ŞCOALA GIMNAZIALĂ “BOGDAN VODĂ”","CÂMPULUNG MOLDOVENESC",SV,1425,15,5,0,20,50,13,0,63,80,27,0,107,100,28,0,128,102,30,0,132
146511,73,"CLUBUL COPIILOR ŞI ELEVILOR – SATUL DE VACANŢĂ","CÂMPULUNG MOLDOVENESC",SV,634,4,0,0,4,15,1,0,16,16,3,0,19,20,7,0,27,24,8,0,32
146511,74,"COLEGIUL SILVIC ""BUCOVINA"" (CORP A)","CÂMPULUNG MOLDOVENESC",SV,1448,14,2,0,16,46,6,0,52,70,12,0,82,78,14,0,92,83,17,0,100
146511,75,"COLEGIUL SILVIC ""BUCOVINA"" (CORP B)","CÂMPULUNG MOLDOVENESC",SV,1380,19,1,0,20,27,1,0,28,46,1,0,47,56,1,0,57,58,2,0,60
146511,76,"COLEGIUL SILVIC ""BUCOVINA"" (CORP C)","CÂMPULUNG MOLDOVENESC",SV,1447,5,0,0,5,26,1,0,27,46,1,0,47,71,3,0,74,80,5,0,85
146511,77,"GRĂDINIŢA NR. 4 „VALEA SEACĂ”","CÂMPULUNG MOLDOVENESC",SV,1139,18,1,0,19,37,2,0,39,61,2,0,63,70,2,0,72,75,3,0,78
146511,78,"ŞCOALA GIMNAZIALĂ „GEORGE VOEVIDCA” - CORP A","CÂMPULUNG MOLDOVENESC",SV,1033,7,3,0,10,14,3,0,17,19,13,0,32,28,18,0,46,33,22,0,55
146511,79,"ŞCOALA GIMNAZIALĂ „GEORGE VOEVIDCA” - CORP B","CÂMPULUNG MOLDOVENESC",SV,1099,10,0,0,10,25,0,0,25,45,0,0,45,62,0,0,62,65,0,0,65
146548,80,"COLEGIUL TEHNIC ""MIHAI BĂCESCU""",FĂLTICENI,SV,1429,20,0,0,20,79,3,0,82,104,9,0,113,126,9,75,210,135,11,75,221
146548,81,"ŞCOALA GIMNAZIALĂ ""ALEXANDRU IOAN CUZA""",FĂLTICENI,SV,1508,22,4,0,26,56,4,0,60,71,5,0,76,92,5,0,97,105,8,0,113
146548,82,"COLEGIUL NAŢIONAL ""NICU GANE""",FĂLTICENI,SV,1520,18,3,0,21,35,9,0,44,71,14,0,85,87,16,0,103,95,16,0,111
146548,83,"COLEGIUL NAŢIONAL ""NICU GANE""",FĂLTICENI,SV,1613,9,2,0,11,31,9,0,40,51,20,0,71,66,29,0,95,87,30,0,117
146548,84,"ŞCOALA GIMNAZIALĂ ""IOAN CIUREA""",FĂLTICENI,SV,1480,12,0,0,12,26,2,0,28,40,2,0,42,59,3,0,62,64,4,0,68
146548,85,"ŞCOALA GIMNAZIALĂ ""IOAN CIUREA""",FĂLTICENI,SV,841,11,4,0,15,25,6,0,31,32,7,0,39,42,7,0,49,50,7,0,57
146548,86,"ŞCOALA GIMNAZIALĂ ""IOAN CIUREA""",FĂLTICENI,SV,1188,10,1,0,11,27,4,0,31,40,5,0,45,50,5,0,55,62,5,0,67
146548,87,"ŞCOALA GIMNAZIALĂ ""MIHAIL SADOVEANU""",FĂLTICENI,SV,1681,8,1,0,9,38,4,0,42,58,5,0,63,80,8,0,88,96,9,0,105
146548,88,"ŞCOALA GIMNAZIALĂ ""MIHAIL SADOVEANU""",FĂLTICENI,SV,1272,14,4,0,18,36,4,0,40,72,5,0,77,92,5,0,97,96,5,0,101
146548,89,"ŞCOALA GIMNAZIALĂ ""MIHAIL SADOVEANU""",FĂLTICENI,SV,1194,18,2,0,20,35,4,0,39,56,7,0,63,75,9,0,84,82,9,1,92
146548,90,"ŞCOALA GIMNAZIALĂ ""ION IRIMIESCU""",FĂLTICENI,SV,1258,16,2,0,18,49,3,0,52,77,3,0,80,89,3,0,92,94,3,0,97
146548,91,"ŞCOALA GIMNAZIALĂ ""ION IRIMIESCU""",FĂLTICENI,SV,1183,13,4,0,17,43,4,0,47,58,7,0,65,78,8,0,86,82,8,0,90
146548,92,"GRĂDINIŢA CU PROGRAM PRELUNGIT ""DUMBRAVA MINUNATĂ""",FĂLTICENI,SV,1076,6,0,0,6,23,3,0,26,43,4,0,47,54,4,0,58,57,4,0,61
146548,93,"GRĂDINIŢA CU PROGRAM PRELUNGIT ""DUMBRAVA MINUNATĂ""",FĂLTICENI,SV,1137,7,4,0,11,26,5,0,31,42,9,0,51,59,9,0,68,67,10,0,77
146548,94,"GRĂDINIŢA CU PROGRAM PRELUNGIT ""DUMBRAVA MINUNATĂ""",FĂLTICENI,SV,923,6,4,0,10,21,4,0,25,26,4,8,38,36,6,8,50,42,6,8,56
146548,95,"COLEGIUL ""VASILE LOVINESCU""",FĂLTICENI,SV,1491,22,0,0,22,57,2,0,59,86,6,0,92,112,6,19,137,134,7,19,160
146548,96,"COLEGIUL ""VASILE LOVINESCU""",FĂLTICENI,SV,1471,31,0,0,31,89,1,0,90,125,3,0,128,149,4,0,153,156,4,0,160
146548,97,"COLEGIUL ""VASILE LOVINESCU""",FĂLTICENI,SV,1487,10,0,0,10,50,0,0,50,62,4,20,86,91,7,30,128,97,7,30,134
146548,98,"ŞCOALA GIMNAZIALĂ ""IOAN CIUREA""- CLĂDIRE GHEORGHE GAFENCU",FĂLTICENI,SV,1550,8,2,0,10,38,2,0,40,47,2,0,49,76,3,0,79,90,3,0,93
146548,99,"GRĂDINIŢA CU PROGRAM NORMAL ŢARNA MARE",FĂLTICENI,SV,418,0,3,0,3,6,3,0,9,16,3,0,19,24,4,0,28,25,4,0,29
146548,100,"GRĂDINIŢA CU PROGRAM NORMAL ŢARNA MICĂ",FĂLTICENI,SV,386,4,5,0,9,18,5,0,23,26,5,0,31,36,7,0,43,38,7,0,45
146637,101,"PRIMARIA RADAUTI",RĂDĂUŢI,SV,1985,8,3,0,11,46,8,0,54,75,9,0,84,103,13,0,116,110,13,0,123
146637,102,"CASA DE CULTURA",RĂDĂUŢI,SV,1771,17,5,0,22,51,7,0,58,94,11,0,105,132,14,0,146,146,15,0,161
146637,103,"GALERIILE DE ARTA",RĂDĂUŢI,SV,1962,29,1,0,30,98,13,0,111,122,13,0,135,153,16,0,169,163,17,0,180
146637,104,"SCOALA GIMNAZIALA REGINA ELISABETA NR.4",RĂDĂUŢI,SV,2004,21,4,0,25,62,5,0,67,114,6,0,120,151,9,0,160,180,9,0,189
146637,105,"COLEGIUL TEHNIC",RĂDĂUŢI,SV,1913,15,5,0,20,37,6,0,43,68,8,0,76,102,8,0,110,132,10,0,142
146637,106,"COLEGIUL EUDOXIU HURMUZACHI",RĂDĂUŢI,SV,1650,21,6,0,27,67,8,0,75,111,10,0,121,141,11,0,152,159,11,0,170
146637,107,"SCOALA GIMNAZIALA NR.5 BOGDAN VODA",RĂDĂUŢI,SV,1647,27,4,0,31,81,4,0,85,107,4,0,111,130,4,0,134,139,4,0,143
146637,108,"GRADINITA NR.8",RĂDĂUŢI,SV,1930,19,3,0,22,69,3,0,72,100,3,0,103,152,4,0,156,170,4,0,174
146637,109,"DIRECȚIA DE ASISTENȚĂ SOCIALĂ",RĂDĂUŢI,SV,1834,17,1,0,18,50,1,0,51,75,3,0,78,103,3,0,106,107,4,0,111
146637,110,POLICLINICA,RĂDĂUŢI,SV,1813,25,2,0,27,68,6,43,117,109,6,49,164,153,8,49,210,168,9,49,226
146637,111,"SCOALA GIMNAZIALA NR.3 MIHAI EMINESCU",RĂDĂUŢI,SV,1929,27,6,0,33,68,8,0,76,95,12,0,107,131,14,0,145,158,14,0,172
146637,112,"CRESA HIPODROM",RĂDĂUŢI,SV,1882,27,6,0,33,58,8,0,66,89,12,0,101,122,13,0,135,133,17,0,150
146637,113,"SCOALA GIMNAZIALA NR.2",RĂDĂUŢI,SV,2040,32,2,0,34,75,3,0,78,111,5,0,116,159,9,0,168,174,9,0,183
146637,114,"SCOALA GIMNAZIALA GHEORGHE POPADIUC NR.1",RĂDĂUŢI,SV,1744,12,6,0,18,44,6,0,50,59,6,0,65,83,6,0,89,98,8,0,106
146637,115,"GRADINITA CU PROGRAM PRELUNGIT PINOCHIO",RĂDĂUŢI,SV,1926,15,2,0,17,63,5,0,68,90,5,1,96,120,7,1,128,132,7,1,140
146753,116,"CASA DE CULTURA "" PLATON PARDAU""","VATRA DORNEI",SV,1343,24,0,0,24,44,16,0,60,75,35,27,137,94,48,27,169,100,53,27,180
146753,117,"HOTEL BRADUL","VATRA DORNEI",SV,888,7,84,0,91,32,190,0,222,52,244,0,296,72,293,0,365,76,302,0,378
146753,118,"HOTEL INTUS","VATRA DORNEI",SV,946,11,50,0,61,40,95,0,135,61,106,0,167,71,125,0,196,75,125,0,200
146753,119,"ŞCOALA GIMNAZIALĂ NR.1","VATRA DORNEI",SV,1031,8,1,0,9,27,2,0,29,46,7,0,53,55,9,0,64,60,15,0,75
146753,120,"ŞCOALA GIMNAZIALĂ NR.1","VATRA DORNEI",SV,1513,4,4,0,8,13,10,0,23,26,17,0,43,36,19,0,55,38,30,0,68
146753,121,"CENTRUL DE PRIMIRE, ASISTARE ŞI ÎNGRIJIRE A PERSOANELOR VÂRSTNICE","VATRA DORNEI",SV,530,3,0,0,3,5,0,0,5,14,0,0,14,15,0,0,15,19,0,0,19
146753,122,"ŞCOALA GIMNAZIALĂ NR.2","VATRA DORNEI",SV,883,5,0,0,5,31,1,0,32,43,5,0,48,56,6,0,62,66,6,0,72
146753,123,"ȘCOALA GIMNAZIALĂ NR.2","VATRA DORNEI",SV,1230,8,0,0,8,41,0,0,41,59,0,0,59,91,0,0,91,96,0,0,96
146753,124,"GRĂDINIȚA CU PROGRAM PRELUNGIT NR.3 ""SCUFIȚA ROȘIE""","VATRA DORNEI",SV,1082,9,4,0,13,47,17,0,64,67,27,0,94,98,33,0,131,100,33,0,133
146753,125,"GRADINITA CU PROGRAM NORMAL NR.5","VATRA DORNEI",SV,1087,7,6,0,13,24,9,0,33,33,11,0,44,44,12,0,56,44,12,0,56
146753,126,"ȘCOALA PRIMARĂ NR.3","VATRA DORNEI",SV,1034,14,4,0,18,27,10,0,37,45,10,8,63,52,13,8,73,54,15,8,77
146753,127,"ȘCOALA PRIMARĂ NR.3","VATRA DORNEI",SV,889,6,2,0,8,28,3,0,31,49,3,0,52,65,3,0,68,65,4,0,69
146753,128,"COMPLEX CFR GARA MARE","VATRA DORNEI",SV,1103,6,1,0,7,16,6,0,22,28,7,0,35,37,11,0,48,42,11,0,53
146753,129,"SCOALA GENERALA ARGESTRU","VATRA DORNEI",SV,520,14,1,0,15,21,1,0,22,30,3,0,33,41,4,0,45,44,4,0,48
147410,130,"CĂMIN CULTURAL HOLDA",HOLDA,SV,1009,2,0,0,2,14,0,0,14,25,3,0,28,35,4,0,39,35,4,0,39
147367,131,"PRIMĂRIA BROŞTENI",BROŞTENI,SV,833,4,3,0,7,11,3,0,14,13,10,0,23,19,10,0,29,21,10,0,31
147367,132,"LICEUL TEHNOLOGIC ""NICOLAI NANU"" BROŞTENI",BROŞTENI,SV,1482,5,1,0,6,27,3,0,30,34,5,0,39,45,8,0,53,56,8,0,64
147367,133,"SPITAL MEDICO SOCIAL CARMEN SYLVA",BROŞTENI,SV,444,3,1,0,4,3,1,1,5,3,1,1,5,6,2,1,9,8,2,1,11
147376,134,"ŞCOALA COTÎRGAŞI NR.1",COTÂRGAŞI,SV,1054,6,0,0,6,16,1,0,17,16,1,0,17,21,1,0,22,22,1,0,23
147394,135,"GRADINITA SAT FRASIN, BROSTENI",FRASIN,SV,417,0,1,0,1,7,3,0,10,11,3,0,14,20,4,0,24,21,4,0,25
147385,136,"ŞCOALA GENERALĂ DÎRMOXA",DÂRMOXA,SV,121,1,1,0,2,1,1,0,2,3,7,0,10,5,7,0,12,6,9,0,15
147642,137,"CĂMIN CULTURAL CAJVANA",CAJVANA,SV,1796,4,0,0,4,17,2,0,19,28,2,0,30,39,2,0,41,46,2,0,48
147642,138,"LICEUL TEHNOLOGIC CAJVANA",CAJVANA,SV,1870,5,5,0,10,22,8,0,30,32,8,0,40,40,8,0,48,49,8,0,57
147642,139,"LICEUL TEHNOLOGIC CAJVANA",CAJVANA,SV,1712,1,6,0,7,16,6,0,22,23,7,0,30,38,7,0,45,45,7,0,52
147642,140,"GRADINITA CU PROGRAM NORMAL CAJVANA",CAJVANA,SV,1460,7,0,0,7,13,0,0,13,18,0,0,18,42,3,0,45,54,5,0,59
148015,141,"LICEUL TEHNOLOGIC ,,OLTEA DOAMNA""",DOLHASCA,SV,1209,8,0,0,8,16,2,0,18,31,7,0,38,50,8,0,58,50,9,0,59
148015,142,"ŞCOALA PRIMARĂ DOLHASCA",DOLHASCA,SV,990,1,1,0,2,11,1,0,12,13,1,0,14,19,3,0,22,27,3,0,30
148015,143,"ŞCOALA PRIMARĂ SÂNDENI",DOLHASCA,SV,738,3,2,0,5,7,2,0,9,10,2,0,12,12,2,0,14,12,2,0,14
148042,144,"ŞCOALA PRIMARĂ POIANA",POIANA,SV,372,1,1,0,2,2,1,0,3,2,1,0,3,2,5,0,7,2,5,0,7
148033,145,"ŞCOALA GIMNAZIALĂ GULIA",GULIA,SV,1751,5,2,0,7,14,2,0,16,34,2,0,36,45,2,0,47,55,2,0,57
148060,146,"ŞCOALA GIMNAZIALĂ PROBOTA",PROBOTA,SV,1466,4,1,0,5,27,2,0,29,35,4,0,39,41,6,0,47,45,7,0,52
148051,147,"ŞCOALA PRIMARĂ POIENARI",POIENARI,SV,240,0,0,0,0,0,0,0,0,3,0,0,3,6,4,0,10,7,4,0,11
148079,148,"ŞCOALA PRIMARĂ SILIŞTEA","SILIŞTEA NOUĂ",SV,590,6,3,0,9,10,3,0,13,11,3,0,14,11,4,0,15,12,5,0,17
148024,149,"ŞCOALA GIMNAZIALĂ BUDENI",BUDENI,SV,1126,3,1,0,4,12,1,0,13,15,2,0,17,23,4,0,27,24,4,0,28
148088,150,"ŞCOALA PRIMARĂ VALEA POIENII","VALEA POIENEI",SV,408,0,0,0,0,4,0,0,4,6,0,0,6,6,0,0,6,6,0,0,6
148621,151,"PRIMĂRIA ORAŞULUI FRASIN",FRASIN,SV,1324,10,3,0,13,15,9,0,24,27,10,0,37,31,10,0,41,36,12,0,48
148621,152,"ŞCOALA GIMNAZIALĂ FRASIN",FRASIN,SV,1104,10,4,0,14,21,4,0,25,33,4,0,37,47,4,0,51,56,6,0,62
148630,153,"ŞCOALA GIMNAZIALĂ BUCŞOAIA",BUCŞOAIA,SV,1278,22,1,0,23,44,4,0,48,65,5,0,70,88,5,0,93,102,5,0,107
148649,154,"ŞCOALA GIMNAZIALĂ DOROTEIA",DOROTEIA,SV,737,5,0,0,5,6,1,0,7,12,3,0,15,27,6,0,33,33,6,0,39
148658,155,"CĂMINCULTURAL PLUTONIŢA",PLUTONIŢA,SV,926,10,3,0,13,22,5,0,27,34,8,0,42,54,8,0,62,59,8,0,67
146593,156,"MUZEUL OBICEIURILOR POPULARE GURA HUMORULUI","GURA HUMORULUI",SV,1774,15,3,0,18,50,8,0,58,81,12,25,118,108,12,25,145,110,16,25,151
146593,157,"GRADINITA CU PROGRAM NORMAL ""PINOCHIO""","GURA HUMORULUI",SV,1442,29,1,0,30,52,6,0,58,67,8,0,75,84,10,0,94,87,10,0,97
146593,158,"COLEGIUL ""ALEXANDRU CEL BUN""CORPUL B","GURA HUMORULUI",SV,1879,9,1,0,10,49,3,0,52,67,11,0,78,90,17,0,107,99,24,0,123
146593,159,"SCOALA GIMNAZIALA NR.1","GURA HUMORULUI",SV,1962,22,4,0,26,59,5,0,64,99,5,0,104,125,9,0,134,131,13,0,144
146593,160,"SCOALA GIMNAZIALA ""PETRU COMARNESCU""","GURA HUMORULUI",SV,1705,20,1,0,21,64,15,0,79,83,18,0,101,105,18,0,123,114,19,0,133
146593,161,"COLEGIUL"" ALEXANDRU CEL BUN"" CORPUL A","GURA HUMORULUI",SV,1797,14,4,0,18,38,5,0,43,59,5,0,64,85,5,0,90,104,8,0,112
146593,162,"SCOALA GIMNAZIALA ""TEODOR BALAN""","GURA HUMORULUI",SV,1739,14,4,0,18,46,4,0,50,75,4,0,79,102,9,0,111,109,9,0,118
146593,163,"SCOALA PRIMARA BOURENI","GURA HUMORULUI",SV,832,1,0,0,1,5,0,0,5,21,1,0,22,35,2,0,37,36,2,0,38
146600,164,"GRADINITA CU PROGRAM NORMALVORONET",VORONEŢ,SV,672,5,8,0,13,22,13,0,35,26,18,0,44,31,36,0,67,36,37,0,73
149236,165,"CASA DE CULTURĂ LITENI",LITENI,SV,1672,10,3,0,13,20,4,0,24,26,5,0,31,32,6,0,38,33,6,0,39
149236,166,"CORPUL III LICEUL TEHNOLOGIC IORGU VÂRNAV LITEANU LITENI",LITENI,SV,1271,5,0,0,5,10,0,0,10,20,0,0,20,26,0,0,26,27,0,0,27
149236,167,"CORPUL A LICEUL TEHNOLOGIC IORGU VÂRNAV LITEANU LITENI",LITENI,SV,942,3,1,0,4,8,1,0,9,11,3,0,14,12,4,0,16,16,5,0,21
149263,168,"ŞCOALA GIMNAZIALĂ NR. 1 ROTUNDA",ROTUNDA,SV,1153,1,0,0,1,2,0,0,2,3,0,0,3,4,0,0,4,4,0,0,4
149263,169,"ŞCOALA PRIMARĂ NR. 2 ROTUNDA",ROTUNDA,SV,692,0,0,0,0,3,0,0,3,4,0,0,4,7,0,0,7,8,0,0,8
149254,170,"ŞCOALA GIMNAZIALĂ ROŞCANI",ROŞCANI,SV,979,7,4,0,11,11,5,0,16,14,7,0,21,21,7,0,28,21,9,0,30
149245,171,"ŞCOALA GIMNAZIALĂ CORNI",CORNI,SV,650,6,2,0,8,8,2,0,10,10,2,0,12,14,2,0,16,14,3,0,17
149272,172,"ŞCOALA GIMNAZIALĂ SILIŞTEA",SILIŞTEA,SV,658,0,0,0,0,1,0,0,1,1,2,0,3,1,2,0,3,1,2,0,3
146986,173,"SEDIUL PRIMĂRIEI MILIȘĂUȚI",MILIŞĂUŢI,SV,1536,14,0,0,14,29,0,0,29,41,0,0,41,65,1,0,66,77,1,0,78
146986,174,"ȘCOALA GIMNAZIALĂ MILIŞĂUŢI, CORP A",MILIŞĂUŢI,SV,1645,1,1,0,2,11,3,0,14,24,3,0,27,38,3,0,41,47,3,0,50
146940,175,"GRĂDINIȚA CU PROGRAM NORMAL BĂDEUȚI",BĂDEUŢI,SV,1245,7,0,0,7,14,1,0,15,19,1,0,20,38,3,0,41,50,4,0,54
146389,176,CĂMINULCULTURALSALCEA,SALCEA,SV,1197,14,0,0,14,34,0,0,34,54,4,0,58,82,5,0,87,98,5,0,103
146389,177,"CĂMINULCULTURAL SALCEA",SALCEA,SV,1358,14,2,0,16,26,2,0,28,45,5,0,50,83,8,0,91,95,8,0,103
146405,178,"CAMIN CULTURAL PLOPENI",PLOPENI,SV,1891,25,3,0,28,60,5,0,65,85,6,0,91,127,7,0,134,150,8,0,158
146398,179,"ȘCOALA MERENI",MERENI,SV,1154,22,5,0,27,42,6,0,48,54,7,0,61,67,8,1,76,86,11,1,98
146423,180,CĂMINCULTURALVĂRATEC,VĂRATEC,SV,1230,11,1,0,12,29,4,0,33,42,4,0,46,69,5,0,74,95,5,0,100
146414,181,"ȘCOALAGIMNAZIALĂMANDACHELEOCOV - PRELIPCA",PRELIPCA,SV,1069,15,2,0,17,44,5,0,49,62,5,0,67,107,6,0,113,132,6,0,138
146664,182,"CENTRUL CULTURAL ”MIHAI TELIMAN”",SIRET,SV,1309,20,4,0,24,47,5,0,52,71,6,0,77,90,8,0,98,102,8,0,110
146664,183,"COLEGIUL LATCU VODA",SIRET,SV,1460,16,4,0,20,41,4,0,45,50,4,0,54,71,4,0,75,77,4,0,81
146664,184,"ȘCOALA GIMNAZIALA PETRU MUȘAT GRĂDINIȚA",SIRET,SV,1319,7,4,0,11,23,4,0,27,44,4,0,48,71,4,0,75,82,4,0,86
146664,185,"COLEGIUL LAȚCU VODĂ ȘCOALA PROFESIONALĂ",SIRET,SV,758,12,0,0,12,16,0,0,16,16,1,0,17,32,6,0,38,32,6,0,38
146664,186,"ȘCOALA GIMNAZIALĂ PETRU MUȘAT CORP II",SIRET,SV,1069,15,3,0,18,33,3,0,36,49,4,0,53,66,5,0,71,68,5,0,73
146664,187,"ȘCOALA GIMNAZIALĂ PETRU MUȘAT CORP I",SIRET,SV,1339,12,0,0,12,34,5,0,39,38,13,0,51,48,17,0,65,59,21,0,80
146664,188,"ȘCOALA GIMNAZIALĂ PĂDURENI",SIRET,SV,472,6,0,0,6,7,3,0,10,10,4,0,14,19,4,0,23,22,4,0,26
146664,189,"ȘCOALA GIMNAZIALĂ MANASTIOARA",SIRET,SV,470,3,0,0,3,8,0,0,8,14,2,0,16,21,2,0,23,25,2,0,27
146717,190,"PRIMĂRIA ORAŞULUI SOLCA",SOLCA,SV,1054,13,3,0,16,34,4,0,38,55,10,0,65,73,11,0,84,77,11,0,88
146717,191,"LICEUL TEHNOLOGIC TOMŞA VODĂ SOLCA",SOLCA,SV,1035,9,4,0,13,16,6,0,22,20,6,0,26,31,6,0,37,32,7,0,39
151102,192,"CĂMINUL CULTURAL VICOVU DE SUS-EST","VICOVU DE SUS",SV,1221,24,0,0,24,44,5,0,49,66,6,0,72,104,10,0,114,115,11,0,126
151102,193,"GRĂDINIŢA CU PROGRAM NORMAL NR. 1-EST","VICOVU DE SUS",SV,1640,15,1,0,16,43,8,0,51,80,9,0,89,116,10,0,126,154,10,0,164
151102,194,"LICEUL TEHHNOLOGIC ""ION NISTOR"" VICOVU DE SUS-CORPUL 4","VICOVU DE SUS",SV,1984,19,1,0,20,52,2,0,54,87,3,0,90,141,3,21,165,161,4,21,186
151102,195,"ŞCOALA GIMNAZIALĂ NR. 3 VICOVU DE SUS","VICOVU DE SUS",SV,1434,5,0,0,5,21,0,0,21,44,0,0,44,65,0,0,65,74,0,0,74
151102,196,"ŞCOALA GIMNAZIALĂ NR. 2 VICOVU DE SUS","VICOVU DE SUS",SV,1423,8,0,0,8,28,2,0,30,41,2,0,43,62,2,0,64,84,2,0,86
151102,197,"ŞCOALA GIMNAZIALĂ NR. 2 VICOVU DE SUS","VICOVU DE SUS",SV,1723,19,0,0,19,35,0,0,35,51,0,0,51,74,2,0,76,84,3,0,87
151111,198,"ŞCOALA GIMNAZIALĂ BIVOLĂRIA",BIVOLĂRIA,SV,1665,29,2,0,31,84,3,0,87,132,8,0,140,245,10,0,255,308,10,0,318
151111,199,"GRĂDINIŢA NOUĂ BIVOLĂRIE",BIVOLĂRIA,SV,840,9,0,0,9,23,2,0,25,39,2,0,41,63,6,0,69,66,6,0,72
146806,200,"SCOALA GIMNAZIALĂIOAN BĂNCESCU ADÂNCATA - CORPUL CU CLASELE I-IV",ADÂNCATA,SV,1431,8,0,0,8,24,2,0,26,42,4,0,46,70,4,0,74,77,8,0,85
146806,201,"SCOALA GIMNAZIALĂ IOAN BĂNCESCU ADÂNCATA - CORPUL CU CLASELE V-VIII",ADÂNCATA,SV,1002,6,1,0,7,9,3,0,12,15,4,0,19,25,5,0,30,33,5,0,38
146833,202,"ŞCOALA PRIMARĂCĂLUGĂRENI",CĂLUGĂRENI,SV,629,9,7,0,16,12,8,0,20,18,10,0,28,27,13,0,40,30,13,0,43
146842,203,"ŞCOALA GIMNAZIALĂFETEŞTI",FETEŞTI,SV,464,5,0,0,5,9,0,0,9,17,3,0,20,20,4,0,24,20,4,0,24
146879,204,"SCOALA GIMNAZIALA NR. 1 ""LUCA ARBURE"", CORP B",ARBORE,SV,1717,13,5,0,18,36,9,0,45,60,11,0,71,95,14,0,109,108,14,0,122
146879,205,"SCOALA GIMNAZIALA NR.2 ARBORE",ARBORE,SV,1682,26,5,0,31,44,6,0,50,67,6,0,73,91,9,0,100,109,13,0,122
146879,206,"SCOALA GIMNAZIALA NR.3 ARBORE",ARBORE,SV,1040,16,1,0,17,24,1,0,25,35,2,0,37,44,7,0,51,51,7,0,58
146897,207,"SALĂ DE FESTIVITĂŢI CLIT",CLIT,SV,1043,13,2,0,15,29,3,0,32,43,3,0,46,69,3,0,72,76,4,0,80
146888,208,"ŞCOALA GIMNAZIALĂ NR.6 BODNĂRENI",BODNĂRENI,SV,253,7,0,0,7,17,4,0,21,19,4,0,23,27,5,0,32,31,9,0,40
146913,209,"SEDIUL PRIMARIEI BAIA",BAIA,SV,1726,0,9,0,9,9,13,0,22,21,13,0,34,28,13,0,41,32,13,0,45
146913,210,"ŞCOALA NR. 2 BAIA",BAIA,SV,1177,4,2,0,6,6,2,0,8,18,2,0,20,23,4,0,27,25,5,0,30
146913,211,"ŞCOALA NR. 3 BAIA",BAIA,SV,1718,4,4,0,8,10,4,0,14,14,4,0,18,21,4,0,25,23,4,0,27
146922,212,"ŞCOALA BOGATA",BOGATA,SV,1086,5,4,0,9,13,6,0,19,22,6,0,28,31,11,0,42,32,11,0,43
147688,213,"ŞCOALA GIMNAZIALĂ BĂLĂCEANA",BĂLĂCEANA,SV,1221,13,3,0,16,41,9,0,50,59,14,0,73,67,14,0,81,75,16,0,91
147009,214,"SEDIUL PRIMĂRIEI COMUNEI BĂLCĂUŢI",BĂLCĂUŢI,SV,1221,11,1,0,12,19,2,0,21,35,3,0,38,40,5,0,45,41,6,0,47
147027,215,"ŞCOALA GIMNAZIALA NEGOSTINA",NEGOSTINA,SV,1108,5,2,0,7,16,2,0,18,40,6,0,46,57,7,0,64,68,7,0,75
147018,216,"ŞCOALA PRIMARAGROPENI",GROPENI,SV,298,5,0,0,5,6,1,0,7,7,1,0,8,9,2,0,11,9,2,0,11
148346,217,"ȘCOALA GIMNAZIALĂ BERCHIȘEȘTI",BERCHIŞEŞTI,SV,1963,11,1,0,12,31,4,0,35,69,8,0,77,126,10,0,136,213,13,0,226
148355,218,"SCOALA PRIMARA CORLATA",CORLATA,SV,399,2,4,0,6,8,4,0,12,12,4,0,16,24,4,0,28,27,4,0,31
147045,219,PRIMARIA,BILCA,SV,1131,10,3,0,13,25,5,0,30,40,6,0,46,57,11,0,68,61,11,0,72
147045,220,"SCOALA GIMNAZIALA NR. 2",BILCA,SV,997,7,2,0,9,14,2,0,16,22,2,0,24,31,2,0,33,36,2,0,38
147045,221,"SCOALA PRIMARA NR. 3",BILCA,SV,941,11,4,0,15,29,5,0,34,47,5,0,52,74,5,0,79,76,6,0,82
147063,222,"GRĂDINIȚA CU PROGRAM NORMAL NR. 1 BOGDĂNEȘTI",BOGDĂNEŞTI,SV,2010,11,2,0,13,17,2,0,19,32,8,0,40,43,11,0,54,44,11,0,55
147063,223,"ȘCOALA GIMNAZIALĂ NR. 2 BOGDĂNEȘTI, LOCAL NOU",BOGDĂNEŞTI,SV,1252,13,4,0,17,22,7,0,29,32,8,0,40,38,8,0,46,42,10,0,52
147081,224,"CĂMIN CULTURAL MIHAI BOLEAC",BOROAIA,SV,832,8,2,0,10,18,13,0,31,24,15,0,39,37,19,0,56,44,41,0,85
147081,225,"ŞCOALA PRIMARĂ NR.2 BOROAIA",BOROAIA,SV,728,3,4,0,7,12,4,0,16,15,4,0,19,22,4,0,26,23,4,0,27
147107,226,"CĂMIN CULTURAL GIULEŞTI",GIULEŞTI,SV,451,8,4,0,12,18,6,0,24,20,11,0,31,23,11,0,34,23,11,0,34
147090,227,"GRĂDINIŢA CU PROGRAM NORMAL BĂRĂŞTI",BĂRĂŞTI,SV,815,12,3,0,15,24,6,0,30,27,6,0,33,30,7,0,37,31,7,0,38
147125,228,"ŞCOALA PRIMARĂ SĂCUŢA",SĂCUŢA,SV,467,3,1,0,4,10,2,0,12,12,4,0,16,12,4,0,16,12,4,0,16
147116,229,"ŞCOALA GIMNAZIALĂ MOIŞA",MOIŞA,SV,563,3,5,0,8,10,7,0,17,14,7,0,21,15,8,0,23,17,8,0,25
147143,230,"CAMINUL CULTURAL BOSANCI",BOSANCI,SV,1238,12,2,0,14,30,2,0,32,52,3,0,55,86,4,0,90,106,4,0,110
147143,231,"CĂMINUL CULTURAL BOSANCI",BOSANCI,SV,1157,16,0,0,16,32,2,0,34,52,10,0,62,74,12,0,86,88,13,0,101
147143,232,"ŞCOALA GIMNAZIALĂ BOSANCI",BOSANCI,SV,1282,15,5,0,20,24,5,0,29,39,5,0,44,49,5,0,54,51,5,0,56
147143,233,"ŞCOALA PRIMARĂ BOSANCI",BOSANCI,SV,1856,29,5,0,34,70,6,0,76,98,7,0,105,130,7,0,137,144,7,0,151
147152,234,"ŞCOALA PRIMARĂ CUMPĂRĂTURA",CUMPĂRĂTURA,SV,299,5,4,0,9,7,4,0,11,7,4,0,11,10,7,0,17,13,7,0,20
147170,235,"SCOALA GIMNAZIALA CU CLASELE I-VIII BOTOSANA",BOTOŞANA,SV,1021,5,2,0,7,28,2,0,30,48,3,0,51,70,5,0,75,79,5,0,84
147170,236,"CĂMIN CULTURAL BOTOŞANA",BOTOŞANA,SV,1077,6,0,0,6,32,0,0,32,46,0,0,46,71,0,0,71,75,0,0,75
147214,237,"CAMINUL CULTURAL SAT BREAZA",BREAZA,SV,1291,9,0,0,9,25,1,0,26,32,2,0,34,47,2,0,49,47,4,0,51
147250,238,"SEDIUL NOU AL PRIMARIEICOMUNEI BRODINA",BRODINA,SV,1267,11,0,0,11,32,2,0,34,46,3,0,49,65,5,0,70,67,5,0,72
147269,239,"CENTRU DE ASISTENTA DUPA PROGRAMUL SCOLARTIPAFTER SCHOOL","BRODINA DE JOS",SV,660,2,0,0,2,5,0,0,5,15,5,0,20,19,5,0,24,19,5,0,24
147303,240,"GRADINITA CU PROGRAM NORMAL FALCAU",FALCĂU,SV,1081,23,1,0,24,42,6,0,48,61,10,0,71,79,13,0,92,101,19,0,120
147474,241,"PRIMARIA COMUNEI BUNESTI",BUNEŞTI,SV,556,6,2,0,8,16,2,0,18,19,2,0,21,21,3,0,24,26,3,0,29
147492,242,"GRADINITA CU PROGRAM NORMALPODENI",PODENI,SV,463,5,1,0,6,13,2,0,15,20,3,0,23,23,4,0,27,26,4,0,30
147483,243,"SCOALA GIMNAZIALA PETIA",PETIA,SV,630,5,0,0,5,12,1,0,13,16,1,0,17,22,1,0,23,29,2,0,31
147517,244,"SCOALA UNCESTI",UNCEŞTI,SV,545,9,3,0,12,21,4,0,25,25,4,12,41,30,4,12,46,33,4,12,49
151148,245,"CAMINUL CULTURAL BURLA - SALA MARE",BURLA,SV,1674,13,0,0,13,28,2,0,30,43,2,0,45,59,3,0,62,79,4,0,83
147535,246,"CENTRUL DE AFACERI MULTICULTURAL CACICA","PÎRTEŞTII DE SUS",SV,1566,15,2,0,17,47,3,0,50,71,4,0,75,96,5,0,101,108,5,0,113
147544,247,"ȘCOALA CACICA",CACICA,SV,1096,5,1,0,6,13,1,0,14,26,5,0,31,35,9,0,44,36,9,0,45
147571,248,"ŞCOALA SOLONEŢU NOU","SOLONEŢU NOU",SV,681,7,5,0,12,11,5,0,16,12,5,0,17,20,6,0,26,22,7,0,29
147562,249,ŞCOALARUNCU,RUNCU,SV,162,3,4,0,7,3,8,0,11,6,9,0,15,6,9,0,15,8,10,0,18
147599,250,"SALA DE SPORT CALAFINDESTI SALAA",CALAFINDEŞTI,SV,1015,9,2,0,11,25,2,0,27,43,2,0,45,85,2,0,87,108,3,0,111
147599,251,"SALA DE SPORTCALAFINDESTI- SALA B",CALAFINDEŞTI,SV,984,22,1,0,23,40,1,0,41,71,1,0,72,107,3,0,110,123,3,0,126
147606,252,"SCOALA PRIMARA BOTOŞANIŢA MARE","BOTOŞANIŢA MARE",SV,286,6,0,0,6,13,2,0,15,17,2,0,19,20,9,0,29,20,9,0,29
150917,253,"GRĂDINIŢA CU PROGRAM NORMAL NR.1 CAPU CÂMPULUI","CAPU CÂMPULUI",SV,1926,33,0,0,33,95,7,0,102,147,10,0,157,185,16,0,201,193,19,42,254
149165,254,"CASA DE CULTURA CIOCANESTI",CIOCĂNEŞTI,SV,906,11,3,0,14,30,4,0,34,40,5,0,45,45,9,19,73,48,9,19,76
149156,255,"CAMIN CULTURAL BOTOS",BOTOŞ,SV,337,5,2,0,7,18,16,0,34,21,17,0,38,32,18,12,62,32,19,12,63
147704,256,"PRIMARIA COMUNEI CIPRIAN PORUMBESCU","CIPRIAN PORUMBESCU",SV,1566,10,1,0,11,25,3,0,28,29,6,0,35,42,7,0,49,55,10,0,65
147731,257,"LOCAL AFTER SCHOOL","CÎRLIBABA NOUĂ",SV,1563,16,4,0,20,31,6,0,37,37,7,0,44,43,8,0,51,47,9,0,56
147189,258,"SCOALA GIMNAZIALA CU CLASELE I-VIII COMANESTI",COMĂNEŞTI,SV,971,5,3,0,8,13,5,0,18,21,8,0,29,31,13,0,44,37,15,0,52
147198,259,"SCOALA GIMNAZIALA CU CLASELE I-VIII HUMORENI",HUMORENI,SV,904,5,0,0,5,9,1,0,10,16,1,0,17,19,4,0,23,24,4,0,28
147795,260,"SCOALA GIMNAZIALA CORNU LUNCII","CORNU LUNCII",SV,1047,10,1,0,11,32,1,0,33,50,1,0,51,78,3,0,81,84,3,0,87
147802,261,"SCOALA GIMNAZIALA BAISESTI",BĂIŞEŞTI,SV,1201,12,2,0,14,32,4,0,36,54,8,0,62,77,10,0,87,79,10,0,89
147811,262,"SCOALA GIMNAZIALA BRAIESTI",BRĂIEŞTI,SV,1018,6,1,0,7,20,2,0,22,31,4,0,35,40,4,0,44,40,4,0,44
147820,263,"SCOALA PRIMARA DUMBRAVA",DUMBRAVA,SV,439,5,0,0,5,9,0,0,9,10,0,0,10,12,3,0,15,15,3,0,18
147866,264,"SCOALA SASCA NOUA","SASCA NOUĂ",SV,187,4,2,0,6,5,2,0,7,7,4,0,11,9,4,0,13,11,4,0,15
147857,265,"SCOALA PRIMARA SASCA MICA","SASCA MICĂ",SV,613,4,3,0,7,15,5,0,20,26,6,0,32,37,7,0,44,40,11,0,51
147875,266,"SCOALA SINCA",ŞINCA,SV,143,0,5,0,5,1,5,0,6,7,5,0,12,11,5,0,16,11,5,0,16
147848,267,"SCOALA SASCA MARE","SASCA MARE",SV,547,4,5,0,9,7,5,0,12,19,6,0,25,22,6,0,28,22,6,0,28
147839,268,"SCOALA PAISENI",PĂISENI,SV,634,5,3,0,8,9,3,0,12,10,3,0,13,16,4,0,20,20,4,0,24
148220,269,"CĂMIN CULTURAL COȘNA",COŞNA,SV,1245,12,4,0,16,19,4,0,23,41,5,0,46,53,7,0,60,81,10,0,91
147893,270,"PRIMĂRIA COMUNEI CRUCEA SALĂ FESTIVITĂȚI",CRUCEA,SV,1257,9,0,0,9,19,1,0,20,38,1,0,39,53,2,0,55,64,3,0,67
147900,271,"CĂMIN CULTURAL CHIRIL",CHIRIL,SV,454,2,1,0,3,8,2,0,10,11,2,0,13,13,2,0,15,15,2,0,17
147964,272,"GRĂDINIŢA CU PROGRAM NORMAL NR.1 DĂRMĂNEŞTI",DĂRMĂNEŞTI,SV,974,2,0,0,2,3,1,0,4,4,4,0,8,5,4,0,9,7,4,0,11
147964,273,"ŞCOALA DĂRMĂNEŞTI NR.2",DĂRMĂNEŞTI,SV,817,5,3,0,8,7,3,0,10,10,3,0,13,11,4,0,15,15,6,0,21
147946,274,"ŞCOALA GIMNAZIALĂ MĂRIŢEI",MĂRIŢEI,SV,1460,11,0,0,11,21,0,0,21,33,2,0,35,41,2,0,43,43,2,0,45
147973,275,"ŞCOALA GIMNAZIALĂ CĂLINEŞTI ENACHE",CĂLINEŞTI,SV,516,4,5,0,9,6,6,0,12,9,6,0,15,13,9,0,22,14,9,0,23
147982,276,"ŞCOALA CĂLINEŞTI-VASILACHE",CĂLINEŞTI-VASILACHE,SV,164,1,0,0,1,3,1,0,4,10,1,0,11,13,3,0,16,13,9,0,22
147955,277,"ŞCOALA GIMNAZIALĂ DĂNILA",DĂNILA,SV,873,8,2,0,10,33,2,0,35,43,6,1,50,48,6,1,55,56,12,1,69
148104,278,"PRIMĂRIA DOLHEŞTI",DOLHEŞTII-MARI,SV,1421,13,2,0,15,36,9,0,45,59,11,0,70,70,11,0,81,75,12,0,87
148113,279,"ŞCOALA GIMNAZIALĂ DOLHEŞTII MICI","DOLHEŞTII MICI",SV,1000,10,0,0,10,18,2,0,20,24,3,0,27,33,5,0,38,35,5,0,40
148122,280,"ŞCOALA PRIMARĂ VALEA BOUREI","VALEA BOUREI",SV,609,6,2,0,8,8,2,0,10,13,3,0,16,15,5,0,20,18,5,0,23
148211,281,"PRIMĂRIA COMUNEIDORNA CANDRENILOR","DORNA CANDRENILOR",SV,1715,14,4,0,18,37,6,0,43,54,9,0,63,74,12,0,86,91,12,0,103
148248,282,"CĂMINUL CULTURAL POIANA NEGRII","POIANA NEGRII",SV,786,4,0,0,4,20,2,0,22,24,2,0,26,36,2,0,38,41,5,0,46
148159,283,"SEDIU ASOCIAŢIE ""OBŞTEA GURA NEGRII"" DORNA ARINI",DORNA-ARINI,SV,545,3,3,0,6,5,4,0,9,5,4,0,9,9,5,0,14,12,7,0,19
148140,284,"CĂMIN CULTURAL COZĂNEŞTI",COZĂNEŞTI,SV,1278,10,3,0,13,26,5,0,31,37,9,0,46,57,9,0,66,63,11,0,74
148186,285,"GRĂDINIŢA CU PROGRAM NORMAL RUSCA, SAT RUSCA, NR. 59A",RUSCA,SV,685,4,0,0,4,10,1,0,11,17,13,0,30,26,17,0,43,27,20,0,47
148300,286,"SCOALA GIMNAZIALA DORNESTI",DORNEŞTI,SV,1761,16,0,0,16,27,4,0,31,43,4,0,47,57,5,0,62,70,5,0,75
148300,287,"CAMINUL CULTURAL DORNESTI",DORNEŞTI,SV,1815,26,3,0,29,66,4,0,70,89,4,0,93,114,5,0,119,123,5,0,128
148319,288,"SCOALA PRIMARA IAZ",IAZ,SV,225,2,0,0,2,4,0,0,4,6,4,0,10,6,5,0,11,6,5,0,11
148337,289,"PRIMARIA COMUNEI DRĂGOIEŞTI",MĂZĂNĂEŞTI,SV,511,0,2,0,2,3,2,0,5,5,3,0,8,6,4,0,10,6,4,0,10
148364,290,"CĂMIN CULTURAL DRĂGOIEȘTI",DRĂGOIEŞTI,SV,1528,12,1,0,13,23,10,0,33,36,16,0,52,51,22,0,73,64,22,0,86
148373,291,"CĂMIN CULTURAL LUCĂCEȘTI",LUCĂCEŞTI,SV,220,2,0,0,2,3,4,0,7,5,6,0,11,7,7,0,14,10,7,0,17
148391,292,"PRIMĂRIA COMUNEI DRĂGUŞENI",DRĂGUŞENI,SV,1822,7,4,0,11,21,9,0,30,27,12,0,39,34,13,0,47,35,16,0,51
148408,293,"GRĂDINIŢA CU PROGRAM NORMAL BROŞTENI",BROŞTENI,SV,272,3,3,0,6,11,4,0,15,13,4,0,17,16,4,0,20,17,4,0,21
148435,294,ATENEUDUMBRAVENI,DUMBRĂVENI,SV,1564,19,1,0,20,49,4,0,53,77,15,0,92,121,16,0,137,142,20,0,162
148435,295,"LICEUL TEHNOLOGIC MIHAI EMINESCU DUMBRAVENI",DUMBRĂVENI,SV,1805,23,3,0,26,50,5,0,55,79,6,0,85,132,10,0,142,167,14,0,181
148435,296,"SCOALA TOLOACA",DUMBRĂVENI,SV,1842,15,5,0,20,65,7,0,72,102,8,0,110,155,10,0,165,166,10,0,176
148435,297,"SCOALA DEAL",DUMBRĂVENI,SV,1516,12,1,0,13,33,1,0,34,50,8,0,58,92,9,0,101,104,9,0,113
148444,298,"SCOALA SALAGENI",SĂLĂGENI,SV,405,2,4,0,6,7,4,0,11,12,5,0,17,14,5,0,19,16,5,0,21
150828,299,"SCOALA CU CLASELE I-IV FANTANA MARE","FÂNTÂNA MARE",SV,871,10,6,0,16,21,6,0,27,30,6,0,36,30,7,0,37,34,8,0,42
150800,300,"SCOALA CU CLASELE I-IV COTU BAII","COTU BĂII",SV,781,5,0,0,5,21,1,0,22,25,4,0,29,33,5,0,38,33,5,0,38
150873,301,"SCOALA CU CLASELE I-IV PRAXIA",PRAXIA,SV,130,7,0,0,7,9,2,0,11,9,2,0,11,11,2,0,13,11,2,0,13
150882,302,"SCOALA CU CLASELE I-IV SPĂTĂREȘTI",SPĂTĂREŞTI,SV,367,3,0,0,3,14,2,0,16,20,2,0,22,23,2,0,25,29,4,0,33
148462,303,"CĂMINUL CULTURAL FÎNTÎNELE",FÎNTÎNELE,SV,891,11,0,0,11,30,0,0,30,30,1,0,31,32,5,0,37,35,5,0,40
148499,304,"SCOALA DIN SATUL SLOBOZIA",SLOBOZIA,SV,172,3,2,0,5,5,3,0,8,6,3,0,9,8,4,0,12,8,4,0,12
148471,305,"CĂMINUL CULTURAL BĂNEŞTI",BĂNEŞTI,SV,932,9,0,0,9,21,0,0,21,32,1,0,33,41,2,0,43,45,5,0,50
148505,306,"CĂMINUL CULTURAL STAMATE",STAMATE,SV,1540,5,1,0,6,14,7,0,21,21,7,0,28,41,8,0,49,50,9,0,59
148480,307,"SCOALA DIN SATUL COTU DOBEI","COTU DOBEI",SV,147,5,7,0,12,14,8,0,22,18,8,0,26,22,9,0,31,22,10,0,32
148523,308,"SEDIULPRIMARIEI FORASTI",FORĂŞTI,SV,496,2,0,0,2,3,0,0,3,9,3,0,12,12,3,0,15,12,3,0,15
148532,309,"SCOALA ANTOCENI",ANTOCENI,SV,256,1,0,0,1,7,2,0,9,11,5,0,16,12,5,0,17,12,5,0,17
148569,310,"SCOALA GIMNAZIALA ONICENI",ONICENI,SV,798,11,4,0,15,13,5,0,18,13,5,0,18,15,5,0,20,19,5,0,24
148578,311,"SCOALA ROSIORI",ROŞIORI,SV,294,0,0,0,0,3,3,0,6,5,4,0,9,9,5,0,14,9,5,0,14
148587,312,"SCOALA PRIMARA RUSI",RUŞI,SV,326,1,0,0,1,5,2,0,7,7,2,0,9,10,3,0,13,10,3,0,13
148596,313,"SCOALA TOLESTI",ŢOLEŞTI,SV,340,2,0,0,2,2,0,0,2,4,1,0,5,4,3,0,7,5,3,0,8
148541,314,"SCOALA PRIMARA BOURA",BOURA,SV,462,1,0,0,1,2,1,0,3,6,1,0,7,12,1,0,13,13,1,0,14
148550,315,"SEDIUL FOSTEIPRIMARII MANOLEA",MANOLEA,SV,435,6,0,0,6,8,0,0,8,12,0,0,12,12,1,0,13,16,1,0,17
148603,316,"SCOALA PRIMARA UIDESTI",UIDEŞTI,SV,134,2,2,0,4,3,2,0,5,4,2,0,6,6,2,0,8,7,2,0,9
148550,317,"SCOALA VIISOARA, CATUN VIISOARA",MANOLEA,SV,163,7,0,0,7,8,1,0,9,9,1,0,10,9,1,0,10,9,1,0,10
148676,318,"CĂMINUL CULTURAL FRĂTĂUŢII NOI","FRĂTĂUŢII NOI",SV,1222,18,0,0,18,40,1,0,41,55,2,0,57,67,3,0,70,71,3,0,74
148676,319,"ŞCOALA GIMNAZIALĂ NR 2 FRĂTĂUŢII NOI","FRĂTĂUŢII NOI",SV,1549,7,1,0,8,12,2,0,14,24,2,0,26,57,2,0,59,59,4,0,63
148676,320,"GRADINITA CU PROGRAM NORMAL NR 3 FRĂTĂUŢII NOI","FRĂTĂUŢII NOI",SV,394,7,1,0,8,11,1,0,12,14,1,0,15,20,1,0,21,23,1,0,24
148685,321,"CĂMIN CULTURAL COSTIŞA",COSTIŞA,SV,784,7,4,0,11,17,5,0,22,29,6,0,35,42,6,0,48,46,6,0,52
148685,322,"GRĂDINIŢA CU PROGRAM NORMAL NR 2 COSTIŞA",COSTIŞA,SV,506,3,5,0,8,9,5,0,14,18,6,0,24,30,7,0,37,33,7,0,40
148701,323,"CAMIN CULTURAL FRATAUTII VECHI","FRĂTĂUŢII VECHI",SV,1501,5,1,0,6,18,4,0,22,37,6,0,43,47,7,0,54,61,7,0,68
148701,324,"ŞCOALA PRIMARĂ LIVIU V. IONESI FRĂTĂUŢII-VECHI","FRĂTĂUŢII VECHI",SV,1185,8,4,0,12,23,5,0,28,35,5,0,40,45,5,0,50,51,5,0,56
148710,325,"CAMIN CULTURAL MĂNEUŢI",MĂNEUŢI,SV,1752,15,2,0,17,26,2,0,28,38,3,0,41,58,9,0,67,63,10,0,73
148738,326,"PRIMARIA FRUMOSU",FRUMOSU,SV,1833,15,1,0,16,42,2,0,44,54,2,0,56,69,2,0,71,75,2,0,77
148747,327,"SCOALA GENERALA CU CLASELE I-IV DEIA",DEIA,SV,688,5,0,0,5,10,0,0,10,15,0,0,15,20,0,0,20,27,0,0,27
148756,328,"SCOALA DRAGOSA",DRAGOŞA,SV,353,1,0,0,1,2,0,0,2,2,0,0,2,8,2,0,10,8,2,0,10
148774,329,"ŞCOALA GIMNAZIALĂ""DIMITRIE GUSTI""","FUNDU MOLDOVEI",SV,1582,18,0,0,18,40,0,0,40,53,4,0,57,57,5,0,62,62,5,0,67
148818,330,"CĂMINUL CULTURAL COLACU",COLACU,SV,816,6,3,0,9,22,3,0,25,36,3,0,39,47,5,0,52,47,5,0,52
148792,331,"ŞCOALA GIMNAZIALĂ BOTUŞ",BOTUŞ,SV,983,9,0,0,9,13,2,0,15,19,2,0,21,26,5,0,31,29,5,0,34
148881,332,"ŞCOALA PRIMARĂ DIN SATUL GĂLĂNEŞTI",GĂLĂNEŞTI,SV,1393,6,0,0,6,12,2,0,14,29,2,0,31,45,2,0,47,48,2,0,50
148881,333,"CĂMIN CULTURAL GĂLĂNEŞTI",GĂLĂNEŞTI,SV,883,2,1,0,3,3,1,0,4,3,1,0,4,5,4,0,9,7,4,0,11
148925,334,"CĂMIN CULTURAL GRĂMEŞTI",GRĂMEŞTI,SV,1674,9,6,0,15,26,9,0,35,37,10,0,47,41,14,0,55,46,14,0,60
148934,335,"ŞCOALA PRIMARĂ BĂLINEŞTI",BĂLINEŞTI,SV,582,1,5,0,6,2,5,0,7,8,6,0,14,14,9,0,23,16,9,0,25
148943,336,"ŞCOALA CU CLASELE I-IV BOTOŞANIŢA MICĂ","BOTOŞANIŢA MICĂ",SV,197,0,4,0,4,0,4,0,4,2,4,0,6,2,4,0,6,2,4,0,6
148989,337,"ŞCOALA GIMNAZIALĂ ""MIHAIL SADOVEANU"" GRĂNICEŞTI",GRĂNICEŞTI,SV,977,14,0,0,14,27,3,0,30,52,4,0,56,65,6,1,72,78,6,1,85
148989,338,"SCOALA GIMNAZIALA MIHAIL SADOVEANU GRANICESTI",GRĂNICEŞTI,SV,923,9,0,0,9,19,0,0,19,31,0,0,31,51,3,1,55,54,3,1,58
148998,339,"ŞCOALA PRIMARĂ DUMBRAVA",DUMBRAVA,SV,331,13,0,0,13,17,8,0,25,27,9,0,36,39,11,0,50,41,13,0,54
149003,340,"ŞCOALA GIMNAZIALĂ GURA SOLCII","GURA SOLCII",SV,578,8,3,0,11,14,3,0,17,20,3,0,23,28,4,0,32,31,4,0,35
149012,341,"ŞCOALA PRIMARĂ IACOBEŞTI",IACOBEŞTI,SV,447,5,4,0,9,13,6,0,19,18,7,0,25,30,8,0,38,35,8,0,43
149021,342,"ŞCOALA GIMNAZIALĂ ROMÂNEŞTI",ROMÂNEŞTI,SV,540,3,0,0,3,14,2,0,16,19,3,0,22,20,5,0,25,29,6,0,35
149030,343,"ŞCOALA PRIMARĂ SLOBOZIA SUCEVEI","SLOBOZIA SUCEVEI",SV,566,5,1,0,6,10,2,0,12,18,4,0,22,29,13,0,42,34,13,0,47
146851,344,"SCOALA GIMNAZIALA ,,MIHAI HALUNGA” HANTESTI",HĂNŢEŞTI,SV,1423,13,2,0,15,25,2,0,27,35,2,0,37,47,3,0,50,52,3,0,55
146851,345,"ȘCOALA PRIMARĂ NR. 2 HĂNȚEȘTI VALE",HĂNŢEŞTI,SV,1185,4,3,0,7,6,5,0,11,26,5,0,31,45,7,0,52,52,10,0,62
146815,346,"ȘCOALAPRIMARĂ BEREȘTI",ARŢARI,SV,506,3,1,0,4,7,2,0,9,8,5,0,13,19,7,0,26,20,10,0,30
150016,347,"CLĂDIRE ADMINISTRATIVĂ",HÂRTOP,SV,1136,14,4,0,18,34,8,0,42,56,8,0,64,69,8,0,77,79,8,0,87
150016,348,"CLĂDIRE ADMINISTRATIVĂ",HÂRTOP,SV,877,18,1,0,19,29,1,0,30,36,1,0,37,45,2,0,47,47,2,0,49
149110,349,"CĂMINUL CULTURAL HORODNIC DE JOS","HORODNIC DE JOS",SV,1355,13,3,0,16,35,5,0,40,45,8,0,53,50,8,0,58,62,8,0,70
149110,350,"SCOALA PRIMARĂ VASILE ŢIGĂNESCU","HORODNIC DE JOS",SV,628,7,2,0,9,14,2,0,16,15,2,0,17,19,2,0,21,22,2,0,24
149129,351,"SCOALA GIMNAZIALA NR.2","HORODNIC DE SUS",SV,1171,15,0,0,15,54,2,0,56,85,4,0,89,114,8,0,122,122,8,0,130
149129,352,"SALA DE SPORT","HORODNIC DE SUS",SV,1744,24,3,0,27,53,8,0,61,81,10,0,91,103,11,0,114,118,11,0,129
149129,353,"SCOALA GIMNAZIALA NR.3","HORODNIC DE SUS",SV,1064,12,0,0,12,37,0,0,37,57,5,0,62,76,6,0,82,82,8,0,90
149058,354,"PRIMĂRIA COMUNEI HORODNICENI",HORODNICENI,SV,901,11,0,0,11,32,4,0,36,46,6,0,52,63,8,0,71,63,8,0,71
149067,355,"ȘCOALA CU CL.I-IV BOTEȘTI",BOTEŞTI,SV,382,2,4,0,6,11,4,0,15,15,4,0,19,24,4,0,28,26,4,0,30
149076,356,"ȘCOALA CU CL.I-IV BRĂDĂȚEL",BRĂDĂŢEL,SV,448,4,5,0,9,7,5,0,12,7,5,0,12,10,7,0,17,10,7,0,17
149085,357,"ȘCOALA CU CL.I-VIII MIHĂIEȘTI",MIHĂIEŞTI,SV,637,8,4,0,12,15,4,0,19,24,4,0,28,32,4,0,36,32,4,0,36
149094,358,"PUNCT DOCUMENTAR NICOALE ISTRATI",ROTOPĂNEŞTI,SV,505,9,0,0,9,18,0,0,18,20,0,0,20,25,2,0,27,25,2,0,27
149147,359,"CASA NAȚIONALĂ IACOBENI",IACOBENI,SV,920,2,0,0,2,31,0,0,31,43,4,0,47,51,5,0,56,61,6,0,67
149174,360,"CLUBUL FERMIERILOR MESTECANIS STR FERMIERILOR NR 14 SAT MESTECANIS COMUNA IACOBENI JUDETUL SUCEAVA",MESTECĂNIŞ,SV,263,8,0,0,8,18,2,0,20,19,2,0,21,23,2,0,25,27,2,0,29
149147,361,"LICEUL TEHNOLOGIC LIVIU SUHAR IACOBENI CORP A STR. MINELOR NR 17 COMUNA IACOBENI JUDETUL SUCEAVA",IACOBENI,SV,596,16,0,0,16,30,0,0,30,35,0,0,35,43,0,0,43,44,0,0,44
146968,362,"SALA MICĂ A CĂMINULUI CULTURAL IASLOVĂŢ",IASLOVĂŢ,SV,1547,24,0,0,24,40,0,0,40,64,0,0,64,85,6,0,91,109,6,0,115
146968,363,"ŞCOALA GIMNAZIALA NR. 2 IASLOVAT",IASLOVĂŢ,SV,1537,15,3,0,18,42,3,0,45,64,3,0,67,99,6,0,105,125,9,0,134
147679,364,"PRIMARIA ILISESTI",ILIŞEŞTI,SV,1915,24,5,0,29,45,25,0,70,77,44,0,121,88,49,23,160,94,50,23,167
147697,365,"CAMIN CULTURAL BRASCA",BRAŞCA,SV,302,0,6,0,6,2,6,0,8,4,7,0,11,13,8,0,21,16,8,0,24
146290,366,"ȘCOALA GIMNAZIALĂ IPOTEȘTI",IPOTEŞTI,SV,1456,29,2,0,31,65,2,0,67,127,4,0,131,213,9,0,222,239,11,0,250
146290,367,"ȘCOALA GIMNAZIALĂ IPOTEȘTI",IPOTEŞTI,SV,1514,35,1,0,36,87,7,0,94,140,8,0,148,208,12,0,220,234,20,0,254
146290,368,"ȘCOALA PRIMARĂ IPOTEȘTI",IPOTEŞTI,SV,1138,24,4,0,28,72,4,0,76,109,5,0,114,148,9,0,157,171,13,0,184
146316,369,"ŞCOALA PRIMARĂ TIŞĂUŢI",TIŞĂUŢI,SV,983,19,1,0,20,40,6,0,46,53,8,0,61,79,11,0,90,96,13,0,109
146307,370,"ŞCOALA PRIMARĂ LISAURA",LISAURA,SV,905,11,2,0,13,30,4,0,34,50,7,0,57,78,8,0,86,88,8,0,96
149192,371,"PRIMARIA IZVOARELE SUCEVEI","IZVOARELE SUCEVEI",SV,715,5,0,0,5,8,0,0,8,17,1,0,18,26,2,0,28,30,3,0,33
149209,372,"SCOALA PRIMARĂ BOBEICA",BOBEICA,SV,346,5,5,0,10,8,5,0,13,11,5,0,16,14,5,0,19,14,5,0,19
149218,373,"SCOALA GIMNAZIALĂ BRODINA - IZVOARELE SUCEVEI",BRODINA,SV,585,0,0,0,0,4,1,0,5,7,1,0,8,9,1,0,10,10,2,0,12
149307,374,"SCOALA CU CLASELE I-VIII NR. 2 MARGINEA",MARGINEA,SV,1621,21,0,0,21,60,0,0,60,83,0,0,83,127,4,0,131,139,4,0,143
149307,375,"LICEUL TEHNOLOGIC VASILE GHERASIM MARGINEA",MARGINEA,SV,1673,6,1,0,7,24,1,0,25,50,1,0,51,74,3,0,77,84,8,0,92
149307,376,"LICEUL TEHNOLOGIC VASILE GHERASIM MARGINEA",MARGINEA,SV,1575,10,2,0,12,24,3,0,27,43,3,0,46,86,4,0,90,122,8,0,130
149307,377,"LICEUL TEHNOLOGIC VASILE GHERASIM MARGINEA",MARGINEA,SV,1694,11,1,0,12,25,1,0,26,61,4,0,65,85,7,0,92,101,7,0,108
149307,378,"SCOALA CU CLASELE I-VIII NR. 3 MARGINEA",MARGINEA,SV,1809,9,0,0,9,27,5,0,32,42,6,0,48,70,9,0,79,101,13,0,114
149325,379,"PRIMARIA MALINI",MĂLINI,SV,1304,10,2,0,12,16,5,0,21,26,7,0,33,36,7,0,43,39,8,0,47
149325,380,"SCOALA GIMNAZIALA SUHA",MĂLINI,SV,1529,8,0,0,8,15,0,0,15,20,3,0,23,26,6,0,32,34,6,0,40
149343,381,"SCOALA GIMNAZIALAPIRAIE",PÎRAIE,SV,1548,8,2,0,10,21,7,0,28,23,8,0,31,33,9,0,42,33,9,0,42
149352,382,"SCOALA GIMNAZIALA POIANA MARULUI","POIANA MĂRULUI",SV,1025,0,0,0,0,3,0,0,3,8,0,0,8,16,3,0,19,17,3,0,20
149361,383,"SCOALA GIMNAZIALA VALENI-STANISOARA",VĂLENI-STÎNIŞOARA,SV,649,2,0,0,2,4,0,0,4,6,2,0,8,13,3,0,16,17,3,0,20
149389,384,"ŞCOALA GIMNAZIALĂ MĂNĂSTIREA HUMORULUI","MĂNĂSTIREA HUMORULUI",SV,992,6,0,0,6,24,0,0,24,28,0,0,28,43,1,0,44,48,1,0,49
149389,385,"ŞCOALA GIMNAZIALĂ MĂNĂSTIREA HUMORULUI","MĂNĂSTIREA HUMORULUI",SV,1056,9,0,0,9,20,1,0,21,25,4,0,29,35,6,0,41,36,6,0,42
149398,386,"CASA POLONĂ ”DOM POLSKI”",PLEŞA,SV,171,1,2,0,3,1,4,0,5,1,6,0,7,2,8,0,10,2,8,0,10
149405,387,"ŞCOALA GIMNAZIALĂ ""KRYSTINA BOCHENEK"" POIANA MICULUI","POIANA MICULUI",SV,495,0,0,0,0,2,1,0,3,2,1,0,3,2,2,0,4,4,9,0,13
149405,388,"FOSTA ""ŞCOALĂ PRIMARĂ NR. .1 POIANA MICULUI""","POIANA MICULUI",SV,346,2,1,0,3,9,1,0,10,12,4,0,16,15,6,0,21,16,6,0,22
146334,389,"CAMINUL CULTURAL AL COMUNEI MITOCU DRAGOMIRNEI","MITOCU DRAGOMIRNEI",SV,1447,13,0,0,13,34,1,0,35,60,21,0,81,85,23,0,108,96,24,0,120
146334,390,"GRĂDINIŢA CU PROGRAM NORMAL NR. 1","MITOCU DRAGOMIRNEI",SV,1434,19,1,0,20,40,1,0,41,67,6,0,73,101,13,0,114,109,15,0,124
146361,391,"ŞCOALA PRIMARĂ ""IONCREANGĂ"" MITOCAŞI",MITOCAŞI,SV,702,2,1,0,3,8,3,0,11,20,3,0,23,28,4,0,32,28,4,0,32
146352,392,"ŞCOALA PRIMARĂ LIPOVENI",LIPOVENI,SV,390,2,0,0,2,9,0,0,9,11,0,0,11,14,0,0,14,16,0,0,16
149423,393,PRIMARIE,"MOARA NICA",SV,1477,8,2,0,10,22,2,0,24,38,3,0,41,54,4,0,58,66,6,0,72
149423,394,"SCOALA GENERALA MOARA NICA","MOARA NICA",SV,1124,6,0,0,6,16,3,0,19,42,3,0,45,50,6,0,56,55,6,0,61
149478,395,"SCOALA GENERALA MOARA CARP","MOARA CARP",SV,709,8,1,0,9,18,1,0,19,35,1,0,36,38,1,0,39,38,3,0,41
149441,396,"SCOALA GENERALA FRUMOASA",FRUMOASA,SV,201,2,2,0,4,8,5,0,13,10,5,0,15,14,5,0,19,14,5,0,19
149469,397,"SCOALA GENERALA LITENI",LITENI,SV,737,1,0,0,1,10,3,0,13,18,3,0,21,23,4,0,27,23,4,0,27
149487,398,"SCOALA GENERALA VORNICENII MARI","VORNICENII MARI",SV,215,1,0,0,1,5,5,0,10,9,5,0,14,10,5,0,15,10,5,0,15
149511,399,"PRIMĂRIA COM MOLDOVA SULIȚA",MOLDOVA-SULIŢA,SV,1042,4,1,0,5,9,2,0,11,14,6,0,20,27,8,0,35,29,8,0,37
149520,400,"ȘCOALA PRIMARĂ BENIA",BENIA,SV,531,2,0,0,2,18,0,0,18,18,0,0,18,25,1,0,26,25,1,0,26
149548,401,"SALA DE SPECTACOLE",MOLDOVIŢA,SV,1887,18,4,0,22,34,7,0,41,56,15,0,71,68,15,0,83,79,15,0,94
149557,402,"ŞCOALA GIMNAZIALĂ ARGEL",ARGEL,SV,823,4,1,0,5,5,1,0,6,7,4,0,11,14,4,0,18,20,4,0,24
149566,403,"GRĂDINIŢA CU PROGRAM NORMAL DEMACUŞA",DEMACUŞA,SV,808,3,0,0,3,7,0,0,7,11,0,0,11,21,0,0,21,25,1,0,26
149575,404,"GRĂDINIŢA CU PROGRAM NORMAL RAŞCA",RAŞCA,SV,655,0,0,0,0,5,0,0,5,11,0,0,11,14,0,0,14,14,0,0,14
149593,405,"CĂMINUL CULTURAL BAINEŢ",BAINEŢ,SV,251,4,2,0,6,7,2,0,9,10,2,0,12,13,3,0,16,14,3,0,17
149619,406,"CĂMINUL CULTURAL CLIMĂUŢI",CLIMĂUŢI,SV,318,0,4,0,4,4,4,0,8,6,4,0,10,7,4,0,11,9,4,0,13
149646,407,"CLĂDIREA ""DOM POLSKI"" VICŞANI",VICŞANI,SV,187,3,3,0,6,3,3,0,6,3,3,0,6,6,3,0,9,7,3,0,10
149628,408,"ŞCOALA CU CL.I-IV MUŞENIŢA",MUŞENIŢA,SV,309,2,2,0,4,4,2,0,6,8,2,0,10,10,2,0,12,14,4,0,18
149637,409,"CĂMINUL CULTURAL VĂŞCĂUŢI",VĂŞCĂUŢI,SV,501,3,0,0,3,5,0,0,5,6,2,0,8,11,2,0,13,14,5,0,19
149664,410,"ŞCOALA GIMNAZIALĂOSTRA",OSTRA,SV,2118,8,0,0,8,26,0,0,26,47,0,0,47,64,3,0,67,65,3,0,68
149664,411,"CASA DE TIP FAMILIAL ""CIREŞARII""",OSTRA,SV,678,1,6,0,7,11,7,0,18,15,9,0,24,18,9,0,27,18,9,0,27
149691,412,"ȘCOALA GIMNAZIALĂ PANACI",PANACI,SV,669,4,9,0,13,13,9,0,22,15,9,0,24,20,11,0,31,25,13,0,38
149717,413,"SCOALA CU CLASELE I-IV COVERCA",COVERCA,SV,666,6,0,0,6,12,0,0,12,22,0,0,22,27,0,0,27,30,0,0,30
149744,414,"ȘCOALA CU CLASELE I-IV PĂLTINIȘ",PĂLTINIŞ,SV,269,1,1,0,2,7,1,0,8,18,6,0,24,25,8,0,33,25,8,0,33
149735,415,"CAMIN CULTURAL GLODU",GLODU,SV,282,3,2,0,5,7,4,0,11,11,4,0,15,13,6,0,19,15,7,0,22
149762,416,"CĂMINUL CULTURAL PĂLTINOASA",PĂLTINOASA,SV,1253,11,4,0,15,15,9,0,24,31,22,0,53,59,27,0,86,59,29,0,88
149762,417,"ŞCOALA GIMNAZIALĂ PĂLTINOASA",PĂLTINOASA,SV,1366,13,0,0,13,26,0,0,26,38,2,0,40,52,2,0,54,52,2,0,54
149771,418,"CĂMINUL CULTURAL CAPU CODRULUI","CAPU CODRULUI",SV,921,6,3,0,9,23,3,0,26,42,3,0,45,44,5,0,49,49,5,0,54
149771,419,"ŞCOALA GIMNAZIALĂ BOGDAN VODĂ CAPU CODRULUI","CAPU CODRULUI",SV,1222,4,7,0,11,11,8,0,19,22,8,0,30,29,9,0,38,35,10,0,45
149842,420,"PRIMARIA COMUNEI PATRAUTI",PĂTRĂUŢI,SV,2024,18,0,0,18,49,1,0,50,90,10,0,100,134,10,0,144,158,13,0,171
149842,421,"CAMINUL CULTURAL VECHI PATRAUTI",PĂTRĂUŢI,SV,1865,11,8,0,19,19,13,0,32,32,16,0,48,49,19,0,68,61,19,0,80
149799,422,"LICEUL TEHNOLOGIC ”NICANOR MOROȘAN” PÎRTEȘTII DE JOS","PÎRTEŞTII DE JOS",SV,1592,12,2,0,14,32,4,0,36,50,5,0,55,76,6,0,82,85,6,0,91
149806,423,"ŞCOALA DELENI",DELENI,SV,574,2,1,0,3,13,5,0,18,22,6,0,28,27,6,0,33,29,6,0,35
149824,424,"ŞCOALA VÂRFU DEALULUI","VÎRFU DEALULUI",SV,138,2,0,0,2,2,4,0,6,2,4,0,6,2,5,0,7,2,6,0,8
149860,425,"PRIMĂRIA POIANA STAMPEI","POIANA STAMPEI",SV,1603,18,0,0,18,65,1,0,66,82,1,0,83,100,3,0,103,115,4,0,119
149888,426,"COMPLEX SOCIAL DORNISOARA",DORNIŞOARA,SV,253,5,3,0,8,21,4,0,25,27,4,0,31,30,8,0,38,35,9,0,44
146726,427,"PRIMĂRIA POIENI-SOLCA",POIENI-SOLCA,SV,1714,6,0,0,6,25,2,0,27,29,2,0,31,39,2,0,41,55,2,0,57
149940,428,"ŞCOALA CU CLASELE I-IV POJORÎTA",POJORÎTA,SV,796,11,5,0,16,18,31,0,49,41,72,12,125,64,73,12,149,68,76,12,156
149940,429,"ŞCOALA GIMNAZIALĂ POJORÎTA",POJORÎTA,SV,1415,18,2,0,20,33,5,0,38,75,17,0,92,101,21,1,123,111,21,1,133
149959,430,"CĂMINUL CULTURAL VALEA PUTNEI","VALEA PUTNEI",SV,297,10,0,0,10,14,2,0,16,16,3,0,19,21,3,0,24,23,3,0,26
149986,431,"ŞCOALA GIMNAZIALĂ ARGHIRA",ARGHIRA,SV,927,4,4,0,8,16,7,0,23,19,8,0,27,26,9,0,35,34,11,0,45
149995,432,"ŞCOALA GIMNAZIALĂ BASARABI",BASARABI,SV,1420,5,0,0,5,15,1,0,16,20,1,0,21,24,1,0,25,28,2,0,30
150007,433,"ŞCOALA PRIMARĂ BAHNA ARIN","BAHNA ARIN",SV,178,2,0,0,2,14,0,0,14,24,0,0,24,25,0,0,25,29,0,0,29
149977,434,"CĂMINUL CULTURAL PREUTEŞTI",PREUTEŞTI,SV,1529,22,2,0,24,31,5,0,36,39,8,0,47,54,9,0,63,65,9,0,74
150025,435,"ŞCOALA PRIMARĂ HUŞI",HUŞI,SV,559,10,4,0,14,20,6,0,26,33,7,0,40,47,7,0,54,47,7,0,54
150034,436,"ŞCOALA GIMNAZIALĂ LEUCUŞEŞTI",LEUCUŞEŞTI,SV,924,12,2,0,14,26,2,0,28,39,3,0,42,53,3,0,56,57,7,0,64
150052,437,"CĂMINUL CULTURAL PUTNA- SALA CĂSĂTORIILOR",PUTNA,SV,1300,25,6,0,31,119,28,0,147,180,33,0,213,203,51,0,254,206,61,0,267
150052,438,"CĂMINUL CULTURAL PUTNA- SALA DE ŞEDINŢE",PUTNA,SV,793,9,4,0,13,41,5,0,46,56,12,0,68,74,36,0,110,89,36,0,125
150061,439,"CĂMINUL CULTURAL GURA PUTNEI","GURA PUTNEI",SV,1096,2,0,0,2,12,0,0,12,17,0,0,17,25,0,0,25,33,0,0,33
150089,440,"PRIMĂRIA COMUNEI RĂDĂŞENI",RĂDĂŞENI,SV,1067,9,3,0,12,22,11,0,33,28,12,0,40,33,12,0,45,35,12,0,47
150089,441,"PRIMĂRIA COMUNEI RĂDĂŞENI",RĂDĂŞENI,SV,1174,2,5,0,7,23,5,0,28,31,5,0,36,53,5,0,58,56,6,0,62
150098,442,"ȘCOALA MIHAI NICULĂIASA, SAT LĂMĂȘENI",LĂMĂŞENI,SV,1045,7,0,0,7,15,3,0,18,19,3,0,22,27,5,0,32,29,5,0,34
150105,443,"ȘCOALA POCOLENI",POCOLENI,SV,165,1,0,0,1,6,0,0,6,9,0,0,9,12,0,0,12,12,0,0,12
150123,444,"CĂMIN CULTURALRÎŞCA",RÎŞCA,SV,1532,5,2,0,7,16,3,0,19,27,5,0,32,37,7,0,44,41,7,0,48
150123,445,"ŞCOALA GENERALĂ RÎŞCA 3",RÎŞCA,SV,728,5,3,0,8,10,3,0,13,13,3,0,16,21,3,0,24,25,5,0,30
150150,446,"ȘCOALA JAHALIA",JAHALIA,SV,248,1,4,0,5,6,5,0,11,7,5,0,12,9,6,0,15,9,6,0,15
150132,447,"ȘCOALA PRIMARĂ NR. 2 RÎȘCA",BUDA,SV,604,4,7,0,11,8,11,0,19,11,11,0,22,13,12,0,25,14,12,0,26
150141,448,"ȘCOALA DUMBRĂVENI",DUMBRĂVENI,SV,318,6,2,0,8,7,3,0,10,11,3,0,14,12,3,0,15,13,3,0,16
150169,449,"ȘCOALA SLĂTIOARA",SLĂTIOARA,SV,635,7,0,0,7,17,0,0,17,21,2,0,23,26,3,0,29,28,8,0,36
150187,450,"CĂMINUL CULTURAL SADOVA",SADOVA,SV,1127,12,0,0,12,29,1,0,30,36,1,0,37,58,2,0,60,68,3,0,71
150187,451,"ŞCOALA GENERALĂ FUNDU SADOVEI",SADOVA,SV,938,6,0,0,6,12,0,0,12,16,0,0,16,30,0,0,30,33,0,0,33
150203,452,"CAMIN CULTURAL","SATU MARE",SV,1172,13,0,0,13,19,2,0,21,34,3,0,37,38,3,0,41,43,3,0,46
150203,453,"SCOALA GIMNAZIALA SATU MARE","SATU MARE",SV,1203,7,2,0,9,18,2,0,20,32,3,1,36,41,5,1,47,45,5,1,51
150212,454,"SCOALA GIMNAZIALA SAT TIBENI",ŢIBENI,SV,1156,9,0,0,9,13,0,0,13,18,0,0,18,33,0,0,33,37,0,0,37
150230,455,"CĂMINUL CULTURAL SIMINICEA",SIMINICEA,SV,1257,21,3,0,24,34,3,0,37,47,3,0,50,75,3,0,78,87,3,0,90
150230,456,"SCOALA GIMNAZIALA SIMINICEA",SIMINICEA,SV,850,6,0,0,6,11,0,0,11,27,2,0,29,44,2,0,46,46,4,0,50
150249,457,"SCOALA PRIMARA GRIGORESTI",GRIGOREŞTI,SV,260,0,1,0,1,5,3,0,8,7,8,0,15,13,9,0,22,14,9,0,23
150267,458,"PRIMARIA COMUNEI SLATINA",SLATINA,SV,1558,8,2,0,10,13,2,0,15,18,2,0,20,35,3,0,38,35,5,34,74
150285,459,"CĂMINUL CULTURAL HERLA",HERLA,SV,1100,9,4,0,13,17,4,0,21,35,4,0,39,64,6,0,70,65,6,0,71
150276,460,"ȘCOALA GIMNAZIALĂ GĂINEȘTI",GĂINEŞTI,SV,1625,9,0,0,9,25,5,0,30,41,5,0,46,63,5,18,86,69,5,18,92
150301,461,"GRĂDINIŢA DE COPII NR. 1 STRAJA",STRAJA,SV,1247,3,4,0,7,16,4,0,20,26,6,0,32,42,6,0,48,47,6,0,53
150301,462,"GRĂDINIŢA DE COPII NR. 3STRAJA",STRAJA,SV,1112,5,1,0,6,24,5,0,29,27,8,0,35,34,12,0,46,35,12,0,47
150301,463,"PRIMĂRIA COMUNEI STRAJA",STRAJA,SV,1162,4,3,0,7,22,7,0,29,38,8,0,46,56,11,0,67,63,11,0,74
150301,464,"GRĂDINIŢA DE COPII NR. 2STRAJA",STRAJA,SV,990,11,3,0,14,28,10,0,38,63,10,0,73,89,11,0,100,107,11,0,118
150329,465,"ŞCOALA GIMNAZIALĂ STROIEŞTI, SALA DE SPORT",STROIEŞTI,SV,1151,6,0,0,6,14,1,0,15,28,2,0,30,38,5,0,43,50,5,0,55
150329,466,"ŞCOALA GIMNAZIALĂ STROIEŞTI, SALA DE CLASĂ",STROIEŞTI,SV,984,9,0,0,9,26,3,0,29,26,4,0,30,29,5,0,34,39,5,0,44
150347,467,"SCOALA CU CLASELE I - IV ,, ILIE GRAMADA""",ZAHAREŞTI,SV,612,6,0,0,6,8,2,0,10,9,3,0,12,12,4,0,16,13,5,0,18
150365,468,"CAMINUL CULTURAL STULPICANI",STULPICANI,SV,1139,11,1,0,12,19,1,0,20,29,1,0,30,52,3,0,55,79,5,0,84
150365,469,"GRĂDINIŢACU PROGRAM NORMAL STULPICANI",STULPICANI,SV,1190,9,6,0,15,11,6,0,17,24,6,0,30,49,9,0,58,54,9,0,63
150383,470,"CĂMINUL CULTURAL NEGRILESA",NEGRILEASA,SV,839,5,4,0,9,6,4,0,10,18,5,0,23,24,5,0,29,26,5,0,31
150409,471,"ŞCOALA PRIMARĂ VADU NEGRILESEI","VADU NEGRILESEI",SV,465,4,3,0,7,5,3,0,8,9,3,0,12,14,3,0,17,14,3,0,17
150374,472,"ŞCOALA GIMNAZIALĂ GEMENEA",GEMENEA,SV,645,4,0,0,4,5,0,0,5,8,0,0,8,12,2,0,14,13,2,0,15
150392,473,"CĂMINUL CULTURAL SLĂTIOARA",SLĂTIOARA,SV,501,1,3,0,4,7,5,0,12,14,5,0,19,18,8,0,26,20,8,0,28
150427,474,"SCOALA GIMNAZIALĂ DIMITRIE VATAMANIUC",SUCEVIŢA,SV,1372,23,0,0,23,92,12,0,104,116,13,0,129,136,29,0,165,151,31,0,182
150436,475,"CĂMINUL CULTURAL VOIEVODEASA",VOIEVODEASA,SV,1035,12,5,0,17,39,8,0,47,62,8,0,70,91,9,0,100,100,10,0,110
150454,476,"SCOALA GIMNAZIALA NEAGRA SARULUI","NEAGRA ŞARULUI",SV,1609,24,0,0,24,52,1,0,53,90,4,0,94,108,5,0,113,120,5,0,125
150515,477,"SCOALA CU CLASELE I-VIII SARU DORNEI","ŞARU DORNEI",SV,943,6,0,0,6,12,1,0,13,17,2,0,19,22,3,0,25,29,3,0,32
150463,478,"SCOALA CU CLASELE I-IV GURA HAITII","GURA HAITII",SV,485,6,0,0,6,14,0,0,14,20,0,0,20,26,0,0,26,31,0,0,31
150490,479,"SCOALA CU CLASELE I-IV SARISORU MARE","SĂRIŞORU MARE",SV,451,1,0,0,1,1,0,0,1,12,0,0,12,16,0,0,16,20,0,0,20
146478,480,"CAMIN CULTURAL","SFÎNTU ILIE",SV,1442,11,2,0,13,36,4,0,40,59,5,0,64,84,7,0,91,109,7,0,116
146478,481,"CAMIN CULTURAL","SFÎNTU ILIE",SV,1750,13,4,0,17,36,4,0,40,54,5,0,59,83,5,0,88,93,5,0,98
146450,482,"CAMIN CULTURAL",FLORINTA,SV,172,0,0,0,0,2,0,0,2,3,0,0,3,4,0,0,4,4,0,0,4
146441,483,"ȘCOALA GIMNAZIALĂ ”DIMITRIE PĂCURARIU” ȘCHEIA",ŞCHEIA,SV,1718,15,0,0,15,30,16,0,46,67,24,0,91,103,38,0,141,124,41,0,165
146441,484,"ȘCOALA GIMNAZIALĂ ”DIMITRIE PĂCURARIU” ȘCHEIA",ŞCHEIA,SV,1490,20,3,0,23,37,5,0,42,56,6,0,62,80,8,0,88,92,8,0,100
146469,485,"ŞCOALA GIMNAZIALĂ",MIHOVENI,SV,1820,15,0,0,15,29,2,0,31,50,2,0,52,65,3,0,68,71,3,0,74
147624,486,"CAMIN CULTURAL SERBAUTI",ŞERBĂUŢI,SV,1620,6,0,0,6,21,2,0,23,35,2,0,37,60,2,0,62,66,4,0,70
147615,487,"CAMIN CULTURAL CALINESTI",CĂLINEŞTI,SV,983,3,1,0,4,6,2,0,8,14,4,0,18,26,6,0,32,26,6,0,32
150533,488,"SCOALA GIMNAZIALĂ TODIREŞTI",TODIREŞTI,SV,1216,10,0,0,10,16,0,0,16,28,3,0,31,39,3,0,42,47,3,0,50
150542,489,"SCOALA GIMNAZIALĂ ""VASILE BUMBAC"" COSTÎNA",COSTÎNA,SV,931,7,6,0,13,23,10,0,33,30,12,0,42,43,14,0,57,45,14,0,59
150551,490,"SCOALA GIMNAZIALĂ PĂRHĂUŢI",PĂRHĂUŢI,SV,1015,4,3,0,7,6,5,0,11,19,7,0,26,26,8,0,34,28,8,0,36
150579,491,"SCOALA GIMNAZIALĂ ""I.V.RACHIERU"" SOLONEŢ",SOLONEŢ,SV,1294,5,0,0,5,10,0,0,10,20,6,0,26,29,6,0,35,41,8,0,49
150597,492,"PRIMĂRIA COMUNEI UDEŞTI",UDEŞTI,SV,1976,23,1,0,24,43,3,0,46,68,7,0,75,86,7,0,93,94,9,0,103
150640,493,"CĂMINUL CULTURAL POIENI - SUCEAVA",POIENI-SUCEAVA,SV,466,5,2,0,7,33,9,0,42,36,10,0,46,49,14,0,63,67,16,0,83
150604,494,"CĂMINUL CULTURAL CHILIŞENI",CHILIŞENI,SV,628,5,1,0,6,9,3,0,12,15,3,0,18,17,3,0,20,20,4,0,24
150695,495,"CĂMINUL CULTURAL ŞTIRBĂŢ",ŞTIRBĂŢ,SV,455,8,3,0,11,15,5,0,20,22,6,0,28,49,12,0,61,50,12,0,62
150659,496,"CĂMINUL CULTURAL RACOVA",RACOVA,SV,240,3,1,0,4,5,1,0,6,10,1,0,11,17,2,0,19,19,2,0,21
150677,497,"ŞCOALA PRIMARĂ RUŞII - MĂNĂSTIOARA",RUŞII-MĂNĂSTIOARA,SV,426,8,1,0,9,13,2,0,15,26,3,0,29,33,3,0,36,37,3,0,40
150613,498,"ŞCOALA PRIMARĂ LUNCUŞOARA",LUNCUŞOARA,SV,521,14,1,0,15,39,5,0,44,65,7,0,72,105,9,0,114,111,9,0,120
150668,499,"ŞCOALA GIMNAZIALĂ REUSENI",REUSENI,SV,522,3,0,0,3,8,2,0,10,14,2,0,16,27,2,0,29,28,4,0,32
150631,500,"GRĂDINIŢA CU PROGRAM NORMAL PLĂVĂLARI",PLĂVĂLARI,SV,885,10,3,0,13,36,4,0,40,48,5,0,53,70,5,0,75,79,5,0,84
150711,501,"ŞCOALA GIMNAZIALA ULMA",ULMA,SV,551,5,5,0,10,8,5,0,13,10,5,0,15,14,6,0,20,16,7,0,23
150739,502,"ŞCOALA GIMNAZIALĂ LUPCINA",LUPCINA,SV,788,5,2,0,7,12,6,0,18,28,6,0,34,30,6,0,36,33,7,0,40
150757,503,"SALA DE ŞEDINŢE A CONSILIULUI LOCAL ULMA",NISIPITU,SV,356,2,2,0,4,10,2,0,12,20,3,0,23,24,3,0,27,24,3,0,27
150775,504,"ȘCOALA GIMNAZIALĂ NR 1 VADU MOLDOVEI","VADU MOLDOVEI",SV,874,19,1,0,20,45,4,0,49,45,4,0,49,45,4,0,49,45,4,0,49
150819,505,"ȘCOALA PRIMARĂ DUMBRĂVIȚA",DUMBRĂVIŢA,SV,826,7,0,0,7,16,0,0,16,16,0,0,16,21,3,0,24,24,3,0,27
150864,506,"ȘCOALA GIMNAZIALĂ NIGOTEȘTI",NIGOTEŞTI,SV,358,1,4,0,5,7,6,0,13,7,6,0,13,13,11,0,24,15,11,0,26
150855,507,"ȘCOALA PRIMARĂ MOVILENI",MOVILENI,SV,230,1,5,0,6,3,6,0,9,3,7,0,10,3,7,0,10,3,7,0,10
150846,508,"ȘCOALA PRIMARĂ MESTECENI",MESTECENI,SV,159,0,5,0,5,2,5,0,7,4,6,0,10,4,6,0,10,4,6,0,10
150837,509,"ȘCOALA PRIMARĂ IONEASA",IONEASA,SV,281,5,2,0,7,13,5,0,18,17,6,0,23,18,7,0,25,18,7,0,25
150793,510,"CĂMINUL CULTURAL CIUMULEȘTI",CIUMULEŞTI,SV,693,2,2,0,4,14,4,0,18,58,10,0,68,134,19,0,153,135,19,0,154
150775,511,"ȘCOALA GIMNAZIALĂ NR 2 VADU MOLDOVEI","VADU MOLDOVEI",SV,322,1,1,0,2,8,4,0,12,8,4,0,12,11,5,0,16,15,5,0,20
150908,512,"PRIMĂRIA COMUNEI VALEA MOLDOVEI, JUDEȚUL SUCEAVA","VALEA MOLDOVEI",SV,1329,9,0,0,9,18,4,0,22,28,11,0,39,33,11,0,44,35,13,0,48
150926,513,"ȘCOALA PRIMARĂ MIRONU",MIRONU,SV,1561,7,1,0,8,28,1,0,29,40,1,0,41,52,1,0,53,55,2,0,57
150944,514,"CĂMIN CULTURAL VAMA",VAMA,SV,994,9,2,0,11,19,3,0,22,23,4,0,27,32,5,0,37,35,6,0,41
150944,515,"SCOALA GIMNAZIALĂ ""IORGU G. TOMA"" LOCALUL NR.2",VAMA,SV,1710,10,0,0,10,27,0,0,27,27,3,16,46,39,8,16,63,42,8,16,66
150971,516,"ŞCOALA GIMNAZIALĂ ""IORGU G. TOMA"" LOCALUL DIN SATUL STRÂMTURA",STRÎMTURA,SV,1037,3,3,0,6,5,7,0,12,7,7,0,14,8,7,0,15,13,7,0,20
150953,517,"ŞCOLA GIMNAZIALĂ ""IORGU G. TOMA"" LOCALUL DIN SATUL MOLID",MOLID,SV,522,8,1,0,9,16,3,0,19,20,5,0,25,23,5,0,28,28,6,0,34
150962,518,"ŞCOALA GIMNAZIALĂ ""IORGU G. TOMA"" LOCALUL DIN SATUL PRISACA DORNEI","PRISACA DORNEI",SV,684,8,1,0,9,13,1,0,14,22,3,0,25,35,3,0,38,40,3,0,43
150999,519,"CĂMINUL CULTURAL VATRA MOLDOVIȚEI","VATRA MOLDOVIŢEI",SV,1172,11,0,0,11,16,3,0,19,25,6,0,31,61,10,0,71,65,10,0,75
150999,520,"ȘCOALA PRIMARĂVALEA STÂNII","VATRA MOLDOVIŢEI",SV,649,6,0,0,6,10,0,0,10,11,2,0,13,19,5,0,24,21,5,0,26
151004,521,"SALA POLIVALENTĂ CIUMÂRNA",CIUMÎRNA,SV,381,1,0,0,1,1,0,0,1,5,1,0,6,8,1,0,9,10,1,0,11
151013,522,"ȘCOALA GIMNAZIALĂPALTINU",PALTINU,SV,697,5,0,0,5,9,0,0,9,9,0,0,9,15,0,0,15,15,0,0,15
151013,523,"ŞCOALA PRIMARĂ SPĂRTURI",PALTINU,SV,671,0,0,0,0,4,0,0,4,7,0,0,7,11,0,0,11,12,0,0,12
151031,524,"CAMINUL CULTURAL VERESTI",VEREŞTI,SV,1256,7,0,0,7,23,1,0,24,35,1,0,36,61,3,0,64,65,4,0,69
151068,525,"SALA DE SEDINTE A CONSILIULUI LOCAL VERESTI",HANCEA,SV,889,2,0,0,2,3,0,0,3,6,2,0,8,15,2,0,17,21,2,0,23
151059,526,"SCOALA GIMNAZIALA COROCAIESTI",COROCĂIEŞTI,SV,1042,9,0,0,9,15,3,0,18,33,5,0,38,50,7,0,57,59,9,0,68
151059,527,"CAMINUL CULTURAL COROCAIESTI",COROCĂIEŞTI,SV,1290,8,2,0,10,21,2,0,23,32,3,0,35,44,3,0,47,48,3,0,51
151040,528,"SCOALA GIMNAZIALA BURSUCENI",BURSUCENI,SV,1149,11,0,0,11,22,0,0,22,45,0,0,45,45,5,0,50,53,5,0,58
151086,529,"SCOALACU CLASELE I-VIII IOAN VICOVEANU","VICOVU DE JOS",SV,1349,11,2,0,13,29,4,0,33,53,6,0,59,73,12,0,85,79,12,0,91
151086,530,"SCOALA CU CLASELE I-VIII NR.2 REMEZAU","VICOVU DE JOS",SV,1967,26,2,0,28,39,4,0,43,75,4,0,79,106,4,0,110,125,4,0,129
151086,531,"SCOALA CU CLASELE I-IV MARGINE","VICOVU DE JOS",SV,794,2,6,0,8,6,6,0,12,13,6,0,19,17,6,0,23,25,6,0,31
151086,532,"GRĂDINIŢA ""POD DABÎCA""","VICOVU DE JOS",SV,1032,15,0,0,15,26,0,0,26,46,0,0,46,72,0,0,72,91,1,0,92
148907,533,"CĂMINUL CULTURAL VOITINEL",VOITINEL,SV,1716,6,0,0,6,32,1,23,56,68,1,23,92,150,1,23,174,205,7,23,235
148907,534,"SCOALA CU CLASELE I-VIII VOITINEL",VOITINEL,SV,1535,11,0,0,11,35,1,0,36,84,2,8,94,143,9,8,160,190,11,8,209
151139,535,"CĂMINUL CULTURAL",VOLOVĂŢ,SV,1661,17,2,0,19,35,2,0,37,68,2,0,70,94,2,0,96,108,2,0,110
151139,536,"CĂMINUL CULTURAL",VOLOVĂŢ,SV,1679,28,1,0,29,70,1,0,71,100,2,0,102,126,3,0,129,143,3,0,146
151139,537,"PRIMĂRIA COMUNEI VOLOVĂŢ",VOLOVĂŢ,SV,850,11,1,0,12,22,1,0,23,34,1,0,35,45,1,0,46,56,1,0,57
151166,538,"ŞCOALA GIMNAZIALĂ ""CONSTANTIN TOMESCU"" PLEŞEŞTI",PLEŞEŞTI,SV,499,1,2,0,3,1,2,0,3,2,4,0,6,10,8,0,18,12,8,0,20
151228,539,"ŞCOALA GIMNAZIALĂ VALEA GLODULUI","VALEA GLODULUI",SV,734,14,1,0,15,20,2,0,22,26,4,0,30,30,4,0,34,30,4,0,34
151175,540,"SCOALA GIMNAZIALĂ GIURGEŞTI",GIURGEŞTI,SV,590,2,1,0,3,2,1,0,3,7,2,0,9,8,2,0,10,10,2,0,12
151184,541,"LOCALUL FOSTEI ŞCOLI HREAŢCA (IMOBIL PROPRIETATEA SOCIETĂŢII COOPERATIVE ""VULTURUL PLEŞUV"" VULTUREŞTI)",HREAŢCA,SV,329,0,1,0,1,4,1,0,5,5,2,0,7,7,2,0,9,7,4,0,11
151200,542,"ŞCOALA CU CLASELE I - IV",MEREŞTI,SV,201,2,0,0,2,2,0,0,2,2,2,0,4,6,3,0,9,11,5,0,16
151193,543,"LOCALUL FOSTEI ŞCOLI JACOTA",JACOTA,SV,114,1,2,0,3,5,3,0,8,5,3,0,8,6,4,0,10,8,4,0,12
151219,544,"SCOALA PRIMARĂ OSOI",OSOI,SV,275,4,3,0,7,7,3,0,10,7,3,0,10,8,3,0,11,8,3,0,11
151255,545,"CĂMINUL CULTURAL ZAMOSTEA",ZAMOSTEA,SV,1234,3,2,0,5,13,6,0,19,24,6,0,30,34,6,0,40,40,8,0,48
151273,546,"ȘCOALA PRIMARĂ CIOMÎRTAN",CIOMÎRTAN,SV,465,3,0,0,3,12,3,0,15,12,4,0,16,13,8,0,21,16,8,0,24
151308,547,"ȘCOALA PRIMARĂ LUNCA",LUNCA,SV,208,1,0,0,1,2,2,0,4,6,2,0,8,6,2,0,8,6,2,0,8
151317,548,"ȘCOALA PRIMARĂ NICANI",NICANI,SV,409,2,4,0,6,8,7,0,15,16,7,0,23,26,7,0,33,28,7,0,35
151335,549,"ȘCOALA PRIMARĂ TĂUTEȘTI",TĂUTEŞTI,SV,150,0,0,0,0,4,5,0,9,5,5,0,10,10,5,0,15,12,5,0,17
151353,550,"ŞCOALA GENERALĂ ZVORIŞTEA",ZVORIŞTEA,SV,777,8,0,0,8,16,0,0,16,17,2,0,19,22,2,50,74,24,2,50,76
151371,551,"ŞCOALA GENERALĂ BUDA",DEALU,SV,654,3,0,0,3,7,0,0,7,13,0,0,13,19,0,0,19,23,0,0,23
151362,552,"ŞCOALA GENERALĂ BUDA",BUDA,SV,930,7,0,0,7,10,0,0,10,27,0,0,27,37,0,0,37,46,0,0,46
151415,553,"CASA DE PRĂZNUIRE A PAROHIEI ORTODOXE STÎNCA",STÎNCA,SV,476,2,5,0,7,8,5,0,13,8,5,0,13,9,5,0,14,9,5,0,14
151424,554,"ŞCOALA GENERALĂ STÎNCUŢA",STÎNCUŢA,SV,130,2,0,0,2,2,0,0,2,2,2,0,4,2,2,0,4,2,3,0,5
151380,555,"CASA DE PRĂZNUIRE A PAROHIEI ORTODOXE POIANA",POIANA,SV,453,9,1,0,10,23,3,0,26,44,6,0,50,60,7,0,67,61,7,0,68
151399,556,"ŞCOALA GENERALĂ ŞERBĂNEŞTI",ŞERBĂNEŞTI,SV,925,8,2,0,10,20,2,0,22,22,2,0,24,29,3,1,33,32,3,1,36
151406,557,"CASA DE PRĂZNUIRE A PAROHIEI ORTODOXE SLOBOZIA",SLOBOZIA,SV,490,1,2,0,3,5,3,0,8,6,4,0,10,13,6,0,19,16,9,0,25
146478,558,"CĂMINUL CULTURAL, SAT SFÎNTU ILIE","SFÎNTU ILIE",SV,717,2,8,0,10,11,8,0,19,19,8,0,27,28,8,0,36,43,8,0,51
159623,1,"GRĂDINIŢA CU PROGRAM PRELUNGIT NR.18",TULCEA,TL,1081,7,1,0,8,18,2,0,20,26,3,0,29,34,5,0,39,38,7,0,45
159623,2,"GRĂDINIŢA CU PROGRAM PRELUNGIT NR.18",TULCEA,TL,1318,8,0,0,8,25,5,0,30,39,5,0,44,53,7,0,60,61,7,1,69
159623,3,"ŞCOALA GIMNAZIALĂ"" ION LUCA CARAGIALE""",TULCEA,TL,1836,16,0,0,16,39,2,0,41,59,2,0,61,69,2,0,71,72,2,0,74
159623,4,"ŞCOALA GIMNAZIALĂ"" ION LUCA CARAGIALE""",TULCEA,TL,1758,17,3,0,20,53,4,0,57,70,5,0,75,91,5,0,96,93,5,0,98
159623,5,"ŞCOALA GIMNAZIALĂ"" ION LUCA CARAGIALE""",TULCEA,TL,1799,16,4,0,20,35,4,0,39,42,4,0,46,54,5,0,59,57,5,0,62
159623,6,"GRĂDINIŢA CU PROGRAM PRELUNGIT NR.13",TULCEA,TL,1712,9,6,0,15,33,6,0,39,44,6,0,50,59,7,0,66,62,8,0,70
159623,7,"LICEUL DE ARTE ""GEORGEGEORGESCU""",TULCEA,TL,1238,29,1,0,30,67,1,0,68,86,3,0,89,96,5,0,101,102,5,0,107
159623,8,"LICEUL DE ARTE ""GEORGEGEORGESCU""",TULCEA,TL,1153,12,1,0,13,25,3,0,28,29,3,0,32,36,3,0,39,40,3,0,43
159623,9,"LICEUL DE ARTE ""GEORGEGEORGESCU""",TULCEA,TL,1356,6,0,0,6,21,1,0,22,26,3,0,29,40,3,0,43,48,4,0,52
159623,10,"LICEUL DE ARTE ""GEORGEGEORGESCU""",TULCEA,TL,980,15,0,0,15,47,3,0,50,61,7,0,68,72,14,0,86,73,18,0,91
159623,11,"LICEUL DE ARTE ""GEORGEGEORGESCU""",TULCEA,TL,977,15,0,0,15,40,6,0,46,47,7,0,54,54,7,0,61,54,7,0,61
159623,12,"GRĂDINIŢA CU PROGRAM PRELUNGIT NR.12",TULCEA,TL,1774,31,3,0,34,71,4,0,75,88,5,0,93,95,5,0,100,100,6,0,106
159623,13,"LICEUL TEORETIC ""ION CREANGĂ""",TULCEA,TL,1194,16,0,0,16,26,2,0,28,36,6,0,42,42,7,0,49,44,7,0,51
159623,14,"LICEUL TEORETIC ""ION CREANGĂ""",TULCEA,TL,990,8,2,0,10,16,2,0,18,26,5,0,31,37,5,0,42,42,5,0,47
159623,15,"ŞCOALA GIMNAZIALĂ ""ELENA DOAMNA""",TULCEA,TL,1300,9,5,0,14,32,11,0,43,43,11,0,54,48,11,0,59,55,11,0,66
159623,16,"ŞCOALA GIMNAZIALĂ ""ELENA DOAMNA""",TULCEA,TL,1002,6,1,0,7,17,4,0,21,27,4,0,31,42,5,0,47,43,5,0,48
159623,17,"SEMINARUL TEOLOGIC ORTODOX ""SF. IOAN CASIAN""",TULCEA,TL,1058,8,5,0,13,17,6,0,23,27,6,0,33,30,6,0,36,36,11,0,47
159623,18,"SEMINARUL TEOLOGIC ORTODOX ""SF. IOAN CASIAN""",TULCEA,TL,973,6,1,0,7,29,2,0,31,43,5,0,48,51,5,0,56,54,5,0,59
159623,19,"TEATRUL ""JEAN BART""",TULCEA,TL,1678,16,3,0,19,68,8,0,76,99,12,0,111,124,15,1,140,140,15,1,156
159623,20,"ŞCOALA GIMNAZIALĂ ""GRIGORE ANTIPA""",TULCEA,TL,1209,16,0,0,16,37,0,0,37,47,0,0,47,62,1,0,63,66,1,0,67
159623,21,"ŞCOALA GIMNAZIALĂ ""GRIGORE ANTIPA""",TULCEA,TL,1135,19,1,0,20,41,1,0,42,56,3,0,59,64,8,0,72,67,8,0,75
159623,22,"GRĂDINIȚA CU PROGRAM PRELUNGIT ""DRUMBAVA MINUNATĂ""",TULCEA,TL,1838,13,4,0,17,39,7,0,46,61,10,0,71,86,12,0,98,89,12,0,101
159623,23,"ŞCOALA GIMNAZIALĂ ""ALEXANDRU CIUCURENCU""",TULCEA,TL,1298,17,6,0,23,46,7,0,53,72,11,0,83,87,20,0,107,99,22,0,121
159623,24,"ŞCOALA GIMNAZIALĂ ""ALEXANDRU CIUCURENCU""",TULCEA,TL,1701,28,6,0,34,57,7,0,64,67,7,0,74,89,11,0,100,93,11,0,104
159623,25,"ŞCOALA GIMNAZIALĂ ""CONSTANTIN GĂVENEA""",TULCEA,TL,1721,13,4,0,17,31,5,0,36,54,7,0,61,72,8,0,80,79,10,0,89
159623,26,"ŞCOALA GIMNAZIALĂ ""CONSTANTIN GĂVENEA""",TULCEA,TL,1444,5,0,0,5,24,1,0,25,33,1,0,34,37,5,0,42,46,5,0,51
159623,27,"ŞCOALA GIMNAZIALĂ ""CONSTANTIN GĂVENEA""",TULCEA,TL,1564,6,0,0,6,31,2,0,33,44,2,0,46,55,4,0,59,61,4,0,65
159623,28,"PUNCT DE ÎNCASARE TAXE ŞI IMPOZITE LOCALE",TULCEA,TL,1767,13,0,0,13,40,0,0,40,52,0,0,52,59,0,0,59,67,0,0,67
159623,29,"LICEUL TEORETIC ""GRIGORE MOISIL""",TULCEA,TL,1309,11,4,0,15,37,6,0,43,49,9,0,58,64,11,0,75,69,11,0,80
159623,30,"LICEUL TEORETIC ""GRIGORE MOISIL""",TULCEA,TL,1173,10,4,0,14,31,4,0,35,41,4,84,129,60,4,84,148,65,4,84,153
159623,31,"ŞCOALA GIMNAZIALĂ NR.12",TULCEA,TL,1320,10,0,0,10,32,0,0,32,44,1,0,45,53,1,0,54,59,1,0,60
159623,32,"ŞCOALA GIMNAZIALĂ NR.12",TULCEA,TL,1446,14,0,0,14,38,1,0,39,48,1,0,49,61,1,0,62,64,1,0,65
159623,33,"SALA DE SPORT MULTIFUNCŢIONALĂ",TULCEA,TL,1522,11,0,0,11,39,1,0,40,56,1,0,57,73,1,0,74,76,1,0,77
159623,34,"GRĂDINIŢA CU PROGRAM PRELUNGIT NR.17",TULCEA,TL,1635,19,2,0,21,53,2,0,55,67,3,0,70,89,3,0,92,92,3,0,95
159623,35,"GRĂDINIŢA CU PROGRAM PRELUNGIT NR.17",TULCEA,TL,1753,11,1,0,12,27,1,0,28,38,2,0,40,43,3,0,46,45,3,0,48
159623,36,"COLEGIUL TEHNIC ""HENRY COANDĂ""",TULCEA,TL,1574,7,2,0,9,22,4,0,26,35,5,0,40,61,9,1,71,70,9,1,80
159623,37,"BIBLIOTECA JUDEŢEANĂ",TULCEA,TL,1376,18,5,0,23,59,9,0,68,74,13,0,87,92,16,0,108,97,16,0,113
159623,38,"COLEGIUL ECONOMIC "" DELTA DUNĂRII""",TULCEA,TL,1222,6,6,0,12,16,6,0,22,20,9,0,29,27,11,0,38,27,11,0,38
159623,39,"COLEGIUL ECONOMIC "" DELTA DUNĂRII""",TULCEA,TL,999,0,4,0,4,10,4,0,14,14,5,0,19,20,6,0,26,20,6,0,26
159623,40,"S.C. TRANSPORT PUBLIC S.A.",TULCEA,TL,1403,3,0,0,3,13,3,0,16,25,3,0,28,32,4,0,36,38,4,0,42
159623,41,"COLEGIUL""ANGHEL SALIGNY""",TULCEA,TL,1604,11,3,0,14,17,3,0,20,22,4,0,26,28,4,0,32,29,5,0,34
159623,42,"CASA DE CULTURĂ",TULCEA,TL,1478,7,2,0,9,32,4,0,36,53,6,0,59,62,6,0,68,64,6,0,70
159623,43,"CASA DE CULTURĂ",TULCEA,TL,541,6,10,0,16,17,13,0,30,21,16,0,37,23,16,0,39,23,16,0,39
159623,44,"COLEGIUL DOBROGEAN ""SPIRU HARET""",TULCEA,TL,1846,11,0,0,11,33,2,0,35,43,4,0,47,57,4,0,61,60,5,0,65
159623,45,"ŞCOALA GIMNAZIALĂ ""NIFON BĂLĂŞESCU""",TULCEA,TL,1131,12,0,0,12,30,5,0,35,37,5,0,42,39,5,0,44,40,5,0,45
159623,46,"ŞCOALA GIMNAZIALĂ ""NIFON BĂLĂŞESCU""",TULCEA,TL,1568,17,4,0,21,37,5,0,42,48,6,0,54,64,6,0,70,67,6,0,73
159623,47,"ŞCOALA GIMNAZIALĂ ""NIFON BĂLĂŞESCU""",TULCEA,TL,1488,9,2,0,11,32,5,0,37,49,6,0,55,62,6,9,77,71,6,9,86
159623,48,"ŞCOALA PROFESIONALĂ ""DANUBIUS""",TULCEA,TL,1192,1,0,0,1,11,1,0,12,21,1,0,22,25,1,0,26,25,1,0,26
159623,49,"ŞCOALA PROFESIONALĂ ""DANUBIUS""",TULCEA,TL,1162,6,0,0,6,10,0,0,10,14,0,0,14,17,0,0,17,19,0,0,19
159623,50,"ŞCOALA PRIMARĂ NR. 9",TULCEA,TL,1194,5,8,0,13,19,8,0,27,30,9,0,39,33,9,0,42,36,9,0,45
159623,51,"ŞCOALA PRIMARĂ NR. 9",TULCEA,TL,1357,8,4,0,12,32,5,0,37,45,5,0,50,56,5,0,61,58,5,0,63
159623,52,"ŞCOALA GIMNAZIALĂ ""IOAN NENIŢESCU""",TULCEA,TL,1315,11,3,0,14,23,3,0,26,36,3,0,39,40,3,0,43,48,4,0,52
159623,53,"ŞCOALA GIMNAZIALĂ ""IOAN NENIŢESCU""",TULCEA,TL,1379,19,3,0,22,31,3,0,34,37,3,0,40,47,6,0,53,50,6,0,56
159669,54,"GRUP SCOLAR DIMITRIE CANTEMIR",BABADAG,TL,1480,12,6,0,18,26,6,0,32,33,6,0,39,40,6,0,46,47,7,0,54
159669,55,"SCOALA GENERALA NR.1MIRCEA CEL BATRAN",BABADAG,TL,1819,24,1,0,25,41,5,0,46,60,8,0,68,73,9,0,82,78,11,0,89
159669,56,"SCOALA GENERALA NR.2",BABADAG,TL,1348,10,0,0,10,19,2,0,21,27,2,0,29,34,5,0,39,42,6,0,48
159669,57,"ŞCOALA GENERALĂ NR. 3 “CONSTANTIN BRÂNCOVEANU”",BABADAG,TL,1421,4,0,0,4,6,1,0,7,13,5,0,18,14,5,0,19,18,6,0,24
159669,58,"GRĂDINIŢA DE COPII NR.2-VETERANI",BABADAG,TL,604,1,0,0,1,3,0,0,3,5,0,0,5,6,0,0,6,7,0,0,7
159669,59,"SALA DE SPORT TOMA AUREL",BABADAG,TL,1289,12,4,0,16,26,5,0,31,44,5,0,49,57,5,0,62,65,6,0,71
159696,60,"SEDIUL ADMINISTRATIV AL PRIMĂRIEI ORAȘULUI ISACCEA",ISACCEA,TL,1350,11,0,0,11,22,0,0,22,29,0,0,29,43,0,0,43,43,0,0,43
159696,61,"LICEUL TEORETIC “CONSTANTIN BRĂTESCU""",ISACCEA,TL,1154,5,2,0,7,7,2,0,9,12,2,0,14,16,2,0,18,20,2,0,22
159696,62,"GRĂDINIŢA “CONSTANTIN BRĂTESCU”",ISACCEA,TL,1322,7,0,0,7,13,5,0,18,18,5,0,23,25,5,0,30,31,5,0,36
159712,63,"GRĂDINIȚA CU PROGRAM NORMAL REVĂRSAREA",REVĂRSAREA,TL,407,4,1,0,5,5,1,0,6,7,1,0,8,9,2,0,11,10,2,0,12
159749,64,"ŞCOALA GIMNAZIALĂ “GHEORGHE BANEA”",MĂCIN,TL,1265,14,0,0,14,26,1,0,27,26,4,0,30,34,5,0,39,36,5,0,41
159749,65,"ŞCOALA GIMNAZIALĂ “GHEORGHE BANEA”",MĂCIN,TL,1374,10,0,0,10,26,2,0,28,28,4,0,32,36,5,0,41,39,5,0,44
159749,66,"GRĂDINIŢA NR. 3",MĂCIN,TL,1213,11,0,0,11,16,0,0,16,22,0,0,22,29,1,0,30,32,1,0,33
159749,67,"ŞCOALA GIMNAZIALĂ NR. 1",MĂCIN,TL,1628,9,2,0,11,17,3,0,20,20,3,0,23,29,3,0,32,29,3,0,32
159749,68,"ŞCOALA GIMNAZIALĂ NR. 1",MĂCIN,TL,1211,17,0,0,17,26,0,0,26,42,0,0,42,51,0,0,51,53,0,0,53
159749,69,"LICEUL TEORETIC” GHEORGHE MUNTEANU MURGOCI”",MĂCIN,TL,1435,6,0,0,6,10,0,0,10,12,0,0,12,16,2,0,18,16,2,0,18
159749,70,"LICEUL TEORETIC” GHEORGHE MUNTEANU MURGOCI”",MĂCIN,TL,929,3,0,0,3,7,0,0,7,11,2,0,13,15,2,0,17,15,2,0,17
159776,71,"SCOALA I- IV - INCAPERE EXPOZITIONALA",SULINA,TL,1045,11,0,0,11,22,0,0,22,27,1,0,28,36,1,0,37,36,1,0,37
159776,72,"LICEUL “JEAN BART”, LOCALITATEA SULINA",SULINA,TL,210,3,1,0,4,8,3,0,11,8,3,0,11,9,3,0,12,9,3,0,12
159776,73,"LICEUL “JEAN BART”, LOCALITATEA SULINA",SULINA,TL,1088,9,1,0,10,18,1,0,19,20,1,0,21,26,1,0,27,27,2,0,29
159776,74,"PRIMĂRIA ORAŞULUI SULINA",SULINA,TL,1111,3,5,0,8,11,9,0,20,26,16,0,42,36,25,0,61,38,32,0,70
159794,75,"ŞCOALAGIMNAZIALĂ BAIA",BAIA,TL,1551,27,1,0,28,31,6,0,37,37,6,0,43,45,7,0,52,46,7,0,53
159794,76,"ŞCOALA CU CLASELE I-IV BAIA",BAIA,TL,817,10,0,0,10,16,0,0,16,22,0,0,22,26,0,0,26,26,0,0,26
159801,77,"ŞCOALA PRIMARĂ CAMENA",CAMENA,TL,309,4,2,0,6,7,3,0,10,19,4,0,23,20,4,0,24,21,4,0,25
159810,78,"ŞCOALA CU CLASELE I-IVCAUGAGIA",CAUGAGIA,TL,181,3,5,0,8,3,6,0,9,4,6,0,10,6,8,0,14,7,8,0,15
159838,79,"ŞCOALA PRIMARĂ PANDURU",PANDURU,TL,319,0,0,0,0,2,0,0,2,2,1,0,3,8,1,0,9,8,1,0,9
159829,80,"ŞCOALA GIMNAZIALĂ CEAMURLIA DE SUS","CEAMURLIA DE SUS",TL,540,4,1,0,5,7,1,0,8,11,1,0,12,13,1,0,14,13,1,0,14
159856,81,PUBLICA,BEIDAUD,TL,429,2,5,0,7,7,7,0,14,15,10,0,25,18,13,0,31,20,13,0,33
159865,82,"CAMINUL CULTURAL",NEATÎRNAREA,TL,383,3,0,0,3,5,0,0,5,9,2,0,11,10,3,0,13,10,3,0,13
159874,83,"CAMINUL CULTURAL","SARIGHIOL DE DEAL",TL,465,7,0,0,7,8,3,0,11,8,3,0,11,17,5,0,22,48,5,0,53
160760,84,"ŞCOALA GIMNAZIALĂ BEŞTEPE",BEŞTEPE,TL,1418,9,0,0,9,14,0,0,14,16,0,0,16,20,3,0,23,21,3,0,24
160742,85,ŞCOALA,"BĂLTENII DE JOS",TL,57,0,0,0,0,1,0,0,1,6,1,0,7,6,3,0,9,6,3,0,9
159918,86,"ŞCOALA PRIMARĂ",LETEA,TL,241,4,0,0,4,4,1,0,5,6,1,0,7,10,3,0,13,11,3,0,14
159927,87,"ŞCOALA PRIMARĂ",PERIPRAVA,TL,180,3,0,0,3,3,0,0,3,7,1,0,8,7,2,0,9,7,8,0,15
159892,88,"ŞCOALA GIMNAZIALĂ","C.A. ROSETTI",TL,243,7,2,0,9,10,4,0,14,10,4,0,14,10,4,0,14,11,4,0,15
159954,89,"ŞCOALA GIMNAZIALA CARCALIU",CARCALIU,TL,1392,8,0,0,8,13,0,0,13,16,1,0,17,20,3,0,23,21,3,0,24
159954,90,"ŞCOALA GIMNAZIALA CARCALIU",CARCALIU,TL,1146,6,0,0,6,8,0,0,8,11,0,0,11,11,4,0,15,12,4,0,16
159981,91,ŞCOALA,"CIŞMEAUA NOUĂ",TL,36,4,3,0,7,4,3,0,7,9,4,0,13,13,4,0,17,13,4,0,17
159972,92,"ŞCOALA GIMNAZIALĂ",CASIMCEA,TL,1115,9,0,0,9,21,2,0,23,23,2,0,25,38,4,0,42,38,4,0,42
159990,93,"ŞCOALA PRIMARĂ",CORUGEA,TL,336,4,1,0,5,4,1,0,5,4,1,0,5,7,1,0,8,8,1,0,9
160010,94,"ŞCOALA PRIMARĂ",RAHMAN,TL,249,6,0,0,6,14,0,0,14,15,1,0,16,20,3,0,23,22,3,0,25
160029,95,"ŞCOALA PRIMARĂ",RĂZBOIENI,TL,495,4,0,0,4,5,0,0,5,8,0,0,8,9,0,0,9,11,0,0,11
160109,96,"ȘCOALA GIMNZIALĂ CEMURLIA DE JOS","CEAMURLIA DE JOS",TL,988,8,1,0,9,9,2,0,11,11,2,0,13,21,3,0,24,25,4,0,29
160118,97,"ŞCOALA PRIMARĂ LUNCA",LUNCA,TL,1039,4,1,0,5,16,1,0,17,22,1,0,23,24,5,0,29,30,5,0,35
160065,98,"ŞCOALA VECHE",PĂTLĂGEANCA,TL,172,3,1,0,4,10,3,0,13,11,3,0,14,17,5,0,22,17,5,0,22
160056,99,"CĂMINUL CULTURAL",CEATALCHIOI,TL,387,4,4,0,8,5,4,0,9,10,6,0,16,11,6,0,17,13,6,0,19
160074,100,"ŞCOALA VECHE",PLAURU,TL,36,2,4,0,6,3,7,0,10,3,8,0,11,4,11,0,15,4,13,0,17
160154,101,"ŞCOALA MIRCEA VODĂ","MIRCEA VODĂ",TL,407,4,3,0,7,6,3,0,9,6,3,0,9,9,3,0,12,9,3,0,12
160136,102,"ŞCOALA GIMNAZIALĂ ""PANAIT CERNA""",CERNA,TL,1716,5,0,0,5,18,0,0,18,29,0,0,29,46,3,0,49,46,4,0,50
160163,103,"ŞCOALA TRAIAN",TRAIAN,TL,821,2,0,0,2,8,1,0,9,13,2,0,15,17,4,0,21,20,4,0,24
160145,104,"ŞCOALA GENERAL PRAPORGESCU","GENERAL PRAPORGESCU",TL,154,2,1,0,3,2,3,0,5,8,3,0,11,9,3,0,12,9,3,0,12
160181,105,"CAMIN CULTURAL","CHILIA VECHE",TL,836,4,0,0,4,9,0,0,9,10,0,0,10,15,7,0,22,17,11,0,28
160181,106,"CAMIN CULTURAL","CHILIA VECHE",TL,834,5,1,0,6,7,1,0,8,9,1,0,10,11,2,0,13,11,2,0,13
160234,107,"ŞCOALA GIMNAZIALĂ",CIUCUROVA,TL,1117,11,4,0,15,18,4,0,22,21,4,0,25,28,4,0,32,32,4,0,36
160243,108,"ŞCOALA PRIMARĂ",ATMAGEA,TL,150,0,3,0,3,1,5,0,6,1,5,0,6,2,5,0,7,2,5,0,7
160252,109,"ŞCOALA PRIMARĂ","FÎNTÎNA MARE",TL,442,5,2,0,7,11,4,0,15,13,5,0,18,15,5,0,20,16,5,0,21
160270,110,"ŞCOALA GIMNAZIALĂ CRISAN",CRIŞAN,TL,380,9,1,0,10,15,11,0,26,19,16,0,35,19,18,0,37,19,19,0,38
160289,111,"ŞCOALA PRIMARĂ CARAORMAN",CARAORMAN,TL,249,2,0,0,2,4,0,0,4,4,0,0,4,6,0,0,6,6,0,0,6
160298,112,"ŞCOALA GIMNAZIALĂ MILA23","MILA 23",TL,382,5,3,0,8,6,5,0,11,7,7,0,14,9,15,0,24,10,20,0,30
160314,113,"ȘCOALA GIMNAZIALĂ DĂENI",DĂENI,TL,1665,4,3,0,7,8,3,0,11,15,4,0,19,19,4,0,23,19,5,0,24
160332,114,"SCOALA GIMNAZIALA DOROBANTU",DOROBANŢU,TL,636,7,0,0,7,9,1,0,10,15,3,0,18,19,4,0,23,22,7,0,29
160350,115,"ȘCOALA CÎRJELARI",CÎRJELARI,TL,362,3,2,0,5,3,2,0,5,4,4,0,8,7,4,0,11,9,5,0,14
160378,116,"ȘCOALA MEȘTERU",MEŞTERU,TL,127,2,2,0,4,2,2,0,4,3,2,0,5,4,2,0,6,4,2,0,6
160396,117,"CAMIN CULTURAL FRECATEI",FRECĂŢEI,TL,1016,11,1,0,12,17,1,0,18,23,2,0,25,28,3,0,31,32,4,0,36
160403,118,"CENTRU MULTIFUNCTIONAL CATALOI",CATALOI,TL,1037,6,0,0,6,14,0,0,14,21,0,0,21,22,0,0,22,22,0,0,22
160412,119,"CAMIN CULTURAL POSTA",POŞTA,TL,525,6,3,0,9,9,5,0,14,20,11,0,31,31,19,0,50,31,19,0,50
160421,120,"CĂMIN CULTURAL TELIȚA",TELIŢA,TL,438,4,0,0,4,5,3,0,8,5,3,0,8,7,3,0,10,7,3,0,10
160449,121,"ŞCOALA GIMNAZIALĂ GRECI, CORP A",GRECI,TL,1521,2,1,0,3,5,1,0,6,10,2,0,12,21,5,0,26,23,5,0,28
160449,122,"ŞCOALA GIMNAZIALĂ GRECI, CORP B",GRECI,TL,1562,10,0,0,10,16,0,0,16,28,0,0,28,35,2,0,37,35,2,0,37
160449,123,"ŞCOALA GIMNAZIALĂ GRECI,CORP B",GRECI,TL,1271,2,0,0,2,5,4,0,9,10,4,0,14,14,5,0,19,16,5,0,21
160467,124,"CENTRUL SOCIAL DE ZI PENTRU PERSOANE DEFAVORIZATE",GRINDU,TL,1139,2,0,0,2,7,1,0,8,12,1,0,13,17,1,0,18,17,1,0,18
160485,125,SCOALA,HAMCEARCA,TL,281,2,0,0,2,3,0,0,3,6,0,0,6,9,1,0,10,9,1,0,10
160494,126,SCOALA,BALABANCEA,TL,271,8,0,0,8,12,5,0,17,19,5,0,24,20,7,0,27,22,7,0,29
160519,127,SCOALA,NIFON,TL,539,2,2,0,4,4,2,0,6,5,2,0,7,9,4,0,13,9,4,0,13
160546,128,"ŞCOALA CU CLASELE I-IV",CLOŞCA,TL,98,1,4,0,5,1,5,0,6,6,5,0,11,10,6,0,16,10,6,0,16
160555,129,"GRADINITA FLORESTI",FLOREŞTI,TL,223,2,1,0,3,3,1,0,4,5,2,0,7,12,2,0,14,12,2,0,14
160537,130,"GRADINITA HORIA",HORIA,TL,831,22,2,0,24,30,4,0,34,40,5,0,45,48,6,0,54,48,8,0,56
161534,131,"CĂMINUL CULTURAL",I.C.BRĂTIANU,TL,959,4,3,0,7,10,4,0,14,15,7,0,22,20,7,0,27,21,7,0,28
160573,132,"ŞCOALA GIMNAZIALĂ",IZVOARELE,TL,1309,2,1,0,3,6,1,0,7,11,1,0,12,16,2,0,18,16,2,0,18
160582,133,"ŞCOALA PRIMARĂ",ALBA,TL,207,5,0,0,5,8,5,0,13,12,6,0,18,13,13,0,26,13,13,0,26
160591,134,"ŞCOALA PRIMARĂ",IULIA,TL,261,5,1,0,6,10,5,0,15,13,7,0,20,16,7,0,23,16,7,0,23
160626,135,"CĂMINUL CULTURAL",JIJILA,TL,1867,6,0,0,6,11,0,0,11,15,0,0,15,16,0,0,16,17,0,0,17
160626,136,"CĂMINUL CULTURAL",JIJILA,TL,1634,4,1,0,5,8,1,0,9,8,1,0,9,14,1,0,15,16,1,0,17
160635,137,"CĂMINUL CULTURAL",GARVĂN,TL,1103,2,4,0,6,7,5,0,12,9,6,0,15,14,8,0,22,17,9,0,26
160671,138,"CĂMINUL CULTURAL",SĂLCIOARA,TL,1052,13,0,0,13,22,0,0,22,30,0,0,30,40,10,0,50,62,14,0,76
160662,139,"CĂMINUL CULTURAL",VIŞINA,TL,598,4,1,0,5,6,1,0,7,15,4,0,19,25,4,0,29,26,4,0,30
160653,140,"ŞCOALA GENERALĂ",JURILOVCA,TL,984,7,1,0,8,17,5,0,22,22,5,0,27,34,10,0,44,34,13,0,47
160653,141,"GRADINITA DE COPII",JURILOVCA,TL,1072,14,2,0,16,22,4,0,26,26,4,0,30,29,5,0,34,32,5,0,37
160699,142,"CĂMIN CULTURAL",LUNCAVIŢA,TL,1617,4,0,0,4,12,3,0,15,16,5,0,21,22,7,0,29,23,8,0,31
160699,143,"CĂMIN CULTURAL",LUNCAVIŢA,TL,1310,4,2,0,6,11,2,0,13,16,2,0,18,17,3,0,20,18,7,0,25
160706,144,"ŞCOALA GENERALĂ",RACHELU,TL,623,4,4,0,8,10,4,0,14,10,4,0,14,13,8,0,21,14,9,0,23
160733,145,"LICEUL TEHNOLOGIC""VASILEBACALU""",MAHMUDIA,TL,1090,6,1,0,7,17,2,0,19,34,2,0,36,47,12,0,59,49,13,0,62
160733,146,"LICEUL TEHNOLOGIC ""VASILE BACALU""",MAHMUDIA,TL,1122,7,3,0,10,21,7,0,28,28,8,0,36,40,11,0,51,44,11,0,55
160804,147,"ȘCOALA PRIMARĂ GORGOVA",GORGOVA,TL,105,5,0,0,5,8,0,0,8,9,2,0,11,10,2,0,12,12,2,0,14
160788,148,"ŞCOALA GIMNAZIALĂ MALIUC",MALIUC,TL,328,3,1,0,4,4,2,0,6,4,2,0,6,8,4,0,12,8,4,0,12
160813,149,"ŞCOALA GIMNAZIALĂ ”IOAN NENIȚESCU ” PARTIZANI",PARTIZANI,TL,363,6,1,0,7,6,1,0,7,8,3,0,11,10,4,0,14,11,4,0,15
160859,150,"ŞCOALA CU CLASELE I-IV","SATU NOU",TL,567,11,3,0,14,16,3,0,19,17,3,0,20,24,3,0,27,26,3,0,29
160840,151,"ŞCOALA CU CLASELE I-VIII","MIHAI BRAVU",TL,555,2,4,0,6,5,5,0,10,7,5,0,12,8,5,0,13,8,5,0,13
160868,152,"CĂMINUL CULTURAL",TURDA,TL,986,3,0,0,3,7,0,0,7,12,2,0,14,17,2,0,19,20,2,0,22
160895,153,"ŞCOALA PRIMARĂ LĂSTUNI",LĂSTUNI,TL,418,6,1,0,7,13,2,0,15,25,4,0,29,31,7,0,38,32,7,0,39
160902,154,"ŞCOALA PRIMARĂ RÎNDUNICA",RÎNDUNICA,TL,529,14,1,0,15,27,1,0,28,30,1,0,31,36,2,0,38,40,2,0,42
160886,155,"ŞCOALA GIMNAZIALĂ MIHAIL KOGĂLNICEANU","MIHAIL KOGĂLNICEANU",TL,1643,7,1,0,8,15,2,0,17,33,2,0,35,44,2,0,46,45,2,0,47
160920,156,"ŞCOALA GIMNAZIALĂ MURIGHIOL",MURIGHIOL,TL,1212,5,3,0,8,15,12,0,27,22,21,0,43,28,39,0,67,30,43,0,73
160939,157,"ŞCOALA CU CLASELE I-IV COLINA",COLINA,TL,125,3,1,0,4,3,2,0,5,3,3,0,6,3,3,0,6,3,4,0,7
160948,158,"ŞCOALA CU CLASELE I-IV DUNAVĂȚU DE JOS","DUNAVĂŢU DE JOS",TL,526,4,0,0,4,5,2,0,7,10,2,0,12,11,4,0,15,11,7,0,18
160957,159,"ŞCOALA CU CLASELE I-IV DUNAVĂȚU DE SUS","DUNAVĂŢU DE SUS",TL,122,1,4,0,5,1,10,0,11,1,10,0,11,1,10,0,11,1,10,0,11
160966,160,"ŞCOALA CU CLASELE I-IV PLOPUL",PLOPUL,TL,507,4,1,0,5,6,3,0,9,8,4,0,12,10,5,0,15,13,6,0,19
160975,161,"CĂMIN CULTURAL SARINASUF",SARINASUF,TL,363,3,0,0,3,6,3,0,9,8,3,0,11,16,3,0,19,18,3,0,21
161026,162,"ŞCOALA CU CLASELE I-IV",TRESTENIC,TL,268,2,1,0,3,2,6,0,8,6,7,0,13,9,8,0,17,10,9,0,19
161008,163,"ŞCOALA CU CLASELE I-VIII",NALBANT,TL,777,2,0,0,2,4,0,0,4,5,0,0,5,8,2,0,10,8,2,0,10
161017,164,"ŞCOALA CU CLASELE I-VIII","NICOLAE BĂLCESCU",TL,1040,3,1,0,4,10,1,0,11,12,1,0,13,20,1,0,21,24,2,0,26
161044,165,"ŞCOALA GIMNAZIALĂ ""NICHIFOR LUDOVIG""",NICULIŢEL,TL,1319,9,5,0,14,21,7,0,28,28,10,0,38,38,15,0,53,43,15,0,58
161044,166,"ŞCOALA GIMNAZIALĂ ""NICHIFOR LUDOVIG""",NICULIŢEL,TL,1211,1,1,0,2,11,4,0,15,16,5,0,21,21,7,0,28,23,9,0,32
161044,167,"GRĂDINIŢA DE COPII",NICULIŢEL,TL,1261,5,0,0,5,14,1,0,15,20,1,0,21,32,1,0,33,34,1,0,35
161099,168,"ŞCOALA CU CLASELE I-IV",VICTORIA,TL,179,2,2,0,4,7,3,0,10,8,8,0,16,8,8,0,16,8,9,0,17
161062,169,"ŞCOALA CU CLASELE I-VIII",NUFĂRU,TL,1044,3,2,0,5,8,6,0,14,13,11,0,24,18,11,0,29,19,11,0,30
161080,170,"CENTRUL CULTURAL ADMINISTRATIV SOCIAL",MALCOCI,TL,1020,12,3,0,15,23,3,0,26,30,3,0,33,44,3,0,47,45,3,0,48
161115,171,"GRĂDINIŢA DE COPII OSTROV",OSTROV,TL,1587,19,0,0,19,31,4,0,35,42,4,0,46,63,5,0,68,69,5,0,74
161142,172,"CAMINUL CULTURAL",PARDINA,TL,471,5,0,0,5,11,2,0,13,14,2,0,16,15,4,0,19,21,8,0,29
161160,173,"CĂMINUL CULTURAL",PECENEAGA,TL,1425,9,0,0,9,16,1,0,17,24,1,0,25,34,1,0,35,35,2,0,37
161204,174,"ŞCOALA PRIMARĂ SABANGIA",SABANGIA,TL,457,3,1,0,4,5,1,0,6,6,2,0,8,7,3,0,10,7,3,0,10
161213,175,"ŞCOALA PRIMARĂ VISTERNA",VISTERNA,TL,331,0,0,0,0,3,4,0,7,5,4,0,9,7,4,0,11,7,4,0,11
161197,176,"ŞCOALA PRIMARĂ ENISALA",ENISALA,TL,788,2,0,0,2,3,0,0,3,4,0,0,4,4,0,0,4,6,0,0,6
161222,177,"ŞCOALA GIMNAZIALĂ ZEBIL",ZEBIL,TL,1133,0,0,0,0,3,1,0,4,6,1,0,7,14,1,0,15,18,2,0,20
161188,178,"ŞCOALA GIMNAZIALĂ SARICHIOI",SARICHIOI,TL,1599,7,1,0,8,18,7,0,25,21,7,0,28,23,9,0,32,25,9,0,34
161188,179,"ŞCOALA GIMNAZIALĂ SARICHIOI",SARICHIOI,TL,1406,3,0,0,3,9,0,0,9,16,1,0,17,26,2,0,28,29,2,0,31
161240,180,"CAMIN CULTURAL","SFÎNTU GHEORGHE",TL,711,9,5,0,14,21,13,0,34,27,31,0,58,30,37,0,67,31,37,0,68
161268,181,"CONSILIUL LOCAL","SLAVA CERCHEZĂ",TL,1041,4,0,0,4,4,0,0,4,5,0,0,5,6,0,0,6,6,0,0,6
161277,182,"ŞCOALA GENERALĂ CU CLASELE I-IV","SLAVA RUSĂ",TL,921,4,0,0,4,6,1,0,7,7,1,0,8,8,2,0,10,8,2,0,10
161295,183,"ŞCOALA GIMNAZIALĂ""MAIOR IOAN MURGESCU""",SMÎRDAN,TL,901,0,0,0,0,2,1,0,3,4,1,0,5,7,1,0,8,8,1,0,9
161320,184,"ŞCOALA CU CLASELE I-IV",MINERI,TL,1418,4,0,0,4,10,2,0,12,15,2,0,17,17,3,0,20,17,3,0,20
161339,185,"ŞCOALA CU CLASELE I-IV",PARCHEŞ,TL,650,1,0,0,1,1,0,0,1,1,0,0,1,6,0,0,6,6,0,0,6
161311,186,"ŞCOALA ""TRAIAN COŞOVEI"" CU CLASELE I-VIII",SOMOVA,TL,1946,8,1,0,9,16,1,0,17,21,1,0,22,22,1,0,23,23,1,0,24
161357,187,"CĂMINUL CULTURAL",STEJARU,TL,512,9,1,0,10,12,4,0,16,16,4,0,20,16,5,0,21,19,5,0,24
161366,188,"GRĂDINIȚA MINA ALTÎN TEPE","MINA ALTÎN TEPE",TL,348,1,1,0,2,5,1,0,6,10,1,0,11,13,2,0,15,16,2,0,18
161375,189,"SEDIUL FOSTEI ŞCOLI","VASILE ALECSANDRI",TL,393,4,1,0,5,8,4,0,12,10,5,0,15,20,8,0,28,20,9,0,29
161393,190,"LICEUL TEHNOLOGIC TOPOLOG TOPOLOG",TOPOLOG,TL,919,7,1,0,8,13,3,0,16,23,6,0,29,29,6,0,35,34,6,0,40
161393,191,"LICEUL TEHNOLOGIC TOPOLOG",TOPOLOG,TL,975,8,0,0,8,20,2,0,22,27,3,0,30,34,3,0,37,36,3,0,39
161400,192,"ŞCOALA GENERALĂ",CALFA,TL,102,2,3,0,5,4,3,0,7,5,3,0,8,7,4,0,11,7,4,0,11
161419,193,"ŞCOALA GENERALĂ",CERBU,TL,183,2,1,0,3,3,1,0,4,3,1,0,4,3,2,0,5,3,2,0,5
161428,194,"ŞCOALA GENERALĂ","FĂGĂRAŞU NOU",TL,517,2,0,0,2,3,0,0,3,5,0,0,5,9,4,0,13,9,4,0,13
161437,195,"ŞCOALA GENERALĂ",LUMINIŢA,TL,210,2,2,0,4,2,2,0,4,5,3,0,8,11,3,0,14,11,3,0,14
161446,196,"ŞCOALA GENERALĂ",MĂGURELE,TL,199,2,3,0,5,3,6,0,9,6,6,0,12,7,7,0,14,7,8,0,15
161455,197,"ŞCOALA GENERALĂ","SÎMBĂTA NOUĂ",TL,435,2,1,0,3,4,1,0,5,12,2,0,14,13,3,0,16,13,3,0,16
161473,198,"ŞCOALA GIMNAZIALĂ TURCOAIA",TURCOAIA,TL,1495,9,0,0,9,21,0,0,21,26,0,0,26,27,3,0,30,33,3,0,36
161473,199,"SCOALA GIMNAZIALA TURCOAIA",TURCOAIA,TL,1216,9,0,0,9,17,0,0,17,24,0,0,24,28,1,0,29,32,1,0,33
161491,200,"CĂMINUL CULTURAL","VALEA NUCARILOR",TL,816,8,5,0,13,21,6,0,27,19,8,0,27,21,11,0,32,22,11,0,33
161507,201,"ȘCOALA GIMNAZIALĂ AGIGHIOL",AGIGHIOL,TL,1429,5,1,0,6,6,1,0,7,10,1,0,11,16,1,0,17,16,1,0,17
161516,202,"ȘCOALA IAZURILE",IAZURILE,TL,678,5,1,0,6,11,1,0,12,14,2,0,16,18,3,0,21,18,3,0,21
160608,203,"ŞCOALA GIMNAZIALĂ ""MIHAI EMINESCU""VALEA TEILOR","VALEA TEILOR",TL,1129,3,0,0,3,8,0,0,8,9,0,0,9,12,0,0,12,12,0,0,12
160715,204,"CĂMINUL CULTURAL",VĂCĂRENI,TL,1816,5,1,0,6,13,3,0,16,18,3,0,21,29,3,0,32,33,3,0,36
155252,1,"UNIVERSITATEA DE MEDICINA ŞI FARMACIE ""VICTOR BABEŞ""",TIMIŞOARA,TM,1448,10,3,0,13,39,11,0,50,56,31,0,87,81,46,24,151,88,50,24,162
155252,2,"UNIVERSITATEA DE MEDICINA ŞI FARMACIE ""VICTOR BABEŞ""",TIMIŞOARA,TM,1083,9,3,0,12,25,11,0,36,44,29,0,73,59,41,0,100,64,45,1,110
155252,3,"LICEUL PEDAGOGIC "" CARMEN SYLVA""",TIMIŞOARA,TM,661,5,6,15,26,28,12,15,55,40,17,15,72,56,30,15,101,62,41,15,118
155252,4,"COLEGIUL TEHNIC ""EMANUIL UNGUREANU""",TIMIŞOARA,TM,1450,14,5,0,19,39,12,0,51,63,21,0,84,79,28,0,107,89,36,0,125
155252,5,"LICEUL TEORETIC ""NIKOLAUS LENAU"" - CORP CLADIRE SCOALA CU CLASELE I-IV",TIMIŞOARA,TM,785,7,0,0,7,22,2,0,24,29,11,0,40,40,17,12,69,43,17,12,72
155252,6,"LICEUL TEORETIC ""NIKOLAUS LENAU"" - CORP CLADIRE SCOALA CU CLASELE I-IV",TIMIŞOARA,TM,671,11,0,0,11,29,0,0,29,49,0,0,49,62,36,0,98,62,36,0,98
155252,7,"LICEUL TEORETIC ""NIKOLAUS LENAU"" - CORP CLADIRE SCOALA CU CLASELE I-IV",TIMIŞOARA,TM,908,2,0,0,2,19,3,0,22,23,6,21,50,40,6,21,67,43,7,21,71
155252,8,"COLEGIUL TEHNIC ""HENRI COANDĂ""",TIMIŞOARA,TM,887,8,3,0,11,21,5,0,26,29,8,0,37,36,9,0,45,40,13,0,53
155252,9,"COLEGIUL TEHNIC ""HENRY COANDA""",TIMIŞOARA,TM,1238,10,0,0,10,46,0,0,46,74,5,0,79,102,10,0,112,109,11,0,120
155252,10,"COLEGIUL TEHNIC ""ION MINCU""",TIMIŞOARA,TM,649,5,6,0,11,19,7,0,26,38,16,0,54,38,17,0,55,38,18,0,56
155252,11,"INSPECTORATUL JUDETEAN AL POLIŢIEI DE FRONTIERA",TIMIŞOARA,TM,1328,8,1,0,9,27,1,0,28,38,2,0,40,55,4,0,59,57,4,0,61
155252,12,"INSPECTORATUL JUDETEAN AL POLIŢIEI DE FRONTIERA",TIMIŞOARA,TM,1383,7,1,0,8,24,3,0,27,31,4,0,35,39,8,0,47,49,10,0,59
155252,13,"FUNDAŢIA IOAN SLAVICI",TIMIŞOARA,TM,1297,13,2,0,15,44,4,0,48,57,12,0,69,80,16,0,96,98,19,0,117
155252,14,"FUNDAŢIA IOAN SLAVICI",TIMIŞOARA,TM,1453,16,2,0,18,34,4,0,38,55,9,0,64,66,10,0,76,77,11,0,88
155252,15,"FUNDAŢIA IOAN SLAVICI",TIMIŞOARA,TM,1115,11,5,0,16,32,5,0,37,55,6,0,61,75,7,0,82,77,9,0,86
155252,16,"FUNDAŢIA IOAN SLAVICI",TIMIŞOARA,TM,1048,8,2,0,10,22,2,0,24,35,3,0,38,43,4,0,47,49,4,0,53
155252,17,"FUNDAŢIA IOAN SLAVICI",TIMIŞOARA,TM,1839,26,1,0,27,62,1,0,63,91,3,0,94,115,7,0,122,122,7,0,129
155252,18,"GRĂDINIŢA CU PROGRAM PRELUNGIT NR. 36 (FOSTA GRĂDINIŢĂ NR. 37)",TIMIŞOARA,TM,1720,15,2,0,17,57,8,0,65,86,10,0,96,106,12,0,118,118,12,0,130
155252,19,"GRĂDINIŢA CU PROGRAM PRELUNGIT NR. 36 (FOSTA GRĂDINIŢĂ NR. 37)",TIMIŞOARA,TM,1531,22,2,0,24,55,4,0,59,85,10,0,95,105,16,0,121,115,18,0,133
155252,20,"UNIVERSITATEA DE ȘTIINȚE AGRICOLE ȘI MEDICINĂ VETERINARĂ A BANATULUI( ÎN INCINTA FACULTĂȚII DE TEHNOLOGIA PRODUSELOR AGROALIMENTARE)",TIMIŞOARA,TM,1800,10,0,0,10,55,2,0,57,64,11,0,75,101,16,0,117,112,20,0,132
155252,21,"UNIVERSITATEA DE ȘTIINȚE AGRICOLE ȘI MEDICINĂ VETERINARĂ A BANATULUI( ÎN INCINTA FACULTĂȚII DE TEHNOLOGIA PRODUSELOR AGROALIMENTARE)",TIMIŞOARA,TM,1767,5,4,0,9,35,8,0,43,47,12,0,59,68,23,0,91,80,24,0,104
155252,22,"UNIVERSITATEA DE ȘTIINȚE AGRICOLE ȘI MEDICINĂ VETERINARĂ A BANATULUI( ÎN INCINTA FACULTĂȚII DE TEHNOLOGIA PRODUSELOR AGROALIMENTARE)",TIMIŞOARA,TM,1661,11,1,0,12,28,2,0,30,55,5,0,60,72,7,0,79,87,7,0,94
155252,23,"UNIVERSITATEA DE ȘTIINȚE AGRICOLE ȘI MEDICINĂ VETERINARĂ A BANATULUI( ÎN INCINTA FACULTĂȚII DE TEHNOLOGIA PRODUSELOR AGROALIMENTARE )",TIMIŞOARA,TM,1780,7,0,0,7,28,0,0,28,58,2,0,60,81,2,0,83,86,4,0,90
155252,24,"UNIVERSITATEA DE ȘTIINȚE AGRICOLE ȘI MEDICINĂ VETERINARĂ A BANATULUI( ÎN INCINTA FACULTĂȚII DE TEHNOLOGIA PRODUSELOR AGROALIMENTARE)",TIMIŞOARA,TM,1743,5,2,0,7,36,5,0,41,62,6,0,68,92,7,0,99,108,7,0,115
155252,25,"ŞCOALA GIMNAZIALĂ NR.24 (GRĂDINIŢA CU PROGRAM PRELUNGIT NR.27)",TIMIŞOARA,TM,1380,13,2,0,15,44,5,0,49,61,8,0,69,79,14,0,93,88,14,0,102
155252,26,"ŞCOALA GIMNAZIALĂ NR.24 (GRĂDINIŢA CU PROGRAM PRELUNGIT NR.27)",TIMIŞOARA,TM,1333,8,2,0,10,36,5,0,41,46,5,0,51,59,6,0,65,68,7,0,75
155252,27,"ŞCOALA GIMNAZIALĂ NR.19 (ŞCOALA PRIMARĂ NR.19)",TIMIŞOARA,TM,1413,14,0,0,14,48,8,0,56,81,8,0,89,99,9,0,108,113,10,0,123
155252,28,"ŞCOALA GIMNAZIALĂ NR.19 (ŞCOALA PRIMARĂ NR.19)",TIMIŞOARA,TM,1639,19,3,0,22,52,7,0,59,63,11,0,74,93,11,0,104,106,11,0,117
155252,29,"ŞCOALA GIMNAZIALĂNR.24",TIMIŞOARA,TM,1278,12,2,0,14,44,10,0,54,78,15,0,93,97,21,0,118,113,28,0,141
155252,30,"ŞCOALA GIMNAZIALĂNR.24",TIMIŞOARA,TM,1458,16,1,0,17,45,2,0,47,78,7,0,85,102,8,0,110,113,8,0,121
155252,31,"ŞCOALA GIMNAZIALĂNR.24",TIMIŞOARA,TM,818,2,4,0,6,13,5,0,18,31,9,0,40,43,9,0,52,50,10,0,60
155252,32,"ŞCOALA GIMNAZIALĂNR.24",TIMIŞOARA,TM,961,17,2,0,19,36,4,0,40,51,4,0,55,62,4,0,66,70,6,0,76
155252,33,"ŞCOALA GIMNAZIALĂ NR. 26",TIMIŞOARA,TM,1420,14,0,0,14,55,2,0,57,74,14,0,88,92,18,0,110,94,18,0,112
155252,34,"ŞCOALA GIMNAZIALĂ NR. 26",TIMIŞOARA,TM,1156,13,3,0,16,40,5,0,45,62,8,0,70,85,11,0,96,94,11,0,105
155252,35,"ŞCOALA GIMNAZIALĂ NR. 26",TIMIŞOARA,TM,1118,6,0,0,6,16,0,0,16,40,6,0,46,47,7,0,54,47,8,0,55
155252,36,"ŞCOALA GIMNAZIALĂ NR. 26",TIMIŞOARA,TM,1329,15,0,0,15,36,2,0,38,49,3,0,52,73,5,0,78,75,5,0,80
155252,37,"ŞCOALA GIMNAZIALĂ NR.18",TIMIŞOARA,TM,1512,12,3,0,15,37,7,0,44,60,11,0,71,96,16,0,112,107,16,0,123
155252,38,"ŞCOALA GIMNAZIALĂ NR.18",TIMIŞOARA,TM,1614,11,5,0,16,51,10,0,61,77,13,0,90,96,15,0,111,110,15,0,125
155252,39,"ŞCOALA GIMNAZIALĂ NR.18",TIMIŞOARA,TM,1310,9,3,0,12,43,4,0,47,69,4,0,73,82,5,0,87,82,5,0,87
155252,40,"CLUBUL SPORTIV ŞCOLAR NR.1",TIMIŞOARA,TM,954,6,2,0,8,36,3,0,39,60,6,0,66,81,7,0,88,85,7,0,92
155252,41,"GRĂDINIŢA CU PROGRAM PRELUNGIT NR.36",TIMIŞOARA,TM,1301,17,5,0,22,49,6,0,55,69,6,0,75,87,10,0,97,91,12,0,103
155252,42,"ŞCOALA GIMNAZIALĂ NR.19 ""AVRAM IANCU""",TIMIŞOARA,TM,1106,11,1,0,12,38,6,0,44,63,6,0,69,87,8,0,95,98,9,0,107
155252,43,"ŞCOALA GIMNAZIALĂ NR.19 ""AVRAM IANCU""",TIMIŞOARA,TM,1202,21,8,0,29,66,17,0,83,85,22,0,107,106,27,0,133,113,37,0,150
155252,44,"ŞCOALA GIMNAZIALĂ NR.19 ""AVRAM IANCU""",TIMIŞOARA,TM,1265,7,4,0,11,36,8,0,44,56,9,0,65,74,15,0,89,83,19,0,102
155252,45,"ŞCOALA GIMNAZIALĂ NR.19 ""AVRAM IANCU""",TIMIŞOARA,TM,1441,12,2,0,14,40,4,0,44,50,7,0,57,66,7,0,73,75,8,0,83
155252,46,"GRĂDINIŢA CU PROGRAM PRELUNGIT NR.26",TIMIŞOARA,TM,1368,17,3,0,20,55,8,0,63,83,13,0,96,111,19,0,130,120,19,0,139
155252,47,"GRĂDINIŢA CU PROGRAM PRELUNGIT NR.26",TIMIŞOARA,TM,1345,15,1,0,16,51,4,0,55,69,7,0,76,92,7,0,99,97,8,0,105
155252,48,"GRĂDINIŢA CU PROGRAM PRELUNGIT NR.20 (GRĂDINIŢA CU PROGRAM PRELUNGIT NR.9 ""CARLA PELZ"")",TIMIŞOARA,TM,1397,17,2,0,19,37,4,0,41,56,4,0,60,82,4,0,86,95,4,0,99
155252,49,"GRĂDINIŢA CU PROGRAM PRELUNGIT NR.20 (GRĂDINIŢA CU PROGRAM PRELUNGIT NR.9 ""CARLA PELZ"")",TIMIŞOARA,TM,1490,12,2,0,14,42,4,0,46,64,5,0,69,99,9,0,108,103,9,0,112
155252,50,"BIROUL LOCUINŢE/DIRECŢIA CLĂDIRI, TERENURI ŞI DOTĂRI DIVERSE- PRIMĂRIA MUNICIPIULUI TIMIŞOARA",TIMIŞOARA,TM,768,6,0,0,6,29,3,0,32,40,3,0,43,45,4,0,49,49,7,0,56
155252,51,"LICEUL TEHNOLOGIC DE INDUSTRIE ALIMENTARĂ",TIMIŞOARA,TM,1107,10,1,0,11,35,16,0,51,53,23,0,76,72,38,0,110,82,41,0,123
155252,52,"LICEUL TEHNOLOGIC DE INDUSTRIE ALIMENTARĂ",TIMIŞOARA,TM,1237,14,0,0,14,32,12,0,44,60,16,0,76,79,19,0,98,81,20,0,101
155252,53,"LICEUL TEHNOLOGIC UCECOM ""SPIRU HARET""",TIMIŞOARA,TM,1313,12,0,0,12,50,4,0,54,67,4,0,71,94,9,1,104,98,11,1,110
155252,54,"LICEUL TEHNOLOGIC UCECOM ""SPIRU HARET""",TIMIŞOARA,TM,1404,12,0,0,12,31,2,0,33,41,2,0,43,58,4,0,62,73,6,0,79
155252,55,"COLEGIUL TEHNIC ""HENRI COANDĂ"" (ŞCOALA PRIMARĂ NR.11)",TIMIŞOARA,TM,1713,21,4,0,25,65,6,0,71,95,11,0,106,128,15,0,143,154,16,0,170
155252,56,"COLEGIUL TEHNIC ""HENRI COANDĂ"" (ŞCOALA PRIMARĂ NR.11)",TIMIŞOARA,TM,1716,24,2,0,26,64,2,0,66,102,2,0,104,141,3,0,144,167,3,0,170
155252,57,"COLEGIUL TEHNIC ""HENRI COANDĂ"" (ŞCOALA PRIMARĂ NR.11)",TIMIŞOARA,TM,1851,14,1,0,15,38,1,0,39,73,2,0,75,124,7,0,131,144,8,0,152
155252,58,"ŞCOALA GIMNAZIALĂNR.19 ""AVRAM IANCU""(ŞCOALA PRIMARĂ NR.19)",TIMIŞOARA,TM,1738,16,3,0,19,55,6,0,61,67,8,0,75,85,10,0,95,96,11,0,107
155252,59,"ŞCOALA GIMNAZIALĂNR.19 ""AVRAM IANCU""(ŞCOALA PRIMARĂ NR.19)",TIMIŞOARA,TM,1751,19,2,0,21,60,3,0,63,89,8,0,97,125,8,0,133,143,8,0,151
155252,60,"ŞCOALA GIMNAZIALĂNR.19 ""AVRAM IANCU""(ŞCOALA PRIMARĂ NR.19)",TIMIŞOARA,TM,1672,5,1,0,6,44,2,0,46,64,11,0,75,81,14,0,95,84,14,0,98
155252,61,"INSPECTORATUL TERITORIAL DE MUNCĂ TIMIŞ",TIMIŞOARA,TM,1342,6,1,0,7,41,2,0,43,53,5,0,58,75,7,0,82,83,8,0,91
155252,62,"S.C. DRUMURI MUNICIPALE TIMIŞOARA S.A.(FOSTA ADMINISTRAREA DOMENIULUI PUBLIC )",TIMIŞOARA,TM,1436,8,0,0,8,41,1,1,43,75,4,1,80,101,6,1,108,103,6,1,110
155252,63,"S.C. DRUMURI MUNICIPALE TIMIŞOARA S.A.(FOSTA ADMINISTRAREA DOMENIULUI PUBLIC )",TIMIŞOARA,TM,1401,5,4,0,9,17,8,0,25,33,10,0,43,42,11,0,53,44,15,0,59
155252,64,"COLEGIUL TEHNIC DE VEST",TIMIŞOARA,TM,1296,10,3,0,13,22,4,0,26,43,4,0,47,52,6,0,58,58,6,0,64
155252,65,"COLEGIUL TEHNIC DE VEST",TIMIŞOARA,TM,1067,11,5,0,16,30,9,0,39,48,18,0,66,54,18,0,72,66,22,0,88
155252,66,"COLEGIUL TEHNIC DE VEST",TIMIŞOARA,TM,1013,7,3,0,10,23,4,0,27,33,4,0,37,39,5,0,44,52,6,0,58
155252,67,"ŞCOALA GIMNAZIALĂ NR.12",TIMIŞOARA,TM,1015,11,0,0,11,36,3,0,39,49,6,0,55,65,9,18,92,68,9,18,95
155252,68,"ŞCOALA GIMNAZIALĂ NR.12",TIMIŞOARA,TM,1287,8,7,0,15,27,11,0,38,39,15,0,54,56,15,0,71,65,16,0,81
155252,69,"COLEGIUL ECONOMIC""F.S.NITTI""",TIMIŞOARA,TM,1232,6,4,0,10,36,6,0,42,45,7,0,52,58,12,23,93,68,16,23,107
155252,70,"COLEGIUL ECONOMIC ""F.S.NITTI""",TIMIŞOARA,TM,1177,14,5,0,19,24,6,0,30,33,6,0,39,56,8,0,64,59,8,0,67
155252,71,"COLEGIUL ECONOMIC ""F.S.NITTI""",TIMIŞOARA,TM,1328,7,6,0,13,36,7,0,43,58,7,0,65,86,8,0,94,96,10,0,106
155252,72,"COLEGIUL ECONOMIC ""F.S. NITTI""",TIMIŞOARA,TM,1307,7,0,0,7,40,0,0,40,66,2,0,68,85,4,0,89,94,4,0,98
155252,73,"LICEULTEORETIC ""GRIGORE MOISIL"" (ŞCOALA GIMNAZIALĂ NR.22)",TIMIŞOARA,TM,965,8,2,0,10,26,2,0,28,56,2,0,58,75,5,0,80,78,5,0,83
155252,74,"LICEULTEORETIC ""GRIGORE MOISIL"" (ŞCOALA GIMNAZIALĂ NR.22)",TIMIŞOARA,TM,946,6,2,0,8,30,2,0,32,47,5,0,52,56,7,0,63,65,7,0,72
155252,75,"LICEULTEORETIC ""GRIGORE MOISIL"" (ŞCOALA GIMNAZIALĂ NR.22)",TIMIŞOARA,TM,1052,12,3,0,15,35,4,0,39,56,6,0,62,66,10,0,76,66,10,0,76
155252,76,"LICEULTEORETIC ""GRIGORE MOISIL"" (ŞCOALA GIMNAZIALĂ NR.22)",TIMIŞOARA,TM,1072,6,1,0,7,20,6,0,26,27,11,0,38,42,11,0,53,49,11,0,60
155252,77,"LICEUL""GRIGORE MOISIL""",TIMIŞOARA,TM,1024,15,0,0,15,33,0,13,46,43,0,13,56,57,0,13,70,60,0,14,74
155252,78,"LICEUL ""GRIGORE MOISIL""",TIMIŞOARA,TM,1032,13,1,0,14,36,4,0,40,55,10,11,76,71,13,11,95,82,13,11,106
155252,79,"ŞCOALA SF. ANTIM IVIREANUL (FOST LICEUL DE ARTE PLASTICE -FOSTA ŞCOALA GENERALĂ NR.9)",TIMIŞOARA,TM,1593,9,2,0,11,37,6,0,43,68,6,0,74,99,9,0,108,117,9,0,126
155252,80,"ŞCOALA SF. ANTIM IVIREANUL (FOST LICEUL DE ARTE PLASTICE -FOSTA ŞCOALA GENERALĂ NR.9)",TIMIŞOARA,TM,1750,7,0,0,7,31,2,0,33,45,6,0,51,58,8,0,66,63,10,0,73
155252,81,"ŞCOALA SF. ANTIM IVIREANUL (FOST LICEUL DE ARTE PLASTICE -FOSTA ŞCOALA GENERALĂ NR.9)",TIMIŞOARA,TM,1509,9,0,0,9,27,4,0,31,49,4,0,53,68,8,0,76,83,10,0,93
155252,82,"ŞCOALA SF. ANTIM IVIREANUL (FOST LICEUL DE ARTE PLASTICE -FOSTA ŞCOALA GENERALĂ NR.9)",TIMIŞOARA,TM,1325,6,1,0,7,29,2,0,31,41,7,0,48,65,7,1,73,71,7,1,79
155252,83,"ŞCOALA GIMNAZIALĂ NR.27 (GRADINIŢA CU PROGRAM PRELUNGIT NR. 3)",TIMIŞOARA,TM,1317,8,4,0,12,25,5,0,30,51,7,0,58,70,10,0,80,80,10,0,90
155252,84,"ŞCOALA GIMNAZIALĂ NR.27 (GRADINIŢA CU PROGRAM PRELUNGIT NR. 3)",TIMIŞOARA,TM,1286,9,0,0,9,41,1,0,42,57,2,0,59,78,4,0,82,92,6,0,98
155252,85,"ŞCOALA GIMNAZIALĂ NR. 27",TIMIŞOARA,TM,1743,18,1,0,19,34,1,0,35,47,1,0,48,61,1,0,62,67,1,0,68
155252,86,"ŞCOALA GIMNAZIALĂ NR. 27",TIMIŞOARA,TM,1683,9,3,0,12,40,4,0,44,61,8,0,69,84,10,0,94,96,10,0,106
155252,87,"ŞCOALA GIMNAZIALĂ NR. 27",TIMIŞOARA,TM,1698,8,0,0,8,39,4,0,43,65,5,0,70,77,8,0,85,83,9,0,92
155252,88,"ŞCOALA GIMNAZIALĂ NR. 27",TIMIŞOARA,TM,1720,9,0,0,9,39,0,0,39,57,0,0,57,76,3,0,79,84,3,0,87
155252,89,"ŞCOALA GIMNAZIALĂ NR. 6",TIMIŞOARA,TM,1134,5,3,0,8,31,8,0,39,51,12,0,63,69,14,0,83,75,14,0,89
155252,90,"ŞCOALA GIMNAZIALĂ NR. 6",TIMIŞOARA,TM,1270,10,3,0,13,27,3,0,30,49,4,0,53,64,4,0,68,74,4,0,78
155252,91,"ŞCOALA GIMNAZIALĂ NR. 6",TIMIŞOARA,TM,1290,12,0,0,12,35,0,0,35,63,2,0,65,80,2,0,82,84,2,0,86
155252,92,"ŞCOALA GIMNAZIALĂ NR. 6",TIMIŞOARA,TM,1491,12,0,0,12,31,6,0,37,42,6,0,48,63,6,0,69,70,8,0,78
155252,93,"LICEUL TEHNOLOGIC TRANSPORTURI AUTO",TIMIŞOARA,TM,1561,15,2,0,17,41,7,0,48,51,9,0,60,67,12,0,79,78,12,0,90
155252,94,"LICEUL TEHNOLOGIC TRANSPORTURI AUTO",TIMIŞOARA,TM,1633,15,3,0,18,49,3,0,52,78,5,0,83,94,5,1,100,105,8,1,114
155252,95,"LICEUL TEHNOLOGIC TRANSPORTURI AUTO",TIMIŞOARA,TM,1804,22,0,0,22,75,1,0,76,96,1,0,97,130,4,0,134,144,4,0,148
155252,96,"LICEUL TEHNOLOGIC TRANSPORTURI AUTO (ŞCOALA GIMNAZIALĂ NR. 29)",TIMIŞOARA,TM,1422,10,1,0,11,33,2,0,35,54,3,0,57,70,6,0,76,77,6,0,83
155252,97,"LICEUL TEHNOLOGIC TRANSPORTURI AUTO (ŞCOALA GIMNAZIALĂ NR. 29)",TIMIŞOARA,TM,1413,14,0,0,14,31,0,0,31,53,0,0,53,61,1,0,62,65,5,0,70
155252,98,"LICEUL TEHNOLOGIC TRANSPORTURI AUTO (ŞCOALA GIMNAZIALĂ NR. 29)",TIMIŞOARA,TM,1140,6,0,0,6,17,0,0,17,31,0,0,31,41,0,0,41,43,0,0,43
155252,99,"ŞCOALA GIMNAZIALĂ NR.15 (ŞCOALA PRIMARĂ NR.15)",TIMIŞOARA,TM,1688,22,0,0,22,40,0,0,40,74,1,0,75,86,4,0,90,92,4,0,96
155252,100,"ŞCOALA GIMNAZIALĂ NR.15 (ŞCOALA PRIMARĂ NR.15)",TIMIŞOARA,TM,1504,7,0,0,7,44,2,0,46,51,2,0,53,84,2,0,86,91,3,0,94
155252,101,"ŞCOALA GIMNAZIALĂ NR.2 (GRĂDINIŢA CU PROGRAM PRELUNGIT NR. 29)",TIMIŞOARA,TM,1443,8,0,0,8,32,2,0,34,47,3,0,50,58,8,0,66,69,14,0,83
155252,102,"ŞCOALA GIMNAZIALĂ NR.2 (GRĂDINIŢA CU PROGRAM PRELUNGIT NR. 29)",TIMIŞOARA,TM,1275,2,0,0,2,24,2,0,26,42,2,0,44,60,3,0,63,64,3,0,67
155252,103,"ŞCOALA GIMNAZIALĂ NR.2",TIMIŞOARA,TM,1350,26,2,0,28,38,8,0,46,55,13,0,68,74,18,0,92,83,23,0,106
155252,104,"ŞCOALA GIMNAZIALĂ NR.2",TIMIŞOARA,TM,1446,10,2,0,12,38,3,0,41,56,7,0,63,78,10,0,88,80,12,0,92
155252,105,"ŞCOALA GIMNAZIALĂ NR.2",TIMIŞOARA,TM,1382,17,0,0,17,46,0,0,46,67,0,0,67,81,0,0,81,92,0,0,92
155252,106,"GRĂDINIŢA CU PROGRAM PRELUNGIT NR.2 (GRĂDINIŢA CU PROGRAM PRELUNGIT NR. 1)",TIMIŞOARA,TM,1917,13,1,0,14,56,3,0,59,86,3,0,89,125,3,0,128,145,4,0,149
155252,107,"GRĂDINIŢA CU PROGRAM PRELUNGIT NR.2 (GRĂDINIŢA CU PROGRAM PRELUNGIT NR. 1)",TIMIŞOARA,TM,1957,17,5,0,22,48,9,0,57,67,10,0,77,91,10,0,101,110,12,0,122
155252,108,"LICEUL TEORETIC ""VLAD ŢEPES"" (GRĂDINIŢA CU PROGRAM PRELUNGIT NR.28)",TIMIŞOARA,TM,1244,11,1,0,12,34,1,0,35,50,2,1,53,61,5,1,67,63,5,1,69
155252,109,"LICEUL CU PROGRAM SPORTIV ""BANATUL""",TIMIŞOARA,TM,1430,15,1,0,16,53,2,0,55,74,5,0,79,92,6,0,98,101,9,0,110
155252,110,"COLEGIUL NATIONAL DE ARTA ""ION VIDU""",TIMIŞOARA,TM,542,7,4,0,11,17,15,0,32,23,41,0,64,30,68,0,98,36,75,0,111
155252,111,"FUNDAŢIA JUDEŢEANĂ PENTRU TINERET TIMIŞ (FOSTA CASA TINERETULUI)",TIMIŞOARA,TM,1286,11,4,0,15,30,7,0,37,55,13,37,105,66,15,37,118,78,16,37,131
155252,112,"FUNDAŢIA JUDEŢEANĂ PENTRU TINERET TIMIŞ (FOSTA CASA TINERETULUI)",TIMIŞOARA,TM,1501,17,2,0,19,54,4,0,58,78,12,0,90,86,14,10,110,96,22,10,128
155252,113,"FUNDAŢIA JUDEŢEANĂ PENTRU TINERET TIMIŞ (FOSTA CASA TINERETULUI)",TIMIŞOARA,TM,1128,19,0,0,19,38,6,0,44,56,8,9,73,71,8,9,88,74,8,9,91
155252,114,"LICEUL TEORETIC ""JEAN LOUIS CALDERON"" (FOSTA ŞCOALA GIMNAZIALĂ NR.28) "" CORP B """,TIMIŞOARA,TM,923,4,0,0,4,9,2,0,11,17,4,0,21,25,10,0,35,25,10,0,35
155252,115,"ŞCOALA GIMNAZIALĂ NR.30",TIMIŞOARA,TM,1820,19,2,0,21,64,11,0,75,89,13,0,102,96,15,0,111,107,15,0,122
155252,116,"ŞCOALA GIMNAZIALĂ NR.30",TIMIŞOARA,TM,1380,11,5,0,16,51,10,0,61,70,13,0,83,84,21,0,105,88,23,0,111
155252,117,"ŞCOALA GIMNAZIALĂ NR.30",TIMIŞOARA,TM,1526,18,4,0,22,46,10,0,56,73,16,0,89,101,18,0,119,116,20,0,136
155252,118,"ŞCOALA GIMNAZIALĂ NR.30",TIMIŞOARA,TM,1512,14,0,0,14,41,1,0,42,86,1,0,87,89,14,0,103,96,16,0,112
155252,119,"ŞCOALA GIMNAZIALĂ NR.30",TIMIŞOARA,TM,1356,6,3,0,9,30,4,0,34,55,8,0,63,70,8,0,78,82,10,0,92
155252,120,"UNIVERSITATEA POLITEHNICA TIMIŞOARA - CANTINA STUDENŢEASCĂ",TIMIŞOARA,TM,1069,5,1,0,6,18,22,0,40,28,47,0,75,39,85,0,124,42,99,0,141
155252,121,"UNIVERSITATEA POLITEHNICA TIMIŞOARA- CANTINA STUDENŢEASCĂ",TIMIŞOARA,TM,962,3,5,0,8,32,32,18,82,53,58,18,129,71,89,18,178,79,100,18,197
155252,122,"LICEUL TEORETIC ""WILLIAM SHAKESPEARE"" (FOSTAŞCOALA GIMNAZIALĂ NR. 5 )",TIMIŞOARA,TM,1271,5,9,0,14,27,15,0,42,42,17,0,59,54,19,1,74,65,19,1,85
155252,123,"LICEUL TEORETIC ""WILLIAM SHAKESPEARE"" ( FOSTA ŞCOALA GIMNAZIALĂ NR. 5 )",TIMIŞOARA,TM,1222,15,2,0,17,35,2,0,37,52,2,0,54,71,6,0,77,85,8,0,93
155252,124,"GRADINIŢA CU PROGRAM PRELUNGIT NR.11",TIMIŞOARA,TM,1314,16,0,0,16,39,0,0,39,55,6,0,61,65,6,0,71,72,6,0,78
155252,125,"GRADINIŢA CU PROGRAM PRELUNGIT NR.11",TIMIŞOARA,TM,1094,18,0,0,18,45,2,0,47,63,2,0,65,86,2,0,88,89,2,0,91
155252,126,"COLEGIUL TEHNIC ""AZUR""",TIMIŞOARA,TM,1399,12,1,0,13,42,14,0,56,56,26,0,82,76,28,0,104,76,33,0,109
155252,127,"COLEGIUL TEHNIC ""AZUR""",TIMIŞOARA,TM,1276,5,0,0,5,31,0,0,31,62,4,0,66,81,7,0,88,86,7,0,93
155252,128,"COLEGIUL TEHNIC ""AZUR""",TIMIŞOARA,TM,1201,15,1,0,16,39,1,0,40,47,6,0,53,71,15,0,86,79,18,0,97
155252,129,"COLEGIUL TEHNIC ""AZUR""",TIMIŞOARA,TM,1241,19,4,0,23,52,5,0,57,72,6,0,78,79,7,0,86,85,7,0,92
155252,130,"COLEGIUL TEHNIC ""AZUR""",TIMIŞOARA,TM,1397,5,1,0,6,50,3,0,53,77,5,0,82,94,6,0,100,97,7,0,104
155252,131,"COLEGIUL TEHNIC ""AZUR""",TIMIŞOARA,TM,1205,11,4,0,15,34,5,0,39,53,5,0,58,65,5,0,70,75,5,0,80
155252,132,"LICEUL TEORETIC ""IRIS""",TIMIŞOARA,TM,1476,7,2,0,9,28,6,0,34,41,13,0,54,69,17,0,86,88,18,0,106
155252,133,"ŞCOALA GIMNAZIALĂ NR.25",TIMIŞOARA,TM,1611,16,0,0,16,50,0,0,50,67,0,0,67,90,1,0,91,98,1,0,99
155252,134,"ŞCOALA GIMNAZIALĂ NR.25",TIMIŞOARA,TM,1585,13,0,0,13,46,2,0,48,69,3,0,72,92,5,0,97,102,5,0,107
155252,135,"ŞCOALA GIMNAZIALĂ NR.25",TIMIŞOARA,TM,1911,11,4,0,15,57,10,0,67,84,13,0,97,113,18,1,132,129,31,1,161
155252,136,"ŞCOALA GIMNAZIALĂ NR.25",TIMIŞOARA,TM,1557,18,1,0,19,53,4,0,57,88,6,0,94,120,7,0,127,133,9,0,142
155252,137,"ŞCOALA GIMNAZIALĂ NR.25",TIMIŞOARA,TM,1596,15,2,0,17,32,4,0,36,46,6,0,52,71,7,0,78,79,7,0,86
155252,138,"GRĂDINIŢA CU PROGRAM PRELUNGIT NR. 11 ( GRĂDINIŢA CU PROGRAM PRELUNGIT NR.12)",TIMIŞOARA,TM,952,8,0,0,8,26,3,0,29,40,3,0,43,53,7,0,60,57,8,0,65
155252,139,"ŞCOALA GIMNAZIALĂ NR.15",TIMIŞOARA,TM,1387,10,0,0,10,28,0,0,28,51,0,0,51,69,0,0,69,81,3,0,84
155252,140,"ŞCOALA GIMNAZIALĂ NR.15",TIMIŞOARA,TM,1061,8,2,0,10,17,5,0,22,32,7,0,39,44,7,0,51,49,10,0,59
155252,141,"ŞCOALA GIMNAZIALĂ NR.15",TIMIŞOARA,TM,1279,8,1,0,9,32,1,0,33,61,2,0,63,82,3,0,85,90,3,0,93
155252,142,"ŞCOALA GIMNAZIALĂ NR.15",TIMIŞOARA,TM,1278,7,1,0,8,27,3,0,30,46,3,0,49,59,3,0,62,62,6,0,68
155252,143,"S.C.""DRUMURIMUNICIPALE TIMIŞOARA "" S.A.",TIMIŞOARA,TM,1727,6,0,0,6,27,0,0,27,31,4,0,35,48,6,0,54,56,8,0,64
155252,144,"S.C.""DRUMURIMUNICIPALE TIMIŞOARA "" S.A.",TIMIŞOARA,TM,1718,8,1,0,9,28,1,0,29,46,3,0,49,56,3,0,59,72,5,0,77
155252,145,"GRADINIŢA CU PROGRAM PRELUNGIT NR.23",TIMIŞOARA,TM,1206,22,4,0,26,55,8,0,63,70,9,0,79,91,14,0,105,104,14,0,118
155252,146,"ŞCOALA GIMNAZIALĂ NR.13",TIMIŞOARA,TM,1157,4,1,0,5,31,2,0,33,38,4,0,42,53,5,0,58,55,10,0,65
155252,147,"ŞCOALA GIMNAZIALĂ NR.13",TIMIŞOARA,TM,1383,15,3,0,18,53,6,0,59,77,14,0,91,90,18,0,108,90,19,0,109
155252,148,"ŞCOALA GIMNAZIALĂ NR.13",TIMIŞOARA,TM,1346,9,0,0,9,24,1,0,25,48,7,0,55,69,9,0,78,78,10,0,88
155252,149,"ŞCOALA GIMNAZIALĂ NR.13",TIMIŞOARA,TM,1112,8,0,0,8,29,0,0,29,41,1,0,42,53,2,0,55,63,2,0,65
155252,150,"COLEGIUL TEHNIC ELECTROTIMIŞ",TIMIŞOARA,TM,1604,18,2,0,20,47,2,0,49,63,7,0,70,86,9,0,95,99,10,0,109
155252,151,"COLEGIUL TEHNIC ELECTROTIMIŞ",TIMIŞOARA,TM,1443,15,1,0,16,31,3,0,34,48,4,0,52,72,7,0,79,81,12,0,93
155252,152,"COLEGIUL TEHNIC ELECTROTIMIŞ",TIMIŞOARA,TM,1692,17,2,0,19,45,4,0,49,72,5,0,77,101,8,0,109,111,9,0,120
155252,153,"COLEGIUL TEHNIC ELECTROTIMIŞ",TIMIŞOARA,TM,1482,11,0,0,11,20,4,0,24,35,4,0,39,56,9,0,65,61,9,0,70
155252,154,"LICEUL TEORETIC ""VLAD TEPES""",TIMIŞOARA,TM,1534,18,1,0,19,44,2,0,46,59,5,0,64,86,5,0,91,94,6,0,100
155252,155,"LICEUL TEORETIC ""VLAD TEPES""",TIMIŞOARA,TM,1351,3,3,0,6,20,5,0,25,29,6,0,35,45,8,0,53,48,8,0,56
155252,156,"CENTRUL SCOLAR PENTRU EDUCATIE INCLUZIVA ""CONSTANTIN PUFAN""",TIMIŞOARA,TM,1320,15,1,0,16,46,2,0,48,62,2,0,64,88,5,0,93,98,8,0,106
155252,157,"GRĂDINIŢA CU PROGRAM PRELUNGIT NR.38 (GRADINIŢA CU PROGRAM NORMAL NR.19 )",TIMIŞOARA,TM,1644,20,1,0,21,48,7,0,55,71,8,0,79,89,8,0,97,101,9,0,110
155252,158,"GRĂDINIŢA CU PROGRAM PRELUNGIT NR.38 (GRĂDINIŢA CU PROGRAM NORMAL NR.19 )",TIMIŞOARA,TM,1560,11,4,0,15,43,4,0,47,60,5,0,65,88,5,0,93,99,6,0,105
155252,159,"ŞCOALA GIMNAZIALĂ NR.16 "" TAKE IONESCU """,TIMIŞOARA,TM,1426,18,3,0,21,58,3,0,61,89,3,0,92,104,7,0,111,112,7,0,119
155252,160,"ŞCOALA GIMNAZIALĂ NR.16 "" TAKE IONESCU """,TIMIŞOARA,TM,1128,19,0,0,19,55,2,0,57,74,2,0,76,99,2,0,101,110,4,0,114
155252,161,"ŞCOALA GIMNAZIALĂ NR.16 "" TAKE IONESCU """,TIMIŞOARA,TM,1050,20,0,1,21,56,4,10,70,84,23,11,118,97,27,16,140,101,27,12,140
155252,162,"GRĂDINIŢA CU PROGRAM PRELUNGIT NR.53 ( GRĂDINIŢA CU PROGRAM PRELUNGIT NR.48)",TIMIŞOARA,TM,944,12,2,0,14,28,4,1,33,34,5,1,40,46,6,1,53,55,6,1,62
155252,163,"COLEGIUL TEHNIC ENERGETIC "" REGELE FERDINAND I """,TIMIŞOARA,TM,1689,13,4,0,17,50,4,0,54,76,6,0,82,99,8,0,107,107,8,0,115
155252,164,"ŞCOALA GIMNAZIALĂ NR.21 "" VICENŢIU BABEŞ """,TIMIŞOARA,TM,1439,18,7,0,25,47,23,0,70,71,27,0,98,86,31,0,117,94,34,0,128
155252,165,"ŞCOALA GIMNAZIALĂ NR.21 "" VICENŢIU BABEŞ """,TIMIŞOARA,TM,1597,18,1,0,19,31,1,0,32,42,2,0,44,65,2,0,67,70,2,0,72
155252,166,"ŞCOALA GIMNAZIALĂ NR.21 "" VICENŢIU BABEŞ """,TIMIŞOARA,TM,1564,17,1,0,18,64,3,0,67,90,4,0,94,111,6,0,117,121,8,0,129
155252,167,"ŞCOALA GIMNAZIALĂ NR.21 "" VICENŢIU BABEŞ """,TIMIŞOARA,TM,1176,12,0,0,12,33,0,0,33,51,0,0,51,71,0,0,71,73,0,0,73
155252,168,"ŞCOALA GIMNAZIALĂ NR.7 ""SFÂNTA MARIA """,TIMIŞOARA,TM,1444,11,0,0,11,39,4,0,43,60,10,0,70,83,13,0,96,87,16,0,103
155252,169,"ŞCOALA GIMNAZIALĂ NR.7 ""SFÂNTA MARIA """,TIMIŞOARA,TM,1538,19,5,0,24,43,5,0,48,64,10,0,74,88,16,0,104,99,16,0,115
155252,170,"ŞCOALA GIMNAZIALĂ NR.7 ""SFÂNTA MARIA """,TIMIŞOARA,TM,1469,3,6,0,9,25,12,0,37,46,12,0,58,65,16,0,81,73,19,0,92
155252,171,"ŞCOALA GIMNAZIALĂ NR.7 ""SFÂNTA MARIA """,TIMIŞOARA,TM,1425,9,2,0,11,40,10,0,50,61,10,0,71,77,16,0,93,89,18,0,107
155252,172,"ŞCOALA GIMNAZIALĂ NR.7 ""SFÂNTA MARIA """,TIMIŞOARA,TM,1125,13,5,0,18,31,8,0,39,46,9,0,55,54,10,0,64,59,10,0,69
155252,173,"ŞCOALA GIMNAZIALĂ NR.7 ""SFÂNTA MARIA """,TIMIŞOARA,TM,1300,10,5,0,15,33,7,0,40,55,7,0,62,66,10,0,76,75,11,0,86
155252,174,"GRĂDINIŢA CU PROGRAM PRELUNGIT NR.20",TIMIŞOARA,TM,1665,12,0,0,12,50,5,0,55,76,7,0,83,99,8,0,107,106,9,0,115
155252,175,"GRADINIŢA CU PROGRAM PRELUNGIT NR.20",TIMIŞOARA,TM,1686,14,3,0,17,37,3,0,40,56,5,0,61,78,6,0,84,85,6,0,91
155252,176,"GRADINIŢA CU PROGRAM PRELUNGIT NR.20",TIMIŞOARA,TM,1406,19,4,0,23,43,4,0,47,79,4,0,83,123,4,0,127,126,4,0,130
155252,177,"DIRECȚIADE ASISTENȚĂSOCIALĂ A MUNICIPIULUI TIMIȘOARA, COMPLEXUL DE SERVICII SOCIALE PENTRU PERSOANE VÂRSTNICE „SF. ARH. MIHAIL ȘI GAVRIL”",TIMIŞOARA,TM,1414,11,1,0,12,46,7,0,53,53,12,0,65,71,16,0,87,80,16,0,96
155252,178,"DIRECȚIADE ASISTENȚĂSOCIALĂ A MUNICIPIULUI TIMIȘOARA, COMPLEXUL DE SERVICII SOCIALE PENTRU PERSOANE VÂRSTNICE „SF. ARH. MIHAIL ȘI GAVRIL”",TIMIŞOARA,TM,1235,5,1,0,6,24,3,0,27,38,3,0,41,47,8,0,55,52,8,0,60
155252,179,"COLEGIUL TEHNIC ENERGETIC "" REGELE FERDINAND I ""- CĂMIN NR.1 ( FOSTGRUP ŞCOLAR "" TUDOR TĂNĂSESCU "")",TIMIŞOARA,TM,1466,7,0,0,7,20,0,0,20,43,0,0,43,64,1,0,65,73,1,0,74
155252,180,"COLEGIUL TEHNIC ENERGETIC "" REGELE FERDINAND I ""- CĂMIN NR.1 ( FOSTGRUP ŞCOLAR "" TUDOR TĂNĂSESCU "")",TIMIŞOARA,TM,1271,6,2,0,8,21,2,0,23,28,6,0,34,38,7,0,45,46,7,0,53
155252,181,"COLEGIUL TEHNIC ENERGETIC "" REGELE FERDINAND I ""- CĂMIN NR.1 ( FOSTGRUP ŞCOLAR "" TUDOR TĂNĂSESCU "")",TIMIŞOARA,TM,1373,6,1,0,7,18,1,0,19,25,2,0,27,31,3,0,34,37,5,0,42
155252,182,"COLEGIUL TEHNIC ENERGETIC "" REGELE FERDINAND I ""- CĂMIN NR.1 ( FOSTGRUP ŞCOLAR "" TUDOR TĂNĂSESCU "")",TIMIŞOARA,TM,1313,9,0,0,9,22,0,0,22,28,0,0,28,45,2,0,47,49,2,0,51
155252,183,"COLEGIUL TEHNIC ENERGETIC „REGELE FERDINAND I”",TIMIŞOARA,TM,1572,1,4,0,5,14,5,0,19,23,5,0,28,27,7,0,34,34,8,0,42
155252,184,"COLEGIUL TEHNIC ENERGETIC „REGELE FERDINAND I”",TIMIŞOARA,TM,978,0,4,0,4,6,4,0,10,12,4,0,16,20,5,0,25,20,5,0,25
155252,185,"LICEUL TEORETIC ""WILLIAM SHAKESPEARE""",TIMIŞOARA,TM,1414,17,1,0,18,50,2,0,52,77,4,0,81,101,8,0,109,113,9,0,122
155252,186,"CENTRUL SCOLAR PENTRU EDUCATIE INCLUZIVA "" PAUL POPESCU NEVEANU""",TIMIŞOARA,TM,1251,3,2,0,5,21,2,0,23,39,4,0,43,54,5,0,59,63,5,0,68
155252,187,"CENTRUL SCOLAR PENTRU EDUCATIE INCLUZIVA "" PAUL POPESCU NEVEANU""",TIMIŞOARA,TM,1223,3,2,0,5,19,2,0,21,26,2,0,28,32,3,0,35,37,3,0,40
155252,188,"CENTRUL SCOLAR PENTRU EDUCATIE INCLUZIVA "" PAUL POPESCU NEVEANU""",TIMIŞOARA,TM,1254,1,3,0,4,6,5,0,11,23,6,0,29,33,8,0,41,39,9,0,48
155252,189,"CENTRUL ŞCOLAR PENTRU EDUCAŢIE INCLUZIVĂ ""PAUL POPESCU NEVEANU""",TIMIŞOARA,TM,1047,5,4,0,9,19,4,0,23,40,6,0,46,41,8,0,49,51,9,0,60
155252,190,"LICEUL TEORETIC JEAN LOUIS CALDERON CORP A",TIMIŞOARA,TM,1190,6,3,0,9,14,3,0,17,21,5,0,26,58,11,0,69,62,14,0,76
155252,191,"LICEUL TEORETIC JEAN LOUIS CALDERON CORP A",TIMIŞOARA,TM,1257,13,3,0,16,48,6,0,54,67,10,0,77,76,21,0,97,81,22,0,103
155252,192,"LICEUL TEORETIC JEAN LOUIS CALDERON CORP A",TIMIŞOARA,TM,1181,5,2,0,7,33,2,0,35,52,3,0,55,62,3,0,65,69,4,0,73
155252,193,"LICEUL TEORETIC JEAN LOUIS CALDERON CORP A",TIMIŞOARA,TM,1023,10,2,0,12,29,3,0,32,51,5,0,56,63,6,0,69,67,6,0,73
155252,194,"LICEUL TEOLOGIC PENTICOSTAL LOGOS",TIMIŞOARA,TM,1439,10,3,0,13,45,5,0,50,76,6,0,82,93,11,0,104,98,12,0,110
155252,195,"LICEUL TEOLOGIC PENTICOSTAL LOGOS",TIMIŞOARA,TM,1082,6,2,0,8,27,4,0,31,37,4,0,41,58,4,0,62,64,6,0,70
155252,196,"LICEUL TEOLOGIC PENTICOSTAL LOGOS",TIMIŞOARA,TM,1130,9,1,0,10,29,1,0,30,41,1,0,42,59,2,0,61,59,3,0,62
155252,197,"LICEUL TEOLOGIC PENTICOSTAL LOGOS",TIMIŞOARA,TM,1279,8,1,0,9,36,3,0,39,52,3,0,55,60,3,0,63,68,3,0,71
155252,198,"ŞCOALA GIMNAZIALĂ NR.6 (GRADINIŢA CU PROGRAM PRELUNGIT NR. 30)",TIMIŞOARA,TM,1535,5,3,0,8,24,6,0,30,43,6,0,49,64,6,0,70,83,6,0,89
155252,199,"ŞCOALA GIMNAZIALĂ NR.6 (GRADINIŢA CU PROGRAM PRELUNGIT NR. 30)",TIMIŞOARA,TM,1786,10,1,0,11,35,5,0,40,56,5,0,61,75,5,0,80,87,5,0,92
155252,200,"COLEGIUL TEHNIC "" ELECTROTIMIŞ "" ( ŞCOALA GIMNAZIALĂ NR.20 )",TIMIŞOARA,TM,2027,13,0,0,13,35,0,0,35,72,1,0,73,99,1,0,100,118,3,0,121
155252,201,"ŞCOALA GIMNAZIALĂ NR.1( ŞCOALA GIMNAZIALĂ NR. 4 )",TIMIŞOARA,TM,1618,22,0,0,22,49,0,0,49,75,1,0,76,113,2,0,115,125,6,0,131
155252,202,"ŞCOALA GIMNAZIALĂ NR.1( ŞCOALA GIMNAZIALĂ NR. 4 )",TIMIŞOARA,TM,1438,17,5,0,22,32,6,0,38,63,7,0,70,82,10,0,92,111,10,0,121
155252,203,"GRĂDINIŢA CU PROGRAM PRELUNGIT NR.38 ( GRĂDINIŢA CU PROGRAM PRELUNGIT NR.6 )",TIMIŞOARA,TM,1308,17,0,0,17,51,1,0,52,64,1,0,65,81,1,0,82,91,1,0,92
155252,204,"GRĂDINIŢA CU PROGRAM PRELUNGIT NR.38 ( GRĂDINIŢA CU PROGRAM PRELUNGIT NR.6 )",TIMIŞOARA,TM,1312,27,3,0,30,57,5,0,62,73,5,0,78,88,6,0,94,98,6,0,104
155252,205,"TELEKOM ROMÂNIA COMMUNICATIONS S.A.",TIMIŞOARA,TM,1248,6,0,0,6,29,1,0,30,38,3,0,41,46,3,0,49,51,3,0,54
155252,206,"TELEKOM ROMÂNIA COMMUNICATIONS S.A.",TIMIŞOARA,TM,1085,7,2,0,9,19,3,0,22,38,3,0,41,52,3,2,57,59,3,2,64
155252,207,"GRADINITA AEROPORT CU PROGRAM PRELUNGIT NR.13",TIMIŞOARA,TM,511,6,1,0,7,17,1,0,18,24,1,0,25,37,1,0,38,42,1,0,43
155369,208,"COLEGIUL NAŢIONAL ,,IULIA HAŞDEU""",LUGOJ,TM,1252,11,0,0,11,40,1,0,41,57,3,0,60,81,5,0,86,90,6,0,96
155369,209,"ŞCOALA GIMNAZIALĂ NR.3",LUGOJ,TM,1582,19,4,0,23,42,4,0,46,67,5,0,72,80,6,0,86,105,9,0,114
155369,210,"GRĂDINIŢA CU PROGRAM PRELUNGIT NR.3",LUGOJ,TM,1695,15,4,0,19,59,6,0,65,91,8,0,99,123,8,0,131,134,9,0,143
155369,211,"GRĂDINIŢA CU PROGRAM PRELUNGIT NR.4",LUGOJ,TM,1329,12,1,0,13,50,6,1,57,74,6,1,81,89,6,1,96,98,6,1,105
155369,212,"GRĂDINIŢA CU PROGRAM PRELUNGIT NR.4",LUGOJ,TM,1046,14,2,0,16,44,2,0,46,51,2,0,53,70,2,0,72,80,2,0,82
155369,213,"ŞCOALA GIMNAZIALĂ NR.4",LUGOJ,TM,1013,17,6,0,23,42,7,0,49,62,10,0,72,69,10,0,79,77,10,0,87
155369,214,"GRĂDINIŢA CU PROGRAM PRELUNGIT NR.5",LUGOJ,TM,1512,10,6,0,16,45,6,0,51,65,7,0,72,81,8,0,89,89,8,0,97
155369,215,"GRĂDINIŢA CU PROGRAM PRELUNGIT NR.5",LUGOJ,TM,1160,9,0,0,9,25,1,0,26,37,1,0,38,62,1,0,63,63,1,0,64
155369,216,"ŞCOALA GIMNAZIALĂ NR.2",LUGOJ,TM,1496,10,0,0,10,49,2,0,51,63,2,0,65,71,2,0,73,82,2,0,84
155369,217,"GRĂDINIŢA CU PROGRAM PRELUNGIT NR.7",LUGOJ,TM,1451,7,2,0,9,30,2,0,32,40,2,0,42,53,2,0,55,60,2,0,62
155369,218,"GRĂDINIŢA CU PROGRAM NORMAL NR.11",LUGOJ,TM,1262,12,2,0,14,35,2,0,37,65,2,0,67,96,2,0,98,123,2,0,125
155369,219,"GRĂDINIŢA CU PROGRAM NORMAL NR.11",LUGOJ,TM,1035,20,1,0,21,34,2,0,36,58,5,0,63,77,5,0,82,91,5,0,96
155369,220,"SALA SPORTURILOR ,,IOAN KUNST GHERMĂNESCU""",LUGOJ,TM,773,8,0,0,8,23,1,0,24,32,3,0,35,42,3,0,45,48,4,0,52
155369,221,"SALA SPORTURILOR ,,IOAN KUNST GHERMĂNESCU""",LUGOJ,TM,1482,6,0,0,6,30,2,0,32,56,3,0,59,72,4,0,76,82,4,0,86
155369,222,"SALA SPORTURILOR ,,IOAN KUNST GHERMĂNESCU""",LUGOJ,TM,1337,21,1,0,22,32,1,0,33,53,1,0,54,82,1,0,83,82,2,0,84
155369,223,"SALA SPORTURILOR ,,IOAN KUNST GHERMĂNESCU""",LUGOJ,TM,1172,3,1,0,4,17,1,0,18,35,3,0,38,35,3,0,38,44,3,0,47
155369,224,"ŞCOALA GIMNAZIALĂ ""EFTIMIE MURGU""",LUGOJ,TM,1149,13,0,0,13,35,1,0,36,51,1,0,52,60,1,0,61,72,1,0,73
155369,225,"ŞCOALA GIMNAZIALĂ ,,EFTIMIE MURGU""",LUGOJ,TM,1459,6,0,0,6,26,0,0,26,43,2,0,45,58,2,0,60,62,3,0,65
155369,226,"GRĂDINIŢA CUPROGRAM NORMAL NR.13",LUGOJ,TM,1649,7,0,0,7,40,2,0,42,61,4,0,65,88,7,0,95,93,8,0,101
155369,227,"COLEGIUL TEHNIC ""VALERIU BRANIŞTE""",LUGOJ,TM,1120,5,0,0,5,21,2,0,23,33,6,13,52,52,6,13,71,53,6,13,72
155369,228,"GRĂDINIŢA CU PROGRAM PRELUNGIT NR.2",LUGOJ,TM,1550,14,0,0,14,29,1,0,30,49,1,0,50,57,4,0,61,67,4,0,71
155369,229,"ŞCOALA GIMNAZIALĂ NR.1",LUGOJ,TM,1278,9,3,0,12,40,5,0,45,45,7,0,52,60,7,0,67,78,7,0,85
155369,230,"ŞCOALA GIMNAZIALĂ NR.1",LUGOJ,TM,1293,11,0,0,11,27,0,0,27,51,3,0,54,62,4,1,67,92,4,1,97
155369,231,"ŞCOALA GIMNAZIALĂ NR.1",LUGOJ,TM,434,5,0,0,5,10,0,0,10,12,0,0,12,12,0,0,12,13,1,0,14
155369,232,"CLUBUL TINERETULUI",LUGOJ,TM,1112,9,5,0,14,23,7,0,30,28,11,0,39,40,12,0,52,47,13,0,60
155369,233,"SALA DE LUPTE ŞI GIMNASTICĂ ,,FRANCISC HORVATH""",LUGOJ,TM,1117,13,6,0,19,26,8,0,34,33,9,0,42,40,9,1,50,42,9,1,52
155369,234,"BAZA DE AGREMENT ŞTRAND",LUGOJ,TM,1256,19,1,0,20,44,1,0,45,60,1,0,61,72,2,0,74,77,2,0,79
155369,235,"SALA SPORTURILOR ,,LAVINIA MILOŞOVICI""",LUGOJ,TM,1562,11,2,0,13,30,3,0,33,45,3,0,48,63,4,0,67,79,5,0,84
155369,236,"SALA SPORTURILOR ,,LAVINIA MILOŞOVICI""",LUGOJ,TM,1529,13,1,0,14,40,3,0,43,54,4,0,58,68,10,0,78,78,10,0,88
155369,237,"SALA SPORTURILOR ,,LAVINIA MILOŞOVICI""",LUGOJ,TM,1629,8,6,0,14,29,6,0,35,44,6,0,50,63,7,0,70,73,7,0,80
155378,238,"CĂMINUL CULTURAL MĂGURI",MĂGURI,TM,762,7,4,0,11,15,7,0,22,24,8,0,32,46,9,0,55,47,9,0,56
155387,239,"GRĂDINIŢA CU PROGRAM NORMAL NR.5 TĂPIA",TAPIA,TM,253,4,2,0,6,4,2,0,6,5,8,0,13,10,9,0,19,10,9,0,19
155412,240,"ŞCOALA GIMNAZIALĂ BUZIAŞ",BUZIAŞ,TM,1520,26,11,0,37,53,18,0,71,66,22,0,88,80,26,0,106,90,26,0,116
155412,241,"ŞCOALA GENERALĂ",BUZIAŞ,TM,1363,15,9,0,24,42,30,46,118,50,53,46,149,61,57,46,164,68,61,46,175
155412,242,"LICEUL TEORETIC",BUZIAŞ,TM,1805,13,14,0,27,46,36,0,82,58,42,0,100,70,50,0,120,74,52,0,126
155430,243,"ŞCOALAGIMNAZIALĂ BACOVA",BACOVA,TM,1608,5,3,0,8,27,5,0,32,31,6,0,37,37,6,0,43,39,6,0,45
155421,244,"ŞCOALA PRIMARĂ SILAGIU",SILAGIU,TM,658,5,2,0,7,13,4,0,17,17,4,0,21,23,4,0,27,26,4,0,30
156366,245,PRIMĂRIE,CIACOVA,TM,1303,18,2,0,20,37,2,0,39,54,4,0,58,60,5,0,65,62,7,0,69
156366,246,"LICEUL AL.MOCIONI CIACOVA",CIACOVA,TM,1000,8,1,0,9,17,2,0,19,26,2,0,28,32,3,0,35,32,3,0,35
156375,247,ȘCOALAPRIMARĂCEBZA,CEBZA,TM,611,8,4,0,12,17,9,0,26,44,14,0,58,52,14,0,66,52,15,0,67
156400,248,"CĂMINUL CULTURAL MACEDONIA",MACEDONIA,TM,366,4,0,0,4,12,2,0,14,17,2,0,19,22,3,0,25,23,4,0,27
156419,249,"ŞCOALAPRIMARĂ OBAD",OBAD,TM,517,1,1,0,2,2,2,0,4,2,2,0,4,9,2,0,11,10,2,0,12
156428,250,ŞCOALAPRIMARĂPETROMAN,PETROMAN,TM,565,7,0,0,7,12,1,0,13,15,1,0,16,22,2,0,24,23,3,0,26
155467,251,"LICEUL SFÂNTUL NICOLAE DETA",DETA,TM,1617,18,2,0,20,30,2,0,32,51,3,0,54,80,9,0,89,87,10,0,97
155467,252,"ȘCOALA GIMNAZIALĂ DETA",DETA,TM,1456,10,1,0,11,22,1,0,23,39,1,0,40,51,1,0,52,65,1,0,66
155467,253,"ȘCOALA GIMNAZIALĂ DETA",DETA,TM,1136,10,0,0,10,25,0,0,25,34,0,0,34,42,0,0,42,45,0,0,45
155467,254,"A.N.I.F DETA",DETA,TM,1594,9,0,0,9,31,0,0,31,46,3,0,49,55,3,0,58,60,3,0,63
155476,255,"CĂMINUL CULTURAL OPATIŢA",OPATIŢA,TM,565,4,0,0,4,11,0,0,11,16,0,0,16,18,0,0,18,18,0,0,18
156810,256,"CASA DE CULTURA FAGET",FĂGET,TM,1576,17,4,0,21,69,5,0,74,96,8,0,104,129,11,0,140,142,11,0,153
156810,257,"SC TRANSPORT MIXT FAGETEANA SA",FĂGET,TM,320,5,4,0,9,5,4,0,9,6,4,0,10,8,4,0,12,9,4,0,13
156810,258,"GRĂDINIŢAPROGRAM NORMAL FĂGET",FĂGET,TM,1397,15,0,0,15,31,0,0,31,62,0,0,62,82,8,0,90,99,9,0,108
156829,259,"ŞCOALA PRIMARĂ BĂTEȘTI,",BĂTEŞTI,TM,398,7,1,0,8,12,1,0,13,21,1,0,22,22,2,0,24,28,2,0,30
156838,260,"FOSTA ŞCOALA GIMNAZIALĂ BEGHEIULMIC","BEGHEIU MIC",TM,277,2,0,0,2,6,2,0,8,8,2,0,10,14,2,0,16,15,3,0,18
156847,261,"CĂMINUL CULTURAL BICHIGI",BICHIGI,TM,500,8,3,0,11,16,5,0,21,26,5,0,31,42,7,0,49,54,12,0,66
156856,262,"CAMINUL CULTURAL BRĂNEŞTI",BRĂNEŞTI,TM,409,1,0,0,1,7,2,0,9,10,3,0,13,17,3,0,20,23,4,0,27
156865,263,"ȘCOALA PRIMARĂ BUNEA MARE","BUNEA MARE",TM,172,0,0,0,0,0,0,0,0,0,0,0,0,0,0,0,0,2,0,0,2
156883,264,"ŞCOALA PRIMARĂ , COLONIA MICĂ","COLONIA MICĂ",TM,269,0,0,0,0,8,0,0,8,14,0,0,14,19,2,0,21,33,2,0,35
156892,265,"FOSTA ȘCOALA GENERALĂ JUPÂNEŞTI",JUPÂNEŞTI,TM,149,4,2,0,6,4,2,0,6,5,3,0,8,5,3,0,8,7,3,0,10
156909,266,"CAMINUL CULTURAL POVERGINA",POVÂRGINA,TM,135,1,0,0,1,1,0,0,1,2,0,0,2,2,0,0,2,2,0,0,2
156918,267,"CAMINUL CULTURAL TEMEREŞTI",TEMEREŞTI,TM,436,19,0,0,19,31,0,0,31,47,1,0,48,58,6,0,64,62,6,0,68
157095,268,"LICEUL TEORETIC GĂTAIA",GĂTAIA,TM,1411,19,2,0,21,30,8,0,38,42,9,0,51,59,11,0,70,66,11,0,77
157095,269,"PRIMARIA ORAS GATAIA",GĂTAIA,TM,1335,14,1,0,15,34,4,0,38,52,11,0,63,62,12,0,74,71,12,0,83
157157,270,"SCOALA PRIMARA SCULIA",SCULIA,TM,1621,25,1,0,26,46,2,0,48,76,4,0,80,118,7,0,125,131,8,0,139
157120,271,"ŞCOALA PRIMARĂ BUTIN",BUTIN,TM,318,2,3,0,5,7,5,0,12,11,6,0,17,15,7,0,22,15,8,0,23
157148,272,"ŞCOALA PRIMARĂ PERCOSOVA",PERCOSOVA,TM,226,0,3,0,3,2,4,0,6,2,6,0,8,3,6,0,9,3,6,0,9
157175,273,"SCOALA PRIMARA SEMLACU MARE","ŞEMLACU MARE",TM,268,1,0,0,1,2,5,0,7,5,7,0,12,11,8,0,19,11,11,0,22
157184,274,"ŞCOALA PRIMARĂŞEMLACUL MIC","ŞEMLACU MIC",TM,147,0,2,0,2,4,4,0,8,4,5,0,9,5,6,0,11,5,6,0,11
155500,275,"LICEUL TEHNOLOGIC JIMBOLIA",JIMBOLIA,TM,1689,10,3,0,13,29,3,0,32,42,3,0,45,59,4,0,63,68,4,0,72
155500,276,"LICEUL TEHNOLOGIC JIMBOLIA",JIMBOLIA,TM,1555,14,2,0,16,32,2,0,34,44,2,0,46,53,6,0,59,58,6,0,64
155500,277,"ŞCOALA GIMNAZIALĂ JIMBOLIA",JIMBOLIA,TM,1643,7,0,0,7,13,0,0,13,17,0,0,17,29,2,0,31,42,3,0,45
155500,278,"ŞCOALA GIMNAZIALĂ JIMBOLIA",JIMBOLIA,TM,1622,7,0,0,7,20,5,0,25,30,6,0,36,38,6,0,44,40,6,0,46
155500,279,"INCUBATORUL DE AFACERI JIMBOLIA",JIMBOLIA,TM,1489,6,2,0,8,25,4,0,29,31,4,0,35,42,4,0,46,46,4,0,50
155500,280,"CASA DE CULTURĂ",JIMBOLIA,TM,1532,10,0,0,10,31,5,0,36,49,5,0,54,63,5,0,68,70,5,0,75
155500,281,"CASA DE CULTURĂ",JIMBOLIA,TM,1338,2,4,0,6,13,7,0,20,21,10,0,31,35,16,0,51,38,16,0,54
155500,282,"GRADINITA CU PROGRAM NORMAL CLARII VII",JIMBOLIA,TM,219,0,0,0,0,3,0,0,3,8,0,0,8,10,0,0,10,15,0,0,15
158323,283,"PRIMĂRIA RECAȘ",RECAŞ,TM,1816,17,4,0,21,31,8,0,39,43,9,0,52,57,13,0,70,68,14,0,82
158323,284,"GRĂDINIȚA CU P.P. RECAȘ",RECAŞ,TM,1391,3,3,0,6,8,4,0,12,20,5,0,25,31,6,0,37,38,7,0,45
158323,285,"LICEUL TEORETIC RECAȘ",RECAŞ,TM,1667,7,3,0,10,27,8,0,35,40,12,0,52,53,17,0,70,61,19,0,80
158332,286,"ȘCOALA GIMNAZIALĂ BAZOȘ",BAZOŞ,TM,789,7,3,0,10,12,3,0,15,14,5,0,19,29,9,0,38,32,9,0,41
158341,287,"ȘCOALA PRIMARĂ HERNEACOVA",HERNEACOVA,TM,367,3,0,0,3,5,1,0,6,9,1,0,10,18,1,0,19,23,9,0,32
158350,288,"ȘCOALA GIMNAZIALĂ IZVIN",IZVIN,TM,1300,10,3,0,13,37,6,0,43,64,7,0,71,94,13,0,107,148,14,0,162
158378,289,"ȘCOALA PRIMARĂ PETROVASELO",PETROVASELO,TM,207,2,5,0,7,8,6,0,14,10,11,0,21,12,12,0,24,15,12,0,27
158387,290,"ȘCOALA PRIMARĂ STANCIOVA",STANCIOVA,TM,304,2,0,0,2,9,0,0,9,9,0,0,9,16,2,0,18,16,3,0,19
155537,291,"SALA CASEI DE CULTURĂ (CASTEL NAKO)ETAJ 1","SÂNNICOLAU MARE",TM,1362,9,1,0,10,27,2,0,29,44,3,0,47,55,3,0,58,61,3,0,64
155537,292,"SALA CASEI DE CULTURĂ (CASTEL NAKO) DEMISOL","SÂNNICOLAU MARE",TM,1688,18,4,0,22,45,5,1,51,67,7,1,75,90,11,1,102,102,13,1,116
155537,293,"PRIMĂRIA ORAŞULUI SÂNNICOLAU MARE","SÂNNICOLAU MARE",TM,1782,12,3,0,15,32,7,0,39,47,9,0,56,69,15,0,84,87,19,0,106
155537,294,"GRĂDINIŢA PP1 NR.1 PARTER, SÂNNICOLAU MARE","SÂNNICOLAU MARE",TM,1822,12,0,0,12,48,0,0,48,53,0,0,53,63,1,0,64,70,1,0,71
155537,295,"GRĂDINIŢA PP1 NR.1 ETAJ, SÂNNICOLAU MARE","SÂNNICOLAU MARE",TM,1489,11,0,0,11,35,0,0,35,44,0,0,44,55,0,0,55,67,0,0,67
155537,296,"LICEUL TEHNOLOGIC CRISTOFOR NAKO ORAŞ SÂNNICOLAU MARE","SÂNNICOLAU MARE",TM,1873,16,3,0,19,34,5,0,39,53,10,0,63,70,10,0,80,76,10,0,86
155537,297,"ŞCOALA GIMNAZIALA THEODOR BUCURESCU NR.1, SÂNNICOLAU MARE, PARTER","SÂNNICOLAU MARE",TM,1802,19,7,0,26,35,9,0,44,47,14,15,76,60,17,15,92,65,18,15,98
155555,298,"CĂMINUL CULTURAL BALINŢ",BALINŢ,TM,420,2,2,0,4,10,5,0,15,16,14,0,30,22,16,0,38,22,16,0,38
155564,299,"GRADINITA PN BODO",BODO,TM,402,6,1,0,7,8,2,0,10,8,2,0,10,9,2,0,11,10,2,0,12
155573,300,"ŞCOALA PRIMARĂ FĂDIMAC",FĂDIMAC,TM,190,1,6,0,7,2,6,0,8,4,9,0,13,6,9,0,15,7,9,0,16
155582,301,"ŞCOALA PRIMARĂ TÎRGOVIŞTE",TÎRGOVIŞTE,TM,275,0,0,0,0,4,4,0,8,7,4,0,11,13,4,0,17,17,5,0,22
155608,302,"PRIMĂRIA BANLOC",BANLOC,TM,1356,16,0,0,16,37,1,0,38,54,1,0,55,60,2,0,62,65,3,0,68
155635,303,"GRĂDINIŢA CU PROGRAM NORMAL OFSENIŢA",OFSENIŢA,TM,331,2,1,0,3,11,3,0,14,13,3,0,16,16,3,0,19,17,3,0,20
155644,304,"GRĂDINIŢA CU PROGRAM NORMALPARTOŞ",PARTOŞ,TM,372,4,0,0,4,4,1,0,5,4,1,0,5,6,1,0,7,8,1,0,9
155653,305,"GRĂDINIŢA CU PROGRAM NORMALSOCA",SOCA,TM,449,10,1,0,11,24,1,0,25,37,1,0,38,40,5,0,45,46,6,0,52
155671,306,"PRIMARIA BARA",BARA,TM,139,4,3,0,7,6,7,2,15,10,13,2,25,13,19,2,34,19,23,2,44
155680,307,"CLĂDIREA COMUNEI BARA ( FOSTASCOALĂ DOBRESTI)",DOBREŞTI,TM,33,7,6,0,13,8,7,0,15,8,8,0,16,9,9,0,18,11,10,0,21
155699,308,"CĂMINUL CULTURALLĂPUŞNIC",LĂPUŞNIC,TM,38,4,2,0,6,5,5,0,10,7,5,0,12,13,7,0,20,13,7,0,20
155706,309,"CĂMINUL CULTURALRĂDMĂNEŞTI",RĂDMĂNEŞTI,TM,48,2,2,0,4,2,3,0,5,10,6,0,16,13,7,0,20,13,7,0,20
155733,310,"CĂMINUL CULTURAL BEBA VECHE","BEBA VECHE",TM,856,9,2,0,11,23,9,0,32,24,9,0,33,30,9,0,39,33,9,0,42
155742,311,"CĂMINUL CULTURAL CHEREŞTUR",CHERESTUR,TM,417,2,0,0,2,7,0,0,7,13,0,0,13,16,0,0,16,16,0,0,16
155779,312,"GRĂDINIŢA PP DIMITRIE ŢICHINDEAL","BECICHERECU MIC",TM,1373,8,2,0,10,18,10,0,28,39,15,0,54,48,16,0,64,54,17,0,71
155779,313,"ŞCOALA GIMNAZIALĂ DIMITRIE ŢICHINDEAL","BECICHERECU MIC",TM,1286,7,2,0,9,23,8,0,31,34,9,0,43,39,11,0,50,40,13,0,53
155804,314,"PRIMĂRIA BELINŢ",BELINŢ,TM,1187,5,1,0,6,17,3,0,20,26,8,0,34,45,12,0,57,56,13,0,69
155813,315,"GRADINITA CU PROGRAM NORMAL BABSA-GRUNI",BABŞA,TM,190,2,0,0,2,5,0,0,5,6,0,0,6,8,3,0,11,9,3,0,12
155831,316,"GRADINITA CU PROGRAM NORMAL BABSA-GRUNI",GRUNI,TM,177,7,1,0,8,11,1,0,12,11,2,0,13,17,4,0,21,17,4,0,21
155822,317,"GRADINITA CU PROGRAM NORMAL CHIZATAU",CHIZĂTĂU,TM,630,3,1,0,4,10,4,0,14,16,4,0,20,20,6,0,26,23,7,0,30
155859,318,"PRIMĂRIA BETHAUSEN",BETHAUSEN,TM,697,9,1,0,10,17,1,0,18,23,1,0,24,33,3,0,36,37,3,0,40
155868,319,"CĂMINUL CULTURAL CLADOVA",CLADOVA,TM,368,15,1,0,16,21,1,0,22,30,1,0,31,39,2,0,41,46,3,0,49
155877,320,"CĂMINUL CULTURAL CLICIOVA",CLICIOVA,TM,344,0,0,0,0,8,3,0,11,15,3,0,18,21,3,0,24,24,3,0,27
155886,321,"ŞCOALA PRIMARĂCUTINA",CUTINA,TM,242,8,1,0,9,11,3,0,14,13,5,0,18,17,5,0,22,17,5,0,22
155895,322,"ŞCOALA PRIMARĂ LEUCUŞEŞTI",LEUCUŞEŞTI,TM,354,6,0,0,6,14,0,0,14,19,0,0,19,30,0,0,30,34,1,0,35
155902,323,"GRĂDINIŢA CU PROGRAM NORMAL NEVRINCEA",NEVRINCEA,TM,189,4,2,0,6,8,2,0,10,17,2,0,19,22,2,0,24,26,2,0,28
155920,324,CAMINULCULTURALBILED,BILED,TM,1879,8,4,0,12,25,5,0,30,36,7,0,43,43,9,0,52,47,10,0,57
155920,325,GRADINITAPPBILED,BILED,TM,1513,8,4,0,12,18,4,0,22,19,4,0,23,26,4,0,30,29,4,0,33
157111,326,"ŞCOALA GIMNAZIALĂ BIRDA",BIRDA,TM,920,5,3,0,8,11,3,0,14,16,4,0,20,27,5,0,32,33,8,0,41
157102,327,"CĂMINUL CULTURAL BERECUŢA",BERECUŢA,TM,148,4,3,0,7,8,4,0,12,14,4,0,18,19,5,0,24,23,7,0,30
157139,328,"ŞCOALA PRIMARĂ MÂNĂSTIRE",MÂNĂSTIRE,TM,176,3,1,0,4,6,2,0,8,12,4,0,16,23,7,0,30,23,8,0,31
157166,329,"ŞCOALA PRIMARĂSÂNGEORGE",SÂNGEORGE,TM,440,6,1,0,7,11,1,0,12,17,1,0,18,19,1,0,20,21,1,0,22
155966,330,"CĂMINUL CULTURAL BÎRNA",BÎRNA,TM,422,5,2,0,7,8,2,0,10,14,3,0,17,16,6,0,22,21,7,0,28
155984,331,"CĂMINUL CULTURAL BOTINEŞTI",BOTINEŞTI,TM,164,3,3,0,6,5,3,0,8,7,4,0,11,12,6,0,18,12,6,0,18
155993,332,"CĂMINUL CULTURAL DRINOVA",DRINOVA,TM,162,2,2,0,4,8,2,0,10,12,4,0,16,15,4,0,19,18,4,0,22
156008,333,"CĂMINUL CULTURAL JUREŞTI",JUREŞTI,TM,187,2,0,0,2,5,0,0,5,6,0,0,6,6,3,0,9,8,3,0,11
156017,334,"CĂMINUL CULTURAL POGĂNEŞTI",POGĂNEŞTI,TM,271,3,1,0,4,4,3,0,7,7,3,0,10,15,5,0,20,20,5,0,25
156044,335,"SEDIUL PRIMĂRIEI BOGDA",BOGDA,TM,255,3,2,0,5,4,3,0,7,5,4,0,9,7,7,0,14,9,8,0,17
156062,336,"CASA DE CULTURĂ BUZAD",BUZAD,TM,152,4,4,0,8,8,8,0,16,12,9,0,21,14,9,0,23,14,9,0,23
156115,337,"ŞCOALA GIMNAZIALĂBOLDUR",BOLDUR,TM,488,8,1,0,9,12,3,0,15,19,5,0,24,34,5,0,39,34,5,0,39
156124,338,"ŞCOALA PRIMARĂ JABĂR",JABĂR,TM,359,1,3,0,4,6,3,0,9,12,6,0,18,15,6,0,21,18,6,0,24
156133,339,"ŞCOALA PRIMARĂ OHABA-FORGACI",OHABA-FORGACI,TM,634,8,0,0,8,11,2,0,13,18,3,0,21,23,6,0,29,24,6,0,30
156142,340,"ŞCOALA PRIMARĂ SINERSIG",SINERSIG,TM,501,9,1,0,10,23,2,0,25,32,2,0,34,38,5,0,43,44,7,0,51
156160,341,"PRIMĂRIA BRESTOVĂŢ",BRESTOVĂŢ,TM,232,2,0,0,2,4,2,0,6,5,3,0,8,7,3,0,10,7,3,0,10
156179,342,"CLADIREA COMUNEI BRESTOVAT (FOSTA ŞCOALA GENERALĂ COŞARII)",COŞARII,TM,110,0,0,0,0,2,1,0,3,2,2,0,4,4,2,0,6,4,2,0,6
156204,343,"CĂMINUL CULTURAL TEŞ",TEŞ,TM,229,7,1,0,8,12,1,0,13,17,2,0,19,21,3,0,24,22,3,0,25
158421,344,"CĂMINUL CULTURAL BUCOVĂŢ",BUCOVĂŢ,TM,1259,2,1,0,3,24,6,0,30,37,11,0,48,44,14,0,58,49,14,0,63
158412,345,"CĂMINUL CULTURAL BAZOŞU NOU","BAZOŞU NOU",TM,294,5,4,0,9,6,9,0,15,11,12,0,23,11,16,0,27,18,18,0,36
156222,346,"PRIMARIA CĂRPINIŞ",CĂRPINIŞ,TM,1833,18,0,0,18,48,4,0,52,70,5,0,75,92,7,0,99,99,8,0,107
156222,347,"CĂMINUL CULTURAL CĂRPINIŞ",CĂRPINIŞ,TM,1675,21,2,0,23,63,4,0,67,84,4,0,88,112,10,0,122,129,12,0,141
156240,348,"CĂMINUL CULTURAL IECEA MICĂ","IECEA MICĂ",TM,1035,5,0,0,5,17,1,0,18,25,7,0,32,34,8,0,42,42,9,0,51
156268,349,"ŞCOALA GIMNAZIALĂCENAD",CENAD,TM,1956,8,0,0,8,19,2,0,21,21,3,0,24,38,5,0,43,40,5,0,45
156268,350,"ŞCOALA GIMNAZIALĂ CENAD",CENAD,TM,1933,13,1,0,14,21,4,0,25,37,6,0,43,51,6,0,57,53,8,0,61
156286,351,"SEDIUL PRIMĂRIEI CENEI",CENEI,TM,1821,10,2,0,12,25,2,0,27,33,6,0,39,54,12,0,66,55,12,0,67
156295,352,"ŞCOALA PRIMARĂ BOBDA",BOBDA,TM,777,10,0,0,10,23,2,0,25,28,2,0,30,33,2,0,35,34,3,0,37
156302,353,"CĂMINUL CULTURAL CHECEA",CHECEA,TM,1662,7,1,0,8,21,5,0,26,36,7,6,49,38,12,6,56,40,13,6,59
156320,354,"CONSILIUL LOCAL CHEVEREŞU MARE","CHEVEREŞU MARE",TM,1081,10,3,0,13,13,4,0,17,24,6,0,30,27,8,0,35,30,8,0,38
156339,355,"ŞCOALA PRIMARĂ DRAGŞINA",DRAGŞINA,TM,489,6,2,0,8,13,6,0,19,18,9,0,27,28,12,0,40,34,12,0,46
156348,356,"ŞCOALAPRIMARĂ VUCOVA",VUCOVA,TM,314,3,1,0,4,7,2,0,9,12,3,0,15,14,4,0,18,19,7,0,26
156446,357,"ŞCOALA GIMNAZIALĂ COMLOŞU MARE","COMLOŞU MARE",TM,1470,6,1,0,7,13,4,0,17,26,7,0,33,36,8,0,44,36,8,0,44
156446,358,"CĂMINUL CULTURAL COMLOŞU MARE","COMLOŞU MARE",TM,1465,4,2,0,6,25,5,0,30,33,6,0,39,49,6,0,55,52,6,0,58
156455,359,"BIBLIOTECA DIN COMLOŞU MIC","COMLOŞU MIC",TM,890,6,0,0,6,15,0,0,15,17,0,0,17,27,0,0,27,28,0,0,28
156464,360,"ŞCOALA PRIMARĂ LUNGA",LUNGA,TM,451,1,2,0,3,6,3,0,9,12,3,0,15,22,3,0,25,23,4,0,27
156482,361,"CĂMINUL CULTURAL COŞTEIU",COŞTEIU,TM,656,14,7,0,21,17,8,0,25,26,8,0,34,31,8,0,39,36,8,0,44
156482,362,"PRIMĂRIA VECHECOŞTEIU",COŞTEIU,TM,1237,9,0,0,9,20,2,0,22,36,8,0,44,48,9,0,57,50,11,0,61
156491,363,"ŞCOALA PRIMARA HEZERIS",HEZERIŞ,TM,221,5,0,0,5,12,2,0,14,16,2,0,18,18,3,0,21,20,4,0,24
156507,364,"CAMINUL CULTURAL PARU",PĂRU,TM,195,3,2,0,5,9,3,0,12,11,3,0,14,12,4,0,16,12,4,0,16
156516,365,"CĂMINUL CULTURAL ŢIPARI",ŢIPARI,TM,721,3,3,0,6,4,5,0,9,6,5,0,11,13,5,0,18,16,5,0,21
156525,366,"CĂMINUL CULTURAL VALEA LUNGĂ ROMÂNĂ","VALEA LUNGĂ ROMÂNĂ",TM,123,0,0,0,0,2,0,0,2,3,0,0,3,5,0,0,5,6,0,0,6
156543,367,"GRĂDINIŢA CU PROGRAM NORMAL CRICIOVA",CRICIOVA,TM,594,8,0,0,8,16,2,0,18,26,4,0,30,36,4,0,40,40,5,0,45
156552,368,"CĂMINUL CULTURAL CIREŞU",CIREŞU,TM,290,3,0,0,3,5,4,0,9,8,5,0,13,11,5,0,16,12,5,0,17
156570,369,"GRĂDINIŢA CU PROGRAM NORMAL JDIOARA",JDIOARA,TM,463,4,1,0,5,12,3,0,15,20,3,0,23,26,4,0,30,32,4,0,36
156598,370,"CĂMINUL CULTURAL CURTEA",CURTEA,TM,534,7,1,0,8,24,1,0,25,25,2,0,27,38,2,0,40,46,5,0,51
156605,371,"CĂMINUL CULTURAL COŞAVA",COŞAVA,TM,456,1,0,0,1,4,0,0,4,9,0,0,9,16,1,0,17,16,1,0,17
156632,372,"SCOALA GIMNAZIALA COMUNA DAROVA",DAROVA,TM,1730,2,0,0,2,12,0,0,12,16,0,0,16,20,1,0,21,28,1,0,29
156641,373,"GRADINITA PN",HODOŞ,TM,299,7,1,0,8,10,2,0,12,11,2,0,13,12,2,0,14,14,2,0,16
156650,374,"SCOALA PRIMARA","SACOŞU MARE",TM,716,3,2,0,5,3,3,0,6,7,3,0,10,15,3,0,18,24,6,0,30
156678,375,"SCOALA GIMNAZIALA DENTA",DENTA,TM,965,10,1,0,11,23,1,0,24,26,1,0,27,30,1,0,31,34,1,0,35
156678,376,"SCOALA GIMNAZIALA DENTA",DENTA,TM,985,2,1,0,3,12,2,0,14,18,3,0,21,22,3,0,25,23,5,0,28
156687,377,"ŞCOALA PRIMARA BRESTEA",BREŞTEA,TM,407,5,0,0,5,7,0,0,7,7,1,0,8,12,2,0,14,13,2,0,15
156696,378,"CĂMINUL CULTURAL ROVINIŢA MARE","ROVINIŢA MARE",TM,306,5,1,0,6,9,7,0,16,11,8,0,19,16,8,0,24,16,8,0,24
155788,379,"ŞCOALA GIMNAZIALĂ DUDEŞTII NOI","DUDEŞTII NOI",TM,1508,7,0,0,7,23,2,0,25,31,2,0,33,44,3,0,47,56,6,0,62
155788,380,"ŞCOALA GIMNAZIALĂ DUDEŞTII NOI","DUDEŞTII NOI",TM,1325,11,0,0,11,22,4,0,26,33,4,0,37,43,4,0,47,48,4,0,52
156721,381,"LICEUL TEORETIC ""SFINȚII KIRIL ȘI METODII"" DUDESTII VECHI","DUDEŞTII VECHI",TM,1612,18,4,0,22,43,6,0,49,43,6,0,49,43,6,0,49,43,9,0,52
156721,382,"CONSILIUL LOCAL DUDEŞTII VECHI","DUDEŞTII VECHI",TM,1483,5,1,0,6,10,3,0,13,15,4,0,19,21,4,0,25,23,4,0,27
156730,383,"CĂMINUL CULTURAL CHEGLEVICI",CHEGLEVICI,TM,575,1,2,0,3,4,2,0,6,6,3,0,9,11,3,0,14,11,3,0,14
156776,384,"SEDIUL PRIMARIEI DUMBRAVA",DUMBRAVA,TM,902,3,0,0,3,8,0,0,8,14,0,0,14,18,1,0,19,19,1,0,20
156785,385,"ŞCOALA PRIMARĂBUCOVĂȚ",BUCOVĂŢ,TM,420,0,0,0,0,4,1,0,5,8,1,0,9,9,4,0,13,12,4,0,16
156794,386,"ŞCOALA GIMNAZIALĂ RĂCHITA",RĂCHITA,TM,923,8,1,0,9,16,1,0,17,28,1,0,29,39,3,0,42,41,4,0,45
155270,387,"SCOALA GIMNAZIALA DUMBRAVITA",DUMBRĂVIŢA,TM,1929,6,8,0,14,24,16,0,40,50,16,0,66,74,21,0,95,80,25,0,105
155270,388,"SCOALA GIMNAZIALA",DUMBRĂVIŢA,TM,1947,16,1,0,17,35,1,0,36,74,6,0,80,107,16,0,123,117,20,0,137
155270,389,"SCOALA GIMNAZIALA",DUMBRĂVIŢA,TM,1939,5,0,0,5,30,3,0,33,70,5,0,75,97,11,0,108,113,13,0,126
155270,390,"SALA DE MESE A COMUNEI DUMBRĂVIŢA( SALA DIN SPATE CU INTRARE DIN PARTEA DREAPTĂ)",DUMBRĂVIŢA,TM,1978,9,4,0,13,34,9,0,43,54,11,0,65,68,13,0,81,83,15,0,98
155270,391,"SALA DE MESE A COMUNEI DUMBRĂVIŢA( SALA DIN FAŢĂ)",DUMBRĂVIŢA,TM,1780,10,2,0,12,37,7,0,44,56,9,0,65,83,11,0,94,97,12,0,109
157718,392,"CĂMINUL CULTURALFIBIŞ",FIBIŞ,TM,1403,3,0,0,3,17,6,0,23,21,7,0,28,25,9,0,34,35,11,0,46
156936,393,"CĂMINUL CULTURAL FÎRDEA",FÎRDEA,TM,583,8,1,0,9,26,10,0,36,44,24,0,68,52,28,2,82,55,29,2,86
156945,394,"CĂMINUL CULTURAL DRĂGŞINEŞTI",DRĂGSINEŞTI,TM,385,3,0,0,3,4,0,0,4,9,1,0,10,20,4,0,24,25,9,0,34
156963,395,"CĂMINUL CULTURAL GLADNA ROMÂNĂ","GLADNA ROMÂNA",TM,450,6,2,0,8,19,2,0,21,38,9,0,47,45,15,0,60,48,15,0,63
157013,396,"ŞCOALA GIMNAZIALĂ FOENI",FOENI,TM,992,5,1,0,6,14,4,0,18,16,5,0,21,29,7,0,36,30,7,0,37
157022,397,"PRIMĂRIA VECHE CRUCENI",CRUCENI,TM,447,5,2,0,7,6,2,0,8,7,4,0,11,9,4,0,13,9,4,0,13
157040,398,"SEDIUL PRIMARIEI GĂVOJDIA",GAVOJDIA,TM,1095,14,4,0,18,21,7,0,28,41,9,0,50,50,10,0,60,57,11,0,68
157059,399,"ŞCOALA PRIMARĂ JENA",JENA,TM,419,1,0,0,1,4,0,0,4,9,0,0,9,12,3,0,15,14,3,0,17
157068,400,"CAMIN CULTURAL LUGOJEL",LUGOJEL,TM,569,1,1,0,2,8,1,0,9,13,1,0,14,22,5,0,27,25,5,0,30
157077,401,"CĂMINUL CULTURAL SĂLBĂGEL",SĂLBĂGEL,TM,246,0,0,0,0,8,0,0,8,13,0,0,13,16,0,0,16,17,1,0,18
156393,402,"ŞCOALA GIMNAZIALA GHILAD",GHILAD,TM,1541,9,1,0,10,28,1,0,29,35,3,0,38,47,4,0,51,57,5,0,62
156384,403,"CĂMINUL CULTURAL GAD",GAD,TM,115,1,2,0,3,3,3,0,6,3,4,0,7,5,8,0,13,5,8,0,13
155298,404,"ŞCOALA GIMNAZIALĂ GHIRODA",GHIRODA,TM,1726,15,1,0,16,63,9,0,72,82,15,0,97,121,19,0,140,129,27,0,156
155298,405,"ŞCOALA GIMNAZIALĂ GHIRODA",GHIRODA,TM,1473,18,3,0,21,59,6,0,65,94,7,0,101,117,14,1,132,135,20,1,156
155298,406,"GRĂDINIŢA CU PROGRAM PRELUNGIT GHIRODA",GHIRODA,TM,1226,11,1,0,12,41,4,0,45,59,5,0,64,80,8,0,88,91,10,0,101
155305,407,"ŞCOALA PRIMARĂ GIARMATA VII",GIARMATA-VII,TM,1549,18,2,0,20,49,6,0,55,73,13,0,86,114,18,0,132,126,19,0,145
157200,408,"SEDIUL PRIMARIEI GHIZELA",GHIZELA,TM,375,11,2,0,13,14,3,0,17,17,6,0,23,24,6,0,30,24,6,0,30
157228,409,"CĂMINUL CULTURAL PANIOVA",PANIOVA,TM,207,5,1,0,6,9,3,0,12,14,4,0,18,15,7,0,22,16,7,0,23
157237,410,"CASA NATIONALĂ""NICOLAE URSU"" ŞANOVIŢA",ŞANOVIŢA,TM,394,7,0,0,7,12,1,0,13,18,1,0,19,21,2,0,23,24,2,0,26
157255,411,"CAMIN CULTURAL",GIARMATA,TM,1598,29,0,0,29,50,11,0,61,63,17,0,80,79,19,0,98,80,21,0,101
157255,412,"SCOALA GIMNAZIALA GIARMATA",GIARMATA,TM,1737,7,1,0,8,26,7,0,33,35,9,0,44,56,10,0,66,64,11,0,75
157255,413,"GRADINITA CU PROGRAM PRELUNGIT COMUNA GIARMATA",GIARMATA,TM,1591,11,2,0,13,25,4,0,29,39,5,0,44,52,6,0,58,57,7,0,64
157264,414,"ŞCOALA PRIMARA CERNETEAZ",CERNETEAZ,TM,1105,3,1,0,4,12,9,0,21,21,10,0,31,47,13,0,60,53,15,0,68
157282,415,"SEDIUL PRIMARIEI GIERA",GIERA,TM,644,8,0,0,8,19,0,0,19,22,0,0,22,23,0,0,23,23,0,0,23
157291,416,"GRADINITA CU PROGRAM NORMAL GRĂNICERII",GRĂNICERII,TM,203,5,4,0,9,6,4,0,10,7,4,0,11,13,6,0,19,13,6,0,19
157308,417,"GRADINITA CU PROGRAM NORMAL TOAGER",TOAGER,TM,311,1,0,0,1,4,0,0,4,5,0,0,5,6,0,0,6,8,2,0,10
155323,418,"CĂMINUL CULTURAL GIROC",GIROC,TM,1964,12,1,0,13,45,6,0,51,77,9,0,86,105,16,0,121,115,17,0,132
155323,419,"CĂMINUL CULTURAL GIROC",GIROC,TM,1720,14,2,0,16,46,5,0,51,59,7,0,66,83,12,0,95,92,12,0,104
155323,420,"LICEUL TEORETIC ""DAVID VONIGA"" GIROC",GIROC,TM,1443,18,8,0,26,51,13,0,64,62,14,0,76,77,21,0,98,85,23,0,108
155323,421,"LICEUL TEORETIC DAVID VONIGA GIROC",GIROC,TM,1853,13,4,0,17,39,4,0,43,58,4,0,62,80,6,0,86,97,12,0,109
155323,422,"CALEA TIMIȘOAREI (FOSTELE U.M)",GIROC,TM,2140,6,4,0,10,30,6,0,36,58,12,0,70,89,18,0,107,100,20,0,120
155332,423,"ŞCOALA GIMNAZIALĂ ""IOSIF CIOROGARIU"" ,CHIȘODA",CHIŞODA,TM,1527,4,2,0,6,40,6,0,46,69,10,0,79,87,14,0,101,100,21,0,121
155332,424,"ŞCOALA GIMNAZIALĂ""IOSIF CIOROGARIU"" ,CHIȘODA",CHIŞODA,TM,1568,18,0,0,18,46,2,0,48,65,7,0,72,94,7,0,101,101,7,0,108
157326,425,"PRIMARA GIULVĂZ",GIULVĂZ,TM,1041,5,1,0,6,21,4,0,25,31,5,0,36,43,8,0,51,48,8,0,56
157335,426,"CĂMIN CULTURAL CRAI NOU","CRAI NOU",TM,340,5,3,0,8,10,5,0,15,15,6,0,21,15,6,0,21,15,8,0,23
157344,427,"CAMIN CULTURAL IVANDA",IVANDA,TM,481,8,1,0,9,12,4,0,16,18,4,0,22,25,5,0,30,25,5,0,30
157353,428,"CĂMIN CULTURAL RUDNA",RUDNA,TM,582,0,0,0,0,0,0,0,0,3,2,0,5,9,8,0,17,11,9,0,20
157558,429,"CLADIREA COMUNEI GOTTLOB(SALA DE SEDINTE)",GOTTLOB,TM,1834,16,2,0,18,35,6,0,41,60,7,0,67,68,8,0,76,76,8,0,84
157576,430,"GRADINITA CU PN VIZEJDIA",VIZEJDIA,TM,372,3,3,0,6,4,3,0,7,6,3,0,9,7,4,0,11,9,4,0,13
156231,431,"PRIMARIA IECEA MARE","IECEA MARE",TM,1078,8,0,0,8,16,3,0,19,20,4,0,24,31,6,0,37,36,6,0,42
156231,432,"SCOALA PRIMARĂ IECEA MARE","IECEA MARE",TM,1103,4,2,0,6,9,4,0,13,17,4,0,21,20,6,0,26,21,6,0,27
157371,433,"PRIMARIA JAMU MARE","JAMU MARE",TM,1183,17,1,0,18,31,1,0,32,37,3,0,40,52,3,0,55,54,4,0,58
157380,434,"ŞCOALAPRIMARA CLOPODIA",CLOPODIA,TM,576,5,0,0,5,10,1,0,11,16,3,0,19,22,4,0,26,23,4,0,27
157399,435,"ŞCOALAPRIMARA FERENDIA",FERENDIA,TM,350,9,2,0,11,15,2,0,17,20,2,0,22,27,2,0,29,27,3,0,30
157406,436,"CĂMINUL CULTURAL GHERMAN",GHERMAN,TM,193,0,2,0,2,3,5,0,8,4,7,0,11,7,9,0,16,9,10,0,19
157415,437,"CLADIREA COMUNEI JAMU MARE (FOSTA ŞCOALA LĂŢUNAŞ)",LĂŢUNAŞ,TM,198,3,0,0,3,6,4,0,10,8,4,0,12,9,5,0,14,9,5,0,14
157433,438,"CASA NATIONALA EFTA BOTOCA",JEBEL,TM,1514,25,7,0,32,60,16,0,76,101,25,0,126,136,26,0,162,149,27,0,176
157433,439,"GRADINITA PN JEBEL",JEBEL,TM,1480,17,3,0,20,39,5,0,44,66,5,0,71,82,7,0,89,98,10,0,108
157460,440,"GRĂDINIŢA CU PROGRAM NORMAL LENAUHEIM",LENAUHEIM,TM,1560,9,4,0,13,19,4,0,23,28,7,0,35,39,7,0,46,44,9,0,53
157479,441,"CĂMINUL CULTURAL BULGĂRUŞ",BULGĂRUŞ,TM,1801,6,1,0,7,22,1,0,23,34,1,0,35,46,2,0,48,50,3,0,53
157488,442,"CĂMINUL CULTURAL GRABAŢ",GRABĂŢ,TM,1772,11,3,0,14,25,5,0,30,34,5,0,39,39,5,0,44,40,5,0,45
157503,443,"CĂMINUL CULTURAL LIEBLING",LIEBLING,TM,1541,7,0,0,7,23,3,0,26,33,7,0,40,40,8,0,48,46,8,0,54
157503,444,"ȘCOALA GIMNAZIALĂ LIEBLING",LIEBLING,TM,1312,13,2,0,15,27,2,0,29,40,2,0,42,47,3,0,50,54,4,0,58
157512,445,"CLADIREA FOSTEI PRIMARII DIN CERNA",CERNA,TM,190,0,5,0,5,4,6,0,10,4,11,0,15,4,11,0,15,4,12,0,16
157521,446,"CĂMINUL CULTURAL SATUL IOSIF",IOSIF,TM,297,1,1,0,2,9,3,0,12,11,3,0,14,13,4,0,17,16,5,0,21
155626,447,"PRIMARIA COMUNEI LIVEZILE",LIVEZILE,TM,900,6,1,0,7,16,1,0,17,22,1,0,23,26,1,0,27,29,1,0,30
155617,448,"ŞCOALA PRIMARA DOLAŢ",DOLAŢ,TM,446,6,0,0,6,11,0,0,11,14,0,0,14,19,0,0,19,19,0,0,19
157549,449,"STATIUNEA DE CERCETARE SI DEZVOLTARE AGRICOLA LOVRIN",LOVRIN,TM,1643,8,0,0,8,21,2,0,23,32,3,0,35,50,3,0,53,54,4,0,58
157549,450,"STRAND TERMAL LOVRIN, NR 752/B",LOVRIN,TM,1758,2,4,0,6,15,6,0,21,30,7,0,37,41,7,0,48,49,9,0,58
157594,451,"CĂMINUL CULTURAL MARGINA",MARGINA,TM,971,9,2,0,11,19,3,0,22,31,3,0,34,54,6,0,60,58,7,0,65
157601,452,"CĂMINUL CULTURAL BREAZOVA",BREAZOVA,TM,213,6,4,0,10,12,4,0,16,21,5,0,26,23,10,0,33,26,10,0,36
157638,453,"CĂMINUL CULTURAL COŞTEIU DE SUS","COŞTEIU DE SUS",TM,175,1,3,0,4,5,3,0,8,9,4,0,13,12,7,0,19,13,7,0,20
157647,454,"CĂMINUL CULTURAL GROŞI",GROŞI,TM,71,1,1,0,2,2,2,0,4,4,3,0,7,5,4,0,9,6,6,0,12
157665,455,"ȘCOALA PRIMARĂ SINTEŞTI",SINTEŞTI,TM,407,4,1,0,5,11,1,0,12,19,3,0,22,29,7,0,36,34,7,0,41
157692,456,"PRIMARIA MAŞLOC",MAŞLOC,TM,864,3,0,0,3,11,4,0,15,14,9,0,23,16,16,0,32,17,17,0,34
157709,457,"CĂMINUL CULTURAL ALIOS",ALIOŞ,TM,686,7,4,0,11,22,8,0,30,30,9,0,39,45,15,0,60,48,16,0,64
157727,458,"CĂMINUL CULTURAL REMETEA MICĂ","REMETEA MICĂ",TM,459,5,3,0,8,7,3,0,10,8,3,0,11,12,3,0,15,15,3,0,18
157745,459,"ŞCOALA GIMNAZIALĂ GEORGE GÂRDA MĂNĂŞTIUR",MĂNĂŞTIUR,TM,970,8,1,0,9,20,1,0,21,33,1,0,34,39,2,0,41,41,2,0,43
157754,460,"CLĂDIREA COMUNEI MĂNĂŞTIUR (FOSTA ŞCOALĂ GENERALĂ PĂDURANI)",PĂDURANI,TM,61,1,2,0,3,3,3,0,6,6,3,0,9,8,7,0,15,9,7,0,16
157763,461,"CLĂDIREA COMUNEI MĂNĂŞTIUR ( FOSTA ŞCOALĂ GENERALĂ REMETEA LUNCĂ)",REMETEA-LUNCĂ,TM,324,8,0,0,8,12,0,0,12,20,0,0,20,24,0,0,24,28,1,0,29
157790,462,"CASANATIONALA DE CULTURA MORAVIŢA",MORAVIŢA,TM,1001,15,0,0,15,32,0,0,32,39,0,0,39,45,0,0,45,52,0,0,52
157807,463,"CASA NAŢIONALĂ DEJAN",DEJAN,TM,218,3,1,0,4,11,2,0,13,11,2,0,13,14,2,0,16,15,3,0,18
157816,464,"CASA NAȚIONALĂ GAIU MIC","GAIU MIC",TM,132,5,1,0,6,12,2,0,14,17,3,0,20,24,3,0,27,26,4,0,30
157825,465,"ŞCOALA PRIMARA STAMORA GERMANĂ","STAMORA GERMANĂ",TM,828,4,0,0,4,8,2,0,10,17,2,0,19,23,2,0,25,25,2,0,27
157843,466,"ȘCOALA GIMNAZIALĂ MOȘNIȚA NOUĂ","MOŞNIŢA NOUĂ",TM,1665,27,3,0,30,74,6,0,80,97,8,0,105,122,13,0,135,145,14,0,159
157843,467,"ȘCOALA GIMNAZIALĂ MOȘNIȚA NOUĂ","MOŞNIŢA NOUĂ",TM,1781,11,1,0,12,33,13,0,46,50,14,0,64,80,17,0,97,97,25,0,122
157852,468,"CLĂDIREA COMUNEI MOȘNIȚA NOUĂ FOSTA ȘCOALĂ PRIMARĂ ALBINA",ALBINA,TM,324,0,2,0,2,3,2,0,5,6,2,0,8,15,3,0,18,17,7,0,24
157861,469,"ŞCOALA PRIMARĂMOŞNIŢA VECHE","MOŞNIŢA VECHE",TM,1621,20,0,0,20,46,4,0,50,77,6,0,83,113,10,0,123,133,15,0,148
157889,470,"ŞCOALA PRIMARĂ URSENI",URSENI,TM,1375,10,2,0,12,25,4,0,29,40,4,0,44,55,7,0,62,61,11,0,72
157861,471,"ŞCOALA PRIMARĂ MOŞNIŢA VECHE","MOŞNIŢA VECHE",TM,816,4,1,0,5,8,4,0,12,21,7,0,28,33,16,0,49,41,23,0,64
157905,472,"GRĂDINIŢA CU PROGRAM PRELUNGIT NADRAG",NĂDRAG,TM,1065,13,2,0,15,39,5,0,44,44,8,0,52,60,12,0,72,63,12,0,75
157905,473,"LICEUL TEHNOLOGIC ""TRAIAN GROZĂVESCU"" NĂDRAG",NĂDRAG,TM,1116,10,0,0,10,26,0,0,26,37,6,0,43,55,7,0,62,61,7,0,68
157914,474,"ŞCOALA PRIMARA CRIVINA",CRIVINA,TM,240,5,2,0,7,6,3,0,9,10,3,0,13,21,4,0,25,24,6,0,30
157932,475,"HOLUL PRIMĂRIEI NIŢCHIDORF",NIŢCHIDORF,TM,1069,10,0,0,10,23,3,0,26,29,3,0,32,38,4,0,42,44,4,0,48
157941,476,"CASA NAŢIONALĂ BLAJOVA",BLAJOVA,TM,87,2,4,0,6,5,5,0,10,6,7,0,13,7,8,0,15,8,8,0,16
157950,477,"CLADIREA COMUNEI NITCHIDORF(FOSTA SCOALA CU CLASELEI - IV)",DUBOZ,TM,150,3,3,0,6,8,3,0,11,10,4,0,14,12,5,0,17,15,5,0,20
157978,478,"CĂMINUL CULTURALOHABA LUNGĂ","OHABA LUNGĂ",TM,314,4,2,0,6,5,2,0,7,11,3,0,14,17,4,0,21,19,4,0,23
157987,479,"CĂMINUL CULTURAL DUBEŞTI",DUBEŞTI,TM,197,3,0,0,3,6,1,0,7,9,3,0,12,10,4,0,14,11,5,0,16
157996,480,"CĂMINUL CULTURAL IERŞNIC",IERŞNIC,TM,135,9,3,0,12,12,3,0,15,14,5,0,19,17,7,0,24,19,7,0,26
158001,481,"CĂMINUL CULTURAL OHABA ROMÂNĂ","OHABA ROMÂNĂ",TM,172,7,2,0,9,11,3,0,14,13,3,0,16,20,5,0,25,25,6,0,31
158029,482,"ȘCOALA PRIMARĂ ORȚIȘOARA",ORŢIŞOARA,TM,1169,11,0,0,11,29,0,0,29,41,0,0,41,45,2,0,47,49,2,0,51
158029,483,"BIBLIOTECA COMUNALA ORTISOARA",ORŢIŞOARA,TM,950,17,1,0,18,25,2,0,27,29,3,0,32,39,8,0,47,48,8,0,56
158038,484,"ŞCOALA PRIMARACĂLACEA",CĂLACEA,TM,605,5,3,0,8,11,5,0,16,15,6,0,21,20,7,0,27,21,8,0,29
158047,485,"ŞCOALAPRIMARA CORNEŞTI",CORNEŞTI,TM,528,1,2,0,3,5,4,0,9,6,4,0,10,16,7,3,26,16,7,3,26
158056,486,"CĂMINUL CULTURALSECEANI",SECEANI,TM,472,4,0,0,4,14,2,0,16,19,2,0,21,21,3,0,24,23,3,0,26
159179,487,"CĂMINUL CULTURAL OTELEC",OTELEC,TM,657,1,1,0,2,3,4,0,7,4,4,0,8,7,7,0,14,9,7,0,16
159160,488,"CĂMINUL CULTURALIOHANISFELD",IOHANISFELD,TM,843,7,0,0,7,10,0,0,10,20,0,0,20,25,0,0,25,29,0,0,29
158797,489,"CĂMINUL CULTURAL PARŢA",PARŢA,TM,1891,18,5,0,23,47,11,0,58,57,14,0,71,90,15,0,105,109,17,0,126
157442,490,"ȘCOALA GIMNAZIALĂ PĂDURENI",PĂDURENI,TM,1503,7,0,0,7,16,5,0,21,21,9,0,30,33,10,0,43,37,10,0,47
158074,491,"LICEUL TEORETIC PECIU NOU","PECIU NOU",TM,1495,7,1,0,8,18,1,0,19,29,1,0,30,37,1,0,38,39,1,0,40
158074,492,"CĂMINUL CULTURALPECIU NOU","PECIU NOU",TM,1468,13,5,0,18,30,14,0,44,37,15,0,52,51,17,0,68,55,17,0,72
158083,493,"CĂMINUL CULTURAL DINIAŞ",DINIAŞ,TM,885,0,3,0,3,9,5,0,14,15,8,0,23,22,11,0,33,25,11,0,36
158092,494,"ŞCOALAPRIMARĂ SÎNMARTINU SÎRBESC","SÎNMARTINU SÎRBESC",TM,810,4,0,0,4,9,3,0,12,15,4,0,19,25,10,0,35,28,10,0,38
158118,495,"LICEUL TEORETIC PERIAM",PERIAM,TM,1365,7,9,0,16,31,17,0,48,40,18,0,58,47,22,0,69,52,24,0,76
158118,496,"LICEUL TEORETIC PERIAM",PERIAM,TM,1419,10,10,0,20,25,18,0,43,32,20,0,52,45,20,0,65,52,21,0,73
158118,497,"CASA DE CULTURĂ",PERIAM,TM,1351,9,0,0,9,21,2,0,23,29,2,0,31,35,11,0,46,40,12,0,52
158127,498,"BIBLIOTECA COMUNALĂ PESAC",PESAC,TM,911,21,0,0,21,45,2,0,47,69,2,0,71,83,2,0,85,88,2,0,90
158127,499,"ȘCOALA GIMNAZIALĂ „MARIA BRINDEA”",PESAC,TM,915,14,4,0,18,24,5,0,29,31,7,0,38,43,10,0,53,45,10,0,55
158145,500,"CĂMINUL CULTURAL PIETROASA",PIETROASA,TM,276,5,0,0,5,8,1,0,9,16,1,0,17,17,2,0,19,19,2,0,21
158154,501,"CĂMINUL CULTURAL CRIVINA DE SUS","CRIVINA DE SUS",TM,168,3,0,0,3,4,0,0,4,8,3,0,11,13,4,0,17,20,5,0,25
158163,502,"CĂMINUL CULTURAL FĂRĂŞEŞTI",FĂRĂŞEŞTI,TM,179,1,0,0,1,8,2,0,10,11,2,0,13,15,3,0,18,17,3,0,20
158172,503,"CĂMINUL CULTURAL POIENI",POIENI,TM,215,1,0,0,1,4,0,0,4,7,0,0,7,17,0,0,17,19,1,0,20
158190,504,"ȘCOALA GIMNAZIALĂ PIŞCHIA",PIŞCHIA,TM,1063,11,2,0,13,20,9,0,29,25,10,0,35,38,10,0,48,46,12,0,58
158207,505,"GRĂDINIȚA CU P.N. BENCECU DE JOS","BENCECU DE JOS",TM,322,5,1,0,6,11,1,0,12,21,4,0,25,49,12,0,61,50,12,0,62
158216,506,"ȘCOALA GIMNAZIALĂBENCECU DE SUS","BENCECU DE SUS",TM,762,13,2,0,15,20,4,0,24,32,4,0,36,37,4,0,41,39,5,0,44
158225,507,"GRĂDINIȚA CU P.N.MURANINR.383",MURANI,TM,482,6,1,0,7,13,1,0,14,16,1,0,17,20,4,0,24,22,5,0,27
158252,508,"ŞCOALA GIMNAZIALĂ RACOVIŢA",RACOVIŢA,TM,680,9,2,0,11,19,5,0,24,26,11,0,37,41,13,0,54,42,13,0,55
158261,509,"ŞCOALA PRIMARĂ CĂPĂT",CĂPĂT,TM,210,2,1,0,3,4,1,0,5,6,1,0,7,14,3,0,17,14,3,0,17
158270,510,"ŞCOALA PRIMARĂ DRĂGOIESTI",DRĂGOIEŞTI,TM,313,1,4,0,5,2,4,0,6,3,5,0,8,5,6,0,11,5,6,0,11
158289,511,"ŞCOALA PRIMARĂ FICĂTAR",FICĂTAR,TM,321,3,2,0,5,7,2,0,9,7,2,0,9,10,3,0,13,12,4,0,16
158298,512,"ŞCOALAGIMNAZIALĂ HITIAŞ",HITIAŞ,TM,675,10,0,0,10,13,0,0,13,19,0,0,19,27,7,0,34,32,10,0,42
158305,513,"ŞCOALA PRIMARĂ SÎRBOVA",SÂRBOVA,TM,231,3,2,0,5,11,4,0,15,12,4,0,16,18,7,0,25,19,7,0,26
158403,514,"ŞCOALA GIMNAZIALA REMETEA MARE","REMETEA MARE",TM,1384,1,1,0,2,10,6,0,16,16,10,0,26,40,13,0,53,44,14,0,58
158430,515,"ŞCOALA PRIMARAIANOVA",IANOVA,TM,785,3,1,0,4,11,10,0,21,12,10,0,22,25,14,0,39,30,14,0,44
158458,516,"SCOALA GIMNAZIALA SACOSU TURCESC","SACOŞU TURCESC",TM,752,3,2,0,5,16,3,0,19,22,3,0,25,32,3,0,35,37,3,0,40
158467,517,"ŞCOALA PRIMARA BERINI",BERINI,TM,403,0,0,0,0,3,0,0,3,4,1,0,5,5,3,0,8,6,3,0,9
158476,518,"CLADIREA COMUNEI SACOSU TURCESC ( FOSTA SCOALA PRIMARA ICLODA )",ICLODA,TM,213,0,3,0,3,4,6,0,10,5,6,0,11,11,7,0,18,13,9,0,22
158485,519,"ŞCOALAPRIMARA OTVESTI",OTVEŞTI,TM,283,0,0,0,0,2,1,0,3,5,2,0,7,6,2,0,8,9,3,0,12
158494,520,"CLADIREA COMUNEI SACOSU TURCESC ( FOSTA SCOALA PRIMARA STAMORA ROMANA )","STAMORA ROMÂNĂ",TM,216,1,0,0,1,3,4,0,7,5,7,0,12,6,12,0,18,6,12,0,18
158500,521,"ŞCOALA GIMNAZIALA ULIUC",ULIUC,TM,569,3,4,0,7,6,6,0,12,12,8,0,20,31,10,0,41,35,11,0,46
158519,522,"CAMIN CULTURAL UNIP",UNIP,TM,179,1,1,0,2,3,2,0,5,4,2,0,6,6,4,0,10,8,4,0,12
158760,523,"SALA PRIMARIEI NR. 167B, SARAVALE",SARAVALE,TM,1212,6,1,0,7,18,5,0,23,31,5,0,36,38,5,0,43,45,5,0,50
158760,524,"CAMINUL CULTURAL NR. 673, SARAVALE",SARAVALE,TM,911,6,0,0,6,14,0,0,14,22,2,0,24,39,3,0,42,42,3,0,45
158537,525,"SCOALA GIMNAZIALASATCHINEZ",SATCHINEZ,TM,1235,11,0,0,11,19,0,0,19,32,3,0,35,47,5,0,52,59,9,0,68
158537,526,"SCOALA GIMNAZIALA SATCHINEZ",SATCHINEZ,TM,1238,6,1,0,7,10,2,0,12,24,2,0,26,35,2,0,37,41,3,0,44
158546,527,"SCOALA GIMNAZIALĂBARATEAZ",BĂRĂTEAZ,TM,566,8,1,0,9,12,1,0,13,19,1,0,20,24,1,0,25,25,1,0,26
158555,528,"SCOALA GIMNAZIALA HODONI",HODONI,TM,999,18,4,0,22,27,5,0,32,37,6,0,43,47,7,0,54,53,7,0,60
158573,529,"ŞCOALA GIMNAZIALA SACALAZ",SĂCĂLAZ,TM,1716,12,0,0,12,41,3,0,44,51,3,0,54,68,8,0,76,78,11,0,89
158573,530,"ŞCOALA GIMNAZIALA SĂCĂLAZ",SĂCĂLAZ,TM,1706,15,1,0,16,31,2,0,33,37,4,0,41,52,5,0,57,63,7,0,70
158573,531,"CĂMINUL CULTURAL SĂCĂLAZ",SĂCĂLAZ,TM,1747,15,2,0,17,44,6,0,50,48,14,0,62,60,18,0,78,66,24,0,90
158582,532,"CĂMINUL CULTURALBEREGSĂU MARE","BEREGSĂU MARE",TM,1814,16,4,0,20,41,6,0,47,61,7,0,68,110,11,4,125,131,11,4,146
158591,533,"ŞCOALA PRIMARA BEREGSĂU MIC","BEREGSĂU MIC",TM,750,5,4,0,9,10,5,0,15,18,5,0,23,24,5,0,29,26,5,0,31
158742,534,"PRIMĂRIA COMUNEI SÎNPETRU MARE","SÂNPETRU MARE",TM,968,10,0,0,10,17,0,0,17,20,0,0,20,22,0,0,22,26,0,0,26
158742,535,"PRIMĂRIA COMUNEI SÎNPETRU MARE","SÂNPETRU MARE",TM,850,9,1,0,10,19,1,0,20,19,1,0,20,27,1,0,28,34,1,0,35
158751,536,"ŞCOALA GIMNAZIALA ACADEMICIAN PROFESOR DOCTOR MUNTEANU IOAN",IGRIŞ,TM,948,2,0,0,2,6,0,0,6,11,2,0,13,17,5,0,22,21,8,0,29
158617,537,"SEDIUL PRIMĂRIEI SECAŞ",SECAŞ,TM,220,4,2,0,6,8,4,0,12,11,5,0,16,11,5,0,16,12,6,0,18
158635,538,"CĂMINUL CULTURAL CRIVOBARA",CRIVOBARA,TM,58,1,4,0,5,1,4,0,5,1,4,0,5,3,5,0,8,4,5,0,9
158662,539,"CAMINUL CULTURAL SINANDREI",SÎNANDREI,TM,1887,7,0,0,7,28,10,0,38,38,11,0,49,58,12,0,70,66,12,0,78
158662,540,"ŞCOALA GIMNAZIALA SINANDREI",SÎNANDREI,TM,1622,8,2,0,10,18,4,0,22,41,5,0,46,61,8,0,69,64,8,0,72
158671,541,"CAMINUL CULTURAL CARANI",CARANI,TM,1691,10,0,0,10,24,1,0,25,32,1,0,33,61,2,0,63,68,2,0,70
158680,542,"ŞCOALA PRIMARA COVACI",COVACI,TM,769,8,2,0,10,21,2,0,23,33,5,0,38,42,6,0,48,44,8,0,52
158706,543,"PRIMĂRIA SÎNMIHAIU ROMÂN","SÎNMIHAIU ROMÂN",TM,1522,5,4,0,9,22,5,0,27,36,6,0,42,54,9,0,63,57,10,0,67
158706,544,"ȘCOALA GIMNAZIALA SÎNMIHAIU ROMÂN","SÎNMIHAIU ROMÂN",TM,1543,6,0,0,6,24,2,0,26,34,2,0,36,56,3,0,59,67,5,0,72
158715,545,"ŞCOALAPRIMARA SÂNMIHAIU GERMAN","SÎNMIHAIU GERMAN",TM,857,6,1,0,7,12,1,0,13,26,1,0,27,47,6,0,53,55,8,0,63
158724,546,"GRADINITA CU P.NUTVIN",UTVIN,TM,1103,20,2,0,22,33,7,0,40,46,7,0,53,60,10,0,70,64,16,0,80
158724,547,"ȘCOALA GIMNAZIALAUTVIN",UTVIN,TM,1307,19,1,0,20,49,7,0,56,74,8,0,82,109,10,0,119,118,11,0,129
158788,548,"CASA NATIONALA MIHAI VITEAZU",ŞAG,TM,1535,5,1,0,6,15,5,0,20,39,11,0,50,44,21,0,65,46,23,0,69
158788,549,"CASA NATIONALA MIHAI VITEAZUL",ŞAG,TM,1590,10,0,0,10,19,0,0,19,31,0,0,31,52,0,0,52,58,0,0,58
155939,550,"SCOALA GIMNAZIALA SANDRA",ŞANDRA,TM,1205,7,1,0,8,20,4,0,24,32,7,0,39,47,9,0,56,53,10,0,63
155939,551,"SCOALA GIMNAZIALA SANDRA",ŞANDRA,TM,825,15,0,0,15,23,0,0,23,28,1,0,29,35,2,0,37,35,3,0,38
155948,552,"ŞCOALA PRIMARA UIHEI",UIHEI,TM,470,4,1,0,5,10,1,0,11,14,1,0,15,20,3,0,23,22,3,0,25
158813,553,"CĂMINUL CULTURAL ŞTIUCA",ŞTIUCA,TM,873,9,1,0,10,16,3,0,19,23,3,0,26,41,5,0,46,52,7,0,59
158822,554,"ŞCOALA PRIMARĂDRAGOMIREŞTI",DRAGOMIREŞTI,TM,288,2,1,0,3,4,1,0,5,7,1,0,8,10,2,0,12,21,3,0,24
158831,555,"CĂMINUL CULTURAL OLOŞAG",OLOŞAG,TM,283,2,1,0,3,3,3,0,6,4,6,0,10,7,8,0,15,7,8,0,15
158840,556,"CĂMINUL CULTURAL ZGRIBEŞTI",ZGRIBEŞTI,TM,184,1,2,0,3,4,2,0,6,5,3,0,8,6,4,0,10,6,6,0,12
158868,557,"ȘCOALA GIMNAZIALĂ TEREMIA MARE","TEREMIA MARE",TM,1142,12,1,0,13,19,3,0,22,26,3,0,29,36,3,0,39,36,3,0,39
158868,558,"ȘCOALA GIMNAZIALĂ TEREMIA MARE","TEREMIA MARE",TM,1139,14,2,0,16,24,2,0,26,35,5,0,40,52,7,0,59,57,7,0,64
158877,559,"CAMINUL CULTURAL NERAU",NERĂU,TM,932,5,1,0,6,16,4,0,20,20,4,0,24,26,4,0,30,26,6,0,32
158886,560,"ŞCOALA PRIMARATEREMIA MICĂ","TEREMIA MICĂ",TM,561,2,5,0,7,5,5,0,10,8,5,0,13,12,6,0,18,21,8,0,29
158920,561,"ŞCOALAGIMNAZIALĂ ""SORIN LEIA"", COLONIA FABRICII","COLONIA FABRICII",TM,673,14,0,0,14,29,0,0,29,42,2,0,44,57,4,0,61,59,4,0,63
158911,562,"CĂMINUL CULTURALBALOȘEȘTI",BALOŞEŞTI,TM,113,6,0,0,6,7,2,0,9,8,2,0,10,8,2,0,10,10,2,0,12
158939,563,"GRĂDINIȚA CU PROGRAM NORMAL LUNCANII DE JOS","LUNCANII DE JOS",TM,296,7,1,0,8,13,1,0,14,19,3,0,22,23,5,0,28,24,5,0,29
158957,564,"GRĂDINIȚA CU PROGRAM NORMALROMÂNEŞTI",ROMÂNEŞTI,TM,416,1,2,0,3,9,8,0,17,23,14,0,37,30,14,0,44,33,16,0,49
158902,565,"GRĂDINIȚA CU PROGRAM NORMAL TOMEŞTI",TOMEŞTI,TM,269,10,1,0,11,28,3,0,31,36,3,0,39,48,5,0,53,51,6,0,57
157567,566,"PRIMARIA COMUNEI TOMNATIC , CORP A",TOMNATIC,TM,1705,22,0,0,22,37,0,0,37,47,0,0,47,57,0,0,57,63,0,0,63
157567,567,"PRIMARIA COMUNEI TOMNATIC , CORP B",TOMNATIC,TM,1380,7,0,0,7,15,0,0,15,26,0,0,26,35,1,0,36,36,1,0,37
158975,568,"PRIMĂRIA TOPOLOVĂŢU MARE","TOPOLOVĂŢU MARE",TM,938,8,2,0,10,15,5,0,20,22,7,0,29,38,10,0,48,46,10,0,56
158984,569,"CĂMINUL CULTURALCRALOVĂŢ",CRALOVĂŢ,TM,90,90,3,0,93,2,5,0,7,2,5,0,7,3,7,0,10,3,7,0,10
158993,570,"CLADIREA COMUNEI TOPOLOVATU MARE (SEDIUL FOSTULUI CAP ICTAR - BUDINŢI)",ICTAR-BUDINŢI,TM,328,4,2,0,6,7,5,0,12,11,5,0,16,15,9,0,24,26,10,0,36
159008,571,"SCOALA PRIMARĂ IOSIFALĂU",IOSIFALĂU,TM,440,0,5,0,5,2,5,0,7,10,5,0,15,14,6,0,20,15,6,0,21
159017,572,"CĂMINUL CULTURAL ŞUŞTRA",SUŞTRA,TM,322,3,0,0,3,7,1,0,8,11,1,0,12,13,3,0,16,14,6,0,20
159044,573,"CĂMINUL CULTURAL TORMAC",TORMAC,TM,1404,5,0,0,5,11,0,0,11,13,0,0,13,19,0,0,19,20,0,0,20
159053,574,"CĂMINUL CULTURAL CADĂR",CADAR,TM,218,2,0,0,2,5,3,0,8,5,3,0,8,10,6,0,16,11,6,0,17
159062,575,"CĂMINUL CULTURAL ŞIPET",ŞIPET,TM,685,9,2,0,11,10,3,0,13,18,7,0,25,28,7,0,35,28,7,0,35
159080,576,"TELECENTRUL ""TRAIAN VUIA"" SUDRIAŞ",SUDRIAŞ,TM,640,3,0,0,3,11,0,0,11,20,0,0,20,26,2,0,28,32,2,0,34
159106,577,"CĂMINUL CULTURAL SĂCENI",SĂCENI,TM,171,6,1,0,7,8,1,0,9,19,3,0,22,31,5,0,36,37,6,0,43
159115,578,"CĂMINUL CULTURAL SURDUCU MIC","SURDUCU MIC",TM,261,10,0,0,10,12,3,0,15,15,3,0,18,21,12,0,33,22,12,0,34
159124,579,"CĂMINUL CULTURAL SUSANI",SUSANI,TM,321,4,1,0,5,9,1,0,10,16,3,0,19,27,6,0,33,31,9,0,40
159133,580,"CĂMINUL CULTURAL TRAIAN VUIA","TRAIAN VUIA",TM,364,4,6,0,10,8,6,0,14,15,8,0,23,25,8,0,33,35,8,0,43
159151,581,"CĂMINUL CULTURAL UIVAR",UIVAR,TM,1150,9,3,0,12,17,4,0,21,25,4,0,29,42,9,0,51,44,9,0,53
159188,582,"CĂMINUL CULTURAL PUSTINIŞ",PUSTINIŞ,TM,595,8,0,0,8,22,2,0,24,25,4,0,29,29,6,0,35,31,6,0,37
159197,583,"CĂMINUL CULTURAL RĂUŢI",RĂUŢI,TM,503,5,0,0,5,7,0,0,7,16,3,0,19,26,3,0,29,27,3,0,30
159204,584,"CĂMINUL CULTURAL SÂNMARTINU MAGHIAR","SÂNMARTINU MAGHIAR",TM,220,0,0,0,0,2,0,0,2,7,0,0,7,12,0,0,12,13,0,0,13
159222,585,"CĂMINUL CULTURALVARIAŞ",VARIAŞ,TM,1774,22,0,0,22,38,6,0,44,51,7,0,58,58,7,0,65,65,8,0,73
159222,586,"SCOALA GIMNAZIALA VARIAS",VARIAŞ,TM,1813,9,0,0,9,18,1,0,19,31,2,0,33,55,7,0,62,63,8,0,71
159231,587,"ȘCOALA GIMNAZIALA GELU",GELU,TM,1184,15,2,0,17,19,2,0,21,30,2,0,32,45,8,0,53,52,10,0,62
159240,588,"GRADINITA CU PROGRAM NORMAL SINPETRU MIC","SÎNPETRU MIC",TM,456,3,0,0,3,6,1,0,7,7,1,0,8,10,6,0,16,11,7,0,18
156758,589,"PRIMARIA VĂLCANI",VĂLCANI,TM,1131,25,3,0,28,36,3,0,39,46,3,0,49,65,4,0,69,67,4,0,71
159268,590,"CĂMINUL CULTURAL V.V DELAMARINA","VICTOR VLAD DELAMARINA",TM,377,6,4,0,10,14,6,0,20,20,9,0,29,28,10,0,38,34,10,0,44
159277,591,"CĂMINUL CULTURAL HERENDEŞTI",HERENDEŞTI,TM,370,4,1,0,5,9,1,0,10,13,2,0,15,17,5,0,22,17,5,0,22
159286,592,"CĂMINUL CULTURAL HONORICI",HONORICI,TM,244,2,2,0,4,2,3,0,5,4,4,0,8,6,4,0,10,8,4,0,12
159295,593,"CLADIREA COMUNEI VICTOR VLAD DELAMARINA(FOSTA ŞCOALĂ CU CLS I-IV PĂDURENI)",PĂDURENI,TM,147,4,2,0,6,5,5,0,10,6,5,0,11,10,5,0,15,10,5,0,15
159302,594,"ŞCOALA GIMNAZIALĂ PETROASA MARE","PETROASA MARE",TM,877,7,0,0,7,12,0,0,12,24,2,0,26,32,3,0,35,38,3,0,41
159320,595,"ŞCOALA PRIMARĂ VIȘAG",VIŞAG,TM,286,5,0,0,5,13,6,0,19,17,7,0,24,19,7,0,26,20,8,0,28
159348,596,PRIMĂRIAVOITEG,VOITEG,TM,1652,15,1,0,16,33,4,0,37,33,4,0,37,91,26,0,117,100,28,0,128
159357,597,"ŞCOALA PRIMARĂ FOLEA",FOLEA,TM,362,4,0,0,4,10,0,0,10,12,2,0,14,20,3,0,23,22,6,0,28
151807,1,"ȘCOALA AJUTĂTOARE ALEXANDRIA",ALEXANDRIA,TR,1507,7,0,0,7,29,0,0,29,44,0,0,44,65,0,0,65,74,1,4,79
151807,2,"ȘCOALA GIMNAZIALĂNR.7",ALEXANDRIA,TR,1246,15,3,0,18,30,4,0,34,36,4,0,40,50,6,0,56,58,6,0,64
151807,3,"ȘCOALA GIMNAZIALĂ NR.7",ALEXANDRIA,TR,1249,9,4,0,13,17,4,0,21,24,4,0,28,29,4,0,33,41,4,0,45
151807,4,"ȘCOALA GIMNAZIALĂ NR.7",ALEXANDRIA,TR,1378,4,0,0,4,29,0,0,29,35,1,0,36,55,2,0,57,64,3,0,67
151807,5,"ȘCOALA GIMNAZIALĂ NR.7",ALEXANDRIA,TR,1358,11,3,0,14,34,3,0,37,53,4,0,57,75,4,0,79,86,4,0,90
151807,6,"LICEUL TEHNOLOGIC ""NICOLAE BĂLCESCU""",ALEXANDRIA,TR,1462,12,0,0,12,40,0,0,40,53,1,0,54,64,1,0,65,70,1,0,71
151807,7,"LICEUL TEHNOLOGIC ""NICOLAE BĂLCESCU""",ALEXANDRIA,TR,1167,9,0,0,9,23,0,0,23,32,2,0,34,49,2,0,51,56,3,0,59
151807,8,"COLEGIUL NAȚIONAL ""AL. D. GHICA""",ALEXANDRIA,TR,1523,16,6,0,22,47,6,0,53,66,6,0,72,77,6,0,83,90,6,0,96
151807,9,"COLEGIUL NAȚIONAL ""AL. D. GHICA""",ALEXANDRIA,TR,1304,8,4,0,12,25,4,0,29,40,5,0,45,55,7,0,62,68,7,0,75
151807,10,"LICEUL TEORETIC ""C. NOICA""",ALEXANDRIA,TR,1363,15,3,0,18,37,6,0,43,57,6,0,63,73,7,0,80,81,9,0,90
151807,11,"LICEUL TEORETIC ""C. NOICA""",ALEXANDRIA,TR,1025,14,0,0,14,34,2,0,36,48,2,0,50,83,3,0,86,88,3,0,91
151807,12,"LICEUL PEDAGOGIC ""MIRCEA SCARLAT""",ALEXANDRIA,TR,1232,16,2,0,18,48,4,0,52,52,4,0,56,63,4,0,67,68,4,0,72
151807,13,"ȘCOALA GIMNAZIALĂ NR.5",ALEXANDRIA,TR,993,12,0,0,12,38,3,7,48,53,4,7,64,66,7,7,80,80,13,7,100
151807,14,"GRĂDINIȚA CU PROGRAM PRELUNGIT NR.7",ALEXANDRIA,TR,1144,11,5,0,16,50,5,0,55,66,8,0,74,88,8,0,96,97,8,0,105
151807,15,"GRĂDINIȚA CU PROGRAM PRELUNGIT NR.7",ALEXANDRIA,TR,1068,19,5,0,24,46,5,0,51,60,5,0,65,88,5,0,93,97,5,0,102
151807,16,"STADION MUNICIPAL",ALEXANDRIA,TR,1510,11,1,0,12,32,1,0,33,45,1,0,46,63,1,0,64,69,5,0,74
151807,17,"OFICIUL POȘTAL NR. 3",ALEXANDRIA,TR,1116,28,0,0,28,48,0,0,48,69,4,0,73,96,7,0,103,110,10,0,120
151807,18,"ȘCOALA GIMNAZIALĂ ""ȘTEFAN CEL MARE""",ALEXANDRIA,TR,854,13,0,0,13,29,1,0,30,52,9,0,61,65,10,0,75,65,12,0,77
151807,19,"ȘCOALA GIMNAZIALĂ ""ȘTEFAN CEL MARE""",ALEXANDRIA,TR,994,27,0,0,27,59,4,0,63,75,5,0,80,92,8,0,100,99,8,0,107
151807,20,"ȘCOALA GIMNAZIALĂ ""MIHAI VITEAZUL""",ALEXANDRIA,TR,1388,24,2,0,26,52,7,0,59,62,10,0,72,91,12,0,103,101,13,0,114
151807,21,"ȘCOALA GIMNAZIALĂ ""MIHAI VITEAZUL""",ALEXANDRIA,TR,1110,17,2,0,19,27,3,0,30,44,4,0,48,55,6,0,61,65,6,0,71
151807,22,"ȘCOALA GIMNAZIALĂ NR.6",ALEXANDRIA,TR,989,5,2,0,7,15,2,0,17,23,2,0,25,29,2,0,31,36,3,0,39
151807,23,"ȘCOALA GIMNAZIALĂ NR.6",ALEXANDRIA,TR,1152,14,3,0,17,37,3,0,40,48,4,0,52,65,4,0,69,68,4,0,72
151807,24,"COLEGIUL NAȚIONAL ""AL. I. CUZA""",ALEXANDRIA,TR,1110,17,0,0,17,40,1,0,41,52,2,0,54,66,3,0,69,71,3,0,74
151807,25,"COLEGIUL NAȚIONAL ""AL. I. CUZA""",ALEXANDRIA,TR,1124,4,1,0,5,33,2,0,35,51,2,0,53,67,2,0,69,69,2,0,71
151807,26,"COLEGIUL NAȚIONAL ""AL. I. CUZA""",ALEXANDRIA,TR,1034,17,3,0,20,38,7,0,45,53,9,0,62,64,9,0,73,71,10,0,81
151807,27,"ȘCOALA GIMNAZIALĂ ""ALEXANDRU COLFESCU""",ALEXANDRIA,TR,1400,12,0,0,12,32,1,0,33,46,1,0,47,62,1,0,63,67,2,0,69
151807,28,"ȘCOALA GIMNAZIALĂ ""ALEXANDRU COLFESCU""",ALEXANDRIA,TR,1415,16,5,0,21,53,5,0,58,68,6,0,74,77,7,0,84,91,7,0,98
151807,29,"ȘCOALA GIMNAZIALĂ ""ALEXANDRU COLFESCU""",ALEXANDRIA,TR,1363,4,0,0,4,29,1,0,30,39,2,1,42,56,2,1,59,56,2,1,59
151807,30,"ȘCOALA GIMNAZIALĂ ""ALEXANDRU COLFESCU""",ALEXANDRIA,TR,1471,13,3,0,16,39,5,0,44,56,5,0,61,91,5,0,96,100,5,0,105
151807,31,"GRĂDINIȚA CU PROGRAM PRELUNGIT NR.4",ALEXANDRIA,TR,1424,6,0,0,6,22,1,0,23,31,1,0,32,40,1,0,41,43,1,0,44
151807,32,"GRĂDINIȚA CU PROGRAM PRELUNGIT NR.4",ALEXANDRIA,TR,1551,16,5,0,21,35,7,0,42,43,8,0,51,53,8,0,61,58,8,0,66
151807,33,"ȘCOALA DE ȘOFERI AMATORI",ALEXANDRIA,TR,1515,10,5,0,15,23,5,0,28,36,5,0,41,54,5,0,59,61,5,0,66
151807,34,"GRĂDINIȚA CU PROGRAM PRELUNGIT NR.8",ALEXANDRIA,TR,1242,12,0,0,12,19,2,0,21,21,2,0,23,32,3,0,35,38,3,0,41
151889,35,"ŞCOALA GIMNAZIALĂ ”ZAHARIA STANCU”","ROSIORI DE VEDE",TR,1209,10,2,0,12,19,3,0,22,28,3,0,31,46,3,0,49,49,3,0,52
151889,36,"ŞCOALA GIMNAZIALĂ ”ZAHARIA STANCU”","ROSIORI DE VEDE",TR,1116,14,0,0,14,25,0,0,25,36,0,0,36,46,0,0,46,52,0,0,52
151889,37,"ȘCOALA GIMNAZIALĂ ”DAN BERINDEI”","ROSIORI DE VEDE",TR,1204,11,0,0,11,37,0,0,37,39,5,0,44,53,7,28,88,53,7,28,88
151889,38,"COLEGIUL TEHNIC ”ANGHEL SALIGNY”","ROSIORI DE VEDE",TR,1122,23,1,0,24,44,2,0,46,51,6,0,57,63,6,0,69,66,7,0,73
151889,39,"GRĂDINIŢA CU PROGRAM PRELUNGIT NR.1","ROSIORI DE VEDE",TR,1108,6,5,0,11,21,8,0,29,33,8,0,41,52,10,0,62,56,11,0,67
151889,40,"CENTRUL CULTURAL","ROSIORI DE VEDE",TR,1115,9,2,0,11,26,2,0,28,35,4,0,39,51,4,0,55,55,5,0,60
151889,41,"ŞCOALA GIMNAZIALĂ ”GALA GALACTION”","ROSIORI DE VEDE",TR,1112,14,0,0,14,29,2,0,31,41,2,0,43,53,5,0,58,60,6,0,66
151889,42,"ŞCOALA GIMNAZIALĂ ”GALA GALACTION”","ROSIORI DE VEDE",TR,1205,8,0,0,8,17,3,0,20,24,3,0,27,34,3,0,37,36,3,0,39
151889,43,"MUZEUL DE ISTORIE","ROSIORI DE VEDE",TR,1105,6,6,0,12,12,11,0,23,17,13,0,30,35,17,0,52,41,20,0,61
151889,44,"CLUBUL COPIILOR","ROSIORI DE VEDE",TR,1432,10,0,0,10,29,0,0,29,35,2,39,76,59,3,39,101,62,3,39,104
151889,45,"ŞCOALA GIMNAZIALĂ ”ALEXANDRU DEPĂRĂŢEANU”","ROSIORI DE VEDE",TR,1399,15,0,0,15,30,0,0,30,34,1,0,35,43,1,0,44,48,1,0,49
151889,46,"ŞCOALA GIMNAZIALĂ ”ALEXANDRU DEPĂRĂŢEANU”","ROSIORI DE VEDE",TR,1419,9,2,0,11,19,2,0,21,25,5,0,30,34,5,0,39,36,5,0,41
151889,47,"ŞCOALA GIMNAZIALĂ ”ALEXANDRU DEPĂRĂŢEANU”","ROSIORI DE VEDE",TR,1120,10,0,0,10,20,3,0,23,27,3,0,30,39,3,0,42,44,3,0,47
151889,48,"ŞCOALA PRIMARĂ NR. 5","ROSIORI DE VEDE",TR,1496,15,0,0,15,35,0,0,35,38,0,0,38,50,0,0,50,51,0,0,51
151889,49,"ŞCOALA PRIMARĂ NR. 5","ROSIORI DE VEDE",TR,1120,15,1,0,16,34,1,0,35,43,5,0,48,65,5,0,70,65,5,0,70
151889,50,"LICEUL TEHNOLOGIC ”EMIL RACOVIŢĂ”","ROSIORI DE VEDE",TR,1370,19,1,0,20,35,1,0,36,51,3,0,54,57,4,0,61,60,4,0,64
151889,51,"CASA DE CULTURĂ","ROSIORI DE VEDE",TR,1092,11,1,0,12,26,1,14,41,34,4,14,52,53,4,14,71,57,6,14,77
151889,52,"COLEGIUL NAŢIONAL ”ANASTASESCU”","ROSIORI DE VEDE",TR,1398,15,0,0,15,37,3,0,40,55,3,0,58,74,3,0,77,80,4,0,84
151889,53,"GRĂDINIŢA CU PROGRAM NORMAL NR. 3","ROSIORI DE VEDE",TR,1345,11,0,0,11,31,1,0,32,43,1,0,44,63,5,0,68,74,5,0,79
151889,54,"LICEUL TEHNOLOGIC ”VIRGIL MADGEARU”","ROSIORI DE VEDE",TR,1244,12,6,0,18,32,6,0,38,41,6,0,47,48,7,0,55,52,7,0,59
151889,55,"GRĂDINIŢA CU PROGRAM NORMAL NR. 6","ROSIORI DE VEDE",TR,1106,11,2,1,14,23,2,1,26,29,2,1,32,44,3,1,48,55,4,1,60
151692,56,"GRĂDINIŢA CU PROGRAM NORMAL NR.3","TURNU MĂGURELE",TR,1377,6,1,0,7,15,5,0,20,17,8,0,25,23,8,0,31,25,8,0,33
151692,57,"ŞCOALA GENERALĂ NR.3","TURNU MĂGURELE",TR,1105,5,2,0,7,13,4,0,17,13,4,0,17,18,4,0,22,21,4,0,25
151692,58,"ŞCOALA GIMNAZIALĂ NR.4","TURNU MĂGURELE",TR,1885,5,1,0,6,29,3,0,32,34,3,0,37,43,3,0,46,48,3,0,51
151692,59,"GRĂDINIŢA CU PROGRAM PRELUNGIT NR.7","TURNU MĂGURELE",TR,1813,14,2,0,16,28,3,0,31,44,4,0,48,58,5,0,63,67,5,0,72
151692,60,"COLEGIUL TEHNIC ""G-RAL D. PRAPORGESCU""","TURNU MĂGURELE",TR,1460,32,0,0,32,55,0,0,55,70,0,0,70,84,2,0,86,87,2,0,89
151692,61,"COLEGIUL TEHNIC ""G-RAL D. PRAPORGESCU""","TURNU MĂGURELE",TR,1138,5,0,0,5,20,0,0,20,38,0,0,38,40,0,0,40,43,0,0,43
151692,62,"GRĂDINIŢA CU PROGRAM NORMAL NR.4","TURNU MĂGURELE",TR,883,17,5,0,22,25,5,0,30,34,5,0,39,39,5,0,44,40,7,0,47
151692,63,"GRĂDINIȚA CU PROGRAM PRELUNGIT NR.1","TURNU MĂGURELE",TR,1205,7,0,0,7,19,3,0,22,26,3,0,29,33,3,0,36,35,3,0,38
151692,64,"COLEGIUL NAŢIONAL ""UNIREA""","TURNU MĂGURELE",TR,1153,4,0,0,4,25,1,0,26,34,1,0,35,42,1,0,43,44,2,0,46
151692,65,"COLEGIUL NAŢIONAL ""UNIREA""","TURNU MĂGURELE",TR,1239,10,0,0,10,23,0,0,23,30,0,0,30,43,0,0,43,52,1,0,53
151692,66,"ŞCOALA GIMNAZIALĂ ""MIRCEA CEL BĂTRÂN""","TURNU MĂGURELE",TR,1169,18,3,0,21,44,3,0,47,53,5,0,58,60,6,0,66,68,6,0,74
151692,67,"ŞCOALA GIMNAZIALĂ ""MIRCEA CEL BĂTRÂN""","TURNU MĂGURELE",TR,1606,32,2,0,34,69,6,0,75,93,7,0,100,118,8,0,126,130,9,0,139
151692,68,"LICEUL TEHNOLOGIC ""SF. HARALAMBIE""","TURNU MĂGURELE",TR,1724,26,2,0,28,62,2,0,64,84,4,0,88,97,7,0,104,105,7,0,112
151692,69,"LICEUL TEORETIC ""MARIN PREDA""","TURNU MĂGURELE",TR,1225,22,0,0,22,44,2,0,46,51,2,0,53,60,3,0,63,66,3,0,69
151692,70,"GRĂDINIŢA CU PROGRAM PRELUNGIT NR.5","TURNU MĂGURELE",TR,1094,8,0,0,8,29,0,0,29,37,4,0,41,51,5,0,56,61,6,0,67
151692,71,"GRĂDINIŢA CU PROGRAM NORMAL NR.2","TURNU MĂGURELE",TR,1325,7,1,0,8,21,1,0,22,28,1,0,29,39,1,0,40,44,1,0,45
151692,72,"ŞCOALA GIMNAZIALĂ NR.2","TURNU MĂGURELE",TR,1423,14,5,0,19,33,5,0,38,39,7,0,46,44,10,0,54,47,12,0,59
151692,73,"DISPENSARUL UMAN MĂGURELE","TURNU MĂGURELE",TR,1368,23,1,0,24,33,1,0,34,44,1,0,45,55,2,0,57,61,4,0,65
151914,74,"ȘCOALA GIMNAZIALĂ CU CLASELE I-VIII, NR. 2",VIDELE,TR,1760,16,2,0,18,47,3,0,50,63,5,0,68,95,6,0,101,101,8,0,109
151914,75,"LICEUL TEORETIC",VIDELE,TR,1525,19,1,0,20,50,6,0,56,67,11,0,78,91,14,0,105,97,14,0,111
151914,76,"CASA DE CULTURĂ A ORAȘULUI VIDELE",VIDELE,TR,1491,12,3,0,15,29,4,0,33,36,4,0,40,58,7,0,65,68,7,0,75
151914,77,"GRĂDINIȚA CU PROGRAM NORMAL NR. 4, FOTĂCHEȘTI",VIDELE,TR,935,5,1,0,6,10,1,0,11,15,1,0,16,21,2,45,68,23,2,45,70
151914,78,"GRĂDINIȚA CU PROGRAM NORMAL NR. 3, FURCULEȘTI",VIDELE,TR,1333,6,3,0,9,11,6,0,17,13,7,0,20,27,7,0,34,40,7,0,47
151914,79,"GRĂDINIȚA CU PROGRAM NORMAL NR. 5, CARTOJANCA",VIDELE,TR,679,3,1,0,4,9,3,0,12,12,3,0,15,19,3,0,22,19,4,0,23
151914,80,"GRĂDINIȚA CU PROGRAM NORMAL NR. 2, TĂMĂȘEȘTI",VIDELE,TR,727,6,0,0,6,7,0,0,7,13,0,0,13,35,4,0,39,36,4,0,40
151914,81,"GRĂDINIȚA CU PROGRAM NORMAL NR. 6, PARISEȘTI",VIDELE,TR,477,1,4,0,5,4,4,0,8,8,4,0,12,14,5,0,19,15,5,0,20
151923,82,"GRĂDINIȚA CU PROGRAM NORMAL NR. 7, COȘOAIA",COŞOAIA,TR,276,2,4,0,6,2,4,0,6,8,6,0,14,16,8,0,24,16,8,0,24
151987,83,"ȘCOALA PRIMARĂ NR.4",ZIMNICEA,TR,1404,16,0,0,16,32,0,0,32,37,0,0,37,44,0,0,44,49,0,0,49
151987,84,"ȘCOALA PRIMARĂ NR.4",ZIMNICEA,TR,1500,17,0,0,17,31,3,0,34,50,4,1,55,65,4,1,70,67,4,1,72
151987,85,"S.C. URBANA SERV S.R.L.",ZIMNICEA,TR,1464,25,0,0,25,38,2,0,40,52,2,1,55,72,2,1,75,75,4,1,80
151987,86,"ȘCOALA GIMNAZIALĂ NR.3",ZIMNICEA,TR,1555,19,1,0,20,36,2,0,38,52,2,0,54,65,3,0,68,71,4,0,75
151987,87,"ȘCOALA GIMNAZIALĂ ""MIRON RADU PARASCHIVESCU""",ZIMNICEA,TR,1535,15,4,0,19,31,4,0,35,38,4,0,42,56,5,0,61,66,8,0,74
151987,88,"GRĂDINIȚA CU PROGRAM PRELUNGIT NR.5, NIVEL ȘCOLARIZARE PRE PP",ZIMNICEA,TR,1340,23,0,0,23,40,1,0,41,43,4,13,60,71,6,13,90,76,6,13,95
151987,89,"GRĂDINIȚA CU PROGRAM PRELUNGIT NR.5, NIVEL ȘCOLARIZARE PRE PP",ZIMNICEA,TR,1185,7,1,0,8,19,3,0,22,35,4,0,39,49,6,0,55,56,6,0,62
151987,90,"ȘCOALA GIMNAZIALĂ NR.2",ZIMNICEA,TR,1300,13,0,0,13,35,1,0,36,44,1,4,49,53,2,4,59,61,2,4,67
151987,91,"ȘCOALA GIMNAZIALĂ NR.2",ZIMNICEA,TR,1326,13,5,0,18,20,5,0,25,27,5,3,35,45,6,3,54,49,6,3,58
152001,92,"CĂMINUL CULTURAL BALCI",BALACI,TR,813,10,0,0,10,21,3,0,24,28,7,0,35,37,9,0,46,41,9,0,50
152029,93,"CĂMINUL CULTURAL TECUCI",TECUCI,TR,550,8,1,0,9,15,3,0,18,16,3,0,19,22,3,0,25,25,3,0,28
152047,94,"ŞCOALA GIMNAZIALĂ BĂBĂIŢA",BĂBĂIŢA,TR,1526,9,1,0,10,23,1,0,24,34,2,0,36,43,3,0,46,45,3,0,48
152047,95,"ŞCOALA GIMNAZIALĂ MERIŞANI",BĂBĂIŢA,TR,886,23,5,0,28,42,6,0,48,72,6,0,78,111,8,0,119,113,9,0,122
153641,96,"GRĂDINIŢA DE COPII CU PROGRAM NORMAL NR. 1BECIU",BECIU,TR,806,8,1,0,9,21,1,0,22,57,2,0,59,86,4,0,90,88,4,0,92
153687,97,"GRĂDINIŢA DE COPII CU PROGRAM NORMALNR.2 SMÂRDAN",SMÂRDAN,TR,461,7,1,0,8,8,2,0,10,14,2,0,16,37,3,0,40,37,3,0,40
152813,98,"CĂMINUL CULTURAL BEUCA",BEUCA,TR,922,4,2,0,6,17,3,0,20,30,6,0,36,47,13,53,113,51,14,53,118
152840,99,"CĂMINUL CULTURAL PLOPI",PLOPI,TR,157,5,0,0,5,8,6,0,14,9,7,0,16,13,8,0,21,13,8,0,21
152092,100,"ŞCOALA GIMNAZIALA NR.1 BLEJEŞTI",BLEJEŞTI,TR,995,9,0,0,9,15,2,0,17,36,6,0,42,65,10,0,75,77,11,0,88
152092,101,"GRĂDINIŢA CU PROGRAM NORMAL NR.2 BLEJEŞTI",BLEJEŞTI,TR,871,7,1,0,8,42,4,0,46,68,11,0,79,99,18,0,117,125,27,0,152
152109,102,"ŞCOALA GIMNAZIALĂ NR.2 BACIU COMUNA BLEJEŞTI",BACIU,TR,883,2,1,0,3,7,2,0,9,16,8,0,24,52,16,0,68,58,19,0,77
152118,103,"GRĂDINIŢA DE COPII CU PROGRAM NORMAL SERICU COMUNA BLEJEŞTI",SERICU,TR,340,1,4,0,5,20,8,0,28,45,10,0,55,62,15,0,77,89,17,0,106
152136,104,"ŞCOALA GIMNAZIALĂ BOGDANA",BOGDANA,TR,738,27,9,0,36,54,14,0,68,70,23,0,93,85,33,0,118,85,33,0,118
152154,105,"GRĂDINIŢA DE COPII CU PROGRAM NORMAL NR.2 ULMENI",ULMENI,TR,566,14,2,0,16,22,6,0,28,27,6,0,33,39,6,0,45,40,6,0,46
152163,106,"GRĂDINIŢA DE COPII CU PROGRAM NORMAL NR.3 URLUIU",URLUIU,TR,505,15,7,0,22,41,30,0,71,46,33,0,79,51,36,0,87,54,40,0,94
152181,107,"LICEUL TEHNOLOGIC ""ANDREI ŞAGUNA""",BOTOROAGA,TR,1052,1,4,0,5,9,4,0,13,22,7,0,29,33,13,0,46,34,13,0,47
152190,108,"ŞCOALA GIMNAZIALĂ NR. 1 CĂLUGĂRU",CĂLUGARU,TR,687,2,0,0,2,7,1,0,8,14,1,0,15,28,2,0,30,32,3,0,35
152207,109,"GRĂDINIŢA CU PROGRAM NORMAL NR.2",TÎRNAVA,TR,1042,5,4,0,9,11,12,0,23,22,14,0,36,31,18,0,49,32,21,0,53
152216,110,"ŞCOALA CU CLASELE I-IV TUNARI",TUNARI,TR,153,1,0,0,1,5,6,0,11,6,7,0,13,7,7,0,14,7,7,0,14
152225,111,"ŞCOALA GIMNAZIALĂ NR. 2","VALEA CIREŞULUI",TR,1205,0,3,0,3,3,4,0,7,6,4,0,10,14,9,0,23,16,11,0,27
152243,112,"PRIMĂRIA VECHE",BRAGADIRU,TR,1079,6,1,0,7,10,3,0,13,16,3,0,19,19,4,0,23,20,4,0,24
152243,113,"CĂMINUL CULTURAL",BRAGADIRU,TR,997,7,3,0,10,20,5,0,25,25,10,0,35,36,14,0,50,37,15,0,52
152243,114,"ŞCOALA ROIBA",BRAGADIRU,TR,1131,4,2,0,6,13,2,0,15,18,3,0,21,25,4,0,29,29,4,0,33
152261,115,"ȘCOALA GIMNAZIALĂ BRÎNCENI",BRÎNCENI,TR,762,3,0,0,3,5,0,0,5,12,5,0,17,17,6,0,23,21,6,0,27
152261,116,"CLĂDIRE ADMINISTRATIVĂ BRÎNCENI",BRÎNCENI,TR,1543,12,0,0,12,20,1,0,21,25,1,0,26,30,1,0,31,56,1,0,57
152289,117,"CĂMINUL CULTURAL BUJORENI",BUJORENI,TR,456,7,4,0,11,12,6,0,18,17,15,0,32,65,32,0,97,79,39,0,118
152305,118,"ŞCOALA CU CLASELE I-IV PRUNARU",PRUNARU,TR,353,4,1,0,5,9,2,0,11,17,6,0,23,38,13,0,51,43,14,0,57
152323,119,"GRĂDINIȚA CU PROGRAM NORMAL",BUJORU,TR,744,7,0,0,7,12,1,0,13,15,1,0,16,16,1,0,17,16,1,0,17
152323,120,"CĂMINUL CULTURAL",BUJORU,TR,728,6,3,0,9,12,3,0,15,13,6,0,19,18,6,0,24,20,6,0,26
152341,121,"CĂMIN CULTURAL",BUZESCU,TR,1179,1,0,0,1,9,1,0,10,15,2,0,17,22,4,0,26,25,5,0,30
152341,122,"GRĂDINIŢA CU PROGRAM NORMAL",BUZESCU,TR,1175,5,0,0,5,10,0,0,10,10,0,0,10,12,0,0,12,16,0,0,16
152341,123,"ŞCOALA GIMNAZIALĂ BUZESCU",BUZESCU,TR,1148,1,0,0,1,7,0,0,7,12,0,0,12,14,2,0,16,14,2,0,16
152369,124,"ȘCOALA GIMNAZIALĂ CĂLINEȘTI",CĂLINEŞTI,TR,1171,4,0,0,4,10,0,0,10,21,3,0,24,33,4,0,37,55,5,0,60
152396,125,"ȘCOALA GIMNAZIALĂ LICURICIU",LICURICIU,TR,403,7,3,0,10,13,4,0,17,18,7,0,25,20,7,33,60,25,7,33,65
152387,126,"ȘCOALA GIMNAZIALĂ COPĂCEANCA",COPĂCEANCA,TR,744,8,4,0,12,16,9,0,25,41,11,0,52,57,11,0,68,59,11,0,70
152378,127,"ȘCOALA GIMNAZIALĂ ANTONEŞTI",ANTONEŞTI,TR,246,9,1,0,10,19,5,0,24,25,7,0,32,32,7,19,58,33,7,19,59
152421,128,"ŞCOALA GIMNAZIALĂCĂLMĂŢUIU (FOST LOCAL AL ȘCOLII CU CLASELE I-IV)",CĂLMĂŢUIU,TR,558,10,2,0,12,23,3,0,26,37,5,0,42,52,7,0,59,56,7,0,63
152449,129,"ŞCOLALA GIMNAZIALĂ CĂLMĂȚUIU (FOST LOCAL AL ȘCOLII CU CLASELE I-IV)",CARAVANEŢI,TR,210,5,1,0,6,10,1,0,11,16,1,0,17,16,1,0,17,17,2,0,19
152430,130,"ŞCOALA GIMNAZIALĂ CĂLMĂȚUIU ( FOST LOCAL AL ȘCOLII CU CLASELE I-IV )",BUJORU,TR,211,6,4,0,10,11,5,0,16,18,8,0,26,31,11,0,42,34,16,0,50
152458,131,"ŞCOALA GIMNAZIALĂ CĂLMĂȚUIU ( FOST LOCALAL ȘCOLII NICOLAE BĂLCESCU)","NICOLAE BĂLCESCU",TR,564,6,2,0,8,16,3,0,19,30,3,0,33,43,5,0,48,47,5,0,52
152476,132,"GRĂDINIȚA DE COPII CU PROGRAM NORMAL NR.1 CĂLMĂȚUIU DE SUS","CĂLMĂŢUIU DE SUS",TR,652,3,0,0,3,8,2,0,10,14,3,0,17,24,3,0,27,41,3,0,44
152494,133,"GRĂDINIȚA DE COPII CU PROGRAM NORMAL NR. 3 IONAȘCU",IONAŞCU,TR,284,2,0,0,2,3,0,0,3,8,0,0,8,11,3,0,14,12,10,0,22
152485,134,"CLĂDIRE PRIMĂRIE -FOST SEDIU CAP BĂCĂLEȘTI",BĂCĂLEŞTI,TR,799,3,4,0,7,6,6,0,12,7,7,0,14,12,8,0,20,12,8,0,20
152519,135,"ȘCOALA GIMNAZIALĂ CERVENIA",CERVENIA,TR,1328,14,0,0,14,27,4,0,31,38,7,0,45,62,8,0,70,68,11,0,79
152519,136,"ȘCOALA GIMNAZIALĂ CERVENIA",CERVENIA,TR,1132,9,1,0,10,22,4,0,26,31,7,0,38,39,12,0,51,54,16,0,70
152537,137,"ŞCOALA GIMNAZIALĂNR. 1CIOLĂNEŞTII DIN DEAL","CIOLĂNEŞTII DIN DEAL",TR,831,6,0,0,6,9,0,0,9,12,0,0,12,19,4,0,23,19,4,0,23
152537,138,"ŞCOALA GIMNAZIALĂNR. 2 CIOLĂNEŞTII DIN DEAL","CIOLĂNEŞTII DIN DEAL",TR,495,4,1,0,5,6,3,0,9,10,8,0,18,15,8,0,23,16,8,0,24
152555,139,"ŞCOALA GENERALA NR. 3CIOLĂNEŞTII DIN VALE","CIOLĂNEŞTII DIN VALE",TR,470,0,0,0,0,5,0,0,5,12,0,0,12,16,3,0,19,17,3,0,20
152546,140,"ŞCOALA BALDOVINEŞTI",BALDOVINEŞTI,TR,353,5,2,0,7,7,2,0,9,9,2,0,11,12,2,0,14,12,2,0,14
151718,141,"ȘCOALA GIMNAZIALĂ CIUPERCENI",CIUPERCENI,TR,828,22,2,0,24,62,14,0,76,82,14,0,96,107,18,0,125,113,24,0,137
151727,142,"ȘCOALA GENERALĂ POIANA",POIANA,TR,513,18,2,0,20,49,10,0,59,73,17,0,90,96,25,37,158,100,28,37,165
152573,143,"SALA DE ŞEDINŢE A CONSILIULUI LOCAL CONŢEŞTI",CONŢEŞTI,TR,1427,35,1,0,36,89,5,0,94,133,8,16,157,194,14,16,224,205,15,16,236
152573,144,"GRĂDINIŢA CU PROGRAM NORMAL CONŢEŞTI",CONŢEŞTI,TR,1281,43,4,0,47,121,14,0,135,163,23,33,219,198,27,33,258,219,27,33,279
152591,145,"ȘCOALA GIMNAZIALĂ NR.2 COSMEȘTI",COSMEŞTI,TR,834,5,0,0,5,26,4,0,30,40,5,0,45,62,5,0,67,70,6,0,76
152608,146,"ŞCOLA GIMNAZIALĂ NR. 1 CIUPERCENI",CIUPERCENI,TR,1201,6,2,0,8,18,2,0,20,32,2,0,34,49,2,0,51,68,2,0,70
152671,147,"CĂMINUL CULTURAL DIN SATUL CRÂNGU",CRÂNGU,TR,850,15,5,0,20,54,12,0,66,69,14,0,83,81,17,0,98,87,17,0,104
152706,148,"SEDIUL ADMINISTRATIV DIN SATUL SECARA",SECARA,TR,294,7,3,0,10,20,9,0,29,48,13,0,61,57,16,0,73,58,17,0,75
151941,149,"GRĂDINIŢA CU PROGRAM NORMAL NR. 1 CREVENICU",CREVENICU,TR,716,4,2,0,6,6,2,0,8,11,2,0,13,20,5,0,25,22,8,0,30
151950,150,"CĂMINUL CULTURAL RĂDULEŞTI",RĂDULEŞTI,TR,433,1,1,0,2,1,3,0,4,3,3,0,6,6,5,0,11,6,5,0,11
152626,151,"CĂMINULUI CULTURAL CRINGENI",CRÎNGENI,TR,1215,15,1,0,16,17,2,0,19,26,3,0,29,45,9,0,54,47,9,0,56
152635,152,"CLĂDIRE PRIMĂRIE -FOSTA ŞCOALĂ CU CLASELE I-VIII BALTA SĂRATĂ","BALTA SĂRATĂ",TR,626,5,6,0,11,12,7,0,19,15,10,0,25,20,11,0,31,21,11,0,32
152644,153,"CLĂDIRE PRIMĂRIE FOSTA ŞCOALĂ CU CLASELE I-IV DOROBANŢU",DOROBANŢU,TR,222,3,5,0,8,8,7,0,15,16,10,0,26,18,10,0,28,21,13,0,34
152653,154,"CLĂDIRE PRIMĂRIE FOSTAŞCOALĂ CU CLASELE I-IV STEJARU",STEJARU,TR,144,0,7,0,7,2,7,0,9,4,7,0,11,11,12,0,23,11,12,0,23
152733,155,"CĂMINUL CULTURAL DIDEȘTI",DIDEŞTI,TR,960,4,0,0,4,8,2,0,10,15,4,0,19,24,7,0,31,24,7,0,31
152779,156,"ȘCOALA GIMNAZIALĂ NR.1",DOBROTEŞTI,TR,1310,3,2,0,5,7,14,0,21,7,14,0,21,23,14,0,37,23,14,0,37
152779,157,"CENTRUL DE ÎNGRIJIRE DE ZI PENTRU COPIII ÎN SITUAȚII DE RISC ÎN COMUNA DOBROTEȘTI",DOBROTEŞTI,TR,1338,2,0,0,2,4,1,0,5,6,2,0,8,14,6,0,20,14,7,0,21
152788,158,"ȘCOALA GIMNAZIALĂ NR. 2",MERIŞANI,TR,960,1,0,0,1,12,4,0,16,14,5,0,19,20,5,0,25,23,5,0,28
152680,159,"GRĂDINIŢA CU PROGRAM NORMAL DRACEA",DRACEA,TR,1043,17,1,0,18,32,2,0,34,44,11,0,55,69,17,0,86,73,17,0,90
152715,160,"ŞCOALA GENERALĂ ZLATA",ZLATA,TR,63,1,3,0,4,11,5,0,16,13,7,0,20,15,7,0,22,16,8,0,24
152699,161,"CĂMINUL CULTURAL FLORICA",FLORICA,TR,181,4,2,0,6,14,4,0,18,17,6,0,23,25,6,0,31,25,6,0,31
152804,162,"ŞCOALA CU CLASELE I-IV DRĂCŞENEI",DRĂCŞENEI,TR,618,11,0,0,11,15,0,0,15,20,1,0,21,28,1,0,29,34,2,0,36
152822,163,"ŞCOALA GIMNAZIALĂ DRĂCŞANI",DRĂCŞANI,TR,328,7,0,0,7,14,0,0,14,19,0,0,19,24,6,0,30,24,6,0,30
152831,164,"ŞCOALA CU CLASELE I-IV ODOBEASCA",ODOBEASCA,TR,427,1,3,0,4,3,4,0,7,5,4,0,9,7,4,0,11,7,4,0,11
152877,165,"ŞCOALA GİMNAZİALĂDRĂGĂNEŞTİ DE VEDE","DRĂGĂNEŞTI DE VEDE",TR,1176,6,0,0,6,9,1,0,10,9,1,0,10,25,5,0,30,27,6,0,33
152895,166,"GRĂDİNİŢA CU PROGRAM NORMAL NR.2",VĂCĂREŞTI,TR,543,8,0,0,8,9,2,0,11,12,2,0,14,17,2,0,19,18,4,0,22
152911,167,"LICEUL TEHNOLOGIC DRĂGĂNEŞTI VLAŞCA",DRĂGĂNEŞTI-VLAŞCA,TR,1700,3,3,0,6,15,3,0,18,26,3,0,29,28,3,0,31,29,3,0,32
152911,168,"ŞCOALA GIMNAZIALĂ DRĂGĂNEŞTI VLAŞCA",DRĂGĂNEŞTI-VLAŞCA,TR,1076,5,4,0,9,11,10,0,21,11,13,0,24,11,13,0,24,14,24,0,38
152939,169,"ȘCOALA CU CLASELE I - IV VĂCENI",VĂCENI,TR,218,3,4,0,7,8,6,0,14,9,6,0,15,10,7,0,17,10,7,0,17
152920,170,"ȘCOALA CU CLASELE I-IV COMOARA",COMOARA,TR,358,12,7,0,19,17,12,0,29,28,15,0,43,42,15,0,57,44,18,0,62
154488,171,"ŞCOALA GIMNAZIALĂ FÂNTÂNELE",FÂNTÂNELE,TR,1355,34,1,0,35,56,14,0,70,94,30,0,124,146,40,0,186,157,50,0,207
152065,172,"LOCALUL ŞCOLII GIMNAZIALE FRĂSINET",FRĂSINET,TR,1497,7,1,0,8,16,5,0,21,52,10,0,62,85,10,0,95,122,10,0,132
152056,173,"LOCALUL GRĂDINIŢEI CLĂNIŢA",CLĂNIŢA,TR,555,9,4,0,13,19,5,0,24,26,7,0,33,50,7,0,57,55,9,0,64
153008,174,"CĂMINUL CULTURAL FRUMOASA",FRUMOASA,TR,783,19,6,0,25,32,8,0,40,40,11,0,51,65,12,0,77,67,12,0,79
153008,175,"GRĂDINIȚA CU PROGRAM NORMAL NR. 2 FRUMOASA",FRUMOASA,TR,471,3,2,0,5,9,4,0,13,11,4,0,15,25,4,0,29,31,5,0,36
153017,176,"GRĂDINIȚA CU PROGRAM NORMAL NR. 2 PĂULEASCA",PĂULEASCA,TR,418,6,2,0,8,13,3,0,16,17,3,0,20,23,7,0,30,27,8,0,35
152957,177,"ŞCOALA GIMNAZIALĂ FURCULEŞTI",FURCULEŞTI,TR,1413,8,1,0,9,14,1,0,15,19,2,0,21,28,2,0,30,30,2,0,32
152975,178,"ŞCOALA CU CLASELE I - VIII SPĂTĂREI",SPĂTĂREI,TR,827,5,2,0,7,15,4,0,19,19,6,0,25,25,7,0,32,28,8,0,36
152984,179,"GRĂDINIŢA CU PROGRAM NORMAL VOIEVODA",VOIEVODA,TR,529,8,0,0,8,9,0,0,9,13,3,0,16,17,3,0,20,23,5,0,28
153035,180,"ŞCOALA PRIMARĂ GĂLĂTENI",GĂLĂTENI,TR,1235,1,0,0,1,11,1,0,12,24,3,0,27,42,3,0,45,49,3,0,52
153044,181,"ŞCOALA GIMNAZIALĂ GĂLĂTENI",BÎSCOVENI,TR,852,0,0,0,0,5,2,0,7,6,2,0,8,24,3,0,27,27,3,0,30
153071,182,"GRĂDINIȚA CU PROGRAM NORMAL NR. 1",GRATIA,TR,948,9,3,0,12,17,5,0,22,23,5,0,28,35,5,0,40,37,7,0,44
153080,183,"ȘCOALA GIMNAZIALĂ GRATIA",CIURARI-DEAL,TR,1169,8,0,0,8,22,0,0,22,35,9,0,44,49,12,0,61,52,12,0,64
151745,184,"CĂMINUL CULTURAL",ISLAZ,TR,1230,4,4,0,8,11,7,0,18,15,10,0,25,28,12,0,40,33,12,0,45
151745,185,"GRĂDINIȚA CU PROGRAM NORMAL NR. 2",ISLAZ,TR,1553,15,0,0,15,19,2,0,21,45,5,0,50,81,12,0,93,91,13,0,104
151745,186,"ŞCOALA GIMNAZIALĂ NR. 1 ISLAZ",ISLAZ,TR,767,3,5,0,8,10,7,0,17,14,7,0,21,21,7,0,28,24,7,0,31
151754,187,"ŞCOALA GENERALĂ MOLDOVENI",MOLDOVENI,TR,777,3,0,0,3,7,0,0,7,15,4,0,19,22,7,0,29,24,7,0,31
153115,188,"GRĂDINIŢA DE COPII IZVOARELE",IZVOARELE,TR,1141,7,6,0,13,17,7,0,24,19,8,0,27,28,9,0,37,32,9,0,41
153115,189,"GRĂDINIŢA DE COPII IZVOARELE",IZVOARELE,TR,938,1,0,0,1,4,0,0,4,8,0,0,8,20,1,0,21,22,1,0,23
153133,190,PRIMĂRIALISA,LISA,TR,1293,2,0,0,2,12,1,0,13,14,3,0,17,16,3,0,19,16,4,0,20
153142,191,"GRĂDINIŢA VÂNĂTORI",VÎNĂTORI,TR,545,1,0,0,1,6,1,0,7,7,1,0,8,12,2,0,14,14,2,0,16
151772,192,"ȘCOALA GIMNAZIALĂ LIȚA",LIŢA,TR,1092,3,4,0,7,10,4,0,14,18,9,0,27,30,9,0,39,34,9,0,43
151772,193,"GRĂDINIȚA CU PROGRAM NORMAL NR. 2",LIŢA,TR,1121,5,0,0,5,25,2,0,27,34,4,0,38,40,7,0,47,41,7,0,48
153160,194,"ȘCOALA GIMNAZIALĂ NUMĂRUL 1 LUNCA",LUNCA,TR,952,1,2,0,3,3,2,0,5,3,2,0,5,5,5,0,10,5,5,0,10
153160,195,"GRĂDINIȚA CU PROGRAM NORMAL NUMĂRUL 1 LUNCA",LUNCA,TR,584,1,0,0,1,5,0,0,5,5,1,0,6,7,1,0,8,7,1,0,8
153188,196,"ȘCOALA GIMNAZIALĂ NUMĂRUL 2 PRUNDU",PRUNDU,TR,1162,4,0,0,4,7,2,0,9,8,2,0,10,22,2,0,24,27,2,0,29
153213,197,"ŞCOALA GIMNAZIALĂ MAVRODIN",MAVRODIN,TR,1062,5,3,0,8,15,3,0,18,19,3,0,22,20,4,0,24,22,4,0,26
153213,198,"CĂMINUL CULTURAL MAVRODIN",MAVRODIN,TR,962,5,0,0,5,14,1,0,15,20,5,0,25,32,7,0,39,32,7,0,39
153259,199,"CĂMINUL CULTURAL MĂGURA",MĂGURA,TR,1465,36,1,0,37,69,11,0,80,87,15,0,102,140,21,0,161,167,24,0,191
153268,200,"CĂMINUL CULTURAL GURUIENI",GURUIENI,TR,773,28,3,0,31,59,12,0,71,78,15,0,93,120,20,0,140,135,20,0,155
153286,201,"SCOALA GIMNAZIALA NR.1",MĂLDĂENI,TR,1175,3,1,0,4,8,1,0,9,23,4,9,36,42,7,9,58,57,9,9,75
153286,202,"GRADINITA CU PROGRAM NORMAL NR.1",MĂLDĂENI,TR,975,6,0,0,6,13,0,0,13,19,0,0,19,32,1,8,41,38,5,8,51
153286,203,"GRADINITA CU PROGRAM NORMAL NR.2",MĂLDĂENI,TR,1309,6,2,0,8,21,6,0,27,29,6,0,35,48,10,11,69,51,13,11,75
153302,204,"SCOALA GIMNAZIALĂ CU CLASELE I-VIII MERENII DE JOS","MERENII DE JOS",TR,1317,1,7,0,8,12,7,0,19,20,8,0,28,37,10,0,47,41,11,0,52
153311,205,"SCOALA GENERALĂ CU CLASELEI-VIII","MERENII DE SUS",TR,834,3,0,0,3,7,0,0,7,10,0,0,10,14,0,0,14,15,0,0,15
153357,206,"ŞCOALA GIMNAZIALĂ NR. 2, CERNETU",CERNETU,TR,1105,6,2,0,8,12,5,0,17,16,6,0,22,25,6,0,31,26,7,0,33
153375,207,"GRĂDINIŢA CU PROGRAM NORMAL NR.3 VALEA PĂRULUI","VALEA PĂRULUI",TR,661,7,0,0,7,13,0,0,13,15,0,0,15,16,0,0,16,18,2,0,20
153348,208,"ŞCOALA GIMNAZIALĂ NR.1 MÎRZĂNEŞTI",MÎRZĂNEŞTI,TR,510,7,1,0,8,10,2,0,12,15,4,0,19,19,7,0,26,22,7,0,29
153366,209,"ŞCOALA GIMNAZIALĂ TELEORMANU",TELEORMANU,TR,742,9,1,0,10,13,1,0,14,19,2,0,21,22,2,0,24,24,4,0,28
153393,210,"ȘCOALA GIMNAZIALĂ MOȘTENI",MOŞTENI,TR,673,4,2,0,6,7,3,0,10,15,4,0,19,24,6,33,63,31,9,33,73
153393,211,"ŞCOALA GIMNAZIALĂ MOŞTENI",MOŞTENI,TR,505,4,0,0,4,9,1,0,10,17,1,0,18,26,7,30,63,28,9,30,67
151825,212,"ȘCOALA GIMNAZIALĂ NANOV",NANOV,TR,1688,6,1,0,7,20,6,0,26,39,6,0,45,54,6,0,60,62,11,0,73
151825,213,"GRĂDINIŢA CU PROGRAM NORMAL NR. 2 NANOV",NANOV,TR,1385,6,0,0,6,19,1,0,20,25,1,0,26,30,3,0,33,35,3,0,38
153419,214,"ȘCOALA GIMNAZIALĂ NĂSTURELU",NĂSTURELU,TR,1274,4,1,0,5,14,1,0,15,46,1,0,47,70,1,0,71,90,1,0,91
153428,215,"ȘCOALA GIMNAZIALĂ ZIMNICELE",ZIMNICELE,TR,812,6,1,0,7,8,1,0,9,9,1,0,10,13,1,0,14,15,1,0,16
153446,216,"LOCALUL ŞCOLII CU CLASELE I-IV NECŞEŞTI",NECŞEŞTI,TR,459,8,0,0,8,15,0,0,15,21,1,0,22,30,3,0,33,30,6,0,36
153464,217,"LOCALUL ŞCOLII CU CLASELE I-VIII GÂRDEŞTI",GÎRDEŞTI,TR,438,5,2,0,7,8,2,0,10,10,3,0,13,14,4,0,18,19,5,0,24
153222,218,"ȘCOALA GIMNAZIALĂ NENCIULEȘTI",NENCIULEŞTI,TR,718,4,3,0,7,7,6,0,13,13,8,0,21,39,8,0,47,41,9,0,50
153222,219,"GRĂDINIȚA CU PROGRAM NORMAL NR. 1 NENCIULEȘTI",NENCIULEŞTI,TR,799,6,0,0,6,15,0,0,15,23,2,0,25,42,2,0,44,50,2,0,52
153231,220,"GRĂDINIȚA CU PROGRAM NORMAL NR. 2 PĂRU ROTUND","PĂRU ROTUND",TR,469,5,0,0,5,8,0,0,8,8,0,0,8,11,0,0,11,14,0,0,14
153482,221,"ŞCOALA GIMNAZIALĂNR.1 OLTENI",OLTENI,TR,1504,10,2,0,12,25,4,0,29,35,6,0,41,44,6,0,50,45,6,0,51
153491,222,"ŞCOALA GIMNAZIALĂ NR.2 PERII-BROŞTENI","PERII BROŞTENI",TR,897,0,0,0,0,2,0,0,2,6,0,0,6,10,0,0,10,10,0,0,10
153516,223,"ŞCOALA GIMNAZIALÃ NR. 2ORBEASCA DE JOS ( CORP A)","ORBEASCA DE JOS",TR,870,7,0,0,7,12,0,0,12,21,2,0,23,30,2,0,32,34,4,0,38
153516,224,"ŞCOALA GIMNAZIALÃ NR. 2ORBEASCA DE JOS(CORP A)","ORBEASCA DE JOS",TR,928,2,1,0,3,10,1,0,11,16,3,0,19,28,5,0,33,28,6,0,34
153534,225,"ŞCOALA GIMNAZIALÃ NR. 1 ORBEASCA DE SUS (CORP B)","ORBEASCA DE SUS",TR,1134,5,3,0,8,19,8,0,27,25,9,0,34,38,9,0,47,42,12,0,54
153534,226,"ŞCOALA GIMNAZIALÃ NR. 1 ORBEASCA DE SUS (CORP B)","ORBEASCA DE SUS",TR,1293,15,0,0,15,29,5,0,34,40,6,0,46,56,9,0,65,66,10,0,76
153525,227,"ŞCOALA GIMNAZIALÃ NR.3 LACENI (CORP A)",LĂCENI,TR,887,5,2,0,7,10,2,0,12,15,7,0,22,24,8,0,32,28,8,0,36
153525,228,"ŞCOALA GIMNAZIALÃ NR.3 LACENI (CORP A)",LĂCENI,TR,1070,5,3,0,8,10,4,0,14,17,4,0,21,27,7,0,34,28,7,0,35
153552,229,"ŞCOALA GIMNAZIALĂ ""GRIGORE DIMITRIE GHICA"" PERETU",PERETU,TR,1009,4,0,0,4,7,0,0,7,9,0,0,9,12,1,0,13,18,2,0,20
153552,230,"ŞCOALA GIMNAZIALĂ ""GRIGORE DIMITRIE GHICA"" PERETU",PERETU,TR,1178,5,0,0,5,11,0,0,11,11,0,0,11,14,0,0,14,27,0,0,27
153552,231,"CĂMINUL CULTURAL PERETU",PERETU,TR,1337,3,1,0,4,11,1,0,12,12,1,0,13,16,1,0,17,18,1,0,19
153552,232,"GRĂDINIŢA CU PROGRAM NORMAL PERETU",PERETU,TR,1385,4,3,0,7,9,3,0,12,13,4,0,17,20,5,0,25,23,7,0,30
153552,233,"GRĂDINIŢA CU PROGRAM NORMAL PERETU",PERETU,TR,1117,6,0,0,6,8,0,0,8,10,0,0,10,12,0,0,12,15,0,0,15
153570,234,"ȘCOALA GIMNAZIALĂ PIATRA",PIATRA,TR,906,8,0,0,8,8,0,0,8,13,1,0,14,17,3,0,20,20,3,0,23
153570,235,"GRĂDINIȚA CU PROGRAM NORMAL PIATRA",PIATRA,TR,772,6,1,0,7,8,2,0,10,9,2,0,11,10,3,0,13,10,4,0,14
153570,236,"SALA DE PROTOCOL PRIMĂRIA COMUNEI PIATRA",PIATRA,TR,874,6,4,0,10,14,7,0,21,17,10,0,27,24,12,0,36,26,13,0,39
153598,237,"ŞCOALA GIMNAZIALĂ(ŞCOALA VECHE)",PIETROŞANI,TR,971,7,3,0,10,11,8,0,19,13,9,0,22,33,11,0,44,39,11,0,50
153598,238,"ŞCOALA GIMNAZIALĂ(ŞCOALA NOUĂ)",PIETROŞANI,TR,1149,8,1,0,9,19,1,0,20,24,6,0,30,42,8,0,50,47,8,0,55
153632,239,"ŞCOALA GIMNAZIALĂ PLOPII SLĂVITEŞTI",PLOPII-SLĂVITEŞTI,TR,571,9,1,0,10,9,2,0,11,10,2,0,12,27,2,0,29,28,2,0,30
153669,240,"GRĂDINIŢA CU PROGRAM NORMAL NR.3",BRÎNCOVEANCA,TR,831,5,2,0,7,8,2,0,10,12,3,0,15,18,6,39,63,18,6,39,63
153678,241,"GRĂDINIŢA CU PROGRAM NORMAL NR.2",DUDU,TR,620,4,0,0,4,13,2,0,15,17,2,0,19,33,4,0,37,40,6,0,46
153614,242,"CĂMINUL CULTURAL",PLOSCA,TR,1366,11,0,0,11,16,3,0,19,16,5,0,21,20,7,0,27,25,9,0,34
153614,243,"ŞCOALA RĂSFIRAŢI",PLOSCA,TR,1418,5,0,0,5,10,0,0,10,12,0,0,12,13,0,0,13,15,0,0,15
153614,244,"ŞCOALA GIMNAZIALĂ PLOSCA",PLOSCA,TR,794,0,0,0,0,4,0,0,4,10,0,0,10,13,0,0,13,14,0,0,14
153614,245,"ŞCOALA MICĂ",PLOSCA,TR,1211,8,0,0,8,9,1,0,10,12,1,0,13,13,1,0,14,14,1,0,15
153703,246,"ȘCOALAGENERALĂ POENI",POENI,TR,1138,5,3,0,8,19,4,0,23,30,6,0,36,47,6,0,53,49,6,0,55
153749,247,"ȘCOALA GENERALĂ PREAJBA",PREAJBA,TR,328,6,0,0,6,9,2,0,11,13,3,0,16,23,3,0,26,23,3,0,26
153767,248,"ȘCOALA GENERALĂ VĂTAȘI",VĂTAŞI,TR,482,1,2,0,3,2,4,0,6,3,4,0,7,5,5,0,10,5,5,0,10
153730,249,"ȘCOALA PRIMARĂCĂTUNU",CĂTUNU,TR,362,1,2,0,3,4,6,0,10,6,12,0,18,8,13,0,21,10,13,0,23
151843,250,"ŞCOALA GIMNAZIALĂ POROSCHIA",POROSCHIA,TR,1477,10,6,0,16,22,7,0,29,34,9,0,43,50,11,0,61,66,11,0,77
151843,251,"ȘCOALA GENERALĂ POROSCHIA",POROSCHIA,TR,1392,26,0,0,26,45,3,29,77,63,12,29,104,111,20,29,160,129,22,29,180
151852,252,"GRĂDINIȚA CU PROGRAM NORMAL CALOMFIREȘTI",CALOMFIREŞTI,TR,858,5,6,0,11,21,7,0,28,35,9,0,44,60,10,0,70,70,11,0,81
154255,253,"ŞCOALA GIMNAZIALĂ PURANII DE SUS",PURANI,TR,1163,8,3,0,11,13,3,0,16,15,3,0,18,26,3,10,39,31,3,10,44
153838,254,"GRĂDINIȚA CU PROGRAM NORMAL NR.1 PUTINEIU",PUTINEIU,TR,1069,10,0,0,10,23,3,0,26,36,4,0,40,44,7,1,52,47,8,1,56
153847,255,"GRĂDINIȚA CU PROGRAM NORMAL NR.2 BĂDULEASA",BĂDULEASA,TR,579,9,4,0,13,22,7,0,29,27,8,0,35,38,16,0,54,41,22,0,63
153874,256,"CĂMIN CULTURAL",RĂDOIEŞTI-VALE,TR,528,29,0,0,29,68,0,0,68,84,2,0,86,116,4,0,120,134,4,0,138
153892,257,"ȘCOALA GIMNAZIALĂ RĂDOIEȘTI",RĂDOIEŞTI-DEAL,TR,829,9,1,0,10,18,2,0,20,31,2,0,33,45,7,0,52,46,7,0,53
153883,258,"ȘCOALA GENERALĂ RĂDOIEȘTI CETATEA",CETATEA,TR,319,2,0,0,2,3,3,0,6,8,6,0,14,16,9,0,25,23,10,0,33
153918,259,"CĂMINUL CULTURAL RĂSMIREŞTI",RĂSMIREŞTI,TR,664,6,0,0,6,11,6,0,17,13,10,0,23,25,12,0,37,26,12,0,38
153197,260,"ŞCOALA GIMNAZIALĂ SAELELE",SAELELE,TR,1266,9,2,0,11,30,3,0,33,57,3,0,60,84,6,0,90,92,8,0,100
153179,261,"GRĂDINIŢA PLEAŞOV",PLEAŞOV,TR,684,10,3,0,13,20,7,0,27,23,11,0,34,35,12,0,47,39,12,0,51
153945,262,"LOCALUL CĂMINULUI CULTURAL SALCIA",SALCIA,TR,792,13,2,0,15,24,7,0,31,35,12,0,47,52,20,0,72,60,21,0,81
153954,263,"LOCALUL CĂMINULUI CULTURAL DIN SATUL BĂNEASA",BĂNEASA,TR,710,15,1,0,16,23,7,0,30,37,13,0,50,74,18,0,92,110,25,0,135
153963,264,"LOCALUL CĂMINULUI CULTURAL DIN SATUL TUDOR VLADIMIRESCU","TUDOR VLADIMIRESCU",TR,598,15,0,0,15,28,4,0,32,42,6,0,48,69,11,0,80,72,11,0,83
153981,265,"ȘCOALA GIMNAZIALĂ SĂCENI",SĂCENI,TR,572,5,0,0,5,9,3,0,12,22,4,0,26,26,6,0,32,27,7,0,34
154004,266,"CLĂDIREA FOSTA ȘCOALĂ GIMNAZIALĂ CIURARI",CIURARI,TR,376,5,5,0,10,14,7,0,21,14,7,0,21,17,8,0,25,21,8,0,29
154022,267,"CĂMIN CULTURAL SCRIOAȘTEA",SCRIOAŞTEA,TR,1870,13,2,0,15,38,3,0,41,55,4,0,59,82,7,0,89,93,7,0,100
154031,268,"GRĂDINIŢA DE COPII",BREBINA,TR,640,7,3,0,10,15,7,0,22,28,10,0,38,29,13,0,42,29,13,0,42
154040,269,"CĂMIN CULTURAL CUCUEŢI",CUCUEŢI,TR,683,5,3,0,8,5,5,0,10,12,5,0,17,21,9,0,30,24,9,0,33
154077,270,"LOCALUL ŞCOLII GENERALE CU CLASELE I – VIII SCURTU MARE","SCURTU MARE",TR,878,8,5,0,13,19,6,0,25,31,6,0,37,42,6,0,48,45,8,0,53
154095,271,"LOCALUL ŞCOLII CU CLASELE I-IV DRACESTI",DRĂCEŞTI,TR,281,6,1,0,7,9,1,0,10,22,7,0,29,35,15,0,50,37,15,0,52
154086,272,"LOCALUL ŞCOLII CU CLASELE I-IV ALBENI",ALBENI,TR,166,2,3,0,5,3,10,0,13,5,11,0,16,6,12,0,18,6,13,0,19
154148,273,"GRADINITA CU PROGRAM NORMAL ,NR.1 SEACA , SAT SEACA , JUDETUL TELEORMAN , STRADA VICTORIEI , NR.75",SEACA,TR,1229,18,2,0,20,27,3,0,30,34,3,0,37,46,3,0,49,52,5,0,57
154157,274,"GRADINITA CU PROGRAM NORMAL NR.2 NAVODARI , SAT NAVODARI, COMUNA SEACA , JUDETUL TELEORMAN, STRADA DUNARII, NR.107",NĂVODARI,TR,703,19,2,0,21,26,2,0,28,38,3,0,41,46,3,0,49,49,3,0,52
154193,275,"LOCALUL ŞCOLII CU CLASELE I-VIII SEGARCEA VALE",SEGARCEA-VALE,TR,824,7,2,0,9,25,3,0,28,41,8,0,49,54,12,0,66,54,12,0,66
154200,276,"LOCALUL ŞCOLII CU CLASELE I-VIII OLTEANCA",OLTEANCA,TR,728,6,4,0,10,12,13,0,25,16,17,0,33,24,19,0,43,27,21,0,48
154219,277,"LOCALUL ŞCOLII CU CLASELE I-VIII SEGARCEA DEAL",SEGARCEA-DEAL,TR,937,14,3,0,17,26,5,0,31,34,12,0,46,46,13,0,59,53,13,0,66
154175,278,"LOCALUL CĂMINULUI CULTURAL SFINŢEŞTI",SFINŢEŞTI,TR,920,4,0,0,4,10,0,0,10,18,2,0,20,21,5,0,26,25,5,0,30
154237,279,"CĂMINUL CULTURAL SILIŞTEA",SILIŞTEA,TR,1093,6,1,0,7,15,1,0,16,28,2,0,30,42,7,0,49,46,7,0,53
154246,280,"GRĂDINIȚA CU PROGRAM NORMAL NR. 2 BUTEȘTI (FOST LOCAL AL ȘCOLII CU CLASELE I-IV BUTEȘTI)",BUTEŞTI,TR,507,2,0,0,2,4,3,0,7,6,7,0,13,13,7,0,20,13,7,0,20
154273,281,"GRĂDINIȚA CU PROGRAM NORMAL NR. 3 SILIȘTEA MICĂ (FOST LOCAL AL ȘCOLII CU CLASELE I-IV SILIȘTEA MICĂ)","SILIŞTEA MICĂ",TR,271,7,1,0,8,7,1,0,8,12,2,0,14,15,2,0,17,15,3,0,18
154291,282,"CENTRUL MEMORIAL ”MARIN PREDA”",SILIŞTEA-GUMEŞTI,TR,1172,11,3,0,14,17,7,0,24,20,8,0,28,42,14,0,56,50,15,0,65
154291,283,"ȘCOALA CU CLASELEI-IV ”MĂGURA”",SILIŞTEA-GUMEŞTI,TR,820,4,4,0,8,8,7,0,15,14,11,0,25,20,14,0,34,21,14,0,35
154335,284,"GRĂDINIŢA CU PROGRAM NORMAL NR. 3",UDENI,TR,354,4,5,0,9,6,6,0,12,9,6,0,15,15,6,0,21,15,6,0,21
154326,285,"GRĂDINIŢA CU PROGRAM NORMAL NR. 2",SÎRBENI,TR,544,7,1,0,8,8,2,0,10,12,2,0,14,15,6,0,21,16,6,0,22
154317,286,"LOCALUL ŞCOLII GIMNAZIALE SÂRBENII DE JOS","SÎRBENII DE JOS",TR,213,8,2,0,10,10,2,0,12,13,2,0,15,17,2,0,19,19,2,0,21
154353,287,"ȘCOALA GIMNAZIALĂ SLOBOZIA MÂNDRA","SLOBOZIA MÂNDRA",TR,597,22,4,0,26,43,10,0,53,49,11,18,78,62,13,18,93,63,13,18,94
154353,288,"ȘCOALA GIMNAZIALĂ SLOBOZIA MÂNDRA","SLOBOZIA MÂNDRA",TR,765,8,1,0,9,16,4,0,20,21,4,0,25,29,6,13,48,30,8,13,51
154399,289,"ŞCOALA GIMNAZIALĂ SMÎRDIOASA",SMÎRDIOASA,TR,1528,11,2,0,13,33,4,0,37,41,4,0,45,51,9,0,60,57,9,0,66
154406,290,"ŞCOALA PRIMARĂŞOIMU",ŞOIMU,TR,363,11,4,0,15,18,7,0,25,20,7,0,27,34,11,0,45,38,12,0,50
154424,291,"CĂMIN CULTURAL STEJARU",STEJARU,TR,611,25,6,0,31,40,15,0,55,51,20,0,71,65,23,0,88,73,23,0,96
154451,292,"CLĂDIREA ŞCOLII GENERALE SOCETU",SOCETU,TR,651,10,3,0,13,29,3,0,32,56,6,0,62,80,12,0,92,83,13,0,96
154433,293,"SEDIUL FOSTEI PRIMĂRII COMUNALE BRATCOV",BRATCOVU,TR,111,1,0,0,1,14,4,0,18,19,6,0,25,30,11,0,41,30,11,0,41
154442,294,"CLĂDIREAŞCOLII ELEMENTARE GRESIA",GRESIA,TR,99,11,2,0,13,16,2,0,18,24,4,0,28,29,6,0,35,29,6,0,35
154479,295,"ŞCOALA GIMNAZIALĂ SUHAIA",SUHAIA,TR,887,3,1,0,4,12,2,0,14,13,3,0,16,18,3,0,21,23,3,0,26
154479,296,"ŞCOALA GIMNAZIALĂ SUHAIA",SUHAIA,TR,983,0,0,0,0,3,4,0,7,8,4,0,12,17,8,0,25,19,8,0,27
154503,297,"SCOALA GIMNAZIALA ""VASILE RACOTTA""",ŞTOROBĂNEASA,TR,1425,7,2,0,9,16,5,0,21,26,5,0,31,41,13,24,78,45,13,24,82
154512,298,"SCOALA CU CLASELE I-VIII "" BADEA NEGREANU """,BEIU,TR,1152,7,0,0,7,22,7,0,29,31,7,0,38,51,15,0,66,59,15,0,74
154530,299,"ȘCOALA GIMNAZIALĂ COMUNA TALPA",TALPA-OGRĂZILE,TR,761,9,6,0,15,19,11,0,30,39,17,0,56,75,27,83,185,81,28,83,192
154567,300,"ȘCOALA CU CLASELE I - IV TALPA",TALPA-BÎSCOVENI,TR,708,1,0,0,1,10,0,0,10,42,7,0,49,57,10,18,85,59,10,18,87
154594,301,"ŞCOALA GIMNAZIALĂ TĂTĂRĂŞTII DE JOS","TĂTĂRĂŞTII DE JOS",TR,1207,6,3,0,9,12,6,0,18,17,16,0,33,28,17,0,45,29,17,0,46
154656,302,"ŞCOALA GIMNAZIALĂ SLĂVEŞTI",SLĂVEŞTI,TR,776,4,4,0,8,12,6,0,18,16,6,0,22,21,8,0,29,21,9,0,30
154657,303,"GRĂDINIŢA NEGRENII DE SUS","NEGRENII DE SUS",TR,714,5,0,0,5,17,0,0,17,25,0,0,25,41,0,0,41,42,8,0,50
154674,304,"ȘCOALA GIMNAZIALĂ TĂTĂRĂȘTII DE SUS","TĂTĂRĂŞTII DE SUS",TR,1085,3,3,0,6,3,6,0,9,4,6,0,10,13,7,0,20,25,8,0,33
154692,305,"ȘCOALA GIMNAZIALĂ TĂTĂRĂȘTII DE SUS",UDUPU,TR,1211,6,0,0,6,14,6,0,20,19,6,0,25,27,9,0,36,30,9,0,39
154745,306,"SPAŢII BIROURI, STRADA PRINCIPALĂ NR. 116",TRAIAN,TR,665,7,0,0,7,21,1,0,22,26,1,0,27,41,1,0,42,43,2,0,45
154745,307,"ŞCOALA GIMNAZIALĂ TRAIAN, STRADA PRINCIPALĂ NR. 188",TRAIAN,TR,829,5,1,0,6,14,5,0,19,19,5,0,24,33,7,0,40,34,8,0,42
154763,308,"GRᾸDINIṬA TRIVALEA-SAT (FOSTA)",TRIVALEA-MOŞTENI,TR,772,10,2,0,12,20,2,0,22,26,2,0,28,32,2,0,34,32,2,0,34
154772,309,DISPENSARULBRᾸTᾸŞANI,BRĂTĂŞANI,TR,516,4,2,0,6,12,6,0,18,14,11,0,25,17,13,0,30,20,13,0,33
154781,310,GRᾸDINIṬACUPROGRAMNORMALNR.2,DEPARAŢI,TR,868,2,2,0,4,7,2,0,9,11,5,0,16,13,6,0,19,13,6,0,19
154807,311,"ȘCOALA GIMNAZIALĂ ,,ION PREOTU""",TROIANUL,TR,1306,3,0,0,3,14,2,0,16,26,4,0,30,44,4,0,48,45,4,0,49
154807,312,"ȘCOALA GENARALĂ NR. 2",TROIANUL,TR,828,12,3,0,15,25,9,0,34,32,10,0,42,35,10,0,45,39,10,0,49
154825,313,"ȘCOALA GENERALĂ",VATRA,TR,168,0,0,0,0,0,0,0,0,2,0,0,2,5,0,0,5,5,0,0,5
154816,314,"CĂMINUL CULTURAL",DULCENI,TR,69,3,0,0,3,3,0,0,3,5,0,0,5,5,2,0,7,5,2,0,7
154843,315,"ȘCOALA CU CLASELE I-IV",ŢIGĂNEŞTI,TR,1432,4,1,0,5,10,3,0,13,15,6,0,21,28,6,6,40,46,6,6,58
154843,316,"GRĂDINIȚA CU PROGRAM NORMAL",ŢIGĂNEŞTI,TR,1326,8,1,0,9,22,2,0,24,32,5,7,44,51,7,7,65,77,8,7,92
154843,317,"ȘCOALA GIMNAZIALĂ ,,I.GH.DUCA""",ŢIGĂNEŞTI,TR,1453,15,1,0,16,29,2,0,31,38,6,0,44,58,9,0,67,60,9,0,69
154362,318,"LOCALUL CĂMINULUI CULTURAL UDA CLOCOCIOV",UDA-CLOCOCIOV,TR,634,17,3,0,20,30,5,0,35,34,6,0,40,52,8,0,60,53,9,0,62
154371,319,"LOCALUL ŞCOLII CU CLASELE I – VIII UDA PACIUREA",UDA-PACIUREA,TR,650,21,5,0,26,25,6,0,31,34,8,0,42,52,8,0,60,53,8,0,61
154861,320,"ȘCOALA GIMNAZIALĂ VEDEA",VEDEA,TR,505,10,0,0,10,11,1,0,12,15,1,0,16,22,2,0,24,33,4,0,37
154870,321,"ȘCOALA CU CLASELE I - IV ALBEȘTI",ALBEŞTI,TR,550,0,0,0,0,19,3,0,22,27,6,0,33,45,9,0,54,59,9,0,68
154889,322,"ȘCOALA CU CLASELE I -IV COȘOTENI",COŞOTENI,TR,456,8,0,0,8,17,1,0,18,23,12,0,35,50,14,0,64,63,15,0,78
154898,323,"ŞCOALA CU CLASELE I – VIII DULCEANCA",DULCEANCA,TR,437,4,0,0,4,4,1,0,5,13,1,0,14,39,8,0,47,85,12,0,97
154905,324,"ŞCOALA CU CLASELE I – IV MERI",MERI,TR,383,9,0,0,9,21,2,0,23,30,2,0,32,42,2,0,44,54,3,0,57
154923,325,"ȘCOALA GIMNAZIALĂ VIIȘOARA, NR. 97",VIIŞOARA,TR,726,2,0,0,2,4,4,0,8,6,9,0,15,12,10,0,22,12,10,0,22
154923,326,"GRĂDINIȚA CU PROGRAM NORMAL VIIȘOARA, NR. 519",VIIŞOARA,TR,660,4,1,0,5,4,2,0,6,7,2,0,9,12,2,0,14,12,2,0,14
153810,327,"CĂMIN CULTURAL SAT PURANI",PURANI,TR,603,5,2,0,7,10,5,0,15,18,8,0,26,29,11,0,40,31,11,0,42
153801,328,"CĂMIN CULTURAL SAT SILIŞTEA",SILIŞTEA,TR,698,9,10,0,19,22,15,0,37,28,19,0,47,57,21,41,119,58,22,41,121
153785,329,"GRĂDINIȚA CU PROGRAM NORMAL NR. 1 VITĂNEȘTI",VITANESTI,TR,955,6,5,0,11,19,7,0,26,32,8,0,40,46,15,0,61,52,15,0,67
154941,330,"CĂMINUL CULTURAL VIRTOAPELE DE SUS","VÎRTOAPELE DE SUS",TR,838,3,1,0,4,24,7,0,31,39,15,0,54,66,18,0,84,74,19,0,93
154969,331,"CĂMINUL CULTURAL VIRTOAPELE DE JOS","VÎRTOAPELE DE JOS",TR,742,3,1,0,4,8,4,0,12,15,4,0,19,25,8,0,33,35,8,0,43
154950,332,"CĂMINUL CULTURAL GĂRĂGĂU",GĂRĂGĂU,TR,591,8,2,0,10,12,3,0,15,18,3,0,21,30,4,0,34,32,4,0,36
154987,333,"CĂMINUL CULTURAL",ZÎMBREASCA,TR,787,10,0,0,10,16,2,0,18,23,2,0,25,27,4,53,84,27,4,53,84
154987,334,"ŞCOALA PRIMARĂ",ZÎMBREASCA,TR,403,4,0,0,4,6,0,0,6,17,0,0,17,24,0,25,49,27,0,25,52
167482,1,"COLEGIUL ENERGETIC","RÂMNICU VÂLCEA",VL,1763,14,1,0,15,28,2,0,30,38,3,0,41,62,4,0,66,68,4,0,72
167482,2,"COLEGIUL ENERGETIC","RÂMNICU VÂLCEA",VL,953,2,2,0,4,15,2,0,17,25,3,0,28,37,3,0,40,44,4,0,48
167482,3,"LICEUL SANITAR ""ANTIM IVIREANU""","RÂMNICU VÂLCEA",VL,1336,10,1,0,11,22,2,0,24,30,5,0,35,45,6,0,51,50,6,0,56
167482,4,"LICEUL SANITAR ""ANTIM IVIREANU""","RÂMNICU VÂLCEA",VL,1242,6,5,0,11,15,5,0,20,21,7,0,28,25,7,0,32,27,7,0,34
167482,5,"LICEUL SANITAR ""ANTIM IVIREANU""","RÂMNICU VÂLCEA",VL,1245,10,0,0,10,30,0,0,30,35,0,0,35,54,1,0,55,58,1,0,59
167482,6,"GRĂDINIŢA CU PROGRAM PRELUNGIT NORD II","RÂMNICU VÂLCEA",VL,1025,2,0,0,2,26,2,0,28,38,2,0,40,48,4,0,52,52,5,0,57
167482,7,"GRĂDINIŢA CU PROGRAM PRELUNGIT NORD II","RÂMNICU VÂLCEA",VL,1046,7,5,0,12,27,5,0,32,38,5,0,43,52,5,0,57,58,6,0,64
167482,8,"GRĂDINIŢA CU PROGRAM PRELUNGIT NORD II","RÂMNICU VÂLCEA",VL,949,6,0,0,6,20,0,0,20,33,1,0,34,41,1,0,42,43,1,0,44
167482,9,"LICEUL TEHNOLOGIC HENRI COANDĂ","RÂMNICU VÂLCEA",VL,1065,5,0,0,5,11,0,0,11,24,1,0,25,29,1,0,30,33,1,0,34
167482,10,"LICEUL TEHNOLOGIC HENRI COANDĂ","RÂMNICU VÂLCEA",VL,1050,9,0,0,9,20,0,0,20,34,1,0,35,44,1,0,45,44,2,0,46
167482,11,"LICEUL TEHNOLOGIC HENRI COANDĂ","RÂMNICU VÂLCEA",VL,1025,10,4,0,14,30,5,0,35,37,5,0,42,43,6,0,49,46,6,0,52
167482,12,"LICEUL TEHNOLOGIC HENRI COANDĂ","RÂMNICU VÂLCEA",VL,1261,16,2,0,18,38,2,0,40,48,2,0,50,61,2,0,63,62,2,0,64
167482,13,"LICEUL TEHNOLOGIC HENRI COANDĂ","RÂMNICU VÂLCEA",VL,840,5,0,0,5,7,0,0,7,15,0,0,15,19,0,0,19,21,0,0,21
167482,14,"COLEGIUL NAŢIONAL DE INFORMATICĂ ”MATEI BASARAB”","RÂMNICU VÂLCEA",VL,1041,4,1,0,5,26,3,0,29,32,3,0,35,45,4,0,49,47,4,0,51
167482,15,"COLEGIUL NAŢIONAL DE INFORMATICĂ ”MATEI BASARAB”","RÂMNICU VÂLCEA",VL,805,1,2,0,3,15,2,0,17,28,2,0,30,34,2,0,36,38,2,0,40
167482,16,"COLEGIUL NAŢIONAL DE INFORMATICĂ ”MATEI BASARAB”","RÂMNICU VÂLCEA",VL,1075,4,0,0,4,17,0,0,17,26,0,0,26,39,1,0,40,44,1,0,45
167482,17,"COLEGIUL NAŢIONAL DE INFORMATICĂ ”MATEI BASARAB”","RÂMNICU VÂLCEA",VL,1290,19,0,0,19,48,0,0,48,70,2,0,72,90,5,0,95,98,5,0,103
167482,18,"COLEGIUL DE SILVICULTURĂ ȘI PROTECȚIA MEDIULUI","RÂMNICU VÂLCEA",VL,991,11,2,0,13,39,3,0,42,49,4,0,53,67,5,0,72,71,6,0,77
167482,19,"COLEGIUL DE SILVICULTURĂ ȘI PROTECȚIA MEDIULUI","RÂMNICU VÂLCEA",VL,907,10,4,0,14,43,5,0,48,51,7,0,58,59,8,0,67,62,9,0,71
167482,20,"COLEGIUL DE SILVICULTURĂ ȘI PROTECȚIA MEDIULUI","RÂMNICU VÂLCEA",VL,910,4,1,0,5,12,4,0,16,20,4,0,24,28,4,0,32,38,4,0,42
167482,21,"ȘCOALA GIMNAZIALĂ “IOANGH. DUCA""","RÂMNICU VÂLCEA",VL,976,4,1,0,5,17,3,0,20,20,3,0,23,25,3,0,28,30,5,0,35
167482,22,"ȘCOALA GIMNAZIALĂ “IOANGH. DUCA""","RÂMNICU VÂLCEA",VL,1010,7,3,0,10,16,3,0,19,28,9,0,37,43,9,0,52,53,9,0,62
167482,23,"ȘCOALA GIMNAZIALĂ ""IOAN GH. DUCA""","RÂMNICU VÂLCEA",VL,1028,8,3,0,11,28,4,0,32,49,5,0,54,58,5,0,63,60,5,0,65
167482,24,"ȘCOALA GIMNAZIALĂ ""IOAN GH. DUCA""","RÂMNICU VÂLCEA",VL,846,12,0,0,12,34,0,0,34,55,0,0,55,67,1,0,68,72,1,0,73
167482,25,"ȘCOALA GIMNAZIALĂ ""IOAN GH. DUCA""","RÂMNICU VÂLCEA",VL,1063,14,0,0,14,44,4,0,48,68,5,0,73,76,5,0,81,78,5,0,83
167482,26,"ȘCOALA GIMNAZIALĂ ""IOAN GH. DUCA""","RÂMNICU VÂLCEA",VL,1134,9,0,0,9,30,1,0,31,40,4,0,44,52,5,0,57,58,5,0,63
167482,27,"ȘCOALA GIMNAZIALĂ ""IOAN GH. DUCA""","RÂMNICU VÂLCEA",VL,896,10,1,0,11,36,1,0,37,48,2,0,50,59,3,0,62,66,3,0,69
167482,28,"ȘCOALA GIMNAZIALĂ TAKE IONESCU","RÂMNICU VÂLCEA",VL,1000,20,3,0,23,53,10,0,63,66,17,0,83,80,21,0,101,86,21,0,107
167482,29,"COLEGIUL NAȚIONAL ALEXANDRU LAHOVARI","RÂMNICU VÂLCEA",VL,1079,11,2,0,13,39,6,0,45,55,9,0,64,75,12,0,87,84,14,0,98
167482,30,"COLEGIUL NAȚIONAL ALEXANDRU LAHOVARI","RÂMNICU VÂLCEA",VL,1420,11,1,0,12,55,4,0,59,81,6,0,87,111,9,0,120,119,11,0,130
167482,31,"LICEUL TEHNOLOGIC OLTCHIM","RÂMNICU VÂLCEA",VL,1373,7,0,0,7,33,5,0,38,51,6,0,57,61,6,0,67,61,9,0,70
167482,32,"LICEUL TEHNOLOGIC OLTCHIM","RÂMNICU VÂLCEA",VL,1428,12,1,0,13,26,6,0,32,39,6,0,45,47,8,0,55,49,8,0,57
167482,33,"ŞCOALA GIMNAZIALĂ NR.5","RÂMNICU VÂLCEA",VL,1016,14,5,0,19,43,5,0,48,55,6,0,61,65,7,0,72,73,7,0,80
167482,34,"DADP - SEDIU, BL A17","RÂMNICU VÂLCEA",VL,1728,17,0,0,17,40,0,0,40,63,0,0,63,74,0,0,74,75,2,0,77
167482,35,"S.C. PIEȚE PREST S.A. - PT 13","RÂMNICU VÂLCEA",VL,825,13,3,0,16,36,4,0,40,52,6,0,58,67,7,0,74,69,7,0,76
167482,36,"S.C. PIEȚE PREST S.A. - PT 13","RÂMNICU VÂLCEA",VL,718,9,0,0,9,38,0,0,38,50,3,0,53,53,3,0,56,60,3,0,63
167482,37,"S.C. PIEȚE PREST S.A. - PT 13","RÂMNICU VÂLCEA",VL,939,8,0,0,8,37,5,0,42,55,8,0,63,73,9,0,82,79,9,0,88
167482,38,"GRĂDINIȚA CU PROGRAM PRELUNGIT ”COZIA”","RÂMNICU VÂLCEA",VL,1177,17,1,0,18,47,4,0,51,57,7,0,64,82,7,0,89,86,8,0,94
167482,39,"GRĂDINIŢA CU PROGRAM PRELUNGIT ”COZIA”","RÂMNICU VÂLCEA",VL,1143,16,0,0,16,42,0,0,42,56,0,0,56,71,0,0,71,76,0,0,76
167482,40,"LICEUL TEHNOLOGIC ”CĂPITAN NICOLAE PLEŞOIANU”","RÂMNICU VÂLCEA",VL,1094,10,0,0,10,45,2,0,47,63,2,0,65,82,2,0,84,88,5,0,93
167482,41,"LICEUL TEHNOLOGIC ”CĂPITAN NICOLAE PLEŞOIANU”","RÂMNICU VÂLCEA",VL,1024,7,3,0,10,36,3,0,39,50,4,0,54,71,7,0,78,76,7,0,83
167482,42,"LICEUL TEHNOLOGIC ”CĂPITAN NICOLAE PLEŞOIANU”","RÂMNICU VÂLCEA",VL,1977,12,0,0,12,44,5,0,49,57,5,0,62,78,5,0,83,87,6,0,93
167482,43,"ŞCOALA GIMNAZIALĂ ”SPIRU HARET” (FOSTĂ NR. 3)","RÂMNICU VÂLCEA",VL,1563,10,0,0,10,20,1,0,21,34,4,0,38,37,5,0,42,39,7,0,46
167482,44,"ȘCOALA GIMNAZIALĂ GORANU","RÂMNICU VÂLCEA",VL,1417,8,0,0,8,29,0,0,29,36,0,0,36,48,0,0,48,49,0,0,49
167482,45,"ŞCOALA GIMNAZIALĂ GORANU","RÂMNICU VÂLCEA",VL,1051,2,0,0,2,16,0,0,16,26,1,0,27,34,1,0,35,41,1,0,42
167482,46,"ŞCOALA LESPEZI - ARHIVĂ","RÂMNICU VÂLCEA",VL,1138,2,0,0,2,5,3,0,8,13,3,0,16,20,5,0,25,23,5,0,28
167482,47,"ŞCOALA FEŢENI","RÂMNICU VÂLCEA",VL,188,0,0,0,0,0,0,0,0,0,0,0,0,0,0,0,0,0,0,0,0
167482,48,"CARTIER PETRIŞOR - PT8","RÂMNICU VÂLCEA",VL,1589,7,1,0,8,25,1,0,26,35,1,0,36,56,1,0,57,63,1,0,64
167482,49,"ŞCOALA GIMNAZIALĂ NR.4","RÂMNICU VÂLCEA",VL,1009,12,3,0,15,31,5,0,36,41,10,0,51,59,11,0,70,65,11,0,76
167482,50,"ŞCOALA GIMNAZIALĂ NR.4","RÂMNICU VÂLCEA",VL,1324,8,1,0,9,52,3,0,55,69,3,0,72,81,3,0,84,94,3,0,97
167482,51,"ŞCOALA GIMNAZIALĂ NR.4","RÂMNICU VÂLCEA",VL,976,15,0,0,15,39,0,0,39,61,1,0,62,78,1,0,79,85,1,0,86
167482,52,"COLEGIUL ECONOMIC","RÂMNICU VÂLCEA",VL,1331,7,1,0,8,27,2,7,36,32,2,7,41,47,4,7,58,56,5,7,68
167482,53,"COLEGIUL ECONOMIC","RÂMNICU VÂLCEA",VL,1124,11,2,0,13,32,2,0,34,48,2,0,50,62,2,0,64,68,2,0,70
167482,54,"COLEGIUL ECONOMIC","RÂMNICU VÂLCEA",VL,1163,8,0,0,8,21,1,0,22,37,1,0,38,40,2,0,42,45,2,0,47
167482,55,"ȘCOALA GIMNAZIALĂ NR. 10","RÂMNICU VÂLCEA",VL,1282,8,0,0,8,31,2,0,33,42,3,0,45,57,3,0,60,62,7,0,69
167482,56,"ȘCOALA GIMNAZIALĂ NR. 10","RÂMNICU VÂLCEA",VL,1494,14,0,0,14,45,3,0,48,56,3,0,59,73,3,0,76,81,3,0,84
167482,57,"ȘCOALA GIMNAZIALĂ NR. 10","RÂMNICU VÂLCEA",VL,1160,9,0,0,9,30,0,0,30,47,1,0,48,71,1,0,72,72,1,0,73
167482,58,"GRĂDINIȚA CU PROGRAM PRELUNGIT OSTROVENI I","RÂMNICU VÂLCEA",VL,1297,9,0,0,9,19,0,0,19,38,0,0,38,52,1,0,53,53,1,0,54
167482,59,"LICEUL TEHNOLOGIC FERDINAND I","RÂMNICU VÂLCEA",VL,862,9,5,0,14,28,7,0,35,37,8,0,45,42,8,0,50,42,10,0,52
167482,60,"LICEUL TEHNOLOGIC FERDINAND I","RÂMNICU VÂLCEA",VL,777,4,0,0,4,15,2,0,17,26,3,0,29,30,3,0,33,32,3,0,35
167482,61,"LICEUL TEHNOLOGIC FERDINAND I","RÂMNICU VÂLCEA",VL,888,2,0,0,2,10,0,0,10,22,0,0,22,26,0,0,26,29,0,0,29
167482,62,"LICEUL TEHNOLOGIC FERDINAND I","RÂMNICU VÂLCEA",VL,1155,11,0,0,11,28,0,0,28,42,0,0,42,54,0,1,55,54,0,1,55
167482,63,"LICEUL TEHNOLOGIC FERDINAND I","RÂMNICU VÂLCEA",VL,849,8,0,0,8,19,0,0,19,31,0,0,31,46,0,0,46,46,0,0,46
167482,64,"LICEUL TEHNOLOGIC FERDINAND I","RÂMNICU VÂLCEA",VL,881,9,6,0,15,18,6,0,24,29,6,0,35,45,7,0,52,45,7,0,52
167482,65,"GRĂDINIȚA CU PROGRAM PRELUNGIT OSTROVENI II","RÂMNICU VÂLCEA",VL,1395,7,0,0,7,22,0,0,22,31,0,0,31,44,1,0,45,49,1,0,50
167482,66,"GRĂDINIȚA CU PROGRAM PRELUNGIT OSTROVENI II","RÂMNICU VÂLCEA",VL,1033,8,0,0,8,21,2,0,23,32,3,0,35,38,6,0,44,43,6,0,49
167482,67,"GRĂDINIŢA CU PROGRAM PRELUNGIT OSTROVENI II","RÂMNICU VÂLCEA",VL,1074,5,1,0,6,17,2,0,19,27,4,0,31,30,7,0,37,37,7,0,44
167482,68,"GRĂDINIŢA CU PROGRAM PRELUNGIT OSTROVENI II","RÂMNICU VÂLCEA",VL,1271,7,0,0,7,21,3,0,24,32,3,0,35,42,3,0,45,42,3,0,45
167482,69,"ŞCOALA GIMNAZIALĂ ""ANTON PANN""","RÂMNICU VÂLCEA",VL,1285,13,0,0,13,28,6,0,34,34,8,0,42,48,13,0,61,60,13,0,73
167482,70,"ŞCOALA GIMNAZIALĂ ""ANTON PANN""","RÂMNICU VÂLCEA",VL,1231,4,2,0,6,18,4,0,22,34,5,0,39,40,5,0,45,46,5,0,51
167482,71,"ŞCOALA GIMNAZIALĂ ""ANTON PANN""","RÂMNICU VÂLCEA",VL,1019,5,1,0,6,14,3,0,17,19,4,0,23,29,5,0,34,32,5,0,37
167482,72,"ŞCOALA GIMNAZIALĂ ""ANTON PANN""","RÂMNICU VÂLCEA",VL,1738,5,0,0,5,10,0,0,10,40,0,0,40,68,0,0,68,76,0,0,76
167482,73,"ŞCOALA GIMNAZIALĂ ""ANTON PANN""","RÂMNICU VÂLCEA",VL,1013,5,0,0,5,16,2,0,18,22,2,0,24,30,3,0,33,32,3,0,35
167482,74,"ŞCOALA GIMNAZIALĂ ""ANTON PANN""","RÂMNICU VÂLCEA",VL,804,2,0,0,2,20,0,0,20,23,0,0,23,26,0,0,26,30,0,0,30
167482,75,"ŞCOALA GIMNAZIALĂ ""ANTON PANN""","RÂMNICU VÂLCEA",VL,1121,2,0,0,2,24,2,0,26,31,2,0,33,39,2,0,41,44,4,0,48
167482,76,"ŞCOALA GIMNAZIALĂ ""ANTON PANN""","RÂMNICU VÂLCEA",VL,1345,8,0,0,8,16,0,0,16,34,2,0,36,40,2,0,42,42,2,0,44
167482,77,"ŞCOALA GIMNAZIALĂ NR. 13","RÂMNICU VÂLCEA",VL,965,5,0,0,5,11,0,0,11,20,0,0,20,35,1,0,36,40,1,0,41
167482,78,"ŞCOALA GIMNAZIALĂ NR. 13","RÂMNICU VÂLCEA",VL,965,9,3,0,12,27,4,0,31,33,4,0,37,46,5,0,51,51,6,0,57
167482,79,"ŞCOALA GIMNAZIALĂ NR. 13","RÂMNICU VÂLCEA",VL,960,1,0,0,1,12,2,0,14,24,3,0,27,32,5,0,37,38,5,0,43
167482,80,"ŞCOALA GIMNAZIALĂ NR. 13","RÂMNICU VÂLCEA",VL,1038,6,0,0,6,19,0,0,19,28,1,0,29,34,1,0,35,36,1,0,37
167482,81,"ŞCOALA GIMNAZIALĂ NR. 13","RÂMNICU VÂLCEA",VL,1032,8,1,0,9,24,1,0,25,35,2,0,37,48,2,0,50,55,2,0,57
167482,82,"ŞCOALA GIMNAZIALĂ NR. 13","RÂMNICU VÂLCEA",VL,1352,9,0,0,9,22,0,0,22,42,0,0,42,53,0,0,53,59,0,0,59
167482,83,"ŞCOALA GIMNAZIALĂ NR. 13","RÂMNICU VÂLCEA",VL,1350,7,0,0,7,16,0,0,16,27,1,0,28,40,2,0,42,43,2,0,45
167482,84,"SECŢIA 1 DE POLIŢIE RURALĂ RÂMNICU VÂLCEA","RÂMNICU VÂLCEA",VL,891,7,1,0,8,17,2,0,19,26,2,0,28,33,2,0,35,39,2,0,41
167482,85,"ŞCOALA STOLNICENI","RÂMNICU VÂLCEA",VL,564,5,3,0,8,15,7,0,22,26,11,0,37,29,11,0,40,29,11,0,40
167482,86,"ŞCOALA GIMNAZIALĂ COLONIE","RÂMNICU VÂLCEA",VL,1071,6,0,0,6,20,5,0,25,58,5,0,63,66,6,0,72,74,7,0,81
167482,87,"ŞCOALA COPĂCELU","RÂMNICU VÂLCEA",VL,1976,15,4,0,19,30,5,0,35,40,5,0,45,47,6,0,53,50,6,0,56
167482,88,"GRĂDINIŢA CĂZĂNEŞTI","RÂMNICU VÂLCEA",VL,970,7,2,0,9,16,3,0,19,20,3,0,23,26,4,0,30,33,4,0,37
167990,89,"ŞCOALA TUDOR VLADIMIRESCU",DRĂGĂŞANI,VL,1364,9,2,0,11,34,7,0,41,46,8,0,54,54,8,0,62,59,10,0,69
167990,90,"ŞCOALA TUDOR VLADIMIRESCU",DRĂGĂŞANI,VL,1391,12,0,0,12,29,2,0,31,40,3,0,43,52,6,0,58,61,6,0,67
167990,91,"LICEUL TEHNOLOGIC BRĂTIANU",DRĂGĂŞANI,VL,1449,8,0,0,8,21,1,0,22,26,2,0,28,33,2,0,35,36,2,0,38
167990,92,"LICEUL TEHNOLOGIC BRĂTIANU",DRĂGĂŞANI,VL,1374,5,0,0,5,16,7,0,23,19,7,0,26,31,8,0,39,35,8,0,43
167990,93,"GRĂDINIȚA CU PROGRAM PRELUNGIT NR. 2",DRĂGĂŞANI,VL,1330,11,0,0,11,30,1,0,31,44,1,0,45,56,1,0,57,63,1,0,64
167990,94,"GRĂDINIŢA I.C. BRĂTIANU",DRĂGĂŞANI,VL,903,4,6,0,10,6,6,0,12,10,7,0,17,16,8,0,24,16,8,0,24
167990,95,"ȘCOALA NICOLAE BĂLCESCU",DRĂGĂŞANI,VL,1179,9,1,0,10,18,3,0,21,28,3,0,31,41,3,0,44,46,3,0,49
167990,96,"ŞCOALA NICOLAE BĂLCESCU",DRĂGĂŞANI,VL,1275,6,0,0,6,20,0,0,20,26,0,0,26,35,0,0,35,41,0,0,41
167990,97,"COLEGIUL NAȚIONAL GIB MIHĂESCU",DRĂGĂŞANI,VL,1514,6,1,0,7,17,2,0,19,33,7,0,40,46,7,0,53,58,9,0,67
167990,98,"LICEUL TEHNOLOGIC BRĂTIANU - ȘCOALA PROFESIONALĂ",DRĂGĂŞANI,VL,1202,1,0,0,1,14,0,0,14,20,0,0,20,33,1,0,34,36,1,0,37
167990,99,"ŞCOALA GIMNAZIALĂ NR. 8 (BÂRSANU)",DRĂGĂŞANI,VL,940,5,2,0,7,9,2,0,11,14,2,0,16,20,2,0,22,21,2,0,23
167990,100,"GRĂDINIŢACU PROGRAM NORMAL NR. 8",DRĂGĂŞANI,VL,531,3,0,0,3,11,0,0,11,20,0,0,20,24,0,0,24,29,0,0,29
167990,101,"ŞCOALA GIMNAZIALĂ NR. 5",DRĂGĂŞANI,VL,770,4,0,0,4,13,0,0,13,16,1,0,17,24,1,0,25,24,1,0,25
167990,102,"GRĂDINIȚA CAPUL DEALULUI",DRĂGĂŞANI,VL,791,6,5,0,11,15,5,0,20,23,7,0,30,32,10,0,42,34,10,0,44
167990,103,"ȘCOALA ZLĂTĂREI",DRĂGĂŞANI,VL,1221,5,1,0,6,17,1,0,18,27,2,0,29,41,3,0,44,42,3,0,45
168381,104,"PRIMĂRIA ORAŞULUI BĂBENI",BĂBENI,VL,1797,6,2,0,8,24,6,0,30,36,9,0,45,48,9,0,57,56,9,0,65
168381,105,"LICEUL,,GEORGE ŢĂRNEA,, BĂBENI",BĂBENI,VL,1249,7,0,0,7,11,0,0,11,15,0,0,15,23,0,0,23,28,2,0,30
168381,106,"S.C. ALFA FARM S.R.L.",BĂBENI,VL,636,5,2,0,7,15,2,0,17,20,2,0,22,24,2,0,26,31,2,0,33
168381,107,"ŞCOALA GENERALĂ CU CLASELE I-IV VALEA MARE",BĂBENI,VL,858,3,0,0,3,7,4,0,11,8,5,0,13,17,5,0,22,18,5,0,23
168381,108,"ŞCOALA GIMNAZIALĂ, SAT VALEA MARE, ORAȘ BĂBENI",BĂBENI,VL,1312,9,2,0,11,12,4,0,16,20,10,0,30,28,11,0,39,39,13,0,52
168381,109,"ŞCOALA GENERALĂ TĂTĂRANI",BĂBENI,VL,504,6,2,0,8,9,2,0,11,12,2,0,14,23,5,0,28,24,5,0,29
168381,110,"ȘCOALA GENERALĂ ROMÂNI",BĂBENI,VL,1078,2,1,0,3,9,1,0,10,15,2,0,17,22,2,0,24,31,5,0,36
168381,111,"ȘCOALA PĂDUREȚU",BĂBENI,VL,181,1,0,0,1,1,0,0,1,1,0,0,1,1,0,0,1,1,0,0,1
167650,112,"SALA DE CĂSĂTORII A PRIMĂRIEI",CURĂTURILE,VL,1082,14,17,0,31,24,74,0,98,26,118,0,144,31,136,0,167,40,150,0,190
167678,113,"LICEUL TEHNOLOGIC BĂILE GOVORA",PRAJILA,VL,1025,9,2,0,11,30,7,0,37,37,7,0,44,59,9,0,68,63,10,0,73
167669,114,"ȘCOALA GENERALĂ CU CLASELE I-IV GĂTEJEȘTI",GĂTEJEŞTI,VL,321,0,1,0,1,0,1,0,1,0,1,0,1,2,1,0,3,2,1,0,3
167730,115,"LICEUL TEHNOLOGIC JUSTINIAN MARINA",LIVADIA,VL,1552,7,84,0,91,20,252,0,272,43,348,0,391,70,420,0,490,78,430,0,508
167758,116,"ȘCOALA GIMNAZIALĂ DUMITRU BĂDESCU",OLĂNEŞTI,VL,1337,4,0,0,4,15,8,0,23,24,11,0,35,45,13,0,58,49,13,0,62
167703,117,"ȘCOALA GIMNAZIALĂ IONESCU CHEIANU",CHEIA,VL,899,7,1,0,8,25,1,0,26,35,4,0,39,39,4,0,43,43,6,0,49
168461,118,"LICEUL TEHNOLOGIC PETRACHE POENARU",BĂLCEŞTI,VL,994,8,0,0,8,22,2,0,24,32,2,0,34,37,2,0,39,38,3,0,41
168461,119,"LICEUL TEHNOLOGIC PETRACHE POENARU",BĂLCEŞTI,VL,869,7,1,0,8,12,5,0,17,17,8,0,25,23,11,0,34,24,11,0,35
168470,120,"ŞCOALA PRIMARĂ BENEŞTI",BENEŞTI,VL,367,367,2,0,369,3,2,0,5,4,2,0,6,6,2,0,8,6,3,0,9
168504,121,"ŞCOALA PRIMARĂGORUNEŞTI",GORUNEŞTI,VL,647,5,0,0,5,14,4,0,18,18,4,0,22,22,5,0,27,22,5,0,27
168513,122,"SCOALA PRIMARĂ CÂRLOGANI",IRIMEŞTI,VL,463,2,5,0,7,2,6,0,8,4,7,0,11,5,7,0,12,5,9,0,14
168522,123,"ŞCOALA PRIMARĂ OTETELIŞU",OTETELIŞU,VL,847,5,0,0,5,6,1,0,7,13,1,0,14,16,1,0,17,19,2,0,21
168639,124,"GRĂDINIȚA NR.1 (PECO)","DEALU ALUNIŞ",VL,954,1,0,0,1,8,0,0,8,15,0,0,15,17,2,0,19,18,2,0,20
168639,125,"GRĂDINIȚA NR. 2 BLOCURI","DEALU ALUNIŞ",VL,1150,5,0,0,5,14,0,0,14,23,0,0,23,29,0,0,29,31,0,0,31
168648,126,"ȘCOALA GENERALĂ CU CLASELE I- VIII BERBEȘTI",ROŞIOARA,VL,1484,5,0,0,5,9,2,0,11,12,2,0,14,21,2,0,23,22,4,0,26
168657,127,"GRUP ȘCOLAR PREDA BUZESCU","TÂRGU GÂNGULEŞTI",VL,929,2,2,0,4,6,4,0,10,13,4,0,17,14,4,0,18,19,4,0,23
167856,128,"ŞCOALA CU CLASELE I-IV PĂSCOAIA",PĂSCOAIA,VL,168,0,0,0,0,1,1,0,2,2,4,0,6,6,8,0,14,6,9,0,15
167874,129,"ŞCOALA CU CLASELE I-VIII VALEA LUI STAN","VALEA LUI STAN",VL,439,0,1,0,1,0,1,0,1,20,2,0,22,41,3,0,44,57,4,0,61
167801,130,"ȘCOALA CU CLASELE I-IV NR. 2 BREZOI",BREZOI,VL,1094,7,3,0,10,25,6,0,31,39,6,0,45,42,7,0,49,43,7,0,50
167801,131,"GRĂDINIȚA CU PROGRAM NORMAL NR.1- PARTER",BREZOI,VL,945,2,0,0,2,18,0,0,18,24,2,0,26,33,2,0,35,35,2,0,37
167801,132,"GRĂDINIȚA CU PROGRAM NORMAL NR.1- PARTER",BREZOI,VL,1150,5,0,0,5,14,2,0,16,24,2,0,26,27,2,0,29,28,2,0,30
167801,133,"ȘCOALA CU CLASELE I-IV NR 1 BREZOI",BREZOI,VL,1422,3,0,0,3,19,2,0,21,30,2,0,32,38,3,0,41,40,3,0,43
167810,135,"CĂMINUL CULTURAL CĂLINEŞTI",CĂLINEŞTI,VL,545,2,0,0,2,8,6,0,14,10,8,0,18,14,8,0,22,17,8,0,25
167918,136,"ŞCOALA GENERALĂ CU CLASELE I-IV SEACA",CĂLIMĂNEŞTI,VL,472,7,4,0,11,12,4,0,16,16,4,0,20,22,4,0,26,22,4,0,26
167918,137,"LICEUL TEHNOLOGIC DE TURISM CĂLIMĂNEŞTI (SALĂ CANTINĂ RESTAURANT)",CĂLIMĂNEŞTI,VL,899,11,9,0,20,25,40,0,65,31,49,0,80,35,57,0,92,40,58,0,98
167918,138,"ŞCOALA GIMNAZIALĂ ,,ŞERBAN VODĂ CANTACUZINO,, CĂLIMĂNEŞTI",CĂLIMĂNEŞTI,VL,1014,3,4,0,7,25,18,0,43,39,19,0,58,48,25,0,73,48,26,0,74
167918,139,"ŞCOALA GENERALĂ CU CLASELE I-IV CĂLIMĂNEŞTI (DEAL)",CĂLIMĂNEŞTI,VL,1083,10,1,0,11,20,3,0,23,34,4,0,38,49,4,0,53,53,6,0,59
167918,140,"CENTRUL DE INFORMARE TURISTICĂ CĂLIMĂNEŞTI",CĂLIMĂNEŞTI,VL,511,10,7,0,17,16,46,0,62,25,77,0,102,31,110,0,141,32,116,0,148
167918,141,"HOTEL TRAIAN (COFETĂRIA)",CĂLIMĂNEŞTI,VL,567,1,34,0,35,15,134,0,149,29,246,0,275,44,323,0,367,47,400,0,447
167918,142,"ŞCOALA GIMNAZIALĂ JIBLEA VECHE",CĂLIMĂNEŞTI,VL,989,1,3,0,4,6,3,0,9,14,4,0,18,16,4,0,20,16,4,0,20
167918,143,"ŞCOALA GIMNAZIALĂ JIBLEA VECHE",CĂLIMĂNEŞTI,VL,975,3,2,0,5,8,3,0,11,16,3,0,19,29,6,0,35,33,7,0,40
167918,144,"ŞCOALA PRIMARĂ JIBLEA NOUĂ",CĂLIMĂNEŞTI,VL,878,2,0,0,2,6,0,0,6,11,2,0,13,18,3,0,21,22,3,0,25
168112,145,"CĂMINUL CULTURAL URȘANI",URŞANI,VL,392,2,1,0,3,9,1,0,10,11,1,0,12,17,1,0,18,21,1,0,22
168050,146,"LICEUL CONSTANTIN BRÂNCOVEANU",HOREZU,VL,1213,6,2,0,8,34,8,0,42,43,9,0,52,61,12,0,73,67,13,0,80
168050,147,"CLUBUL COPIILOR HOREZU",HOREZU,VL,1075,11,0,0,11,20,2,0,22,33,2,0,35,42,2,0,44,45,2,0,47
168050,148,"CASA DE CULTURĂ CONSTANTIN BRÂNCOVEANU",HOREZU,VL,1098,9,4,0,13,34,8,0,42,42,10,0,52,47,11,0,58,49,13,0,62
168078,149,"CĂMINUL CULTURAL RÂMEȘTI",RÎMEŞTI,VL,383,1,0,0,1,5,0,0,5,5,0,0,5,7,2,0,9,10,2,0,12
168087,150,"ȘCOALA GENERALĂ CU CLASELE I - VIII ROMANII DE JOS","ROMANII DE JOS",VL,628,1,3,0,4,22,6,0,28,32,10,0,42,39,11,0,50,39,11,0,50
168096,151,"MAGAZINUL SĂTESC ROMANII DE SUS","ROMANII DE SUS",VL,837,5,0,0,5,9,0,0,9,14,6,0,20,18,6,0,24,25,6,0,31
168103,152,"CĂMINUL CULTURAL TĂNĂSEȘTI",TĂNĂSEŞTI,VL,130,1,0,0,1,3,0,0,3,5,0,0,5,5,0,0,5,5,0,0,5
168176,153,"ȘCOALA GIMNAZIALĂ COSTEA MARINOIU OCNELE MARI","GURA SUHAŞULUI",VL,1382,11,2,0,13,18,3,0,21,25,3,0,28,31,3,0,34,34,3,0,37
168194,154,"FOSTA ȘCOALA CU CLASELE I-VIII OCNIŢA",OCNIŢA,VL,1442,5,0,0,5,11,4,0,15,12,5,0,17,15,6,0,21,18,6,0,24
168265,155,"ŞCOALA GIMNAZIALĂ, COMUNA ALUNU, SAT IGOIU",IGOIU,VL,1485,2,1,0,3,7,2,0,9,11,2,0,13,16,5,0,21,16,5,0,21
168247,156,"FOSTUL LOCAL AL GRĂDINIŢEI CU PROGRAM NORMAL BODEŞTI, SAT BODEŞTI",BODEŞTI,VL,305,0,1,0,1,0,1,0,1,0,1,0,1,0,1,0,1,0,1,0,1
168256,157,"GRĂDINIŢA CU PROGRAM NORMAL COLTEŞTI, SAT COLTEŞTI",COLTEŞTI,VL,1323,2,0,0,2,6,0,0,6,12,0,0,12,14,0,0,14,14,0,0,14
168292,158,"GRĂDINIȚA CU PROGRAM NORMAL ROȘIA",ROŞIA,VL,481,0,7,0,7,3,7,0,10,4,7,0,11,7,7,0,14,10,7,0,17
168318,159,"ŞCOALA GIMNAZIALĂ AMĂRĂŞTI",AMĂRĂŞTI,VL,867,0,4,0,4,1,7,0,8,3,7,0,10,6,7,1,14,6,7,1,14
168336,160,"FOSTA ŞCOALĂ NEMOIU",NEMOIU,VL,657,0,0,0,0,3,0,0,3,5,0,0,5,5,5,0,10,6,5,0,11
168568,161,"FOSTA ŞCOALĂ CU CLASELE I-IV BODEŞTI",BODEŞTI,VL,777,7,1,0,8,8,6,0,14,12,7,0,19,15,7,0,22,16,8,0,24
168577,162,"CĂMINUL CULTURAL BĂRBĂTEŞTI",BĂRBĂTEŞTI,VL,1272,8,0,0,8,23,20,0,43,32,21,0,53,39,25,0,64,48,26,0,74
168586,163,"FOSTA ŞCOALĂ CU CLASELE I-IV BÂRZEŞTI",BÎRZEŞTI,VL,786,3,1,0,4,11,1,0,12,13,1,0,14,16,38,0,54,20,40,0,60
168693,164,"CĂMINUL CULTURAL STOENEŞTI",BERISLĂVEŞTI,VL,776,2,0,0,2,9,1,0,10,10,1,0,11,12,3,0,15,19,6,0,25
168719,165,"CĂMINUL CULTURAL DÎNGEŞTI",DÎNGEŞTI,VL,276,2,2,0,4,3,2,0,5,4,2,0,6,8,2,0,10,9,3,0,12
168728,166,"CĂMINUL CULTURAL RĂDĂCINEŞTI",RĂDĂCINEŞTI,VL,552,3,2,0,5,10,6,0,16,13,6,0,19,17,7,0,24,22,7,0,29
168737,167,"CĂMINUL CULTURAL ROBAIA",ROBAIA,VL,197,2,1,0,3,3,1,0,4,3,1,0,4,3,5,0,8,3,5,0,8
168746,168,"ŞCOALA CU CLASELE I-IV SCĂUENI",SCĂUENI,VL,405,0,0,0,0,2,1,0,3,2,1,0,3,4,1,0,5,5,1,0,6
168764,169,"ŞCOALA CU CLASELE I-VIII BOIŞOARA",BOIŞOARA,VL,1023,5,1,0,6,11,2,0,13,13,2,0,15,13,2,0,15,13,2,0,15
168808,170,"CĂMINUL CULTURAL BUDEŞTI",BUDEŞTI,VL,1276,14,4,0,18,16,5,0,21,21,6,0,27,25,7,0,32,27,7,0,34
168844,171,"ŞCOALA RACOVIŢA",LINIA,VL,546,1,3,0,4,2,3,0,5,3,3,0,6,8,3,0,11,9,3,0,12
168817,172,"ŞCOALA BARZA",BARZA,VL,861,6,4,0,10,11,5,0,16,14,5,0,19,21,5,0,26,22,5,0,27
168835,173,"ŞCOALA BÎRSEŞTI",BÎRSEŞTI,VL,751,3,2,0,5,7,2,0,9,8,2,0,10,13,5,0,18,14,5,0,19
168871,174,"CENTRU SOCIAL RUDA",RUDA,VL,450,5,2,0,7,5,2,0,7,7,2,0,9,9,3,0,12,9,4,0,13
168826,175,"ŞCOALA BERCIOIU",BERCIOIU,VL,289,0,2,0,2,2,2,0,4,5,2,0,7,8,2,0,10,10,2,0,12
168862,176,"GRĂDINIŢA RACOVIŢA",RACOVIŢA,VL,851,5,1,0,6,5,1,0,6,6,1,0,7,11,1,0,12,12,1,0,13
168899,177,"ŞCOALA CU CLASELE I-VIII OLTENI",OLTENI,VL,1487,7,3,0,10,19,3,0,22,27,11,0,38,41,18,0,59,43,18,0,61
168933,178,"ŞCOALA CU CLASELE I-IV LUNCA",LUNCA,VL,581,8,0,0,8,8,1,0,9,8,3,0,11,9,7,0,16,9,7,0,16
168906,179,"ŞCOALA CU CLASELEI-IV BOGDĂNEŞTI",BOGDĂNEŞTI,VL,682,9,3,0,12,12,4,0,16,16,4,0,20,20,6,0,26,21,7,0,28
168924,180,"ŞCOALA CU CLASELE I-VIII GURA VĂII","GURA VĂII",VL,1154,5,2,0,7,6,2,0,8,11,5,0,16,17,7,0,24,17,7,0,24
168979,181,"ŞCOALA CU CLASELE I-VIII BUNEŞTI",BUNEŞTI,VL,942,8,0,0,8,14,0,0,14,19,0,0,19,27,0,0,27,30,0,0,30
169020,182,"ŞCOALA CU CLASELE I-VIIIBUNEŞTI",TITIRECI,VL,867,3,0,0,3,9,1,0,10,12,1,0,13,16,1,0,17,16,1,0,17
169011,183,"ŞCOALA TEIUŞU, COMUNA BUNEŞTI",TEIUŞU,VL,442,1,0,0,1,5,5,0,10,9,5,0,14,11,7,0,18,11,7,0,18
169048,184,"ŞCOALA CU CLASELE I-VIII ARMĂŞEŞTI",ARMĂŞEŞTI,VL,509,1,0,0,1,1,2,0,3,4,2,0,6,7,2,0,9,8,2,0,10
169057,185,"ŞCOALA CU CLASELE I-VIII CERNIŞOARA",CERNIŞOARA,VL,701,4,1,0,5,10,1,0,11,11,1,0,12,13,1,0,14,18,1,0,19
169066,186,"ŞCOALACU CLASELE I-IV GROŞI",GROŞI,VL,764,7,0,0,7,9,0,0,9,11,0,0,11,11,1,0,12,13,1,0,14
169075,187,"ŞCOALACU CLASELE I-VIII MĂDULARI",MĂDULARI,VL,554,1,0,0,1,1,1,0,2,6,1,0,7,10,1,0,11,10,1,0,11
169093,188,"ŞCOALA CU CLASELE I-IV OBÎRŞIA",OBÎRŞIA,VL,444,3,4,0,7,6,5,0,11,9,5,0,14,9,5,0,14,9,5,0,14
169128,189,"ŞCOALA PRIMARĂ CÎINENII MICI","CÎINENII MICI",VL,492,4,1,0,5,11,1,0,12,11,1,0,12,16,2,0,18,16,2,0,18
169137,190,"ŞCOALA GIMNAZIALĂ CÎINENII MARI","CÎINENII MARI",VL,609,3,1,0,4,5,3,0,8,8,3,0,11,18,7,0,25,19,7,0,26
169146,191,"GRĂDINIŢA CU PROGRAM NORMAL GREBLEŞTI",GREBLEŞTI,VL,577,5,0,0,5,14,1,0,15,20,2,0,22,25,4,0,29,26,4,0,30
169173,192,"CĂMINUL CULTURAL ROBEȘTI",ROBEŞTI,VL,172,4,2,0,6,4,3,1,8,4,3,1,8,5,4,1,10,5,4,1,10
169191,193,"GRĂDINIŢA ULMETU",ULMETU,VL,1142,2,0,0,2,8,1,0,9,8,1,0,9,14,1,0,15,19,2,0,21
169244,194,"ŞCOALA CU CLASELE I-IV VEŢELU",VEŢELU,VL,436,5,0,0,5,6,0,0,6,7,4,0,11,7,4,0,11,9,4,0,13
169208,195,"ȘCOALACU CLASELE I-IV BĂLTENI",BĂLTENI,VL,308,1,2,0,3,2,4,0,6,3,4,0,7,4,6,0,10,4,6,0,10
169235,196,"ȘCOALA CU CLASELE I-VIII - HOTĂRASA",HOTĂRASA,VL,312,2,7,0,9,3,8,0,11,3,8,0,11,5,8,0,13,5,9,0,14
169262,197,"ŞCOALA CU CLASELE I-VIII COSTEŞTI",COSTEŞTI,VL,1554,14,0,0,14,27,1,0,28,30,1,0,31,35,3,0,38,36,4,0,40
169271,198,"ŞCOALA CU CLASELEI-IV BISTRIŢA",BISTRIŢA,VL,720,7,2,0,9,42,15,0,57,55,20,0,75,68,30,0,98,71,30,0,101
169280,199,"ŞCOALA CU CLASELE I-IV PIETRENI",PIETRENI,VL,443,4,1,0,5,6,1,0,7,7,2,0,9,12,4,0,16,13,4,0,17
169315,200,"ȘCOALA GIMNAZIALĂ CREȚENI",CREŢENI,VL,878,4,2,0,6,9,2,0,11,13,3,0,16,16,4,0,20,20,4,0,24
169324,201,"GRĂDINIȚA CU PROGRAM NORMAL IZVORU",IZVORU,VL,474,2,4,0,6,8,5,0,13,10,6,0,16,14,8,0,22,17,8,0,25
169342,202,"GRĂDINIȚA CU PROGRAM NORMAL STREMINOASA",STREMINOASA,VL,494,4,3,0,7,12,3,0,15,16,3,0,19,21,3,0,24,21,3,0,24
169360,203,ŞCOALADĂEŞTI,DĂEŞTI,VL,848,3,1,0,4,7,3,0,10,7,5,0,12,10,5,0,15,11,6,0,17
169397,204,"CĂMINUL CULTURAL SÎNBOTIN",SÎNBOTIN,VL,706,8,1,0,9,11,1,0,12,22,1,0,23,29,2,1,32,29,2,1,32
169388,205,"ŞCOALA FEDELEŞOIU",FEDELEŞOIU,VL,853,8,0,0,8,9,2,0,11,13,2,0,15,17,4,0,21,19,4,0,23
169379,206,ŞCOALABĂBUEŞTI,BĂBUEŞTI,VL,73,0,0,0,0,0,0,0,0,0,0,0,0,0,1,0,1,0,1,0,1
169529,207,"ŞCOALA GIMNAZIALĂ UDREŞTI",UDREŞTI,VL,808,4,5,0,9,5,7,0,12,8,10,0,18,12,15,0,27,14,18,0,32
169459,208,"ŞCOALA PRIMARĂ DEALU SCHEIULUI","DEALU SCHEIULUI",VL,237,3,1,0,4,5,1,0,6,9,1,0,10,12,4,0,16,12,4,0,16
169501,209,"ŞCOALA GIMNAZIALĂ LĂUNELE DE JOS","LĂUNELE DE JOS",VL,357,2,0,0,2,4,7,0,11,6,7,0,13,7,9,0,16,7,12,0,19
169431,210,"ȘCOALA PRIMARĂ CERETU",CERETU,VL,312,0,0,0,0,0,0,0,0,1,0,0,1,3,3,0,6,11,5,0,16
169609,211,"ŞCOALA CU CLASELE I-VIII BĂBENI-OLTEŢU",BĂBENI-OLTEŢU,VL,889,4,1,0,5,6,1,0,7,11,1,0,12,14,1,0,15,15,1,0,16
169618,212,"ŞCOALA CU CLASELE I-IV BUDEŞTI",BUDEŞTI,VL,660,2,0,0,2,17,1,0,18,23,4,0,27,27,5,0,32,27,5,0,32
169556,213,"ŞCOALA CU CLASELE I-VIII DRĂGOEŞTI",DRĂGOEŞTI,VL,642,0,0,0,0,0,3,0,3,4,10,0,14,7,10,0,17,7,10,0,17
169556,214,"ȘCOALA CU CLASELE I- IV GEAMĂNA- BUCIUMENI",DRĂGOEŞTI,VL,600,7,0,0,7,10,1,0,11,12,2,0,14,19,2,0,21,21,3,0,24
169556,215,"ŞCOALA CU CLASELE I-IV BONCANI",DRĂGOEŞTI,VL,441,2,0,0,2,7,0,0,7,13,0,0,13,17,0,0,17,17,0,0,17
169672,216,"ŞCOALA GIMNAZIALĂ FĂUREŞTI",MĂRCUŞU,VL,657,3,2,0,5,3,2,0,5,4,2,0,6,7,3,0,10,7,4,0,11
169592,217,"GRĂDINIŢA MILEŞTI",MILEŞTI,VL,516,5,2,0,7,5,3,0,8,11,3,0,14,17,3,0,20,18,3,0,21
169690,218,"PRIMĂRIA FÎRTĂŢEŞTI",FÎRTĂŢEŞTI,VL,330,2,4,0,6,2,5,0,7,2,6,0,8,3,6,0,9,4,6,0,10
169716,219,"FOSTA ŞCOALĂ DEJOI",BECŞANI,VL,376,5,0,0,5,6,0,0,6,7,0,0,7,8,0,0,8,9,0,0,9
169761,221,"ŞCOALA CU CLASELE I-VIII DOZEŞTI",DOZEŞTI,VL,1406,0,0,0,0,2,6,0,8,3,7,0,10,5,11,0,16,5,11,0,16
169770,222,"ŞCOALACU CLASELE I-VIII RUSĂNEŞTI",GIULEŞTI,VL,990,1,3,0,4,5,4,0,9,15,4,0,19,20,4,0,24,23,5,0,28
169903,223,"ŞCOALACU CLASELE I-VIII FRÎNCEŞTI",FRÎNCEŞTI,VL,615,3,1,0,4,12,2,0,14,13,2,0,15,20,2,0,22,20,2,0,22
169958,224,"ȘCOALA GENERALĂ CU CLASELE I-VIIIGENUNENI",MĂNĂILEŞTI,VL,647,3,1,0,4,5,1,0,6,10,1,0,11,14,4,0,18,15,4,0,19
169949,225,"GRĂDINIŢA NEGRENI",GENUNENI,VL,418,3,4,0,7,5,4,0,9,9,4,0,13,13,4,0,17,17,4,0,21
169921,226,"ŞCOALA GENERALĂ CU CLASELE I-IV COŞANI",COŞANI,VL,1155,3,1,0,4,15,5,0,20,21,5,0,26,24,5,0,29,27,5,0,32
169930,227,"GRĂDINIŢA DEZROBIŢI",DEZROBIŢI,VL,569,40,8,0,48,47,8,0,55,56,8,0,64,60,10,0,70,65,11,0,76
169967,228,"ŞCOALA GENERALĂ CU CLASELE I-IV SURPATE",MOŞTENI,VL,658,0,0,0,0,0,0,0,0,0,0,0,0,11,2,0,13,22,3,0,25
169985,229,"GRĂDINIŢA VIIŞOARA",VIIŞOARA,VL,231,0,0,0,0,1,0,0,1,2,5,0,7,7,6,0,13,7,6,0,13
170006,230,"CĂMINUL CULTURAL GALICEA",GALICEA,VL,951,6,5,0,11,18,8,0,26,21,9,0,30,25,10,0,35,27,10,0,37
170079,231,"ŞCOALA TEIU",TEIU,VL,351,7,3,0,10,8,4,0,12,12,4,0,16,18,4,0,22,22,4,0,26
170088,232,"ŞCOALA VALEA RÎULUI","VALEA RÎULUI",VL,359,3,1,0,4,10,4,0,14,11,4,0,15,14,4,0,18,16,4,0,20
170033,233,"ŞCOALA COCORU",COCORU,VL,545,4,1,0,5,11,2,0,13,15,2,0,17,18,2,0,20,18,2,0,20
170024,234,"ŞCOALA BRATIA DIN VALE","BRATIA DIN VALE",VL,379,2,1,0,3,4,1,0,5,8,3,0,11,12,3,0,15,13,3,0,16
170015,235,"ŞCOALA BRATIA DIN DEAL","BRATIA DIN DEAL",VL,278,2,2,0,4,5,3,0,8,8,3,0,11,9,6,0,15,9,6,0,15
170042,236,"CĂMINUL CULTURAL CREMENARI",CREMENARI,VL,336,8,0,0,8,12,5,0,17,13,5,0,18,15,6,0,21,16,6,0,22
170159,237,"ŞCOALA ŞTIRBEŞTI",ŞTIRBEŞTI,VL,488,11,2,0,13,15,2,0,17,17,5,0,22,18,6,0,24,20,6,0,26
170104,238,"CĂMINUL CULTURAL GHIOROIU",GHIOROIU,VL,489,1,1,0,2,5,3,0,8,11,7,0,18,20,7,0,27,21,7,0,28
170140,239,ŞCOALAPOIENARI,POIENARI,VL,228,5,2,0,7,9,4,0,13,11,4,0,15,11,4,0,15,13,4,0,17
170177,240,"ŞCOALA GIMNAZIALĂ ,,BARTOLOMEU VALERIU ANANIA""GLĂVILE",GLĂVILE,VL,865,9,0,0,9,13,0,0,13,17,0,0,17,22,0,0,22,22,0,0,22
170186,241,"ŞCOALA PRIMARĂ ANINOASA",ANINOASA,VL,156,1,6,0,7,3,7,0,10,4,7,0,11,6,7,0,13,8,7,0,15
170202,242,"ŞCOALA PRIMARĂ OLTEANCA",OLTEANCA,VL,588,1,4,0,5,1,5,0,6,4,5,0,9,6,5,0,11,6,7,0,13
170239,243,"ŞCOALA CU CLASELE I-VIII POPEŞTI",POPEŞTI,VL,756,7,3,0,10,9,3,0,12,17,3,0,20,17,3,0,20,18,3,0,21
170257,244,"ŞCOALA BLIDARI",BLIDARI,VL,858,1,0,0,1,9,0,0,9,11,0,0,11,14,0,0,14,14,1,0,15
170328,245,"ŞCOALA POENIŢA",TULEI-CÎMPENI,VL,341,1,0,0,1,3,1,0,4,5,1,0,6,5,2,0,7,5,2,0,7
170337,246,"ŞCOALA VĂTĂŞEŞTI",VĂTĂŞEŞTI,VL,205,1,1,0,2,2,1,0,3,7,2,0,9,8,3,0,11,8,3,0,11
170355,247,"SALA DE SPORT DE LA LICEUL TEORETIC GRĂDIŞTEA",GRĂDIŞTEA,VL,354,1,2,0,3,1,4,0,5,2,5,0,7,2,5,0,7,2,5,0,7
170435,248,"ŞCOALA CU CLASELE I-IV VALEA GRĂDIŞTEA","VALEA GRĂDIŞTEI",VL,117,2,5,0,7,5,6,0,11,5,6,0,11,7,7,0,14,7,7,0,14
170373,249,"ȘCOALA CU CLASELE I-VIII DOBRICEA",DOBRICEA,VL,650,3,2,0,5,8,2,0,10,8,2,0,10,11,3,0,14,11,3,0,14
170426,250,"GRĂDINIŢA CU PROGRAM NORMAL ŢUŢURU",ŢUŢURU,VL,1058,0,1,0,1,13,4,0,17,23,9,0,32,38,10,0,48,59,11,0,70
170505,251,"ŞCOALA GIMNAZIALĂGUŞOENI",SPÎRLENI,VL,756,6,4,0,10,10,4,0,14,12,8,0,20,19,9,0,28,19,9,0,28
170480,252,"CĂMINUL CULTURAL GUŞOIANCA",GUŞOIANCA,VL,478,1,0,0,1,5,0,0,5,5,0,0,5,7,0,0,7,9,1,0,10
170523,253,"ŞCOALAIONEŞTII GOVORII",IONEŞTI,VL,1129,6,0,0,6,8,1,0,9,12,3,0,15,17,5,0,22,17,5,0,22
170550,254,"ŞCOALA FIŞCĂLIA",DELURENI,VL,879,2,0,0,2,3,1,0,4,4,1,0,5,6,2,0,8,10,5,0,15
170578,255,ŞCOALAFOTEŞTI,FOTEŞTI,VL,694,5,3,0,8,8,3,0,11,12,3,0,15,13,4,0,17,13,4,0,17
170596,256,"ŞCOALA MARCEA",MARCEA,VL,693,7,2,0,9,13,2,0,15,13,4,0,17,17,4,0,21,17,4,0,21
170621,257,"ŞCOALA PRIMARĂ LALOŞU",LALOŞU,VL,763,1,0,0,1,3,0,0,3,5,0,0,5,9,0,0,9,10,0,0,10
170658,258,"ŞCOALA GIMNAZIALĂ MOLOGEŞTI",MOLOGEŞTI,VL,522,2,1,0,3,5,2,0,7,6,2,0,8,12,2,0,14,14,2,0,16
170630,259,"ŞCOALA PRIMARĂ BERBEŞTI",BERBEŞTI,VL,364,0,0,0,0,0,0,0,0,4,0,0,4,4,0,0,4,6,0,0,6
170667,260,"ŞCOALA PRIMARĂ OLTEŢANI",OLTEŢANI,VL,203,0,0,0,0,2,0,0,2,4,3,0,7,4,3,0,7,6,3,0,9
174389,261,"ŞCOALA CU CLASELE I-IV LĂCUSTENI",LĂCUSTENI,VL,418,2,1,0,3,7,2,0,9,7,3,0,10,9,3,0,12,9,3,0,12
174334,262,"ŞCOALA CU CLASELE V-VIII LĂCUSTENI",CONTEA,VL,249,1,0,0,1,3,0,0,3,5,0,0,5,8,1,0,9,8,1,0,9
174370,263,"ŞCOALA CU CLASELE I-IV GĂNEŞTI",GĂNEŞTI,VL,456,1,0,0,1,1,0,0,1,5,1,0,6,10,2,0,12,13,2,0,15
170694,264,"CĂMINUL CULTURAL LĂDEȘTI",LĂDEŞTI,VL,743,1,0,0,1,2,1,0,3,10,3,0,13,11,7,0,18,11,7,0,18
170747,265,"ȘCOALA PRIMARĂ GĂGENI",GĂGENI,VL,192,0,0,0,0,0,0,0,0,1,4,0,5,1,4,0,5,1,4,0,5
170710,266,"ȘCOALA PRIMARĂ CHIRICEȘTI",CHIRICEŞTI,VL,412,2,2,0,4,5,4,0,9,10,4,0,14,15,6,0,21,17,6,0,23
170765,267,"ȘCOALA PRIMARĂ OLTEANCA",OLTEANCA,VL,81,0,0,0,0,2,1,0,3,2,1,0,3,4,1,0,5,4,1,0,5
170809,268,"ŞCOALA GIMNAZIALĂ SĂRULEŞTI",SĂRULEŞTI,VL,1143,4,1,0,5,13,1,0,14,18,2,0,20,18,2,0,20,19,3,0,22
170827,269,"ŞCOALA PRIMARĂ BROŞTENI",BROŞTENI,VL,548,3,3,0,6,3,4,0,7,4,4,0,8,6,5,0,11,8,5,0,13
170881,270,"CLĂDIRE ȘCOALĂ I-IV TINA",LIVEZI,VL,598,0,0,0,0,0,3,0,3,5,7,0,12,7,7,0,14,7,7,0,14
170934,271,"ŞCOALA CU CLASELE I-IV PLEŞOIU",PLEŞOIU,VL,328,1,0,0,1,3,1,0,4,6,1,0,7,6,3,0,9,6,3,0,9
170935,272,"CLĂDIRE GRĂDINIȚĂ PÎRÎIENII DE JOS","PÎRÎIENII DE JOS",VL,942,4,2,0,6,7,2,0,9,11,2,0,13,18,3,0,21,19,4,0,23
170961,273,"ŞCOALA LUNGEŞTI",LUNGEŞTI,VL,829,2,1,0,3,8,1,0,9,11,1,0,12,17,2,0,19,17,2,0,19
171012,274,"ŞCOALA CU CLASELE I-IV STĂNEŞTI-LUNCA",STĂNEŞTI-LUNCA,VL,814,2,0,0,2,5,0,0,5,9,0,0,9,10,0,0,10,11,0,0,11
170998,275,"CĂMINUL CULTURAL FUMURENI",FUMURENI,VL,565,1,0,0,1,3,0,0,3,4,0,0,4,7,0,0,7,9,0,0,9
170989,276,"ŞCOALA CU CLASELE I-IV DUMBRAVA",DUMBRAVA,VL,319,3,0,0,3,3,1,0,4,3,1,0,4,4,2,0,6,5,2,0,7
171030,277,"ŞCOALA GIMNAZIALĂ MALAIA",MALAIA,VL,873,6,3,0,9,16,10,0,26,26,10,0,36,29,10,0,39,33,12,0,45
171049,278,"ŞCOALA PRIMARĂ CIUNGET",CIUNGETU,VL,401,2,0,0,2,4,4,0,8,5,4,0,9,6,8,0,14,9,8,0,17
171058,279,"GRĂDINIŢA CU PROGRAM NORMAL SĂLIŞTE",SĂLIŞTEA,VL,240,4,0,0,4,7,0,0,7,9,2,0,11,9,2,0,11,9,2,0,11
171076,280,"ŞCOALA GIMNAZIALĂ MATEEŞTI",MATEEŞTI,VL,1085,2,0,0,2,6,0,0,6,9,0,0,9,15,2,0,17,16,2,0,18
171085,281,"GRĂDINIŢA GRECI",GRECI,VL,479,2,0,0,2,4,0,0,4,6,2,0,8,7,3,0,10,9,3,0,12
171094,282,"ŞCOALA GIMNAZIALĂ TURCEŞTI",TURCEŞTI,VL,1004,4,1,0,5,4,2,0,6,4,5,0,9,6,5,0,11,12,14,0,26
171110,283,"SEDIU VECHI PRIMĂRIE CENTRU CIVIC",OVESELU,VL,798,1,0,0,1,8,1,0,9,11,3,0,14,14,6,0,20,14,8,0,22
171174,284,"ŞCOALA GENERALĂ POPEŞTI, COMUNA MĂCIUCA, SATUL POPEŞTI",POPEŞTI,VL,378,3,0,0,3,6,1,0,7,10,1,0,11,11,2,0,13,11,2,0,13
171183,285,"ȘCOALA CU CLASELE I-IV ZĂVOIENI",ŞTEFĂNEŞTI,VL,250,1,0,0,1,1,0,0,1,1,1,0,2,3,2,0,5,3,2,0,5
171218,286,"ȘCOALA CU CLASELE . I-VIII MĂDULARI",MĂDULARI,VL,642,5,0,0,5,12,1,0,13,17,2,0,19,24,4,0,28,31,6,0,37
171227,287,"ŞCOALA CU CLASELE I-IV BĂLŞOARA",BĂLŞOARA,VL,262,0,0,0,0,0,1,0,1,4,2,0,6,7,2,0,9,9,2,0,11
171236,288,"ȘCOALA CU CLASELE. I-IV BĂNȚEȘTI",BĂNŢEŞTI,VL,258,0,0,0,0,2,1,0,3,4,1,0,5,6,1,0,7,8,2,0,10
171281,289,"ŞCOALA VECHEMĂLDĂREŞTI",MĂLDĂREŞTI,VL,1509,10,0,0,10,21,2,0,23,26,4,0,30,30,4,0,34,31,5,0,36
171316,290,"ŞCOALA TELECHEŞTI",TELECHEŞTI,VL,133,0,0,0,0,0,0,0,0,0,0,0,0,1,0,0,1,3,0,0,3
171334,291,"GRĂDINIȚA BULETA",BULETA,VL,1193,2,4,0,6,5,5,0,10,18,8,0,26,28,9,0,37,31,9,0,40
171389,292,"CĂMINUL CULTURAL MĂGURA",MĂGURA,VL,724,6,2,0,8,9,4,0,13,19,13,0,32,22,13,0,35,23,13,0,36
171450,293,"CĂMINUL CULTURAL VULPUEŞTI",VULPUEŞTI,VL,643,5,4,0,9,13,4,0,17,13,5,0,18,18,5,0,23,19,5,0,24
171352,294,"ŞCOALA CU CLASELE I-IV BÎRSEŞTI",BÎRSEŞTI,VL,671,5,0,0,5,8,2,0,10,13,2,0,15,13,3,0,16,15,3,0,18
171441,295,"GRĂDINIŢA STUPĂREI",STUPĂREI,VL,718,4,4,0,8,7,5,0,12,15,5,0,20,28,7,0,35,34,7,0,41
171398,296,"GRĂDINIȚA MIHĂEȘTI",MIHĂEŞTI,VL,910,5,0,0,5,9,0,0,9,11,0,0,11,20,28,0,48,21,30,0,51
171370,297,"ȘCOALA GENERALĂ",GURIŞOARA,VL,762,6,0,0,6,13,0,0,13,17,0,0,17,23,2,0,25,23,2,0,25
171478,298,"PRIMĂRIA MILCOIU",MILCOIU,VL,601,2,1,0,3,4,2,0,6,6,3,0,9,7,5,0,12,11,5,0,16
171502,299,"GRĂDINIŢA IZBĂŞEŞTI",IZBĂSEŞTI,VL,204,5,0,0,5,7,1,0,8,8,1,0,9,8,3,0,11,10,5,0,15
171496,300,"GRĂDINIŢA CIUTEŞTI",CIUTEŞTI,VL,234,8,0,0,8,11,3,0,14,15,7,0,22,16,7,0,23,18,7,0,25
173659,301,"CÃMINUL CULTURAL MITROFANI",MITROFANI,VL,577,3,0,0,3,5,0,0,5,7,0,0,7,9,0,0,9,9,0,0,9
173668,302,"FOSTA ŞCOALÃ RACU",RACU,VL,239,1,2,0,3,1,2,0,3,1,3,0,4,1,4,0,5,1,4,0,5
171548,303,"ŞCOALA MUEREASCA DE JOS",MUEREASCA,VL,931,1,0,0,1,1,1,0,2,3,1,0,4,5,1,0,6,5,1,0,6
171593,304,"ŞCOALA MUEREASCA DE SUS","MUEREASCA DE SUS",VL,1161,0,1,0,1,18,4,0,22,28,14,0,42,34,18,0,52,35,18,0,53
171637,305,"ŞCOALA CU CLASELE I-VIII ROTĂRĂŞTI",ROTĂRĂŞTI,VL,915,2,0,0,2,9,0,0,9,10,0,0,10,12,3,0,15,15,3,0,18
171655,306,"ŞCOALA CU CLASELE I-IV CORBI","CORBII DIN VALE",VL,328,2,0,0,2,4,0,0,4,9,1,0,10,12,5,0,17,16,5,0,21
171762,307,"ŞCOALA CU CLASELE I-IVŞERBĂNEASA",ŞERBĂNEASA,VL,756,2,2,0,4,8,3,0,11,14,4,0,18,22,5,0,27,26,5,0,31
171744,308,"ȘCOALA CU CLASELE I-VIII PREDEȘTI",PREDEŞTI,VL,682,6,1,0,7,7,1,0,8,10,1,0,11,16,1,0,17,16,1,0,17
171682,309,"ŞCOALA CU CLASELE I-IV GÂLTOFANI",GÎLTOFANI,VL,137,1,1,0,2,2,2,0,4,2,2,0,4,3,3,0,6,4,3,0,7
171815,310,"ŞCOALACU CLASELE I-IV PERETU",OLANU,VL,469,1,0,0,1,4,2,0,6,7,2,0,9,9,2,0,11,9,2,0,11
171824,311,"ŞCOALA CU CLASELE.I-IV CASAVECHE","CASA VECHE",VL,587,3,0,0,3,5,0,0,5,7,1,0,8,9,1,0,10,10,1,0,11
171833,312,"ŞCOALACU CLASELE I-IV CIOBOŢI",CIOBOŢI,VL,602,1,0,0,1,1,0,0,1,2,2,0,4,8,5,0,13,14,6,0,20
171842,313,"ŞCOALA CU CLASELE I-IV DRĂGIOIU",DRĂGIOIU,VL,491,4,0,0,4,7,0,0,7,20,2,0,22,22,3,0,25,24,3,0,27
171860,314,"ŞCOALA CU CLASELE I-IV STOICĂNEŞTI",STOICĂNEŞTI,VL,350,0,0,0,0,1,1,0,2,1,1,0,2,2,1,0,3,4,2,0,6
171888,315,"CĂMIN CULTURAL(FOSTUL CĂMIN CULTURAL DIN CURTEA PRIMĂRIEI)",ORLEŞTI,VL,1505,8,3,0,11,15,4,0,19,26,5,0,31,34,5,0,39,35,5,0,40
171922,316,"GRĂDINIŢA SILEA",SILEA,VL,879,4,1,0,5,7,2,0,9,12,4,0,16,25,5,0,30,26,5,0,31
171940,317,"CĂMINUL CULTURAL OTEŞANI",OTEŞANI,VL,1124,8,1,0,9,13,1,0,14,15,3,0,18,22,3,0,25,25,3,0,28
171968,318,"ŞCOALA CÎRSTĂNEŞTI",CÎRSTĂNEŞTI,VL,1120,7,2,0,9,9,2,0,11,11,3,0,14,14,4,0,18,16,5,0,21
172117,319,"ŞCOALA GIMNAZIALĂ ACHIM POPESCU",PIETRARI,VL,1081,13,3,0,16,21,5,0,26,28,6,0,34,36,9,0,45,36,9,0,45
172091,320,"ŞCOALA GIMNAZIALĂ ACHIM POPESCU",PĂUŞEŞTI-MĂGLAŞI,VL,1285,9,0,0,9,18,0,0,18,20,0,0,20,33,0,0,33,39,0,0,39
172135,321,"ŞCOALA PRIMARĂ VALEA CHEII","VALEA CHEII",VL,925,5,1,0,6,17,5,0,22,23,5,0,28,28,5,0,33,35,6,0,41
172019,322,"ŞCOALA PRIMARĂ BARCANELE",BARCANELE,VL,495,3,0,0,3,5,0,0,5,9,1,0,10,13,2,0,15,16,2,0,18
172000,323,"CĂMINUL CULTURAL PĂUŞEŞTI",PĂUŞEŞTI,VL,774,14,3,0,17,14,7,0,21,18,10,0,28,24,10,0,34,28,12,0,40
172037,324,"CĂMINUL CULTURAL ŞERBĂNEŞTI",CERNELELE,VL,521,5,1,0,6,6,1,0,7,7,5,0,12,12,5,0,17,12,5,0,17
172028,325,"ŞCOALA GIMNAZIALĂ ŞERBĂNEŞTI",BUZDUGAN,VL,400,3,0,0,3,3,0,0,3,6,1,0,7,10,1,0,11,11,1,0,12
172162,326,"ŞCOALA CU CLASELE I-VIII PERIŞANI",PERIŞANI,VL,470,6,3,0,9,8,4,0,12,14,4,0,18,15,4,0,19,16,4,0,20
172206,327,"CĂMINUL CULTURAL MLĂCENI",MLĂCENI,VL,440,2,0,0,2,9,3,0,12,11,3,0,14,15,7,0,22,16,7,0,23
172224,328,"ŞCOALA CU CLASELE I-VIII POIANA",POIANA,VL,489,4,0,0,4,7,1,0,8,10,1,0,11,11,2,0,13,11,2,0,13
172242,329,"CĂMINUL CULTURAL SPINU",SPINU,VL,301,3,0,0,3,3,0,0,3,9,1,0,10,10,2,0,12,12,3,0,15
172215,330,"ŞCOALA PODENI",PODENI,VL,53,0,0,0,0,0,0,0,0,0,0,0,0,0,0,0,0,2,5,0,7
172288,331,"ŞCOALA CU CLASELE I-IV PESCEANA (ŞCOALA VECHE NR. 2 PESCEANA)",PESCEANA,VL,1363,2,2,0,4,7,2,0,9,8,2,0,10,9,2,0,11,12,2,0,14
172359,332,"ŞCOALĂ GIMNAZIALĂ PIETRARI",PIETRARI,VL,1383,7,4,0,11,16,4,0,20,17,4,0,21,23,5,0,28,25,5,0,30
172368,333,"ŞCOALA PRIMARĂ PIETRARII DE SUS","PIETRARII DE SUS",VL,1138,0,0,0,0,3,1,0,4,4,1,0,5,11,3,0,14,11,3,0,14
172402,334,"ŞCOALA CU CLASELE I-VIII DĂEŞTI",DĂEŞTI,VL,774,0,0,0,0,1,1,0,2,4,4,0,8,6,4,0,10,6,5,0,11
172420,335,"CĂMINUL CULTURAL POPEŞTI",MEIENI,VL,382,0,1,0,1,2,1,0,3,3,2,0,5,6,3,0,9,7,3,0,10
172386,336,"ŞCOALA CU CLASELE I-IV POPEŞTI",POPEŞTI,VL,510,4,2,0,6,6,3,0,9,12,3,0,15,16,4,0,20,18,4,0,22
172439,337,"ŞCOALA CU CLASELE I-VIII URŞI",URŞI,VL,854,4,0,0,4,9,0,0,9,15,0,0,15,18,0,0,18,19,0,0,19
172466,338,"ȘCOALA PRUNDENI",PRUNDENI,VL,1295,6,3,0,9,15,6,0,21,18,6,0,24,33,12,0,45,38,12,0,50
172484,339,"ȘCOALA CĂLINA",CĂLINA,VL,1185,6,3,0,9,12,3,0,15,15,4,0,19,20,4,0,24,22,5,0,27
172475,340,"ȘCOALA BĂRBUCENI",BĂRBUCENI,VL,991,1,1,0,2,6,2,0,8,7,3,0,10,13,4,0,17,15,4,0,19
172518,341,"CĂMINUL CULTURAL RACOVIŢA",RACOVIŢA,VL,768,7,3,0,10,14,13,0,27,21,15,0,36,22,16,0,38,22,16,0,38
172563,342,"ŞCOALA GRUIUL LUPULUI","GRUIU LUPULUI",VL,123,2,4,0,6,11,11,0,22,12,12,0,24,12,12,0,24,12,12,0,24
172572,343,"OCOLUL SILVIC LOVIŞTEA",TUŢULEŞTI,VL,118,0,0,0,0,9,3,0,12,9,3,0,12,11,3,0,14,11,3,0,14
172527,344,"CĂMINUL CULTURAL BALOTA",BALOTA,VL,318,1,1,0,2,1,1,0,2,3,2,0,5,6,4,0,10,6,4,0,10
172607,345,"ŞCOALA CU CLASELEI-IV ROEŞTI",BĂIAŞA,VL,622,2,0,0,2,3,0,0,3,8,6,0,14,10,6,0,16,11,7,0,18
172634,346,"ŞCOALA CU CLASELE I-VIII CIOCÎLTEI",CIOCÎLTEI,VL,504,2,0,0,2,4,0,0,4,5,0,0,5,5,0,0,5,5,0,0,5
172643,347,"ŞCOALA CU CLASELE I-VIII CUENI",CUENI,VL,510,0,0,0,0,3,0,0,3,3,0,0,3,5,2,0,7,5,3,0,8
172625,348,"ŞCOALA CU CLASELE I-IV BĂRBĂRIGENI",BĂRBĂRIGENI,VL,169,1,2,0,3,1,2,0,3,4,2,0,6,4,2,0,6,4,2,0,6
172705,349,"ŞCOALA GIMNAZIALĂ ROŞIILE",ROŞIILE,VL,878,1,0,0,1,2,0,0,2,3,0,0,3,3,0,0,3,6,1,0,7
172796,350,"ŞCOALA PRIMARĂ ROMANEŞTI",ROMÂNEŞTI,VL,843,2,0,0,2,4,0,0,4,5,0,0,5,5,0,0,5,5,0,0,5
172803,351,"GRĂDINIŢA CU PROGRAM NORMAL ZGUBEA",ZGUBEA,VL,277,2,1,0,3,2,1,0,3,3,3,0,6,10,5,0,15,10,5,0,15
172769,352,"FOSTA ŞCOALĂ PERTEŞTI",PERTEŞTI,VL,53,0,0,0,0,1,3,0,4,1,3,0,4,3,3,0,6,4,3,0,7
172821,353,"ŞCOALAGIMNAZIALĂ CU CLASELE I-VIII RUNCU",RUNCU,VL,441,0,3,0,3,4,3,0,7,6,5,0,11,8,7,0,15,9,9,0,18
172876,354,"ŞCOALA GENERALĂ CU CLASELE I-IV VALEA BABEI","VALEA BABEI",VL,208,2,4,0,6,4,6,0,10,5,7,0,12,7,7,0,14,7,7,0,14
172867,355,"ŞCOALA GENERALĂ CU CLASELE I-IV SURPAŢI",SURPAŢI,VL,114,2,0,0,2,5,0,0,5,5,0,0,5,5,0,0,5,5,0,0,5
172901,356,"CĂMINUL CULTURAL SĂLĂTRUCEL",SĂLĂTRUCEL,VL,1172,5,0,0,5,9,1,0,10,11,1,0,12,15,1,0,16,22,3,0,25
172938,357,ŞCOALAŞERBĂNEŞTI,ŞERBĂNEŞTI,VL,399,1,0,0,1,3,0,0,3,7,0,0,7,7,3,0,10,7,3,0,10
172910,358,ŞCOALAPATEŞTI,PĂTEŞTI,VL,103,103,0,0,103,3,0,0,3,6,0,0,6,6,1,0,7,6,2,0,8
172929,359,ŞCOALASEACA,SEACA,VL,89,0,0,0,0,0,1,0,1,1,5,0,6,1,5,0,6,4,5,0,9
172956,360,"ȘCOALA CU CLASELEI-VIII SCUNDU",SCUNDU,VL,980,9,1,0,10,15,7,0,22,24,8,0,32,30,8,0,38,33,8,0,41
172983,361,"ȘCOALA CU CLASELE I-VIII AVRĂMEȘTI",CRÎNGU,VL,656,3,0,0,3,6,3,0,9,15,3,0,18,25,4,0,29,27,4,0,31
173007,362,"ȘCOALA GIMNAZIALĂ COMUNASINEȘTI",SINEŞTI,VL,700,1,0,0,1,3,1,0,4,6,1,0,7,7,1,0,8,7,1,0,8
173034,363,"ȘCOALA URZICA, SAT URZICA",MIJLOCU,VL,823,1,2,0,3,3,2,0,5,5,2,0,7,8,7,0,15,8,7,0,15
173043,364,"ȘCOALA PRIMARĂ, SAT POPEȘTI",POPEŞTI,VL,530,0,0,0,0,2,0,0,2,3,3,0,6,5,3,0,8,6,3,0,9
173114,365,"CASA DE CULTURĂ SLĂTIOARA",MOGEŞTI,VL,821,3,4,0,7,9,7,0,16,10,11,0,21,13,11,0,24,15,12,0,27
173105,366,"ȘCOALA CU CLASELE I-VIII MILOSTEA",MILOSTEA,VL,647,3,0,0,3,6,0,0,6,7,0,0,7,7,0,0,7,7,0,0,7
173123,367,"ȘCOALA CU CLASELE I-VIII RUGETU",RUGETU,VL,536,3,0,0,3,6,1,0,7,9,1,0,10,13,1,0,14,15,1,0,16
173098,368,"ŞCOALA GENERALĂ GORUNEȘTI",GORUNEŞTI,VL,364,0,1,0,1,4,1,0,5,4,2,0,6,4,2,0,6,4,5,0,9
173070,369,"GRĂDINIŢA CUMPENE",SLĂTIOARA,VL,412,5,0,0,5,9,1,0,10,11,1,0,12,13,1,0,14,13,1,0,14
173141,370,"ŞCOALA CU CLASELE I-VIII STĂNEŞTI",STĂNEŞTI,VL,422,2,0,0,2,5,0,0,5,8,0,0,8,12,2,0,14,12,3,0,15
173221,371,"ŞCOALA CU CLASELEI-IV VÂRLENI",VÎRLENI,VL,378,4,0,0,4,5,0,0,5,6,1,0,7,11,4,0,15,13,4,0,17
173196,372,"ŞCOALA CU CLASELE I-IV LINIA DEALULUI","LINIA DEALULUI",VL,136,1,0,0,1,2,0,0,2,3,0,0,3,8,1,0,9,8,1,0,9
173249,373,"ŞCOALA GIMNAZIALĂ STOENEŞTI",STOENEŞTI,VL,898,4,0,0,4,5,5,0,10,11,7,0,18,21,9,0,30,22,9,0,31
173258,374,"CĂMINUL CULTURALBÂRLOGU",BÎRLOGU,VL,299,2,1,0,3,4,3,0,7,7,3,0,10,8,4,0,12,10,4,0,14
173285,375,"ŞCOALA GIMNAZIALĂ DOBRICENI",DOBRICENI,VL,1035,7,1,0,8,16,2,0,18,18,2,0,20,32,3,0,35,33,3,0,36
173338,376,"CĂMINUL CULTURALPISCU MARE","PISCU MARE",VL,503,0,0,0,0,2,0,0,2,5,3,0,8,7,5,0,12,7,5,0,12
173365,377,"CĂMINUL CULTURALZMEURĂTU",ZMEURĂTU,VL,142,2,0,0,2,7,4,0,11,9,4,0,13,12,6,0,18,16,6,0,22
173515,378,"ŞCOALA CU CLASELE I-VIII URŞI",URŞI,VL,1183,7,2,0,9,9,2,0,11,16,2,0,18,35,4,0,39,38,4,0,42
173383,379,"ȘCOALA CU CLASELE I-VIII STOILEȘTI",STOILEŞTI,VL,607,3,0,0,3,5,5,0,10,8,7,0,15,14,7,0,21,19,8,0,27
173436,380,"ŞCOALA CU CLASELE I-IV GEAMĂNA",GEAMĂNA,VL,780,8,2,0,10,10,4,0,14,12,5,0,17,16,5,0,21,16,5,0,21
173409,381,"ŞCOALA CU CLASELE I-IV BÎRSOIU",BÎRSOIU,VL,524,3,1,0,4,6,4,0,10,8,8,0,16,12,11,0,23,12,11,0,23
173542,382,"ŞCOALA CU CLASELE I-VIII CĂPITAN MĂRĂŞANU STROEŞTI",STROEŞTI,VL,754,4,0,0,4,6,0,0,6,11,0,0,11,13,0,0,13,13,0,0,13
173551,383,"ŞCOALA CU CLASELE I-VIII CIREŞU",CIREŞU,VL,659,6,3,0,9,9,5,0,14,12,5,0,17,15,5,0,20,16,5,0,21
173560,384,"ŞCOALA CU CLASELE I-VIII DIANU",DIANU,VL,410,3,4,0,7,9,5,0,14,10,5,0,15,13,5,0,18,16,6,0,22
173579,385,"CENTRUL SOCIAL OBROCEŞTI",OBROCEŞTI,VL,279,4,0,0,4,5,0,0,5,7,0,0,7,8,1,0,9,8,1,0,9
173588,386,"CĂMINUL CULTURAL POJOGI - CERNA",POJOGI-CERNA,VL,209,2,6,0,8,2,11,0,13,4,12,0,16,5,12,0,17,5,12,0,17
173640,387,"CĂMINUL CULTURAL SUTEŞTI",MĂZILI,VL,1323,6,4,0,10,15,5,0,20,23,7,0,30,32,7,0,39,35,9,0,44
173677,388,"FOSTA ŞCOALA VERDEA",VERDEA,VL,440,1,1,0,2,2,1,0,3,6,1,0,7,11,2,0,13,11,2,0,13
173695,389,"ŞCOALA GIMNAZIALĂ ŞIRINEASA",ŞIRINEASA,VL,1186,3,0,0,3,8,0,0,8,10,2,0,12,18,4,0,22,20,4,0,24
173711,390,"ŞCOALA PRIMARĂ CIORĂŞTI",CIORĂŞTI,VL,491,7,0,0,7,9,3,0,12,13,3,0,16,14,3,0,17,14,3,0,17
173720,391,"ŞCOALA PRIMARĂ SLĂVITEŞTI",SLĂVITEŞTI,VL,254,1,2,0,3,3,2,0,5,3,3,0,6,4,4,0,8,4,4,0,8
173757,392,"ŞCOALA CU CLASELE I-VIII ŞTEFĂNEŞTI",ŞTEFĂNEŞTI,VL,957,6,0,0,6,10,2,0,12,15,2,0,17,19,2,0,21,24,3,0,27
173784,393,"GRĂDINIŢA ŞERBĂNEŞTI",ŞERBĂNEŞTI,VL,689,6,1,0,7,7,1,0,8,17,1,0,18,24,1,0,25,28,1,0,29
173775,394,"ŞCOALA GENERALĂ CU CLASELE.I-IV DOBRUŞA DE JOS",DOBRUŞA,VL,530,4,3,0,7,5,3,0,8,9,3,0,12,11,3,0,14,13,4,0,17
173775,395,"GRĂDINIŢA DOBRUŞA DE SUS",DOBRUŞA,VL,507,2,4,0,6,6,4,0,10,9,4,0,13,18,4,0,22,26,4,0,30
173846,396,"CĂMINUL CULTURAL UŞUREI",UŞUREI,VL,449,2,0,0,2,6,2,0,8,10,3,0,13,12,5,0,17,13,5,0,18
173800,397,"ŞCOALA ŞUŞANII DE SUS",ŞUŞANI,VL,494,0,3,0,3,2,3,0,5,2,3,0,5,3,3,0,6,3,6,0,9
173800,398,"ŞCOALAŞUŞANII DE JOS",ŞUŞANI,VL,454,3,0,0,3,4,0,0,4,4,0,0,4,9,0,0,9,9,0,0,9
173837,399,ŞCOALASTOICULEŞTI,STOICULEŞTI,VL,309,3,0,0,3,4,1,0,5,6,1,0,7,12,1,0,13,16,1,0,17
173819,400,"ŞCOALA RÎMEŞTI",RÎMEŞTI,VL,894,6,0,0,6,6,0,0,6,6,0,0,6,9,1,0,10,11,2,0,13
173873,401,"ŞCOALA CU CLASELE I-IV BĂROIU",BĂROIU,VL,319,3,2,0,5,5,3,0,8,8,5,0,13,10,6,0,16,14,6,0,20
173864,402,"CĂMINUL CULTURAL TETOIU",TETOIU,VL,546,0,0,0,0,2,0,0,2,6,0,0,6,6,4,0,10,6,4,0,10
173926,403,"ŞCOALA GENERALĂ CU CLASELE.I-VIII ŢEPEŞTI",ŢEPEŞTI,VL,703,0,0,0,0,2,0,0,2,5,0,0,5,5,0,0,5,5,0,0,5
173908,404,"ŞCOALA GENERALĂ CU CLASELE.I-IV NENCIULEŞTI",NENCIULEŞTI,VL,277,5,1,0,6,7,3,0,10,8,3,0,11,13,5,0,18,14,6,0,20
173882,405,"SCOALA GENERALĂ CU CLASELE.I-IV BUDELE",BUDELE,VL,153,0,1,0,1,0,1,0,1,1,1,0,2,5,2,0,7,5,2,0,7
172260,406,"ŞCOALA CU CLASELE I-VIII TITEŞTI (SALĂ DE FESTIVITĂȚI)",TITEŞTI,VL,470,7,1,0,8,8,4,0,12,11,4,0,15,12,4,0,16,18,7,0,25
172180,407,"ŞCOALA CU CLASELE I-IV BRATOVEŞTI",BRATOVEŞTI,VL,145,2,2,0,4,3,4,0,7,3,4,0,7,9,5,0,14,9,5,0,14
173944,408,"CĂMINUL CULTURAL TOMŞANI",TOMŞANI,VL,964,7,3,0,10,15,5,0,20,17,5,0,22,23,6,0,29,25,6,0,31
174003,409,"ŞCOALA GENERALĂ FOLEŞTII DE SUS","FOLEŞTII DE SUS",VL,957,6,2,0,8,10,2,0,12,11,5,0,16,11,5,0,16,12,5,0,17
173999,410,"CĂMINUL CULTURAL FOLEȘTII DE JOS","FOLEŞTII DE JOS",VL,666,0,0,0,0,6,6,0,12,13,8,0,21,15,12,0,27,16,13,0,29
173962,411,"CĂMINUL CULTURAL BOGDĂNEȘTI",BOGDĂNEŞTI,VL,592,8,2,0,10,6,2,0,8,13,2,0,15,22,4,0,26,22,4,0,26
174030,412,"CĂMINUL CULTURAL VAIDEENI",VAIDEENI,VL,935,8,2,0,10,19,4,0,23,23,5,0,28,36,8,0,44,41,8,0,49
174030,413,"CĂMINUL CULTURAL VAIDEENI",VAIDEENI,VL,1191,10,1,0,11,27,1,0,28,40,3,0,43,54,3,0,57,58,5,0,63
174067,414,"CĂMINUL CULTURAL IZVORU RECE","IZVORU RECE",VL,664,6,1,0,7,7,3,0,10,16,3,0,19,20,3,0,23,20,3,0,23
174076,415,"CĂMINUL CULTURAL MARIŢA",MARIŢA,VL,464,2,3,0,5,6,7,0,13,10,9,0,19,11,11,0,22,11,11,0,22
174110,416,"ŞCOALA CU CLASELE I-IV DELURENI",DELURENI,VL,421,2,7,0,9,3,7,0,10,5,7,0,12,7,7,0,14,8,7,0,15
174094,417,"GRĂDINIŢA VALEA MARE","VALEA MARE",VL,517,5,3,0,8,6,4,0,10,9,4,0,13,13,4,0,17,15,4,0,19
174101,418,"ŞCOALA CU CLASELE I-VIII BĂTĂŞANI",BĂTĂŞANI,VL,408,3,5,0,8,3,7,0,10,7,7,0,14,8,8,0,16,8,9,0,17
174138,419,"ŞCOALA MĂRGINENI",MĂRGINENI,VL,311,2,1,0,3,5,3,0,8,7,4,0,11,7,8,0,15,9,9,0,18
174129,420,"CĂMINUL CULTURAL DRĂGANI",DRĂGANU,VL,437,1,4,0,5,2,4,0,6,4,4,0,8,6,6,0,12,6,6,0,12
174165,421,"ŞCOALA CU CLASELE I-VIII VLĂDEŞTI",VLĂDEŞTI,VL,1528,12,1,0,13,23,2,0,25,38,2,0,40,44,3,0,47,47,3,0,50
174192,422,"ŞCOALA CU CLASELE I-VIII VLĂDEŞTI",PRIPORU,VL,1152,7,1,0,8,17,4,0,21,26,4,0,30,32,4,0,36,34,4,0,38
174227,423,"GRĂDINIŢA CU PROGRAM NORMAL VOICEŞTI",VOICEŞTI,VL,1267,11,0,0,11,19,3,0,22,20,3,0,23,29,3,0,32,31,3,0,34
174263,424,"LOCALUL PRIMĂRIEI VOINEASA",VOINEASA,VL,711,4,1,0,5,9,4,0,13,13,9,0,22,16,9,0,25,16,12,0,28
174281,425,"ŞCOALA CU CLASELE I-VIII VOINEASA",VOINEŞIŢA,VL,617,5,3,0,8,8,4,0,12,14,5,0,19,18,7,0,25,19,9,0,28
174307,426,"ŞCOALA GIMNAZIALĂ ZĂTRENI",ZĂTRENI,VL,549,0,0,0,0,1,0,0,1,4,0,0,4,6,0,0,6,6,0,0,6
174450,427,"ŞCOALA PRIMARĂ STANOMIRU",STANOMIRU,VL,379,3,0,0,3,5,0,0,5,6,1,0,7,7,1,0,8,10,2,0,12
174478,428,"ŞCOALA PRIMARĂ VĂLENI",VĂLENI,VL,370,3,2,0,5,4,2,0,6,7,2,0,9,11,5,0,16,12,5,0,17
174352,429,"ŞCOALA DEALUL VĂLENI","DEALU VĂLENI",VL,220,0,1,0,1,1,7,0,8,2,7,0,9,2,12,0,14,2,12,0,14
174441,430,"ŞCOALA PRIMARĂ SĂSCIOARA",SĂŞCIOARA,VL,332,2,2,0,4,4,2,0,6,4,4,0,8,4,6,0,10,4,7,0,11
174753,1,"DIRECTIA SILVICĂ VRANCEA",FOCŞANI,VN,1442,25,2,0,27,60,5,0,65,89,7,0,96,105,7,0,112,114,7,0,121
174753,2,"TEATRUL MUNICIPAL FOCŞANI",FOCŞANI,VN,1594,21,4,0,25,62,6,0,68,87,11,0,98,123,16,0,139,138,16,0,154
174753,3,"BIBLIOTECA JUDEŢEANĂ ""DUILIU ZAMFIRESCU""",FOCŞANI,VN,1511,17,3,0,20,61,4,0,65,87,8,0,95,110,9,0,119,170,9,0,179
174753,4,"BIBLIOTECA JUDEŢEANĂ ""DUILIU ZAMFIRESCU""",FOCŞANI,VN,1312,4,0,0,4,19,3,0,22,33,3,0,36,50,10,0,60,67,10,0,77
174753,5,"ŞCOALA GIMNAZIALĂ ""ŞTEFAN CEL MARE"" - INTRAREA PRINCIPALĂ",FOCŞANI,VN,1134,12,2,0,14,18,2,0,20,38,9,0,47,55,10,0,65,63,10,0,73
174753,6,"ŞCOALA GIMNAZIALĂ ""ŞTEFAN CEL MARE"" - INTRAREA ELEVILOR",FOCŞANI,VN,1242,5,2,0,7,37,3,0,40,53,4,0,57,75,5,0,80,87,6,0,93
174753,7,"ŞCOALA GIMNAZIALĂ ""ŞTEFAN CEL MARE"" - INTRAREA SECUNDARA",FOCŞANI,VN,849,9,0,0,9,35,0,0,35,50,2,0,52,66,2,0,68,67,2,0,69
174753,8,"COLEGIUL TEHNIC AUTO „TRAIAN VUIA""",FOCŞANI,VN,597,4,4,0,8,18,6,0,24,25,8,0,33,31,8,0,39,37,8,0,45
174753,9,"COLEGIUL TEHNIC AUTO „TRAIAN VUIA""",FOCŞANI,VN,1020,7,5,0,12,27,5,0,32,39,5,0,44,51,5,0,56,54,5,0,59
174753,10,"COLEGIUL ECONOMIC „MIHAIL KOGĂLNICEANU”",FOCŞANI,VN,1708,7,0,0,7,30,1,0,31,41,3,0,44,71,3,0,74,84,6,0,90
174753,11,"COLEGIUL ECONOMIC „MIHAIL KOGĂLNICEANU”",FOCŞANI,VN,1670,5,5,0,10,19,6,0,25,35,7,0,42,54,8,0,62,58,9,0,67
174753,12,"COLEGIUL ECONOMIC ""MIHAIL KOGĂLNICEANU""",FOCŞANI,VN,1589,10,6,0,16,43,12,0,55,71,15,0,86,97,17,0,114,102,19,0,121
174753,13,"COLEGIUL ECONOMIC ""MIHAIL KOGĂLNICEANU""",FOCŞANI,VN,1659,14,0,0,14,35,0,0,35,55,0,0,55,85,1,0,86,93,1,0,94
174753,14,"ŞCOALA GIMNAZIALĂ NR. 7",FOCŞANI,VN,1285,17,1,0,18,41,1,0,42,52,6,0,58,67,10,0,77,74,12,0,86
174753,15,"GRĂDINIŢA CU PROGRAM PRELUNGIT NR. 15",FOCŞANI,VN,957,13,1,0,14,22,1,0,23,25,1,0,26,41,1,0,42,53,2,0,55
174753,16,"GRĂDINIŢA CU PROGRAM PRELUNGIT NR. 15",FOCŞANI,VN,1800,13,0,0,13,23,0,0,23,42,3,0,45,74,4,0,78,86,6,0,92
174753,17,"LICEUL TEHNOLOGIC ""G.G.LONGINESCU""",FOCŞANI,VN,1974,9,2,0,11,28,5,0,33,44,5,0,49,58,7,0,65,59,8,0,67
174753,18,"ŞCOALA GIMNAZIALĂ ""ION BASGAN""",FOCŞANI,VN,1779,18,2,0,20,46,5,0,51,61,5,0,66,79,11,0,90,89,11,0,100
174753,19,"OCOLUL SILVIC FOCȘANI",FOCŞANI,VN,1539,12,0,0,12,31,1,0,32,54,2,0,56,81,4,0,85,89,4,0,93
174753,20,"COLEGIUL TEHNIC ""VALERIU D. COTEA""",FOCŞANI,VN,1182,12,1,0,13,34,4,0,38,49,4,0,53,75,7,106,188,78,7,106,191
174753,21,"COLEGIUL NAŢIONAL ""AL. I. CUZA""",FOCŞANI,VN,873,8,4,0,12,19,4,0,23,25,4,0,29,38,4,0,42,42,5,0,47
174753,22,"ŞCOALA GIMNAZIALĂ ""ANGHEL SALIGNY""",FOCŞANI,VN,1329,14,1,0,15,33,3,0,36,47,4,0,51,66,5,0,71,71,5,0,76
174753,23,"ȘCOALA GIMNAZIALĂ „ANGHEL SALIGNY” INTRAREA SECUNDARĂ",FOCŞANI,VN,1761,18,0,0,18,36,1,0,37,45,1,0,46,61,2,0,63,68,2,0,70
174771,24,"CONSILIUL LOCAL AL MUNICIPIULUI FOCŞANI (FOST SEDIU AL ȘCOLII CU CLASELE I-IV MÎNDREȘTI)",MÎNDREŞTI-MUNTENI,VN,1365,3,0,0,3,11,0,0,11,25,1,158,184,36,1,158,195,38,1,158,197
174753,25,"AGENŢIA NAŢIONALĂ DE ÎMBUNĂTĂŢIRI FUNCIARE",FOCŞANI,VN,1060,7,0,0,7,15,0,0,15,20,1,196,217,30,3,196,229,31,3,196,230
174753,26,"GRĂDINIŢA CU PROGRAM PRELUNGIT NR. 16",FOCŞANI,VN,1388,13,3,0,16,20,3,0,23,30,3,0,33,53,3,0,56,57,3,0,60
174753,27,"GRĂDINIŢA CU PROGRAM PRELUNGIT NR. 16",FOCŞANI,VN,1704,7,0,0,7,22,0,0,22,29,0,0,29,46,4,0,50,52,4,0,56
174753,28,"COLEGIUL NAŢIONAL ""UNIREA""",FOCŞANI,VN,1189,9,1,0,10,20,1,0,21,35,1,49,85,54,1,49,104,57,2,49,108
174753,29,"ŞCOALAGIMNAZIALĂ NR. 3",FOCŞANI,VN,1210,11,1,0,12,33,1,0,34,47,2,0,49,66,6,0,72,75,10,0,85
174753,30,"AGENŢIA JUDEŢEANĂ PENTRU PLĂŢI ŞI INSPECŢIE SOCIALĂ",FOCŞANI,VN,1471,12,0,0,12,43,3,0,46,64,4,0,68,76,5,0,81,85,6,0,91
174753,31,"COLEGIUL TEHNIC ""EDMOND NICOLAU""",FOCŞANI,VN,1202,6,0,0,6,14,0,0,14,17,4,0,21,24,5,0,29,27,6,0,33
174753,32,"SALA SPORTURILOR",FOCŞANI,VN,1237,11,1,0,12,35,2,0,37,45,2,0,47,65,6,0,71,67,6,0,73
174753,33,"INSPECTORATUL TERITORIAL DE MUNCĂ VRANCEA",FOCŞANI,VN,1354,9,2,0,11,35,5,0,40,57,10,0,67,70,14,0,84,85,14,0,99
174753,34,"DIRECŢIA JUDEŢEANĂ A SPORTURILOR VRANCEA",FOCŞANI,VN,1495,8,2,0,10,23,3,0,26,35,5,0,40,58,7,0,65,60,8,0,68
174753,35,"CENTRUL MEDICAL FOCŞANI",FOCŞANI,VN,1024,13,0,0,13,31,1,0,32,51,2,0,53,66,2,0,68,70,5,0,75
174753,36,"ŞCOALA GIMNAZIALĂ ""DUILIU ZAMFIRESCU""",FOCŞANI,VN,919,4,5,0,9,16,7,0,23,27,8,0,35,41,8,0,49,44,9,0,53
174753,37,"ŞCOALA GIMNAZIALĂ ""DUILIU ZAMFIRESCU""",FOCŞANI,VN,1472,14,0,0,14,46,5,0,51,67,5,0,72,83,7,0,90,94,7,0,101
174753,38,"ŞCOALA GIMNAZIALĂ ""DUILIU ZAMFIRESCU""",FOCŞANI,VN,1661,10,0,0,10,56,0,0,56,72,0,0,72,85,0,0,85,101,0,0,101
174753,39,"LICEUL PEDAGOGIC ""SPIRU HARET""",FOCŞANI,VN,1658,14,2,0,16,46,2,0,48,58,2,0,60,87,2,0,89,92,2,0,94
174753,40,"SC FEDERAL COOP SA",FOCŞANI,VN,1514,10,2,0,12,35,6,0,41,53,10,0,63,71,11,0,82,81,12,0,93
174753,41,"GRĂDINIŢA CU PROGRAM PRELUNGIT NR. 18",FOCŞANI,VN,1042,11,2,0,13,48,2,0,50,69,2,0,71,85,2,0,87,95,2,0,97
174753,42,"COLEGIUL TEHNIC ""ION MINCU""",FOCŞANI,VN,907,7,0,0,7,16,0,0,16,25,0,0,25,35,5,0,40,45,5,0,50
174753,43,"ŞCOALA GIMNAZIALĂ ""NICOLAE IORGA""",FOCŞANI,VN,1465,9,2,0,11,25,3,0,28,35,4,0,39,55,6,0,61,65,7,0,72
174753,44,"ŞCOALA GIMNAZIALĂ ""NICOLAE IORGA""",FOCŞANI,VN,1500,17,0,0,17,37,4,0,41,39,6,0,45,56,6,0,62,56,6,0,62
174753,45,"ŞCOALA GIMNAZIALĂ ""NICOLAE IORGA""",FOCŞANI,VN,1550,10,0,0,10,39,0,0,39,51,0,0,51,68,0,0,68,76,1,0,77
174753,46,"ŞCOALA GIMNAZIALĂ ""ALEXANDRU VLAHUŢĂ""",FOCŞANI,VN,901,10,5,0,15,14,6,0,20,25,9,0,34,32,21,0,53,34,22,0,56
174753,47,"ŞCOALA GIMNAZIALĂ ""ALEXANDRU VLAHUŢĂ""",FOCŞANI,VN,1471,13,0,0,13,33,0,0,33,55,0,0,55,79,0,0,79,88,0,0,88
174753,48,"ŞCOALA GIMNAZIALĂ ""ALEXANDRU VLAHUŢĂ""",FOCŞANI,VN,925,5,4,0,9,15,5,0,20,23,6,0,29,37,6,0,43,38,6,0,44
174753,49,"GRĂDINIŢA CU PROGRAM PRELUNGIT NR. 13",FOCŞANI,VN,1681,14,2,0,16,32,5,0,37,46,5,0,51,70,8,0,78,79,8,0,87
174753,50,"GRĂDINIŢA CU PROGRAM PRELUNGIT NR. 13",FOCŞANI,VN,1796,14,1,0,15,41,2,0,43,59,2,0,61,70,4,0,74,83,4,0,87
174753,51,"GRĂDINIŢA CU PROGRAM PRELUNGIT NR. 1",FOCŞANI,VN,926,3,0,0,3,18,0,0,18,30,0,0,30,41,0,0,41,48,0,0,48
174753,52,"ȘCOALA GIMNAZIALĂ „NICOLAE IORGA”",FOCŞANI,VN,992,12,2,0,14,27,2,0,29,40,3,0,43,59,3,0,62,61,3,0,64
174753,53,"DIRECŢIA SANITAR-VETERINARĂ",FOCŞANI,VN,1672,16,2,0,18,38,3,0,41,45,4,0,49,64,5,0,69,74,6,0,80
174753,54,"GRĂDINIŢA CU PROGRAM PRELUNGIT NR. 8",FOCŞANI,VN,973,5,7,0,12,19,9,0,28,26,9,0,35,32,10,0,42,39,12,0,51
174753,55,"GRĂDINIŢA CU PROGRAM PRELUNGIT NR. 4",FOCŞANI,VN,1729,14,5,0,19,41,9,0,50,60,9,0,69,77,9,0,86,96,10,0,106
174753,56,"SCOALA GIMNAZIALA „NICOLAE IORGA”",FOCŞANI,VN,1685,11,0,0,11,35,0,0,35,45,0,0,45,67,0,0,67,77,0,0,77
174753,57,"GRĂDINIŢA CU PROGRAM PRELUNGIT NR. 17",FOCŞANI,VN,1135,10,1,0,11,36,1,0,37,53,1,0,54,76,2,0,78,84,2,0,86
174753,58,"ŞCOALA GIMNAZIALĂ NR. 3",FOCŞANI,VN,741,1,1,0,2,6,1,0,7,17,8,0,25,24,10,0,34,32,10,0,42
174879,59,"CASA DE CULTURĂ ""TUDOR VORNICU""",ADJUD,VN,972,8,3,0,11,23,10,0,33,27,11,0,38,37,11,0,48,39,11,0,50
174879,60,"SCOALĂ GIMNAZIALĂ ""MIHAIL ARMENCEA""",ADJUD,VN,1077,8,0,0,8,24,1,0,25,41,3,0,44,49,4,0,53,53,4,0,57
174879,61,"SCOALĂ GIMNAZIALĂ ""MAREȘAL ALEXANDRU AVERESCU""",ADJUD,VN,1329,6,1,0,7,13,2,0,15,18,2,0,20,26,2,0,28,26,2,0,28
174879,62,"SCOALĂ GIMNAZIALĂ ""PRINCIPELE RADU""A",ADJUD,VN,1252,5,0,0,5,22,3,0,25,35,7,0,42,43,7,0,50,46,7,0,53
174879,63,"SCOALĂ GIMNAZIALĂ ""PRINCIPELE RADU"" B",ADJUD,VN,1309,12,0,0,12,27,0,0,27,32,0,0,32,40,0,0,40,44,0,0,44
174879,64,"SCOALĂ GIMNAZIALĂ ""PRINCIPELE RADU"" C",ADJUD,VN,1301,3,5,0,8,20,7,0,27,32,7,0,39,46,8,0,54,51,8,0,59
174879,65,"MIXTCOM SRL ADJUD",ADJUD,VN,1477,8,4,0,12,22,6,0,28,31,8,0,39,44,8,0,52,50,8,0,58
174879,66,"SALA DE SPORT",ADJUD,VN,1219,13,0,0,13,24,4,0,28,32,10,0,42,39,10,0,49,41,10,0,51
174879,67,"SCOALĂ GIMNAZIALĂ ""ANGELA GHEORGHIU""",ADJUD,VN,1667,10,7,0,17,33,53,0,86,50,54,0,104,53,55,0,108,59,55,0,114
174879,68,"COLEGIUL TEHNIC ""GHEORGHE BALŞ"" A",ADJUD,VN,1393,6,2,0,8,23,6,0,29,32,8,0,40,40,8,0,48,47,8,0,55
174879,69,"COLEGIUL TEHNIC ""GHEORGHE BALŞ"" B",ADJUD,VN,1040,2,0,0,2,15,0,0,15,18,0,0,18,22,0,0,22,24,2,0,26
174888,70,"SCOALĂ PRIMARA BURCIOAIA",BURCIOAIA,VN,452,2,0,0,2,6,2,0,8,7,2,0,9,16,2,0,18,16,2,0,18
174904,71,"SCOALĂ PRIMARA SISCANI",ŞIŞCANI,VN,698,7,0,0,7,7,0,0,7,8,3,0,11,10,3,0,13,10,3,0,13
174897,72,"SCOALĂ GENERALA ADJUDU VECHI","ADJUDU VECHI",VN,1380,2,0,0,2,10,0,0,10,23,3,0,26,34,3,0,37,35,3,0,38
174931,73,"SCOALA GIMNAZIALĂ ""ECATERINA TEODOROIU""",MĂRĂŞEŞTI,VN,1384,9,0,0,9,19,1,0,20,26,1,0,27,36,4,0,40,37,4,0,41
174931,74,"SCOALA PRIMARĂ ""SIRETU""",MĂRĂŞEŞTI,VN,1638,1,0,0,1,4,0,0,4,9,0,0,9,13,0,0,13,13,0,0,13
174931,75,"CLUBUL ELEVILOR",MĂRĂŞEŞTI,VN,791,4,1,0,5,9,1,0,10,11,1,0,12,14,1,0,15,15,1,0,16
174931,76,"LICEUL TEHNOLOGIC ""EREMIA GRIGORESCU""",MĂRĂŞEŞTI,VN,1693,6,1,0,7,26,1,0,27,30,1,0,31,44,1,0,45,46,2,0,48
174931,77,"LICEUL TEHNOLOGIC ''EREMIA GRIGORESCU""",MĂRĂŞEŞTI,VN,1439,14,0,0,14,24,0,0,24,30,0,0,30,40,0,0,40,42,0,0,42
174931,78,"SCOALA GENERALA NR.2",MĂRĂŞEŞTI,VN,1177,9,4,0,13,18,4,0,22,27,4,0,31,32,4,0,36,41,4,0,45
174931,79,"STATIE CFR MARASESTI",MĂRĂŞEŞTI,VN,296,3,0,0,3,5,2,0,7,10,2,0,12,10,3,0,13,11,4,0,15
174968,80,"ŞCOALA PRIMARĂ HARET",HARET,VN,491,1,2,0,3,2,3,0,5,2,3,0,5,2,6,0,8,4,6,0,10
174995,81,"ŞCOALA PRIMARĂ PĂDURENI",PĂDURENI,VN,423,7,0,0,7,16,2,0,18,22,4,0,26,31,6,0,37,35,6,0,41
174977,82,"ŞCOALA PRIMARĂ CĂLIMĂNEŞTI",CĂLIMĂNEŞTI,VN,449,7,0,0,7,8,0,0,8,10,0,0,10,14,0,0,14,14,0,0,14
174959,83,"ŞCOALA PRIMARĂ DOAGA",TIŞIŢA,VN,225,2,0,0,2,5,0,0,5,6,0,0,6,9,0,0,9,12,0,0,12
175028,84,"BIBLIOTECA ORASENEASCA ""ANA GEORGESCU""",ODOBEŞTI,VN,1598,12,3,0,15,25,6,0,31,41,8,0,49,59,9,0,68,62,9,0,71
175028,85,"LICEUL TEORETIC""DUILIU ZAMFIRESCU"" ODOBESTI",ODOBEŞTI,VN,1640,17,4,0,21,43,10,0,53,55,12,0,67,77,13,0,90,86,14,0,100
175028,86,"GRUPUL SCOLAR AGRICOL ODOBESTI",ODOBEŞTI,VN,1591,15,2,0,17,31,3,0,34,37,3,0,40,47,3,0,50,51,4,0,55
175028,87,"GRADINITA NR.2CARAGEA",ODOBEŞTI,VN,931,3,3,0,6,11,4,0,15,22,8,0,30,28,10,0,38,28,12,0,40
175037,88,"ȘCOALA PRIMARĂ UNIREA ODOBEȘTI",UNIREA,VN,755,2,4,0,6,5,4,0,9,9,4,0,13,11,4,0,15,11,6,0,17
175037,89,"SCOALA GENERALA UNIREA",UNIREA,VN,1368,6,2,0,8,14,2,0,16,23,2,0,25,29,2,0,31,34,2,0,36
175064,90,"CASA DE CULTURA A ORASULUI PANCIU",PANCIU,VN,1406,20,0,0,20,34,0,0,34,49,0,0,49,68,0,0,68,68,3,0,71
175064,91,"SCOALA GENERALA NR. 1",PANCIU,VN,1305,9,4,0,13,24,9,0,33,39,10,0,49,62,11,0,73,64,11,0,75
175064,92,"FOSTUL SEDIU BANCPOST",PANCIU,VN,1029,5,0,0,5,13,0,0,13,19,0,0,19,24,0,0,24,26,0,0,26
175064,93,"SPITALUL ORASENESC",PANCIU,VN,1197,17,4,0,21,32,8,0,40,41,10,0,51,48,17,0,65,53,17,0,70
175117,94,"SCOALA GENERALA SATU-NOU","SATU NOU",VN,837,5,0,0,5,13,0,0,13,17,0,0,17,25,1,0,26,26,1,0,27
175073,95,"CLUBUL DE SOCIALIZARE CRUCEA DE JOS","CRUCEA DE JOS",VN,389,6,0,0,6,8,6,0,14,9,6,0,15,15,6,0,21,15,7,0,22
175091,96,"SCOALA GENERALA DUMBRAVA",DUMBRAVA,VN,402,7,0,0,7,10,0,0,10,13,0,0,13,15,0,0,15,15,0,0,15
175082,97,"SCOALA GENERALA CUCEA DE SUS","CRUCEA DE SUS",VN,724,14,3,0,17,34,3,0,37,40,3,0,43,42,3,0,45,43,4,0,47
175108,98,"CAMINUL CULTURAL NEICU",NEICU,VN,543,6,0,0,6,17,7,0,24,23,7,0,30,25,7,0,32,26,7,0,33
175135,99,"ȘCOALAGIMNAZIALĂANDREIAȘU DE JOS","ANDREIAŞU DE JOS",VN,476,9,0,0,9,10,1,0,11,11,4,0,15,11,4,0,15,13,4,0,17
175180,100,"ȘCOALAPRIMARĂ NR.1 RĂCHITAȘU",RĂCHITAŞU,VN,574,0,0,0,0,3,0,0,3,8,0,0,8,11,0,0,11,11,3,0,14
175144,101,"ȘCOALAGIMNAZIALĂANDREIAȘU DE SUS","ANDREIAŞU DE SUS",VN,393,3,0,0,3,4,0,0,4,9,0,0,9,10,0,0,10,10,0,0,10
175215,102,"SCOALA GIMNAZIALA CU CLASELE I-VIII BALESTI",BĂLEŞTI,VN,853,4,0,0,4,16,2,0,18,26,2,0,28,33,5,0,38,36,5,0,41
175215,103,"SCOALA GIMNAZIALA CU CLASELE I-VIII BALESTI",BĂLEŞTI,VN,722,5,0,0,5,15,1,0,16,23,3,0,26,29,3,0,32,31,4,0,35
175233,104,"CAMIN CULTURAL(SALA FESTIVITATI)",BÂRSEŞTI,VN,1196,10,0,0,10,23,0,0,23,28,0,5,33,37,4,12,53,40,4,17,61
177860,105,"SCOALA GIMNAZIALA BILIESTI",BILIEŞTI,VN,1021,7,2,0,9,18,3,0,21,23,3,0,26,28,5,0,33,33,5,0,38
177860,106,"SCOALA GENERALA NR. 2 BILIESTI",BILIEŞTI,VN,1046,4,2,0,6,11,4,7,22,36,7,7,50,48,12,7,67,50,12,7,69
175279,107,PRIMARIE,BOGHEŞTI,VN,679,5,0,0,5,6,1,0,7,6,2,0,8,10,2,0,12,11,2,0,13
175340,108,SCOALA,PRISECANI,VN,427,7,0,0,7,7,1,0,8,7,1,0,8,8,1,0,9,12,1,0,13
175313,109,"SCOALA IUGANI",IUGANI,VN,125,1,2,0,3,2,1,0,3,3,3,0,6,3,3,0,6,4,4,0,8
175377,110,"CAMINUL CULTURAL BOLOTESTI",BOLOTEŞTI,VN,608,4,2,0,6,8,3,0,11,12,5,0,17,15,8,0,23,18,9,0,27
175411,111,"SCOALA GIMNAZIALA PUTNA",PUTNA,VN,525,5,1,0,6,8,1,0,9,9,1,0,10,12,2,0,14,12,2,0,14
175395,112,"SCOALA CU CL. I - IV IVANCESTI",IVĂNCEŞTI,VN,368,0,0,0,0,1,1,0,2,1,1,0,2,3,5,0,8,3,6,0,9
175386,113,"SCOALA GIMNAZIALA GAGESTI",GĂGEŞTI,VN,1275,5,1,0,6,6,1,0,7,8,1,0,9,11,1,0,12,13,1,0,14
175386,114,"SCOALA GIMNAZIALA GAGESTI",GĂGEŞTI,VN,490,1,2,0,3,2,2,0,4,3,2,0,5,7,4,0,11,7,4,0,11
175420,115,"SCOALA CU CLASELE I - IV VITANESTII DE SUB MAGURA","VITĂNEŞTII DE SUB MĂGURĂ",VN,595,4,0,0,4,5,0,0,5,7,0,0,7,15,2,0,17,17,2,0,19
175448,116,"CAMINUL CULTURAL",BORDEŞTI,VN,1017,6,0,0,6,7,2,0,9,14,2,0,16,16,2,0,18,26,2,0,28
175457,117,"SCOALA CU CLASELE I-IV","BORDEŞTII DE JOS",VN,416,3,2,0,5,12,2,0,14,15,5,0,20,17,6,0,23,21,10,0,31
175475,118,"CAMIN CULTURAL",BROŞTENI,VN,1354,7,0,0,7,15,10,0,25,28,10,0,38,36,12,0,48,41,13,0,54
175484,119,GRADINITA,ARVA,VN,514,2,0,0,2,5,2,0,7,5,3,0,8,9,3,0,12,9,3,0,12
175518,120,"GRĂDINIȚA CU PROGRAM NORMAL CHIOJDENI",CHIOJDENI,VN,796,0,0,0,0,1,0,0,1,2,0,0,2,4,0,0,4,6,0,0,6
175527,121,"ȘCOALA PRIMARĂ CĂTĂUȚI",CĂTĂUŢI,VN,288,1,0,0,1,3,0,0,3,4,0,0,4,4,0,0,4,4,0,0,4
175545,122,"ȘCOALA PRIMARĂ LUNCILE",LUNCILE,VN,740,2,0,0,2,5,0,0,5,10,1,0,11,15,2,0,17,17,2,0,19
175607,123,"CAMIN CULTURAL CIORASTI",CIORĂŞTI,VN,711,6,2,0,8,14,4,0,18,17,4,0,21,32,7,0,39,34,7,0,41
175616,124,"MAGAZIN SC SAND VAD SRL",CODREŞTI,VN,170,1,0,0,1,2,0,0,2,4,2,0,6,5,5,0,10,6,6,0,12
175625,125,"SCOALA PRIMARA MIHALCENI",MIHĂLCENI,VN,563,4,0,0,4,5,1,0,6,12,2,0,14,14,2,0,16,20,2,0,22
175634,126,"CAMIN CULTURAL SAT SALCIA NOUA","SALCIA NOUĂ",VN,339,6,3,0,9,31,10,0,41,49,11,0,60,57,11,0,68,60,11,0,71
175643,127,"SCOALA SALCIA VECHE","SALCIA VECHE",VN,235,3,0,0,3,12,1,0,13,19,1,0,20,26,1,0,27,26,1,0,27
175652,128,"SCOALA SATU NOU","SATU NOU",VN,206,0,2,0,2,3,3,0,6,7,3,0,10,7,4,0,11,10,4,0,14
175661,129,"SC OVION COM SERV SRL",SPĂTĂREASA,VN,164,0,0,0,0,4,1,0,5,6,1,0,7,12,2,0,14,16,2,0,18
174799,130,"SCOALA PRIMARA CIMPINEANCA",CÎMPINEANCA,VN,1870,9,1,0,10,27,7,0,34,46,10,0,56,67,10,0,77,69,10,0,79
174799,131,"SCOALA PRIMARA CIMPINEANCA",CÎMPINEANCA,VN,1608,6,0,0,6,13,0,0,13,39,1,0,40,61,1,0,62,64,3,0,67
175689,132,"SCOALA PRIMARA CÎMPURI",CÎMPURI,VN,825,5,0,0,5,9,0,0,9,18,2,0,20,24,6,0,30,32,8,0,40
175689,133,"ŞCOALA GIMNAZIALA CÎMPURI",CÎMPURI,VN,900,4,5,0,9,6,5,0,11,13,7,0,20,15,9,0,24,15,9,0,24
175723,134,"SCOALA GIMNAZIALA ROTILESTII MICI","ROTILEŞTII MICI",VN,534,2,0,0,2,7,0,0,7,11,0,0,11,13,4,0,17,13,4,0,17
175698,135,"SCOALA PRIMARA FETESTI",FETEŞTI,VN,764,3,0,0,3,4,7,0,11,7,7,0,14,10,8,0,18,10,8,0,18
175741,136,"CĂMIN CULTURAL",CÎRLIGELE,VN,1061,6,4,0,10,18,5,0,23,25,6,0,31,30,7,0,37,31,9,0,40
175750,137,"SCOALA BLIDARI",BLIDARI,VN,465,4,0,0,4,4,4,0,8,8,5,0,13,13,13,0,26,13,13,0,26
175769,138,"ȘCOALA GIMNAZIALĂ CU CLASELE I-IV ,, EPISCOP MITROFAN ,,",BONŢEŞTI,VN,383,1,2,0,3,2,3,0,5,8,5,0,13,8,8,0,16,12,9,0,21
175778,139,GRĂDINIȚĂ,DĂLHĂUŢI,VN,560,5,3,0,8,16,42,0,58,24,43,0,67,27,44,0,71,27,44,0,71
175796,140,PRIMARIE,ŞERBĂNEŞTI,VN,346,1,0,0,1,4,4,0,8,9,4,0,13,14,5,0,19,15,5,0,20
175803,141,"SCOALA PRIMARA BUDA",BUDA,VN,413,1,0,0,1,5,0,0,5,8,0,0,8,14,2,0,16,18,2,0,20
175858,142,"SCOALA RADACINESTI",RĂDĂCINEŞTI,VN,355,2,1,0,3,7,3,0,10,12,6,0,18,13,6,0,19,16,6,0,22
175849,143,"SCOALA OCHEŞEŞTI",OCHEŞEŞTI,VN,273,3,0,0,3,8,0,0,8,10,0,0,10,12,0,0,12,13,0,0,13
175894,144,"SCOALAGENERALA COTESTI",COTEŞTI,VN,1119,6,3,0,9,17,3,0,20,25,5,0,30,30,5,0,35,35,5,0,40
175894,145,"SCOALA PRIMARA COTESTI",COTEŞTI,VN,464,2,0,0,2,3,1,0,4,6,2,0,8,10,4,0,14,11,4,0,15
175901,146,"CAMINUL CULTURAL BUDESTI",BUDEŞTI,VN,1511,11,1,0,12,22,7,0,29,34,7,0,41,43,9,0,52,43,9,0,52
175929,147,"SCOALA VALEA COTESTI","VALEA COTEŞTI",VN,574,0,1,0,1,2,1,0,3,3,1,0,4,5,1,0,6,5,2,0,7
175910,148,"GRADINITA GOLESTII DE SUS","GOLEŞTII DE SUS",VN,346,4,0,0,4,12,0,0,12,14,0,0,14,22,2,0,24,23,2,0,25
175947,149,"CAMIN CULTURAL DUMBRAVENI",DUMBRĂVENI,VN,1617,10,0,0,10,19,0,0,19,29,0,0,29,35,4,0,39,39,4,0,43
175965,150,"SCOALA GIMNAZIALA CINDESTI",CÎNDEŞTI,VN,1153,1,1,0,2,8,3,0,11,17,5,0,22,24,5,0,29,26,5,0,31
175947,151,"ȘCOALA PRIMARĂ ALEXANDRU VLAHUȚĂ DRAGOSLOVENI",DUMBRĂVENI,VN,917,1,0,0,1,1,0,0,1,6,4,0,10,9,4,0,13,10,4,0,14
175992,152,"LICEUL TEORETIC ''GRIGORE GHEBA'' DUMITREȘTI",DUMITREŞTI,VN,622,4,0,0,4,9,0,0,9,15,1,0,16,17,9,0,26,21,12,0,33
176043,153,"ȘCOALAPRIMARĂ DUMITREȘTIIDE SUS","DUMITREŞTII DE SUS",VN,225,3,2,0,5,3,2,0,5,3,2,0,5,5,2,0,7,6,3,0,9
176089,154,"ȘCOALAPRIMARĂ MOTNĂU",MOTNĂU,VN,286,1,0,0,1,5,0,0,5,5,0,0,5,13,0,0,13,13,0,0,13
176132,155,"ȘCOALA PRIMARĂ TRESTIA",TRESTIA,VN,134,0,0,0,0,0,0,0,0,0,0,0,0,5,0,0,5,6,0,0,6
176123,156,"ȘCOALAPRIMARĂ TINOASA",TINOASA,VN,142,0,0,0,0,0,0,0,0,3,0,0,3,4,0,0,4,4,0,0,4
176061,157,ȘCOALAGIMNAZIALĂLĂSTUNI,LĂSTUNI,VN,272,5,1,0,6,8,1,0,9,9,1,0,10,12,1,0,13,12,2,0,14
176098,158,"ȘCOALAPRIMARĂ POIENIȚA",POIENIŢA,VN,189,2,1,0,3,3,2,0,5,7,2,0,9,7,2,0,9,7,2,0,9
176034,159,"ȘCOALAPRIMARĂ DUMITREȘTII - FAȚĂ",DUMITREŞTII-FAŢĂ,VN,175,1,4,0,5,5,9,0,14,7,9,0,16,9,9,4,22,17,9,4,30
176016,160,"ȘCOALA PRIMARĂBICEȘTIIDE SUS","BICEŞTII DE SUS",VN,611,2,0,0,2,5,1,0,6,9,1,0,10,11,3,0,14,15,3,0,18
176052,161,"ȘCOALAPRIMARĂ GĂLOIEȘTI",GĂLOIEŞTI,VN,470,3,0,0,3,4,0,0,4,5,0,0,5,11,2,0,13,12,2,0,14
176007,162,"ȘCOALAPRIMARĂ BICEȘTII DE JOS","BICEŞTII DE JOS",VN,536,4,0,0,4,15,4,0,19,28,4,0,32,40,5,0,45,44,5,0,49
176169,163,"CĂMIN CULTURAL",FITIONEŞTI,VN,703,0,0,0,0,3,0,0,3,7,1,0,8,8,1,0,9,12,1,0,13
176169,164,"SCOALA CU CLASELE I-IV PISC",FITIONEŞTI,VN,557,0,0,0,0,6,2,0,8,6,3,0,9,7,3,0,10,12,3,0,15
176187,165,"GRADINITA GHIMICESTI",GHIMICEŞTI,VN,338,4,3,0,7,8,3,0,11,8,6,0,14,8,6,0,14,9,6,0,15
176203,166,"SCOALA I-IV MANASTIOARA",MĂNĂSTIOARA,VN,485,2,0,0,2,5,0,0,5,5,0,0,5,11,0,0,11,12,0,0,12
176203,167,"CENTRUL DE ZI SOCIO-EDUCATIONAL MULTIFUNCTIONAL COMUNA FITIONESTI",MĂNĂSTIOARA,VN,133,1,4,0,5,1,9,0,10,1,9,0,10,1,9,0,10,1,9,0,10
176221,168,"CAMINUL CULTURAL",GAROAFA,VN,1591,7,0,0,7,17,2,0,19,32,3,0,35,37,4,0,41,39,4,0,43
176230,169,"ŞCOALA PRIMARĂ",BIZIGHEŞTI,VN,596,7,3,0,10,11,3,0,14,13,3,0,16,21,3,0,24,24,3,0,27
176258,170,ŞCOALA,DOAGA,VN,373,2,4,0,6,3,4,0,7,4,4,0,8,9,5,0,14,9,5,0,14
176249,171,"ŞCOALA GIMNAZIALĂ ""PETRACHE BLÎNDU""",CIUŞLEA,VN,1305,10,3,0,13,30,9,0,39,52,17,0,69,84,21,0,105,86,25,0,111
174833,172,"ŞCOALA GIMNAZIALĂ GOLEŞTI",GOLEŞTI,VN,1379,16,0,0,16,23,2,0,25,42,4,0,46,51,5,0,56,58,5,0,63
174833,173,"CĂMIN CULTURAL GOLEŞTI",GOLEŞTI,VN,1887,16,1,0,17,34,7,0,41,56,7,0,63,65,7,0,72,69,7,0,76
174842,174,"GRĂDINIŢA GOLEŞTI",CEARDAC,VN,556,1,0,0,1,10,0,0,10,14,0,0,14,19,0,0,19,21,0,0,21
176766,175,"GRĂDINIȚA CU PROGRAM NORMAL GOLOGANU",GOLOGANU,VN,1190,6,3,0,9,8,3,0,11,19,3,0,22,22,3,0,25,22,3,0,25
176766,176,"ȘCOALA GIMNAZIALĂ ”PROF. GENERAL GHEORGHE GHEORGHIU” GOLOGANU",GOLOGANU,VN,1449,4,0,0,4,13,0,0,13,20,6,0,26,27,7,0,34,29,7,0,36
176310,177,"CĂMINUL CULTURAL „NICOLAE CIORĂSCU” GUGEŞTI",GUGEŞTI,VN,1641,7,0,0,7,22,0,0,22,32,0,0,32,40,0,0,40,42,1,0,43
176310,178,"ŞCOALAGIMNAZIALĂ NR.2 GUGEŞTI",GUGEŞTI,VN,1492,9,2,0,11,16,3,0,19,19,4,0,23,29,5,0,34,31,5,0,36
176310,179,"GRĂDINIȚACU PROGRAM NORMAL NR.3 GUGEŞTI",GUGEŞTI,VN,901,6,2,0,8,18,2,0,20,33,4,0,37,43,4,0,47,45,6,0,51
176310,180,"ŞCOALAGIMNAZIALĂ ,,ALEXANDRUVLAHUȚĂ” GUGEŞTI",GUGEŞTI,VN,1016,14,1,0,15,24,1,0,25,30,1,0,31,41,1,0,42,41,1,0,42
176329,181,"ŞCOALAGIMNAZIALĂ NR.4 OREAVU",OREAVU,VN,444,4,2,0,6,9,4,0,13,14,6,0,20,19,6,0,25,21,6,0,27
176347,182,"SCOALA GENERALA GURA CALITEI","GURA CALIŢEI",VN,828,7,1,0,8,8,1,0,9,11,1,0,12,13,1,0,14,13,1,0,14
176347,183,"SCOALA GENERALA LACU LUI BABAN","GURA CALIŢEI",VN,377,2,1,0,3,2,2,0,4,4,2,0,6,7,2,0,9,7,2,0,9
176347,184,"SCOALA GENERALA POIENILE","GURA CALIŢEI",VN,321,2,0,0,2,4,0,0,4,4,1,0,5,5,2,0,7,5,2,0,7
176347,185,"SCOALA GENERALA PLOPU","GURA CALIŢEI",VN,277,3,0,0,3,7,0,0,7,9,0,0,9,9,1,0,10,11,1,0,12
176347,186,"SCOALA GENERALA DEALUL LUNG","GURA CALIŢEI",VN,340,3,0,0,3,4,0,0,4,6,0,0,6,8,0,0,8,9,0,0,9
176454,187,"CAMINUL CULTURAL",HOMOCEA,VN,1564,3,0,0,3,14,0,0,14,23,0,0,23,28,0,0,28,31,2,0,33
176481,188,"CAMINUL CULTURAL",LESPEZI,VN,1047,2,3,0,5,5,4,0,9,7,4,0,11,9,5,0,14,13,5,0,18
176472,189,"SCOALA CU CLASELE I-IV",COSTIŞA,VN,295,2,0,0,2,3,0,0,3,5,0,0,5,5,0,0,5,5,0,0,5
176454,190,"GRADINITA NR. 1 CENTRU HOMOCEA",HOMOCEA,VN,1659,4,5,0,9,16,6,0,22,20,6,0,26,26,8,0,34,30,8,0,38
176454,191,"SCOALA CU CLASELE I-VIII",HOMOCEA,VN,1263,2,0,0,2,7,3,0,10,15,4,0,19,19,4,0,23,22,4,0,26
176515,192,"SCOALA GIMNAZIALA JARISTEA",JARIŞTEA,VN,1682,5,5,0,10,17,5,0,22,20,5,0,25,25,5,0,30,28,8,0,36
176515,193,"SCOALA PRIMARA NR 2 MARGINEA",JARIŞTEA,VN,699,4,1,0,5,7,2,0,9,12,4,0,16,17,4,0,21,17,5,0,22
176542,194,"SCOALA PRIMARA VARSATURA",VĂRSĂTURA,VN,470,2,0,0,2,10,0,0,10,10,0,0,10,16,0,0,16,21,0,0,21
176524,195,"SCOALA PRIMARA PADURENI",PĂDURENI,VN,393,6,2,0,8,6,4,0,10,9,4,0,13,16,10,0,26,16,10,0,26
176533,196,"SCOALA PRIMARA SCINTEIA",SCÎNTEIA,VN,170,2,2,0,4,3,3,0,6,3,3,0,6,4,3,0,7,5,3,0,8
176560,197,"SCOALA CU CLASELE I-IV JITIA",JITIA,VN,797,7,0,0,7,12,0,0,12,13,0,0,13,17,0,0,17,20,0,0,20
176597,198,"SCOALA CU CLASELE I-IV JITIA DE JOS NR.1","JITIA DE JOS",VN,328,5,2,0,7,6,2,0,8,8,4,0,12,8,5,0,13,8,5,0,13
176588,199,"SCOALA CU CLASELE I-IV DEALU SARII","DEALU SĂRII",VN,153,3,0,0,3,12,0,0,12,14,0,0,14,15,0,0,15,16,0,0,16
176622,200,"SCOALA GIMNAZIALA MAICANESTI",MĂICĂNEŞTI,VN,1189,10,1,0,11,28,3,0,31,50,4,0,54,54,5,0,59,59,5,0,64
176622,201,"SCOALAGENERALA TATARU",MĂICĂNEŞTI,VN,682,3,0,0,3,8,0,0,8,13,0,0,13,16,0,0,16,20,0,0,20
176640,202,"SCOALA GIMNAZIALA RIMNICENI",RÎMNICENI,VN,1279,11,1,0,12,24,2,0,26,33,6,0,39,54,6,0,60,68,6,0,74
176622,203,"SCOALA GENERALA SLOBOZIA-BOTESTI",MĂICĂNEŞTI,VN,233,3,0,0,3,3,0,0,3,5,0,0,5,10,3,0,13,10,4,0,14
176622,204,SCOALAGENERALASATU-NOU,MĂICĂNEŞTI,VN,228,2,2,0,4,13,5,0,18,19,5,0,24,27,8,0,35,28,8,0,36
176622,205,"GRADINITA CU PROGRAM NORMAL STUPINA",MĂICĂNEŞTI,VN,295,1,0,0,1,3,1,0,4,13,1,0,14,14,2,0,16,14,2,0,16
176695,206,"CĂMINUL CULTURAL ""DIMITRIE CANTEMIR""",MERA,VN,1620,7,2,0,9,15,2,0,17,17,2,0,19,20,2,0,22,20,2,0,22
176739,207,"SCOALA VULCANEASA",VULCĂNEASA,VN,1599,2,0,0,2,5,0,0,5,15,1,0,16,21,4,0,25,22,4,0,26
176757,208,"ȘCOALA GIMNAZIALĂ MILCOVUL",MILCOVUL,VN,1109,4,2,0,6,7,4,0,11,13,5,0,18,22,11,0,33,25,11,0,36
176757,209,"ȘCOALA GIMNAZIALĂ MILCOVUL",MILCOVUL,VN,1097,3,0,0,3,8,0,0,8,25,1,0,26,36,1,0,37,40,1,0,41
176775,210,"GRĂDINIȚA CU PROGRAM NORMAL LĂMOTEȘTI",LĂMOTEŞTI,VN,861,11,0,0,11,14,3,0,17,31,3,0,34,37,8,0,45,37,8,0,45
176819,211,"SCOALA PRIMARA DIOCHETI-REDIU",DIOCHEŢIREDIU,VN,580,1,0,0,1,5,0,0,5,8,0,0,8,11,0,0,11,12,0,0,12
176800,212,"GRADINITA SPERIETI",MOVILIŢA,VN,388,2,1,0,3,4,1,0,5,7,3,0,10,11,3,0,14,11,4,0,15
176800,213,"SCOALA NR.2",MOVILIŢA,VN,676,8,1,0,9,11,1,0,12,13,2,0,15,16,2,0,18,17,2,0,19
176800,214,"SCOALA NR.1",MOVILIŢA,VN,734,6,1,0,7,7,1,0,8,10,2,0,12,11,2,0,13,11,4,0,15
176837,215,"SCOALA PRIMARA TROTUSANU",TROTUŞANU,VN,380,1,1,0,2,2,2,0,4,4,2,0,6,14,5,0,19,16,5,0,21
176828,216,"SCOALA PRIMARA FRECATEI",FRECĂŢEI,VN,408,0,0,0,0,1,0,0,1,2,0,0,2,2,0,0,2,3,0,0,3
176864,217,"CAMIN CULTURAL NANESTI",NĂNEŞTI,VN,1077,5,5,0,10,11,8,0,19,12,9,0,21,15,12,0,27,17,15,0,32
176882,218,"CAMIN CULTURAL CALIENII-VECHI","CĂLIENII VECHI",VN,585,4,1,0,5,9,2,0,11,16,5,0,21,19,6,0,25,20,8,0,28
176873,219,"SCOALA CALIENII-NOI","CĂLIENII NOI",VN,272,1,1,0,2,5,3,0,8,6,5,0,11,6,6,0,12,6,6,0,12
176908,220,"CĂMINUL CULTURAL",NĂRUJA,VN,1004,6,4,0,10,11,9,0,20,23,11,0,34,24,11,0,35,33,11,0,44
176917,221,"ŞCOALA CU CLASELE I-IV","PODU NĂRUJEI",VN,540,0,0,0,0,8,0,0,8,17,0,0,17,22,1,0,23,24,2,0,26
175242,222,"ȘCOALA GIMNAZIALĂ ,,DUMITRU PRICOP''",NEGRILEŞTI,VN,1428,13,0,0,13,33,3,0,36,51,4,35,90,60,7,35,102,61,7,35,103
176953,223,"SCOALA "" DIMITRIE GUSTI""NEREJU",NEREJU,VN,1408,10,6,0,16,28,6,0,34,42,6,0,48,53,7,0,60,56,7,0,63
176980,224,"SCOALA GIMNAZIALA NEREJU-MIC","NEREJU MIC",VN,1466,8,0,0,8,27,0,0,27,39,0,0,39,39,0,0,39,56,0,0,56
176980,225,"INTERNAT SCOLAR","NEREJU MIC",VN,587,1,1,0,2,6,1,0,7,8,1,0,9,10,3,0,13,10,3,0,13
177095,226,"ȘCOALA GIMNAZIALĂ NISTOREȘTI",BÎTCARI,VN,919,5,0,0,5,7,0,0,7,10,0,12,22,14,2,31,47,14,2,31,47
177094,227,"CĂMINUL CULTURAL",VETREŞTI-HERĂSTRĂU,VN,837,1,0,5,6,6,0,24,30,19,4,40,63,20,4,49,73,21,4,49,74
178064,228,"SCOALA GIMNAZIALĂ OBREJIŢA",OBREJIŢA,VN,1284,7,0,0,7,12,0,0,12,20,0,0,20,24,0,0,24,24,0,0,24
177110,229,"CAMIN CULTURAL PALTIN",PALTIN,VN,1122,9,1,0,10,14,2,0,16,28,6,0,34,34,8,0,42,38,11,0,49
177110,230,"CAMIN CULTURAL PRAHUDA",PALTIN,VN,468,1,3,0,4,9,3,0,12,9,3,0,12,18,5,0,23,23,8,0,31
178171,231,"CAMIN CULTURAL PĂULEȘTI",PĂULEŞTI,VN,621,13,0,0,13,16,0,0,16,21,1,0,22,23,1,0,24,26,1,0,27
178171,232,"ŞCOALA CU CLASELE I-IV FUNDATURA",PĂULEŞTI,VN,435,6,3,0,9,11,3,0,14,22,4,0,26,26,4,0,30,26,4,0,30
178153,233,"CĂMINUL CULTURAL HĂULIȘCA",HĂULIŞCA,VN,556,4,3,0,7,13,5,0,18,18,8,0,26,27,12,0,39,29,12,0,41
177245,234,"SCOALA PRIMARA SURLEA",PĂUNEŞTI,VN,1126,1,0,0,1,3,0,0,3,3,0,0,3,9,0,0,9,9,0,0,9
177245,235,"SCOALA PRIMARA NOVACESTI",PĂUNEŞTI,VN,1461,3,0,0,3,7,1,0,8,11,4,0,15,21,4,0,25,22,5,0,27
177245,236,"SCOALA PRIMARA BOSTANESTI",PĂUNEŞTI,VN,925,5,3,0,8,6,3,0,9,7,4,0,11,8,4,0,12,8,4,0,12
177254,237,"GRADINITA CU PROGRAM NORMAL VIISOARA",VIIŞOARA,VN,810,1,1,0,2,4,1,0,5,6,1,0,7,12,1,0,13,14,2,0,16
177245,238,"CAMIN CULTURAL PAUNESTI",PĂUNEŞTI,VN,1105,3,6,0,9,7,6,0,13,9,7,0,16,9,7,0,16,9,7,0,16
176490,239,"SCOALA GENERALA NR.1, CORP A",PLOSCUŢENI,VN,1003,9,0,0,9,14,0,0,14,16,1,0,17,18,1,0,19,19,1,0,20
176490,240,"SCOALA GENERALA NR.1, CORP B",PLOSCUŢENI,VN,1126,14,2,0,16,19,3,0,22,27,4,0,31,31,4,0,35,35,4,0,39
176463,241,"SCOALA PRIMARA SAT ARGEA",ARGEA,VN,339,3,0,0,3,6,0,0,6,9,0,0,9,12,0,0,12,12,0,0,12
177272,242,"CAMIN CULTURAL POIANA CRISTEI, PRIMARIA COMUNEI POIANA CRISTEI","POIANA CRISTEI",VN,946,11,1,0,12,15,1,0,16,19,1,0,20,29,1,0,30,33,2,0,35
177334,243,"SCOALA CU CLASELE I-IV SAT PODU LACULUI, SCOALA COORDONATOARE POIANA CRISTEI","PODU LACULUI",VN,529,4,1,0,5,6,2,0,8,10,3,0,13,20,4,0,24,21,4,0,25
177307,244,"SCOALA CU CLASELE I-IV SAT MAHRIU, SCOALA COORDONATORARE POIANA CRISTEI",MAHRIU,VN,317,1,0,0,1,1,0,0,1,3,0,0,3,6,0,0,6,9,0,0,9
177325,245,"SCOALA CU CLASELE I-IV SAT PETREANU. SCOALA COORDONATOARE POIANA CRISTEI",PETREANU,VN,123,0,0,0,0,2,1,0,3,5,1,0,6,7,1,0,8,9,4,0,13
177343,246,"SCOALA CU CLASELE I-VIII SAT TIRITU, SCOALA COORDONATOARE POIANA CRISTEI",TÎRÎTU,VN,232,5,0,0,5,8,0,0,8,11,0,0,11,17,2,0,19,25,2,0,27
178297,247,"SCOALA GIMNAZIALA PROFESOR DOCTOR GENERAL GHEORGHE V. ZAHARIA",POPEŞTI,VN,1130,2,0,0,2,7,2,0,9,8,3,0,11,18,3,0,21,18,4,0,22
178297,248,"GRĂDINIȚA CU PROGRAMNORMAL NR.2 POPEȘTI",POPEŞTI,VN,921,0,0,0,0,6,0,0,6,6,0,0,6,9,0,0,9,14,0,0,14
178304,249,"SCOALA PRIMARA TERCHESTI",TERCHEŞTI,VN,505,1,0,0,1,2,0,0,2,6,0,0,6,6,0,0,6,8,1,0,9
177361,250,"ŞCOALA GIMNAZIALĂPUFEŞTI",PUFEŞTI,VN,1318,5,0,0,5,13,0,0,13,26,1,0,27,28,2,0,30,31,2,0,33
177370,251,"GRĂDINIŢA CIORANI",CIORANI,VN,817,8,0,0,8,10,3,0,13,14,4,0,18,17,5,0,22,18,6,0,24
177398,252,"ŞCOALA GIMNAZIALĂ DOMNEŞTI",DOMNEŞTI-TÎRG,VN,1233,3,1,0,4,13,1,0,14,18,1,0,19,23,2,0,25,25,2,0,27
177414,253,"SCOALA GENERALA RACOASA",RĂCOASA,VN,916,5,1,0,6,9,1,0,10,13,1,0,14,23,4,0,27,24,4,0,28
177423,254,"SCOALA PRIMARA GOGOIU",GOGOIU,VN,179,0,0,0,0,0,0,0,0,0,0,0,0,5,0,0,5,5,0,0,5
177432,255,"SCOALA PRIMARA MARASTI",MĂRĂŞTI,VN,434,1,1,0,2,4,1,0,5,5,1,0,6,9,4,0,13,9,4,0,13
177441,256,"SCOALA PRIMARA VARNITA",VARNIŢA,VN,448,5,2,0,7,7,3,0,10,8,3,0,11,12,3,0,15,15,4,0,19
177450,257,"SCOALA PRIMARA VERDEA",VERDEA,VN,588,0,1,0,1,2,1,0,3,6,1,0,7,9,1,0,10,11,1,0,12
176784,258,"ŞCOALA GIMNAZIALĂ CU CLASELE I-VIII RĂSTOACA",RĂSTOACA,VN,1242,10,0,0,10,21,1,0,22,29,1,0,30,32,1,0,33,35,1,0,36
176784,259,"ŞCOALA GIMNAZIALĂ CU CLASELE I-VIII RĂSTOACA",RĂSTOACA,VN,864,4,2,0,6,11,2,0,13,19,2,0,21,22,2,0,24,27,2,0,29
177520,260,"SCOALA GIMNAZIALA SINDRILARI NR. 1",ŞINDRILARI,VN,985,4,1,0,5,12,1,0,13,20,2,0,22,22,4,0,26,24,4,0,28
177478,261,"SCOALA PRIMARA REGHIU",REGHIU,VN,532,2,1,0,3,5,3,0,8,10,4,0,14,12,4,0,16,13,4,0,17
177511,262,"ȘCOALA PRIMARĂ RĂIUȚI",RĂIUŢI,VN,286,2,1,0,3,5,1,0,6,11,1,0,12,14,1,0,15,18,1,0,19
177566,263,"GRĂDINIȚA CU PROGRAM NORMAL RUGINEȘTI",RUGINEŞTI,VN,791,8,3,0,11,11,3,0,14,11,4,0,15,20,4,5,29,20,6,5,31
177566,264,"GRĂDINIȚA CU PROGRAM NORMAL RUGINEȘTI",RUGINEŞTI,VN,788,6,0,0,6,9,0,0,9,11,1,0,12,11,1,10,22,12,2,10,24
177575,265,"GRĂDINIȚA CU PROGRAM NORMAL ANGHELEȘTI",ANGHELEŞTI,VN,1017,2,0,0,2,15,2,0,17,25,3,0,28,34,4,0,38,38,5,0,43
177584,266,"SCOALA GENERALA",COPĂCEŞTI,VN,588,5,2,0,7,5,2,0,7,6,2,0,8,10,2,0,12,13,2,0,15
177593,267,"SCOALA GENERALA",VĂLENI,VN,256,4,0,0,4,9,0,0,9,15,1,0,16,16,2,0,18,16,2,0,18
177619,268,"PRIMARIA COMUNEI SIHLEA",SIHLEA,VN,1893,12,1,0,13,29,2,0,31,45,4,0,49,58,9,0,67,61,11,0,72
177637,269,"SCOALA CĂIATA",CĂIATA,VN,565,3,3,0,6,3,4,0,7,8,6,0,14,10,8,0,18,14,9,0,23
177628,270,"GRADINIŢA BOGZA",BOGZA,VN,743,12,2,0,14,31,3,0,34,45,4,0,49,57,4,0,61,58,4,0,62
177646,271,"SCOALA VOETIN",VOETIN,VN,902,10,1,0,11,15,2,0,17,18,3,0,21,29,6,0,35,30,7,0,37
177664,272,"ŞCOALA GIMNAZIALĂ SLOBOZIA BRADULUI SALA A","SLOBOZIA BRADULUI",VN,648,7,5,0,12,14,5,0,19,21,5,0,26,30,7,0,37,40,8,0,48
177664,273,"ŞCOALA GIMNAZIALĂ SLOBOZIA BRADULUI SALA B","SLOBOZIA BRADULUI",VN,758,10,0,0,10,20,2,0,22,29,2,0,31,40,4,0,44,41,4,0,45
177664,274,"ŞCOALA GIMNAZIALĂ SLOBOZIA BRADULUI SALA C","SLOBOZIA BRADULUI",VN,1061,3,2,0,5,15,2,0,17,21,2,0,23,50,2,0,52,56,2,0,58
177682,275,"ŞCOALA GIMNAZIALĂ COROTENI",COROTENI,VN,778,2,2,0,4,9,3,0,12,11,4,0,15,11,6,0,17,11,7,0,18
177673,276,"ŞCOALA PRIMARĂCORNETU SALA A",CORNETU,VN,494,3,3,0,6,9,3,0,12,25,6,0,31,35,7,0,42,37,7,0,44
177673,277,"ŞCOALA PRIMARĂ CORNETU SALA B",CORNETU,VN,545,3,0,0,3,9,0,0,9,16,0,0,16,32,0,0,32,32,0,0,32
177735,278,"CĂMINUL CULTURAL","SLOBOZIA CIORĂŞTI",VN,1110,15,5,0,20,27,8,0,35,29,16,0,45,63,23,0,86,65,23,0,88
177753,279,"GRĂDINIȚA CU PROGRAM NORMAL JILIȘTE",JILIŞTE,VN,569,4,3,0,7,7,5,0,12,11,5,0,16,17,6,0,23,18,6,0,24
177771,280,"SCOALA GENERAL[ SIMION MEHEDINTI",DRAGOSLOVENI,VN,1078,7,4,0,11,21,7,0,28,27,10,0,37,33,10,0,43,33,10,0,43
177780,281,"FOSTA SCOALA GENERALA",RUCĂRENI,VN,777,8,1,0,9,10,2,0,12,23,2,0,25,34,3,0,37,35,3,0,38
177174,282,CAMINULCULTURAL,SPULBER,VN,1010,4,0,0,4,10,0,0,10,24,1,0,25,27,1,0,28,29,1,0,30
177806,283,"CAMINUL CULTURAL STRAOANE DE JOS",STRĂOANE,VN,1175,8,3,0,11,21,4,0,25,29,5,0,34,38,5,0,43,41,6,0,47
177806,284,"CAMINUL CULTURAL STRAOANE DE SUS",STRĂOANE,VN,733,6,5,0,11,13,5,0,18,18,5,0,23,20,5,0,25,20,6,0,26
177824,285,"SCOALA GENERALA REPEDEA",REPEDEA,VN,286,7,2,0,9,10,2,0,12,10,2,0,12,13,4,0,17,14,4,0,18
177815,286,"CAMIN CULTURAL",MUNCELU,VN,792,5,1,0,6,11,1,0,12,20,1,0,21,23,5,0,28,26,5,0,31
177851,287,"SCOALA GIMNAZIALA SURAIA",SURAIA,VN,1780,2,0,0,2,8,0,0,8,22,1,0,23,32,1,14,47,35,1,14,50
177851,288,"GRADINITA NR. 2 SURAIA",SURAIA,VN,1544,6,2,0,8,12,3,0,15,20,3,0,23,31,4,0,35,33,4,11,48
177851,289,"SCOALA VECHE SURAIA",SURAIA,VN,1605,7,0,0,7,10,4,0,14,19,4,6,29,29,4,6,39,32,4,6,42
177888,290,"CAMIN CULTURAL",TĂNĂSOAIA,VN,748,20,1,0,21,31,1,0,32,33,2,4,39,39,2,4,45,39,2,4,45
177889,291,"BIROU ASISTENŢĂ",FELDIOARA,VN,567,2,0,0,2,2,1,0,3,3,1,0,4,4,1,7,12,4,1,7,12
177888,292,"SCOALA GENERALA",TĂNĂSOAIA,VN,197,5,2,1,8,10,4,1,15,16,6,19,41,18,6,19,43,19,6,19,44
177888,293,"SCOALA GENERALA",TĂNĂSOAIA,VN,205,1,1,0,2,2,1,0,3,4,2,0,6,4,2,12,18,6,2,12,20
177995,294,"SCOALA GIMNAZIALA TATARANU",TĂTĂRANU,VN,1190,12,1,0,13,22,1,0,23,30,2,0,32,31,2,0,33,32,2,0,34
178028,295,"FOSTA SCOALA GENERALA MARTINESTI",MĂRTINEŞTI,VN,561,6,0,0,6,10,3,0,13,15,8,0,23,18,11,0,29,18,11,0,29
178037,296,"FOSTA SCOALA PRIMARA VIJIITOAREA",VÎJÎITOAREA,VN,192,10,5,0,15,14,9,0,23,23,12,0,35,30,13,0,43,34,13,0,47
178019,297,"SCOALA GIMNAZIALA NR. 2 BORDEASCA VECHE","BORDEASCA VECHE",VN,653,2,3,0,5,10,5,0,15,11,5,0,16,15,7,0,22,23,15,0,38
178000,298,"FOSTA SCOALA GENERALA BORDEASCA NOUA","BORDEASCA NOUĂ",VN,347,1,0,0,1,6,3,0,9,11,5,0,16,17,6,0,23,17,6,0,23
178019,299,"FOSTA SCOALA GENERALA NR. 1 BORDEASCA VECHE","BORDEASCA VECHE",VN,870,6,1,0,7,15,3,0,18,20,3,0,23,31,4,0,35,36,4,0,40
178055,300,PRIMARIE,TÂMBOEŞTI,VN,1049,5,2,0,7,5,2,0,7,9,2,0,11,11,3,0,14,14,3,0,17
178091,301,"SCOALA SLIMNIC",SLIMNIC,VN,1191,1,0,0,1,5,0,0,5,15,3,0,18,35,3,0,38,47,3,0,50
178108,302,"SCOALA TRESTIENI",TRESTIENI,VN,141,0,0,0,0,2,2,0,4,2,3,0,5,2,3,0,5,7,3,0,10
178126,303,"CASA OBŞTII TULNICI",TULNICI,VN,1150,8,1,0,9,25,1,0,26,40,5,0,45,47,5,0,52,49,5,0,54
178126,304,"CASA OBŞTII TULNICI",TULNICI,VN,1204,7,0,0,7,23,1,0,24,33,1,0,34,41,1,0,42,43,1,0,44
178135,305,"ŞCOALA COZA",COZA,VN,668,5,1,0,6,12,1,0,13,22,1,0,23,27,6,0,33,30,6,0,36
178162,306,"ŞCOALA LEPŞA",LEPŞA,VN,367,2,4,0,6,5,11,0,16,8,14,0,22,9,24,0,33,9,26,0,35
178199,307,"ȘCOALA GIMNAZIALĂ ȚIFEȘTI",ŢIFEŞTI,VN,857,0,0,0,0,3,0,0,3,5,0,0,5,7,0,0,7,7,0,0,7
178206,308,"ȘCOALA GIMNAZIALĂ BĂTINEȘTI",BĂTINEŞTI,VN,1302,8,2,0,10,17,3,0,20,20,5,0,25,28,7,0,35,35,8,0,43
178215,309,"ȘCOALA GIMNAZIALĂ CLIPICEȘTI",CLIPICEŞTI,VN,685,2,0,0,2,6,0,0,6,11,0,0,11,15,0,0,15,16,0,0,16
178233,310,"ȘCOALA CU CLASELE I-IV OLEȘEȘTI",OLEŞEŞTI,VN,740,9,1,0,10,9,1,0,10,11,1,0,12,15,1,0,16,18,2,0,20
178251,311,"GRĂDINIȚA CU PROGRAM NORNAL SÎRBI",SÎRBI,VN,638,4,0,0,4,10,3,0,13,18,5,0,23,22,6,0,28,22,6,0,28
178288,312,"CONSILIUL LOCAL URECHEŞTI",URECHEŞTI,VN,1825,8,3,0,11,17,8,0,25,24,12,0,36,35,13,0,48,38,15,0,53
178288,313,"ŞCOALA PRIMARĂ URECHEŞTI",URECHEŞTI,VN,463,0,0,0,0,3,0,0,3,7,1,0,8,9,2,0,11,10,2,0,12
178322,314,"SCOALA GIMNAZIALĂ ,, VASILE IFTIMESCU "" VALEA SARII","VALEA SĂRII",VN,651,3,1,0,4,9,2,0,11,15,2,0,17,18,3,0,21,19,3,0,22
178322,315,"CAMINUL CULTURAL COLACU","VALEA SĂRII",VN,616,3,0,0,3,13,0,0,13,16,0,0,16,29,1,0,30,29,1,0,30
178322,316,"SCOALA GENERALA PODURI","VALEA SĂRII",VN,240,1,0,0,1,3,0,0,3,9,0,0,9,11,0,0,11,12,0,0,12
178322,317,SCOALAPRISACA,"VALEA SĂRII",VN,157,8,0,0,8,11,0,0,11,13,0,0,13,17,3,0,20,17,3,0,20
178386,318,"SALA DE SPORT VIDRA",VIDRA,VN,1458,14,3,0,17,28,9,0,37,58,10,0,68,67,13,21,101,70,14,21,105
178466,319,"SCOALA GENERALA",VOLOŞCANI,VN,293,2,0,0,2,3,0,0,3,3,0,0,3,4,3,0,7,4,3,0,7
178402,320,"SCOALA GENERALA",IREŞTI,VN,755,2,0,0,2,4,3,0,7,9,5,0,14,14,5,0,19,16,7,0,23
178439,321,"SCOALA GENERALA",ŞERBEŞTI,VN,475,3,0,0,3,7,4,0,11,13,5,0,18,19,5,0,24,20,5,0,25
178395,322,"SCOALA GENERALA",BURCA,VN,645,3,5,0,8,4,7,0,11,6,8,0,14,11,8,0,19,12,8,0,20
178395,323,"SCOALA GENERALA",BURCA,VN,705,1,0,0,1,3,0,0,3,10,2,0,12,15,2,0,17,15,2,0,17
178420,324,"SCOALA GENERALA",SCAFARI,VN,363,3,3,0,6,6,3,0,9,9,4,0,13,14,4,0,18,16,4,0,20
178448,325,"ȘCOALA GENERALĂ TICHIRIȘ - ȘCOALA NOUĂ",TICHIRIŞ,VN,645,3,3,0,6,9,3,0,12,11,5,0,16,16,5,0,21,17,5,0,22
178457,326,"SCOALA GENERALA",VIIŞOARA,VN,575,3,1,0,4,10,1,0,11,10,1,0,11,14,2,0,16,14,2,0,16
178484,327,"SCOALA GIMNAZIALA „REGINA MARIA” VINTILEASCA",VINTILEASCA,VN,631,4,1,0,5,14,1,0,15,23,2,0,25,32,3,0,35,41,5,0,46
178518,328,"GRADINITA „VOINICELUL” NECULELE",NECULELE,VN,382,2,0,0,2,9,2,0,11,15,7,0,22,28,8,0,36,28,9,0,37
178493,329,"SCOALA GIMNAZIALA „ PICTOR MIHAIL BALASESCU” BAHNELE",BAHNELE,VN,466,3,0,0,3,4,2,0,6,12,3,0,15,18,3,0,21,19,3,0,22
178509,330,"SCOALA ION CREANGA DUPA MAGURA","DUPĂ MĂGURA",VN,75,1,0,0,1,2,0,0,2,3,0,0,3,5,0,0,5,6,0,0,6
178527,331,"STAȚIE DE AȘTEPTARE MICROBUZ","POIANA STOICHII",VN,56,0,0,0,0,1,0,0,1,3,2,0,5,4,2,0,6,4,2,0,6
178590,332,"SCOALA DIN VIZANTEA RAZASEASCA","VIZANTEA RĂZĂŞEASCĂ",VN,636,8,1,0,9,22,3,0,25,29,4,0,33,46,8,0,54,46,9,0,55
178581,333,"SCOALA DIN VIZANTEA MANASTIREASCA","VIZANTEA MĂNĂSTIREASCĂ",VN,1426,11,0,0,11,23,3,0,26,35,3,0,38,40,4,30,74,47,4,30,81
178572,334,"SOALA DIN PIISCU-RADULUI","PISCU RADULUI",VN,355,3,4,0,7,4,4,0,8,4,8,0,12,4,8,0,12,5,8,0,13
178563,335,"SCOALA DIN MESTEACANU",MESTEACĂNU,VN,304,5,0,0,5,5,1,0,6,7,1,0,8,7,1,0,8,7,1,0,8
178554,336,"SCOALA DIN LIVEZILE",LIVEZILE,VN,578,2,0,0,2,4,0,0,4,8,1,0,9,11,1,0,12,13,1,0,14
178616,337,"ŞCOALA GIMNAZIALĂ VÎNĂTORI",VÎNĂTORI,VN,1135,11,4,0,15,14,5,0,19,20,5,0,25,30,7,0,37,33,9,0,42
178634,338,"GRĂDINIŢA CU PROGRAM NORMAL JORĂŞTI",JORĂŞTI,VN,1288,4,1,0,5,18,1,0,19,25,1,0,26,35,1,0,36,35,2,0,37
178661,339,"GRĂDINIŢA CU PROGRAM PRELUNGIT PETREŞTI",PETREŞTI,VN,1205,2,4,0,6,15,4,0,19,23,4,0,27,34,4,0,38,35,4,0,39
178643,340,"ŞCOALA GIMNAZIALĂ MIRCEŞTII NOI","MIRCEŞTII NOI",VN,751,1,2,0,3,10,3,0,13,15,3,0,18,17,5,0,22,17,5,0,22
178652,341,"DISPENSARUL UMAN MIRCEŞTII VECHI","MIRCEŞTII VECHI",VN,252,2,1,0,3,7,1,0,8,12,1,0,13,14,2,0,16,14,2,0,16
178625,342,"ŞCOALA PRIMARĂ BALTA RAŢEI","BALTA RAŢEI",VN,239,2,0,0,2,3,0,0,3,3,1,0,4,3,2,0,5,4,3,0,7
178670,343,"GRĂDINIŢA CU PROGRAM NORMAL RĂDULEŞTI",RĂDULEŞTI,VN,746,3,2,0,5,5,3,0,8,12,3,0,15,20,3,0,23,21,6,0,27
178698,344,"CAMIN CULTURALVIRTESCOIU",VÎRTEŞCOIU,VN,1270,2,0,0,2,13,0,0,13,23,0,0,23,30,5,0,35,32,5,0,37
178714,345,"ȘCOALA GIMNAZIALĂFARAOANELE",FARAOANELE,VN,1024,4,0,0,4,7,3,0,10,10,5,0,15,30,9,0,39,31,9,0,40
178705,346,SCOALABECIU,BECIU,VN,346,1,3,0,4,2,4,0,6,8,4,0,12,11,5,0,16,11,5,0,16
178741,347,"SCOALA PRIMARA RIMNICEANCA",RÎMNICEANCA,VN,228,1,0,0,1,2,0,0,2,5,0,0,5,8,1,0,9,13,1,0,14
178769,348,"CAMIN CULTURAL VRINCIOAIA",VRÎNCIOAIA,VN,502,7,0,0,7,21,0,0,21,31,0,0,31,43,0,0,43,44,0,0,44
178803,349,"SCOALA PRIMARĂ POIANA - SALA GRADINIȚEI",POIANA,VN,573,0,1,0,1,2,1,0,3,8,3,0,11,13,4,0,17,13,4,0,17
178812,350,"CĂMIN CULTURAL SAT SPINEȘTI",SPINEŞTI,VN,626,0,0,0,0,3,1,0,4,5,1,0,6,10,1,0,11,10,1,0,11
178787,351,"SCOALA PRIMARA MUNCEI",MUNCEI,VN,582,3,0,0,3,8,0,0,8,8,2,0,10,11,3,0,14,12,3,0,15
178830,352,"SCOALA GENERALA VULTURU",VULTURU,VN,1245,7,0,0,7,14,1,0,15,21,4,0,25,27,6,0,33,34,6,0,40
178830,353,"SCOALA GENERALA VULTURU",VULTURU,VN,1275,4,0,0,4,12,1,0,13,14,1,0,15,25,2,0,27,26,2,0,28
178830,354,"GRADINITA NR 1",VULTURU,VN,1281,0,0,0,0,8,0,0,8,11,1,0,12,23,4,0,27,25,6,0,31
178849,355,"SCOALA BOTARLAU",BOŢÎRLĂU,VN,1224,8,0,0,8,18,0,0,18,20,0,0,20,30,3,0,33,34,3,0,37
178858,356,"SCOALA HANGULESTI",HÎNGULEŞTI,VN,973,4,1,0,5,16,3,0,19,47,5,0,52,67,11,0,78,74,13,0,87
178867,357,"SCOALA MALURI",MALURI,VN,468,3,2,0,5,7,4,0,11,10,6,0,16,11,7,0,18,11,7,0,18
178876,358,"SCOALA VADU ROSCA","VADU ROŞCA",VN,588,2,5,0,7,6,5,0,11,21,7,0,28,32,8,0,40,35,9,0,44
161954,1,"MUZEUL JUDEŢEAN ,,ŞTEFAN CEL MARE""",VASLUI,VS,1481,20,0,0,20,72,4,0,76,101,4,0,105,129,4,0,133,136,4,0,140
161954,2,"MUZEUL JUDEŢEAN ,,ŞTEFAN CEL MARE""",VASLUI,VS,1678,9,3,0,12,41,3,0,44,51,4,0,55,77,4,0,81,81,4,0,85
161954,3,"LICEUL TEORETIC ""MIHAIL KOGĂLNICEANU""",VASLUI,VS,1597,11,1,0,12,31,2,0,33,39,3,0,42,57,3,0,60,58,3,0,61
161954,4,"LICEUL TEORETIC ""MIHAIL KOGĂLNICEANU""",VASLUI,VS,3420,9,0,0,9,18,1,0,19,28,1,0,29,41,1,0,42,43,4,0,47
161954,5,"LICEUL TEORETIC ""MIHAIL KOGĂLNICEANU""",VASLUI,VS,2124,10,1,0,11,29,1,0,30,38,3,0,41,44,3,0,47,44,3,0,47
161954,6,"S.C. COREVAS S.R.L.",VASLUI,VS,1001,6,2,0,8,17,3,0,20,20,3,0,23,30,3,0,33,33,3,0,36
161954,7,"S.C. COREVAS S.R.L.",VASLUI,VS,1043,15,4,0,19,28,4,0,32,36,4,0,40,40,4,0,44,47,4,0,51
161954,8,"GRĂDINIȚA CU PROGRAM PRELUNGIT NR.15",VASLUI,VS,1543,22,1,14,37,49,3,14,66,67,3,14,84,79,3,14,96,86,3,14,103
161954,9,"ȘCOALA GIMNAZIALĂ ”CONSTANTIN PARFENE”",VASLUI,VS,2448,5,0,0,5,13,0,0,13,20,0,0,20,26,0,0,26,27,0,0,27
161954,10,"ȘCOALA GIMNAZIALĂ ”CONSTANTIN PARFENE”",VASLUI,VS,1854,4,0,0,4,10,1,0,11,13,1,0,14,16,3,0,19,16,3,0,19
161954,11,"ȘCOALA GIMNAZIALĂ ”CONSTANTIN PARFENE”",VASLUI,VS,3378,0,2,0,2,0,2,0,2,0,2,0,2,0,2,0,2,0,2,0,2
161954,12,"ȘCOALA GIMNAZIALĂ ”CONSTANTIN PARFENE”",VASLUI,VS,5673,1,0,0,1,5,0,0,5,10,0,1,11,16,1,1,18,18,1,1,20
161954,13,"ȘCOALA GIMNAZIALĂ ”CONSTANTIN PARFENE”",VASLUI,VS,722,0,0,0,0,2,0,0,2,3,0,0,3,3,0,0,3,3,0,0,3
161954,14,"GRĂDINIȚA CU PROGRAM PRELUNGIT NR.5",VASLUI,VS,3067,16,0,0,16,23,0,0,23,31,0,0,31,40,4,0,44,43,4,0,47
161954,15,"GRĂDINIȚA CU PROGRAM PRELUNGIT NR.5",VASLUI,VS,2755,5,0,0,5,12,0,0,12,12,0,0,12,15,0,0,15,16,0,0,16
161954,16,"ROMSILVA - RA - FILIALA VASLUI",VASLUI,VS,1741,9,2,0,11,36,2,0,38,50,2,0,52,69,5,0,74,76,5,0,81
161954,17,"CENTRUL ŞCOLAR DE EDUCAŢIE INCLUZIVĂ ,,ELISABETA POLIHRONIADE""",VASLUI,VS,1883,15,2,0,17,31,3,0,34,51,6,0,57,73,6,0,79,83,6,0,89
161954,18,"CENTRUL ŞCOLAR DE EDUCAŢIE INCLUZIVĂ ,,ELISABETA POLIHRONIADE""",VASLUI,VS,2512,5,4,0,9,11,4,0,15,15,4,0,19,27,4,0,31,31,4,0,35
161954,19,"ȘCOALA GIMNAZIALĂ ""MIHAIL SADOVEANU""",VASLUI,VS,1999,4,0,0,4,16,0,0,16,22,1,0,23,32,1,0,33,37,1,0,38
161954,20,"ȘCOALA GIMNAZIALĂ ""MIHAIL SADOVEANU""",VASLUI,VS,2170,14,0,0,14,35,0,0,35,43,0,0,43,63,0,0,63,69,0,0,69
161954,21,"ȘCOALA GIMNAZIALĂ ”DIMITRIE CANTEMIR”",VASLUI,VS,1736,1,2,0,3,17,2,0,19,22,2,0,24,40,2,0,42,46,3,0,49
161954,22,"ȘCOALA GIMNAZIALĂ ”DIMITRIE CANTEMIR”",VASLUI,VS,3264,5,0,0,5,15,7,0,22,23,7,0,30,28,7,0,35,30,7,0,37
161954,23,"LICEUL CU PROGRAM SPORTIV",VASLUI,VS,1841,11,0,0,11,23,0,0,23,43,2,0,45,68,3,0,71,77,3,0,80
161954,24,"GRADINITA CU PROGRAM PRELUNGIT NR. 6",VASLUI,VS,1682,6,5,0,11,15,5,0,20,20,5,0,25,25,5,0,30,27,5,0,32
161954,25,"GRADINITA CU PROGRAM PRELUNGIT NR.17",VASLUI,VS,1956,18,1,0,19,37,1,0,38,51,3,0,54,70,3,0,73,73,4,0,77
161954,26,"ŞCOALA GIMNAZIALĂ „STEFAN CEL MARE”,",VASLUI,VS,2305,23,0,0,23,35,0,0,35,53,1,0,54,63,1,0,64,64,1,0,65
161954,27,"ŞCOALA GIMNAZIALĂ „STEFAN CEL MARE”,",VASLUI,VS,1913,29,0,0,29,61,1,0,62,80,1,0,81,98,3,0,101,101,3,0,104
161954,28,"ȘCOALA GIMNAZIALĂ ”CONSTANTIN MOTAȘ”",VASLUI,VS,1037,4,0,0,4,14,0,0,14,20,0,0,20,37,0,0,37,42,1,0,43
161954,29,"ȘCOALA GIMNAZIALĂ ”CONSTANTIN MOTAȘ”",VASLUI,VS,1171,15,6,0,21,23,6,0,29,30,6,0,36,35,8,0,43,41,10,0,51
161954,30,"LICEUL TEORETIC „EMIL RACOVIŢĂ”",VASLUI,VS,1650,17,6,0,23,42,6,0,48,55,7,0,62,71,7,0,78,77,7,0,84
161954,31,"GRĂDINIȚA CU PROGRAM NORMAL NR.12",VASLUI,VS,1514,10,2,0,12,25,2,0,27,35,2,0,37,49,5,0,54,49,5,0,54
161954,32,"GRĂDINIȚA CU PROGRAM PRELUNGIT NR.3",VASLUI,VS,1200,27,1,0,28,41,3,0,44,52,3,0,55,56,3,0,59,63,5,0,68
161954,33,"SALA SPORTURILOR",VASLUI,VS,1558,5,5,0,10,29,5,0,34,47,6,0,53,63,6,0,69,65,6,0,71
161954,34,"SALA SPORTURILOR",VASLUI,VS,2952,2,1,0,3,4,3,0,7,11,5,0,16,13,5,0,18,14,5,0,19
161954,35,"SALA SPORTURILOR",VASLUI,VS,882,5,1,0,6,17,2,0,19,22,2,0,24,28,4,0,32,32,4,0,36
161954,36,"ȘCOALA GIMNAZIALĂ ""MIHAI EMINESCU""",VASLUI,VS,1851,14,4,0,18,29,6,0,35,44,8,0,52,54,8,0,62,57,9,0,66
161954,37,"ȘCOALA GIMNAZIALĂ ”VASILE ALECSANDRI”",VASLUI,VS,1056,10,5,0,15,22,6,0,28,28,6,0,34,34,6,0,40,41,6,0,47
161954,38,"ȘCOALA GIMNAZIALĂ ”VASILE ALECSANDRI”",VASLUI,VS,1585,7,3,0,10,15,4,0,19,24,4,0,28,35,5,0,40,36,5,0,41
161954,39,"ȘCOALA GIMNAZIALĂ ”VASILE ALECSANDRI”",VASLUI,VS,1212,7,0,0,7,22,1,0,23,33,1,0,34,41,1,0,42,46,2,0,48
161954,40,"ȘCOALA GIMNAZIALĂ ”VASILE ALECSANDRI”",VASLUI,VS,1655,9,3,0,12,22,3,0,25,42,3,0,45,52,3,0,55,52,3,0,55
161954,41,"ȘCOALA GIMNAZIALĂ ”ALEXANDRA NECHITA”",VASLUI,VS,1034,4,5,0,9,16,5,0,21,24,5,0,29,35,5,0,40,37,7,0,44
161954,42,"ȘCOALA GIMNAZIALĂ ”ALEXANDRA NECHITA”",VASLUI,VS,1333,12,3,0,15,24,4,0,28,34,4,0,38,51,5,0,56,57,5,0,62
161954,43,"ȘCOALA GIMNAZIALĂ ”ALEXANDRA NICHITA”",VASLUI,VS,2870,3,0,0,3,9,0,0,9,14,0,0,14,20,1,0,21,21,1,0,22
161954,44,"ȘCOALA GIMNAZIALĂ ”ALEXANDRA NICHITA”",VASLUI,VS,1421,11,1,0,12,24,4,0,28,35,7,0,42,47,13,0,60,48,13,0,61
161954,45,"COLEGIUL ECONOMIC”ANGHEL RUGINĂ”",VASLUI,VS,1849,12,5,0,17,23,5,0,28,38,5,0,43,47,6,0,53,57,6,0,63
161954,46,"COLEGIUL ECONOMIC”ANGHEL RUGINĂ”",VASLUI,VS,745,5,7,0,12,17,7,0,24,23,7,0,30,38,7,0,45,41,8,0,49
161954,47,"ŞCOALA GIMNAZIALĂ ”ELENA CUZA”",VASLUI,VS,1049,11,1,0,12,24,5,0,29,33,5,0,38,44,5,0,49,45,5,0,50
161954,48,"ŞCOALA GIMNAZIALĂ ”ELENA CUZA”",VASLUI,VS,1034,5,0,0,5,23,0,0,23,31,0,0,31,43,0,0,43,48,0,0,48
161954,49,"ŞCOALA GIMNAZIALĂ”ALEXANDRU IOAN CUZA”",VASLUI,VS,1201,4,0,0,4,15,0,0,15,18,0,0,18,27,0,0,27,31,0,0,31
161954,50,"ŞCOALA GIMNAZIALĂ”ALEXANDRU IOAN CUZA”",VASLUI,VS,1572,9,0,0,9,32,2,0,34,43,2,0,45,57,4,0,61,61,4,0,65
161954,51,"ŞCOALA PRIMARĂ",VASLUI,VS,351,2,2,0,4,3,2,0,5,3,2,0,5,7,2,0,9,7,2,0,9
161954,52,"ŞCOALA PRIMARĂ",VASLUI,VS,1227,4,4,0,8,4,4,0,8,6,4,0,10,8,4,0,12,8,4,0,12
161954,53,"ŞCOALA GIMNAZIALĂ",VASLUI,VS,1343,4,0,0,4,14,0,0,14,22,0,0,22,29,0,0,29,35,0,0,35
161954,54,"ŞCOALA GIMNAZIALĂ",VASLUI,VS,1039,1,3,0,4,9,3,0,12,12,3,0,15,15,3,0,18,16,3,0,19
161954,55,"GRĂDINIȚA CU PROGRAM NORMAL",VASLUI,VS,1716,13,0,0,13,26,4,0,30,29,4,0,33,62,4,0,66,63,4,0,67
161954,56,"LICEUL ”STEFAN PROCOPIU”",VASLUI,VS,3133,11,0,0,11,19,1,0,20,28,2,0,30,38,2,0,40,40,3,0,43
161954,57,"GRADINITA CU PROGRAM NORMAL NR. 22",VASLUI,VS,2444,2,0,0,2,5,0,0,5,10,0,0,10,15,0,0,15,16,0,0,16
161954,58,"SCOALA GIMNAZIALĂ""ALEXANDRU IOAN CUZA""",VASLUI,VS,2373,5,3,0,8,11,3,0,14,14,3,0,17,17,3,0,20,18,3,0,21
161954,59,"LICEUL ”ŞTEFAN PROCOPIU”",VASLUI,VS,387,3,0,0,3,7,3,0,10,8,4,0,12,14,6,0,20,18,7,0,25
161954,60,"GRĂDINIŢA CU PROGRAM NORMAL NR.22",VASLUI,VS,1111,4,0,0,4,8,3,0,11,12,6,0,18,13,6,0,19,17,6,0,23
161954,61,"SCOALA PRIMARĂ",VASLUI,VS,1026,1,0,0,1,5,3,0,8,9,3,0,12,12,3,0,15,14,3,0,17
161954,62,"GRĂDINIȚA CU PROGRAM PRELUNGIT NR. 5",VASLUI,VS,2286,1,0,0,1,2,3,0,5,7,3,0,10,9,3,0,12,9,3,0,12
161801,63,"ŞCOALA GIMNAZIALĂ NR. 10",BÎRLAD,VS,1612,14,2,0,16,29,2,0,31,47,2,0,49,68,2,0,70,74,2,0,76
161801,64,"ŞCOALA GIMNAZIALĂ NR. 10",BÎRLAD,VS,1914,19,0,0,19,33,0,0,33,44,0,0,44,56,0,0,56,62,0,0,62
161801,65,"ŞCOALA GIMNAZIALĂ NR. 10",BÎRLAD,VS,1703,24,3,0,27,39,5,0,44,62,6,0,68,86,7,28,121,90,7,28,125
161801,66,"ŞCOALA GENERALA NR. 7 ""CĂPITAN GRIGORE IGNAT""",BÎRLAD,VS,853,2,2,0,4,15,3,0,18,19,6,0,25,22,7,0,29,25,7,0,32
161801,67,"ŞCOALA GENERALA NR. 7 ""CĂPITAN GRIGORE IGNAT""",BÎRLAD,VS,924,7,0,0,7,23,0,0,23,31,0,0,31,47,0,0,47,48,0,0,48
161801,68,"COLEGIUL NAŢIONAL ""GHEORGHE ROŞCA CODREANU""",BÎRLAD,VS,992,13,0,0,13,28,0,0,28,43,3,0,46,53,4,1,58,55,4,1,60
161801,69,"COLEGIUL NAŢIONAL ""GHEORGHE ROŞCA CODREANU""",BÎRLAD,VS,1535,11,0,0,11,20,1,0,21,34,1,0,35,40,4,0,44,41,4,0,45
161801,70,"COLEGIUL NAŢIONAL ""GHEORGHE ROŞCA CODREANU""",BÎRLAD,VS,1004,13,5,0,18,30,7,0,37,35,7,0,42,51,7,0,58,58,7,0,65
161801,71,"ŞCOALA GIMNAZIALĂ DE ARTE ""N. N. TONITZA""",BÎRLAD,VS,1125,10,1,0,11,46,2,0,48,57,2,0,59,63,6,0,69,64,6,0,70
161801,72,"ŞCOALA GIMNAZIALĂ DE ARTE ""N. N. TONITZA""",BÎRLAD,VS,974,12,0,0,12,32,1,0,33,53,1,0,54,62,2,0,64,70,2,0,72
161801,73,"ŞCOALA GIMNAZIALĂ NR. 8",BÎRLAD,VS,618,9,0,0,9,22,0,0,22,33,0,0,33,45,0,0,45,45,1,0,46
161801,74,"ŞCOALA GIMNAZIALĂ NR. 8",BÎRLAD,VS,1303,27,0,0,27,51,1,0,52,59,1,0,60,79,1,0,80,86,1,0,87
161801,75,"ŞCOALA GIMNAZIALĂ NR. 8",BÎRLAD,VS,1257,10,0,0,10,36,0,0,36,50,0,0,50,62,0,0,62,62,0,0,62
161801,76,"ŞCOALA GIMNAZIALĂ NR. 8",BÎRLAD,VS,1543,21,0,0,21,52,0,0,52,83,1,0,84,114,2,47,163,114,2,47,163
161801,77,"ŞCOALA GIMNAZIALĂ ""MANOLACHE COSTACHE EPUREANU""",BÎRLAD,VS,1360,16,0,0,16,39,8,0,47,54,9,0,63,68,12,0,80,83,13,0,96
161801,78,"COLEGIUL ""ALEXANDRU IOAN CUZA""",BÎRLAD,VS,1573,8,0,0,8,30,1,0,31,39,3,0,42,51,3,0,54,53,5,0,58
161801,79,"COLEGIUL ""ALEXANDRU IOAN CUZA""",BÎRLAD,VS,1384,20,0,0,20,53,1,0,54,74,1,0,75,85,2,0,87,90,2,0,92
161801,80,"COLEGIUL ""ALEXANDRU IOAN CUZA""",BÎRLAD,VS,1397,17,0,0,17,51,0,0,51,68,1,0,69,93,5,0,98,103,7,0,110
161801,81,"COLEGIUL ""ALEXANDRU IOAN CUZA""",BÎRLAD,VS,1272,12,2,0,14,29,2,0,31,35,2,0,37,51,5,0,56,56,5,0,61
161801,82,"COLEGIUL ""ALEXANDRU IOAN CUZA""",BÎRLAD,VS,1312,4,4,0,8,26,4,0,30,34,4,0,38,44,4,0,48,45,4,0,49
161801,83,"COLEGIUL ""ALEXANDRU IOAN CUZA""",BÎRLAD,VS,1405,10,0,0,10,40,1,0,41,56,3,0,59,70,3,0,73,74,4,0,78
161801,84,"COLEGIUL ""ALEXANDRU IOAN CUZA""",BÎRLAD,VS,1428,6,6,0,12,29,7,0,36,51,8,0,59,63,10,0,73,68,10,0,78
161801,85,"LICEUL TEHNOLOGIC “PETRU RAREŞ”",BÎRLAD,VS,1078,12,0,0,12,19,0,0,19,28,0,0,28,37,3,0,40,37,3,0,40
161801,86,"LICEUL TEHNOLOGIC “PETRU RAREŞ”",BÎRLAD,VS,1375,16,0,0,16,29,0,0,29,43,0,0,43,47,0,0,47,49,0,0,49
161801,87,"LICEUL TEHNOLOGIC “PETRU RAREŞ”",BÎRLAD,VS,1568,5,5,0,10,13,7,0,20,26,8,0,34,31,8,0,39,34,8,0,42
161801,88,"ŞCOALA GIMNAZIALĂ“VICTOR IOAN POPA”",BÎRLAD,VS,1215,7,2,0,9,14,2,0,16,19,2,0,21,24,2,0,26,24,2,0,26
161801,89,"ŞCOALA GIMNAZIALĂ“VICTOR IOAN POPA”",BÎRLAD,VS,1418,9,0,0,9,21,0,0,21,31,1,0,32,39,1,0,40,39,1,0,40
161801,90,"ŞCOALA GIMNAZIALĂ “VICTOR IOAN POPA”",BÎRLAD,VS,1354,6,0,0,6,14,0,0,14,21,1,0,22,29,1,0,30,32,1,0,33
161801,91,"CASA DE CULTURĂ A SINDICATELOR “GEORGE TUTOVEANU”",BÎRLAD,VS,1394,6,0,0,6,44,0,0,44,63,3,0,66,78,6,0,84,83,6,0,89
161801,92,"CASA DE CULTURĂ A SINDICATELOR “GEORGE TUTOVEANU”",BÎRLAD,VS,1603,8,0,0,8,32,5,0,37,44,5,0,49,53,6,0,59,59,7,0,66
161801,93,"ŞCOALA GIMNAZIALĂ “PRINCIPESA ELENA BIBESCU”",BÎRLAD,VS,1480,31,0,0,31,64,0,0,64,73,0,0,73,100,0,0,100,103,0,0,103
161801,94,"ŞCOALA GIMNAZIALĂ “PRINCIPESA ELENA BIBESCU”",BÎRLAD,VS,1563,17,2,0,19,37,3,0,40,45,4,0,49,60,4,0,64,66,4,0,70
161801,95,"ŞCOALA GIMNAZIALĂ NR. 2",BÎRLAD,VS,1000,9,3,0,12,17,3,0,20,20,4,0,24,27,7,0,34,28,8,0,36
161801,96,"ŞCOALA GIMNAZIALĂ NR. 2",BÎRLAD,VS,680,6,0,0,6,12,2,0,14,16,3,0,19,18,4,0,22,18,5,0,23
161801,97,"ŞCOALA GIMNAZIALĂ NR. 2",BÎRLAD,VS,1038,14,3,0,17,33,3,0,36,41,3,0,44,56,4,0,60,63,4,0,67
161801,98,"ŞCOALA GIMNAZIALĂ NR. 2",BÎRLAD,VS,893,9,1,0,10,23,2,0,25,31,2,0,33,41,2,0,43,43,3,0,46
161801,99,"ŞCOALA GIMNAZIALĂ “GEORGE TUTOVEANU”",BÎRLAD,VS,1455,8,0,0,8,16,1,0,17,23,2,0,25,34,2,0,36,37,2,0,39
161801,100,"ŞCOALA GIMNAZIALĂ “GEORGE TUTOVEANU”",BÎRLAD,VS,1669,14,3,0,17,46,3,0,49,63,5,0,68,79,5,0,84,82,5,0,87
161801,101,"ŞCOALA GIMNAZIALĂ “GEORGE TUTOVEANU”",BÎRLAD,VS,1375,17,4,0,21,35,6,0,41,48,6,0,54,73,6,0,79,76,6,0,82
161801,102,"LICEUL PEDAGOGIC “IOAN POPESCU”",BÎRLAD,VS,1136,6,0,0,6,18,0,0,18,30,0,0,30,50,0,0,50,50,0,0,50
161801,103,"LICEUL PEDAGOGIC “IOAN POPESCU”",BÎRLAD,VS,1349,0,0,0,0,9,0,0,9,18,0,0,18,29,5,0,34,31,5,0,36
161801,104,"LICEUL PEDAGOGIC “IOAN POPESCU”",BÎRLAD,VS,1492,11,0,0,11,28,0,0,28,38,0,0,38,52,0,0,52,58,0,0,58
161801,105,"LICEUL PEDAGOGIC “IOAN POPESCU”",BÎRLAD,VS,1205,5,0,0,5,22,0,0,22,39,3,0,42,47,4,0,51,51,4,0,55
161801,106,"GRĂDINIȚA CU PROGRAM PRELUNGIT ”LICURICI”",BÎRLAD,VS,1258,15,1,0,16,24,2,0,26,31,2,0,33,49,4,0,53,56,5,0,61
161801,107,"GRĂDINIȚA CU PROGRAM PRELUNGIT ”LICURICI”",BÎRLAD,VS,1370,7,0,0,7,18,0,0,18,21,0,0,21,38,0,0,38,40,0,0,40
161801,108,"GRĂDINIȚA CU PROGRAM PRELUNGIT ”LICURICI”",BÎRLAD,VS,900,2,0,0,2,8,0,0,8,17,2,0,19,23,2,0,25,27,2,0,29
161838,109,"ASOCIATIA AGRICOLA ""CORNI""",HUŞI,VS,1127,3,6,0,9,10,6,0,16,17,6,0,23,29,6,0,35,29,6,0,35
161838,110,"SCOALA PROFESIONALA SPECIALĂ ""SF.ECATERINA""",HUŞI,VS,932,4,9,0,13,16,9,0,25,22,10,0,32,32,14,0,46,36,14,0,50
161838,111,"CENTRUL CONSULTATIV HUȘI",HUŞI,VS,1705,18,2,0,20,42,2,0,44,52,2,0,54,69,5,0,74,74,5,0,79
161838,112,"COLEGIUL NAȚIONAL ""CUZA VODA""",HUŞI,VS,1029,15,0,0,15,38,2,0,40,51,2,0,53,62,2,0,64,64,3,0,67
161838,113,"LICEUL TEHNOLOGIC ”IOAN CORIVAN”",HUŞI,VS,1063,6,4,0,10,17,6,0,23,25,6,0,31,38,7,0,45,46,7,0,53
161838,114,"COLEGIUL AGRICOL ,,DIMITRIE CANTEMIR”",HUŞI,VS,2331,9,8,0,17,27,8,0,35,33,9,0,42,49,16,0,65,55,18,0,73
161838,115,"SCOALA GIMNAZIALĂ ”ANASTASIE PANU”",HUŞI,VS,1023,10,0,0,10,18,2,0,20,22,2,0,24,31,3,0,34,32,5,0,37
161838,116,"SCOALA GIMNAZIALĂ ”ANASTASIE PANU”",HUŞI,VS,2222,4,1,0,5,14,3,0,17,18,4,0,22,27,5,0,32,33,6,0,39
161838,117,"SCOALA GIMNAZIALĂ ”ANASTASIE PANU”",HUŞI,VS,1635,24,2,0,26,33,3,0,36,46,3,0,49,54,7,0,61,54,7,0,61
161838,118,"CASA DE CULTURA”ALEXANDRU GIUGARU”",HUŞI,VS,1107,5,6,0,11,17,9,0,26,32,10,0,42,41,10,0,51,49,11,0,60
161838,119,"SCOALA GIMNAZIALĂ „MIHAIL SADOVEANU”",HUŞI,VS,1706,15,2,0,17,36,7,0,43,45,9,0,54,54,9,0,63,62,13,0,75
161838,120,"SCOALA GIMNAZIALĂ „MIHAIL SADOVEANU”",HUŞI,VS,1195,9,5,0,14,27,5,0,32,44,7,0,51,56,7,0,63,57,8,0,65
161838,121,"ŞCOALA GIMNAZIALĂ ''ION CREANGĂ''",HUŞI,VS,1488,9,1,0,10,26,5,0,31,39,6,0,45,56,7,0,63,64,7,0,71
161838,122,"SCOALA GIMNAZIALA,,ION CREANGA""",HUŞI,VS,1187,4,0,0,4,19,2,0,21,34,3,0,37,48,4,0,52,55,4,0,59
161838,123,"SCOALA GIMNAZIALĂ ,,ION CREANGA""",HUŞI,VS,1427,5,0,0,5,22,0,0,22,33,0,0,33,41,0,0,41,49,0,0,49
161838,124,"SCOALA GIMNAZIALĂ NR.5",HUŞI,VS,967,3,0,0,3,8,0,0,8,12,0,0,12,15,0,0,15,16,0,0,16
161838,125,"SCOALA GIMNAZIALĂ NR.5",HUŞI,VS,814,3,5,0,8,4,5,0,9,5,5,0,10,6,5,0,11,8,5,0,13
161838,126,"SCOALA GIMNAZIALĂ NR.4",HUŞI,VS,1256,9,2,0,11,23,5,0,28,38,5,0,43,42,5,0,47,43,7,0,50
161838,127,"SCOALA GIMNAZIALĂ NR.4",HUŞI,VS,1463,3,0,0,3,15,0,0,15,23,0,0,23,30,1,0,31,34,1,0,35
161838,128,"DIRECTIA AGRICOLA JUDETEANA VASLUI - UNITATEA FITOSANITARA HUSI",HUŞI,VS,1844,4,0,41,45,12,1,41,54,28,1,41,70,32,2,41,75,32,2,41,75
164990,129,"CASA DE CULTURA MURGENI",MURGENI,VS,1803,8,2,0,10,27,2,0,29,48,2,0,50,81,4,0,85,87,4,0,91
164990,130,"SCOALA PRIMARASAT NOU",MURGENI,VS,1050,1,4,0,5,24,5,0,29,40,5,0,45,61,5,0,66,61,6,0,67
165005,131,"ȘCOALA PRIMARĂ SAT CÂRJA",CÂRJA,VS,797,4,7,0,11,9,7,0,16,13,10,0,23,16,14,0,30,23,14,0,37
165050,132,"ȘCOALA GIMNAZIALĂ SAT FLORENI",FLORENI,VS,538,3,0,0,3,6,4,0,10,6,4,0,10,8,4,0,12,8,4,0,12
165014,133,"ȘCOALA PRIMARĂ SAT LĂȚEȘTI",LĂŢEŞTI,VS,258,4,2,0,6,9,3,0,12,9,3,0,12,10,3,0,13,10,3,0,13
165041,134,"ȘCOALA PRIMARĂ SAT RAIU",RAIU,VS,535,0,0,0,0,3,0,0,3,14,0,0,14,21,0,0,21,21,0,0,21
165023,135,"ȘCOALA GIMNAZIALĂ EMIL JUVARA SAT SĂRĂȚENI",SĂRĂŢENI,VS,297,2,2,0,4,2,3,0,5,3,5,0,8,8,5,0,13,8,5,0,13
165032,136,"ȘCOALA PRIMARĂ SAT SCHINENI",SCHINENI,VS,388,4,2,0,6,8,2,0,10,14,2,0,16,16,2,0,18,18,4,0,22
161865,137,"CASA DE CULTURĂ",NEGREŞTI,VS,1589,15,0,0,15,32,0,0,32,54,0,0,54,68,0,0,68,71,2,0,73
161865,138,"CASA DE CULTURĂ",NEGREŞTI,VS,1506,17,0,0,17,31,0,0,31,43,0,0,43,52,2,0,54,58,2,0,60
161865,139,"SERVICIUL PUBLIC DE ASISTENȚĂ SOCIALĂ NEGREȘTI",NEGREŞTI,VS,1907,15,0,0,15,34,2,0,36,44,3,0,47,55,4,0,59,56,5,0,61
161865,140,"GRĂDINIȚA CU PROGRAM NORMAL NR.2 NEGREȘTI",NEGREŞTI,VS,876,2,7,0,9,10,7,0,17,14,7,0,21,19,7,0,26,22,7,0,29
161927,141,"ŞCOALA GIMNAZIALĂ SAT VALEA MARE","VALEA MARE",VS,680,3,0,0,3,6,0,0,6,10,5,0,15,14,5,0,19,21,5,0,26
161918,142,"ȘCOALA PRIMARĂ SAT POIANA",POIANA,VS,218,5,0,0,5,9,6,0,15,10,6,0,16,10,6,0,16,10,6,0,16
161883,143,"ŞCOALA PRIMARĂ SAT CIOATELE",CIOATELE,VS,286,2,5,0,7,5,5,0,10,5,5,0,10,8,5,0,13,8,5,0,13
161909,144,"GRĂDINIȚA CU PROGRAM NORMAL SAT PARPANIȚA",PARPANIŢA,VS,471,6,1,0,7,6,1,0,7,24,2,0,26,47,6,0,53,48,6,0,54
161892,145,"SCOALA PRIMARĂ SAT GLODENI",GLODENI,VS,224,4,4,0,8,9,4,0,13,19,4,0,23,21,4,0,25,21,4,0,25
161874,146,"ŞCOALA PRIMARĂ SAT CĂZĂNEȘTI",CĂZĂNEŞTI,VS,356,2,0,0,2,7,0,0,7,9,1,0,10,10,1,0,11,11,1,0,12
162023,147,"ŞCOALA GIMNAZIALA NR. 1 ALBESTI",ALBEŞTI,VS,830,5,1,0,6,6,1,0,7,15,4,0,19,19,4,0,23,21,4,0,25
162032,148,"ŞCOALA GIMNAZIALACORNI-ALBESTI",CORNI-ALBEŞTI,VS,994,5,2,0,7,8,3,0,11,18,3,0,21,25,3,0,28,26,3,0,29
162041,149,"APELE ROMÂNE-CANTONUL CRASNA",CRASNA,VS,443,2,0,0,2,3,1,0,4,4,1,0,5,5,1,0,6,5,1,0,6
162050,150,"ŞCOALAPRIMARA - GURA ALBEŞTI","GURA ALBEŞTI",VS,116,3,0,0,3,3,0,0,3,5,0,0,5,8,2,0,10,11,2,0,13
162078,151,"ŞCOALA GIMNAZIALA, ALEXANDRU VLAHUŢĂ","ALEXANDRU VLAHUŢĂ",VS,645,3,0,0,3,18,2,0,20,21,29,0,50,26,30,0,56,26,30,0,56
162096,152,"ŞCOALA PRIMARA, GHICANI",GHICANI,VS,139,2,1,0,3,4,1,0,5,4,2,0,6,6,3,0,9,7,3,0,10
162087,153,"ŞCOALA PRIMARA, BUDA",BUDA,VS,219,3,0,0,3,3,0,0,3,4,0,0,4,6,0,0,6,7,0,0,7
162121,154,"ŞCOALA PRIMARA, MORĂRENI",MORĂRENI,VS,198,0,0,0,0,1,0,0,1,6,0,0,6,12,0,0,12,16,3,0,19
162158,155,"ŞCOALA PRIMARĂ ""NICOLAE GH. LUPU"" ARSURA",ARSURA,VS,528,2,0,0,2,6,1,0,7,7,1,0,8,8,1,0,9,9,3,0,12
162167,156,"ŞCOALA PRIMARĂ ""ÎNV. ION BUSUIOC"" FUNDĂTURA",FUNDĂTURA,VS,329,2,1,0,3,5,1,0,6,6,3,0,9,11,3,0,14,13,3,0,16
162185,157,"ŞCOALA PRIMARĂ PÎHNEŞTI",PÎHNEŞTI,VS,345,1,0,0,1,4,3,0,7,6,5,0,11,7,7,0,14,10,7,0,17
162176,158,"ŞCOALA PRIMARĂ MIHAIL KOGĂLNICEANU","MIHAIL KOGĂLNICEANU",VS,80,2,5,0,7,2,7,0,9,4,8,0,12,4,9,0,13,4,9,0,13
162201,159,"ŞCOALA GIMNAZIALĂ NR. 1 GARA BANCA","GARA BANCA",VS,1063,1,0,0,1,6,0,0,6,7,0,0,7,13,0,0,13,15,0,0,15
162210,160,"ŞCOALA GIMNAZIALĂ BANCA",BANCA,VS,839,5,0,0,5,11,1,0,12,17,2,0,19,20,2,0,22,23,2,0,25
162229,161,"ŞCOALA PRIMARĂ GHERMĂNEŞTI",GHERMĂNEŞTI,VS,383,1,1,0,2,1,1,0,2,6,2,0,8,9,2,0,11,10,2,0,12
162283,162,"ŞCOALA PRIMARĂ STOIŞEŞTI",STOIŞEŞTI,VS,482,1,1,0,2,6,2,0,8,13,2,0,15,20,4,0,24,21,4,0,25
162309,163,"ŞCOALA GIMNAZIALĂ ȚIFU",ŢIFU,VS,321,8,4,0,12,8,4,0,12,25,5,0,30,34,6,0,40,35,6,0,41
162318,164,"ŞCOALA PRIMARĂ 1 DECEMBRIE","1 DECEMBRIE",VS,347,4,2,0,6,6,4,0,10,11,4,0,15,19,5,0,24,20,7,0,27
162247,165,"ŞCOALA PRIMARĂ MITOC",MITOC,VS,297,2,0,0,2,8,0,0,8,13,0,0,13,17,0,0,17,22,0,0,22
162274,166,"CAMINUL CULTURAL",SÎRBI,VS,326,1,0,0,1,7,0,0,7,10,0,0,10,15,2,0,17,19,5,0,24
162292,167,"GRĂDINIŢA STRÎMTURA -MITOC",STRÎMTURA-MITOC,VS,165,2,0,0,2,6,0,0,6,8,0,0,8,11,0,0,11,12,0,0,12
162238,168,"ŞCOALA PRIMARA MICLEȘTI",MICLEŞTI,VS,194,1,1,0,2,4,4,0,8,14,5,0,19,24,6,0,30,26,7,0,33
162336,169,"ŞCOALA GIMNAZIALA NR. 1 SAT BĂCANI",BĂCANI,VS,1084,3,1,0,4,13,1,0,14,18,13,0,31,27,15,0,42,27,15,0,42
162345,170,"ŞCOALA PRIMARA SAT BĂLŢĂTENI",BĂLTĂŢENI,VS,362,3,4,0,7,6,4,0,10,8,4,0,12,15,4,0,19,21,4,0,25
162354,171,"ŞCOALA PRIMARA SAT DRUJEŞTI",DRUJEŞTI,VS,344,8,1,0,9,11,4,0,15,14,4,0,18,22,4,0,26,24,4,0,28
162363,172,"ŞCOALA PRIMARA SAT SUSENI",SUSENI,VS,336,0,0,0,0,3,0,0,3,3,0,0,3,6,0,0,6,6,0,0,6
162372,173,"FOSTA ŞCOALA CU CLASELE I-IV VULPĂȘENI",VULPĂŞENI,VS,153,6,3,0,9,7,3,0,10,7,3,0,10,8,3,0,11,8,3,0,11
162390,174,"ŞCOALA GIMNAZIALĂ NR.1 SAT BĂCEŞTI",BĂCEŞTI,VS,1707,2,0,0,2,9,4,0,13,15,5,24,44,28,7,24,59,29,7,24,60
162407,175,"ŞCOALA PRIMARĂ SAT ARMĂŞENI",ARMĂŞENI,VS,318,6,0,0,6,6,0,0,6,8,0,0,8,8,0,0,8,9,0,0,9
162416,176,"ŞCOALA PRIMARĂ SAT BĂBUŞA",BĂBUŞA,VS,340,4,4,0,8,4,6,0,10,5,6,0,11,6,6,0,12,6,6,0,12
162425,177,"ŞCOALA PRIMARĂ SAT PĂLTINIŞ",PĂLTINIŞ,VS,237,2,0,0,2,3,2,0,5,3,2,0,5,6,2,0,8,6,2,0,8
162434,178,"ŞCOALA PRIMARĂ SAT ŢIBĂNEŞTII BUHLII","ŢIBĂNEŞTII BUHLII",VS,171,3,2,0,5,4,4,0,8,4,5,0,9,5,5,0,10,5,5,0,10
162443,179,"ŞCOALA PRIMARĂ SAT VOVRIEŞTI",VOVRIEŞTI,VS,253,2,1,0,3,3,1,0,4,3,1,0,4,7,1,0,8,9,1,0,10
162461,180,"CENTRUL CULTURAL BĂLTENI",BĂLTENI,VS,784,7,0,0,7,14,0,0,14,17,0,0,17,25,3,0,28,26,3,0,29
162470,181,"IMOBIL PROPRIETATE PRIVATĂ ÎNTREPRINDERE INDIVIDUALĂCRAILIUC CĂTĂLINA-MIHAELA",BĂLTENI-DEAL,VS,381,5,0,0,5,11,5,0,16,13,5,0,18,15,5,0,20,16,6,0,22
162489,182,"ŞCOALAPRIMARA CHETREŞTI",CHETREŞTI,VS,103,2,7,0,9,2,7,0,9,2,7,0,9,7,7,0,14,7,7,0,14
162504,183,"ŞCOALA GIMNAZIALĂ ""ANASTASIE FĂTU"" BEREZENI- CORP 1",BEREZENI,VS,1148,12,0,0,12,18,4,0,22,22,5,0,27,26,7,0,33,28,7,0,35
162504,184,"ŞCOALA GIMNAZIALĂ ""ANASTASIE FĂTU"" BEREZENI- CORP 3",BEREZENI,VS,728,3,0,0,3,6,2,0,8,9,2,0,11,13,2,0,15,16,5,0,21
162513,185,"ŞCOALA PRIMARĂ MUŞATA",MUŞATA,VS,365,4,2,0,6,10,2,0,12,11,2,0,13,12,2,0,14,13,2,0,15
162522,186,"ŞCOALA GIMNAZIALĂ RÎNCENI",RÎNCENI,VS,446,2,0,0,2,3,0,0,3,3,1,0,4,10,1,0,11,10,2,0,12
162540,187,"ŞCOALA PRIMARĂ STUHULEŢ",STUHULEŢ,VS,182,2,1,0,3,5,2,0,7,5,4,0,9,8,4,0,12,10,4,0,14
162531,188,"ȘCOALA GIMNAZIALĂ ""ANASTASIE FĂTU"" BEREZENI-CORP 2 SATU NOU","SATU NOU",VS,1150,5,2,0,7,12,2,0,14,17,2,0,19,36,2,0,38,36,2,0,38
162568,189,"CĂMINUL CULTURAL BLĂGEŞTI",BLĂGEŞTI,VS,834,2,0,0,2,2,0,0,2,4,1,0,5,9,1,0,10,9,1,0,10
162577,190,"ŞCOALA PRIMARA IGEŞTI",IGEŞTI,VS,201,0,0,0,0,3,0,0,3,3,0,0,3,3,1,0,4,3,1,0,4
162586,191,"ŞCOALA PRIMARA SIPENI",SIPENI,VS,71,1,1,0,2,1,1,0,2,1,4,0,5,2,4,0,6,2,4,0,6
162602,192,"ŞCOALA GIMNAZIALĂ NR. 1 BOGDANA",BOGDANA,VS,454,5,0,0,5,8,0,0,8,18,1,0,19,24,1,0,25,25,1,0,26
162675,193,"ŞCOALA SUCEVENI",SUCEVENI,VS,158,1,0,0,1,3,0,0,3,3,0,0,3,5,0,0,5,5,0,0,5
162639,194,"ŞCOALA PRIMARĂ GĂVANU",GĂVANU,VS,94,2,0,0,2,4,0,0,4,6,0,0,6,8,4,0,12,8,5,0,13
162684,195,"ŞCOALA VERDEŞ",VERDEŞ,VS,155,2,0,0,2,8,4,0,12,10,4,0,14,10,4,0,14,12,4,0,16
162648,196,"ŞCOALAPRIMARĂ LACU BABEI","LACU BABEI",VS,334,4,0,0,4,8,0,0,8,9,0,0,9,13,0,0,13,14,0,0,14
162700,197,"CĂMINUL CULTURAL BOGDĂNEŞTI",BOGDĂNEŞTI,VS,790,0,0,0,0,5,0,0,5,13,5,0,18,18,7,0,25,19,7,0,26
162719,198,"ŞCOALA PRIMARA, SAT BUDA",BUDA,VS,283,2,6,0,8,2,6,0,8,6,6,0,12,6,6,0,12,24,7,0,31
162773,199,"ŞCOALA PRIMARĂ, SAT VIȘINARI",VIŞINARI,VS,157,3,0,0,3,6,0,0,6,11,2,0,13,12,2,0,14,12,2,0,14
162755,200,"ŞCOALA PRIMARĂ, SAT ULEA",ULEA,VS,269,0,0,0,0,3,4,0,7,4,4,0,8,6,6,0,12,9,7,0,16
162764,201,"ŞCOALA GIMNAZIALĂ, SAT UNȚEȘTI",UNŢEŞTI,VS,792,7,1,0,8,11,1,0,12,13,3,0,16,20,3,0,23,23,3,0,26
162728,202,"ŞCOALA PRIMARĂ, SAT HOROIATA",HOROIATA,VS,119,1,0,0,1,2,1,0,3,3,3,0,6,3,3,0,6,3,3,0,6
162808,203,"SEDIUL PRIMARIEI",BOGDĂNIŢA,VS,150,4,5,0,9,6,6,0,12,7,7,0,14,8,9,0,17,8,9,0,17
162835,204,"ŞCOALA PRIMARACOROIEŞTI",COROIEŞTI,VS,351,9,2,0,11,13,2,0,15,18,2,0,20,19,2,0,21,21,2,0,23
162862,205,"ŞCOALA PRIMARA TUNSEŞTI",TUNSEŞTI,VS,205,7,3,0,10,9,4,0,13,9,4,0,13,13,4,0,17,15,4,0,19
162817,206,"ŞCOALA GIMNAZIALA NR 1CEPEŞTI",CEPEŞTI,VS,437,10,0,0,10,14,0,0,14,25,2,0,27,30,3,0,33,30,3,0,33
162880,207,"ŞCOALA GIMNAZIALĂ NR.1 BOŢEŞTI",BOŢEŞTI,VS,808,4,3,0,7,15,4,0,19,18,4,0,22,19,4,0,23,19,4,0,23
162906,208,"ŞCOALA GIMNAZIALĂ”ALEXANDRUOBREJA” SATGUGEŞTI",GUGEŞTI,VS,799,14,2,0,16,24,3,0,27,27,3,0,30,33,5,0,38,35,6,0,41
162933,209,"ŞCOALA GIMNAZIALA NR. 1 SAT AVEREŞTI",AVEREŞTI,VS,232,4,2,0,6,13,2,0,15,19,2,0,21,24,2,0,26,25,2,0,27
162951,210,"ŞCOALA GIMNAZIALĂ I-IV BUNEŞTI",BUNEŞTI,VS,982,2,0,0,2,6,0,0,6,13,1,0,14,15,1,0,16,21,1,0,22
162960,211,"ŞCOALA PRIMARĂ PLOPI",PLOPI,VS,380,0,1,0,1,4,4,0,8,6,8,0,14,13,13,0,26,17,14,0,31
162942,212,"FOSTA ŞCOALA GENERALĂ ARMĂŞENI",ARMĂŞENI,VS,285,3,1,0,4,8,1,0,9,11,1,0,12,13,1,0,14,14,1,0,15
162979,213,"ŞCOALA PRIMARĂ PODU-OPRII","PODU OPRII",VS,196,1,0,0,1,1,0,0,1,3,0,0,3,6,1,0,7,8,2,0,10
165292,214,"CĂMINUL CULTURAL CIOCANI",CIOCANI,VS,904,2,0,0,2,6,0,0,6,11,0,0,11,13,1,0,14,17,1,0,18
165309,215,"IMOBIL PROPRIETATE PRIVATĂ GIUȘCĂ FILICA",CRÂNG,VS,358,1,0,0,1,4,0,0,4,4,1,0,5,5,2,0,7,6,5,0,11
163011,216,"ȘCOALA GIMNAZIALĂ CODĂEȘTI",CODĂEŞTI,VS,911,11,0,0,11,20,3,0,23,23,5,0,28,26,5,0,31,26,5,0,31
163011,217,"ȘCOALA GIMNAZIALĂ CODĂEȘTI",CODĂEŞTI,VS,798,17,0,0,17,21,3,0,24,26,3,0,29,26,3,0,29,26,3,0,29
163039,218,"ȘCOALA GIMNAZIALĂ PRIBEȘTI",PRIBEŞTI,VS,975,4,0,0,4,12,3,0,15,13,3,0,16,18,3,0,21,18,3,0,21
163048,219,"CĂMINUL CULTURAL REDIU-GALIAN","REDIU GALIAN",VS,454,1,0,0,1,2,0,0,2,4,3,0,7,5,3,0,8,6,4,0,10
163020,220,"ȘCOALA GENERALĂ GHERGHELEU",GHERGHELEU,VS,320,1,1,0,2,2,1,0,3,5,4,0,9,10,6,0,16,11,7,0,18
163066,221,"SCOALA GIMNAZIALA GEORGE C DRAGU SAT COROIESTI",COROIEŞTI,VS,729,3,0,0,3,17,0,0,17,24,0,0,24,37,0,0,37,37,0,0,37
163075,222,"DISPENSAR UMAN, SAT CHILIENI",CHILIENI,VS,211,3,3,0,6,8,6,0,14,15,6,0,21,19,6,0,25,19,6,0,25
163100,223,"SCOALA GIMNAZIALA SAT MIRENI",MIRENI,VS,382,1,0,0,1,3,0,0,3,23,2,0,25,42,2,0,44,65,2,0,67
163093,224,"SCOALA PRIMARA SAT HREASCA",HREASCA,VS,302,1,3,0,4,3,3,0,6,7,3,0,10,11,3,0,14,12,3,0,15
163146,225,"ŞCOALA GIMNAZIALĂ SFÂNTUL IERARH LUCA COSTEȘTI",COSTEŞTI,VS,1452,9,4,0,13,15,4,0,19,21,19,0,40,25,24,0,49,26,29,0,55
163182,226,"ŞCOALAGIMNAZIALĂ PUNTIŞENI",PUNTIŞENI,VS,234,1,0,0,1,9,1,0,10,12,1,0,13,17,1,0,18,17,3,0,20
163155,227,"ŞCOALA PRIMARĂ CHIŢCANI",CHIŢCANI,VS,256,0,0,0,0,3,0,0,3,3,0,0,3,3,0,0,3,3,0,0,3
163164,228,"ŞCOALAPRIMARĂ DINGA",DINGA,VS,107,0,0,0,0,0,1,0,1,1,1,0,2,4,6,0,10,4,6,0,10
163191,229,"ŞCOALA PRIMARĂ RĂDEŞTI",RĂDEŞTI,VS,117,1,0,0,1,3,2,0,5,4,2,0,6,4,2,0,6,4,2,0,6
163173,230,"ŞCOALA PRIMARĂ PÎRVEŞTI",PÎRVEŞTI,VS,78,0,0,0,0,0,0,0,0,1,0,0,1,7,1,0,8,7,1,0,8
163404,231,"ŞCOALA PRIMARÃBÃLEŞTI",BĂLEŞTI,VS,598,7,3,0,10,11,3,0,14,15,3,0,18,23,3,0,26,25,3,0,28
163422,232,"ŞCOALA GIMNAZIALÃ "" CEZAR BOTEZ "" FÂSTÂCI",FÂSTÂCI,VS,289,2,0,0,2,7,1,0,8,9,1,0,10,19,3,0,22,20,3,0,23
163413,233,"FOSTA ŞCOALÃ CU CLASELE I-IV COZMEŞTI",COZMEŞTI,VS,256,4,0,0,4,20,7,0,27,28,7,0,35,32,8,0,40,32,8,0,40
163422,234,ŞCOALAPRIMARÃFÂSTÂCI,FÂSTÂCI,VS,586,5,0,0,5,17,0,0,17,29,0,0,29,32,0,0,32,33,0,0,33
163217,235,"CĂMINUL CULTURAL"" VASILE FOLESCU"" CREŢEŞTI",CREŢEŞTI,VS,488,1,0,0,1,4,0,0,4,5,0,0,5,12,2,0,14,14,3,0,17
163235,236,"ŞCOALA GIMNAZIALA NR.1CRETESTII DE SUS","CREŢEŞTII DE SUS",VS,491,6,3,0,9,8,5,0,13,9,5,0,14,15,7,0,22,15,7,0,22
163244,237,"ŞCOALA NOUA SATU NOU","SATU NOU",VS,252,5,0,0,5,7,2,0,9,8,2,0,10,14,3,0,17,14,5,0,19
163226,238,"ŞCOALA DEZAFECTATA BUDEŞTI",BUDEŞTI,VS,162,5,3,0,8,10,3,0,13,11,3,0,14,16,3,0,19,17,3,0,20
163262,239,"CĂMINUL CULTURAL DĂNEŞTI",DĂNEŞTI,VS,443,6,0,0,6,11,2,0,13,18,2,0,20,23,4,0,27,24,4,0,28
163299,240,"ŞCOALA GIMNAZIALA EMIL RACOVIŢĂ","EMIL RACOVIŢĂ",VS,670,1,0,0,1,9,2,0,11,16,8,0,24,18,8,0,26,19,8,0,27
163271,241,"ŞCOALA PRIMARA BEREASA",BEREASA,VS,311,5,0,0,5,5,0,0,5,8,3,0,11,29,7,0,36,30,7,0,37
163315,242,"ŞCOALA PRIMARA TĂTĂRĂNI",TĂTĂRĂNI,VS,165,1,0,0,1,5,1,0,6,11,1,0,12,16,1,0,17,17,2,0,19
163333,243,"ŞCOALA GIMNAZIALA NR. 1DELENI",DELENI,VS,1392,8,1,0,9,15,9,0,24,27,9,0,36,36,12,0,48,38,12,0,50
163342,244,"GRADINITA CU PROGRAM NORMAL, SAT BULBOACA",BULBOACA,VS,515,8,3,0,11,8,5,0,13,13,7,0,20,23,8,0,31,26,8,0,34
163388,245,"ŞCOALA GIMNAZIALĂ NR. 1, DELEŞTI",DELEŞTI,VS,605,3,1,0,4,6,1,0,7,7,1,0,8,13,2,0,15,14,5,0,19
163397,246,"ŞCOALA PRIMARĂ, ALBEŞTI",ALBEŞTI,VS,157,5,4,0,9,6,4,0,10,8,4,0,12,12,4,0,16,14,4,0,18
163431,247,"ŞCOALA PRIMARĂ, FUNDĂTURA",FUNDĂTURA,VS,332,2,0,0,2,5,0,0,5,15,0,0,15,20,0,0,20,20,0,0,20
163440,248,"ŞCOALA GIMNAZIALĂ, HÎRȘOVA",HÎRSOVA,VS,392,6,2,0,8,14,6,0,20,16,6,0,22,23,7,0,30,25,7,0,32
163468,249,"ŞCOALA PRIMARĂ, MÎNĂSTIREA",MÎNĂSTIREA,VS,147,1,3,0,4,5,3,0,8,11,4,0,15,12,4,0,16,16,4,0,20
163477,250,"ŞCOALA PRIMARĂ, RĂDUIEȘTI",RĂDUIEŞTI,VS,172,0,0,0,0,2,0,0,2,2,0,0,2,4,0,0,4,7,0,0,7
164286,251,"ŞCOALAGIMNAZIALĂ NR.1 HURDUGI",HURDUGI,VS,513,4,0,0,4,28,6,0,34,32,6,0,38,46,6,0,52,46,8,0,54
164295,252,"ŞCOALA PRIMARĂ GRUMEZOAIA",GRUMEZOAIA,VS,325,0,1,0,1,14,5,0,19,18,4,0,22,22,9,0,31,23,9,0,32
164302,253,"ŞCOALA GIMNAZIALĂ GUȘIȚEI",GUŞIŢEI,VS,616,5,2,0,7,5,2,0,7,9,2,0,11,17,3,0,20,17,3,0,20
164311,254,"ŞCOALAPRIMARĂ PLOTONEŞTI",PLOTONEŞTI,VS,264,0,0,0,0,5,1,0,6,9,1,0,10,12,1,0,13,16,1,0,17
164320,255,"ŞCOALA PRIMARĂ URLAŢI",URLAŢI,VS,199,8,2,0,10,8,3,0,11,10,3,0,13,12,3,0,15,13,3,0,16
166725,256,"ŞCOALA GIMNAZIALĂ ""V.I. POPA""",DODEŞTI,VS,1155,3,6,0,9,5,6,0,11,10,7,0,17,10,7,0,17,19,7,0,26
166743,257,"ŞCOALA PRIMARĂ URDEŞTI",URDEŞTI,VS,197,0,0,0,0,1,0,0,1,2,0,0,2,9,1,0,10,10,1,0,11
163495,258,"CĂMINUL CULTURAL DRAGOMIREŞTI",DRAGOMIREŞTI,VS,450,5,0,0,5,7,0,0,7,9,0,0,9,14,0,0,14,15,0,0,15
163556,259,"ŞCOALA PRIMARĂ POIANA PIETREI","POIANA PIETREI",VS,235,1,0,0,1,5,0,0,5,9,1,0,10,9,2,0,11,9,2,0,11
163547,260,"ŞCOALA GIMNAZIALĂ DOAGELE",DOAGELE,VS,834,1,0,0,1,2,0,0,2,3,0,0,3,5,0,0,5,7,0,0,7
163609,261,"LICEUL TEHNOLOGIC VLADIA",VLADIA,VS,384,0,0,0,0,2,0,0,2,5,0,0,5,6,0,0,6,6,0,0,6
163510,262,"ŞCOALA PRIMARĂBELZENI",BELZENI,VS,204,4,0,0,4,6,0,0,6,8,2,0,10,8,2,0,10,8,2,0,10
163501,263,"ŞCOALA PRIMARĂ BĂBUŢA",BĂBUŢA,VS,129,0,0,0,0,0,0,0,0,5,0,0,5,7,0,0,7,7,0,0,7
163574,264,"ŞCOALA GIMNAZIALĂ NR. 1RĂDENI",RĂDENI,VS,927,9,3,0,12,12,4,0,16,14,6,0,20,16,6,0,22,16,7,0,23
163592,265,"ŞCOALA PRIMARĂ TULEŞTI",TULEŞTI,VS,144,0,0,0,0,5,2,0,7,6,2,0,8,8,2,0,10,8,2,0,10
163565,266,"ŞCOALA PRIMARĂ POPEŞTI",POPEŞTI,VS,309,0,0,0,0,3,0,0,3,8,0,0,8,11,0,0,11,12,0,0,12
163654,267,"SALA DE EDUCAŢIE FIZICĂ ŞCOLARĂ GHERMĂNEŞTI",GHERMĂNEŞTI,VS,1638,40,0,0,40,48,0,0,48,64,1,0,65,74,2,0,76,83,2,0,85
163627,268,"ŞCOALA PRIMARĂ, SAT DRÎNCENI",DRÎNCENI,VS,464,7,0,0,7,9,2,0,11,13,2,0,15,13,2,0,15,13,2,0,15
163663,269,"ŞCOALA GIMNAZIALĂ, SAT RÎŞEŞTI",RÎŞEŞTI,VS,1676,5,0,0,5,13,7,0,20,24,7,0,31,39,8,0,47,41,10,0,51
163690,270,"ŞCOALA GIMNAZIALA CONSTANTIN ASIMINEI",EPURENI,VS,1211,1,3,0,4,5,4,0,9,14,4,0,18,22,7,0,29,22,7,0,29
163716,271,"ŞCOALA GIMNAZIALA IOAN GHE. PRICOP",DUDA,VS,980,5,1,0,6,15,8,0,23,22,11,0,33,24,11,0,35,28,11,0,39
163725,272,"ŞCOALA GIMNAZIALA NICOLAE POPA","VALEA GRECULUI",VS,1306,4,0,0,4,4,0,0,4,7,0,0,7,7,0,0,7,8,0,0,8
163707,273,"FOSTA ŞCOALA CU CLASELE I-IV BOBEŞTI",BOBEŞTI,VS,110,1,0,0,1,1,0,0,1,1,0,0,1,1,0,0,1,4,0,0,4
163743,274,"ŞCOALA GIMNAZIALĂ ”MAREȘAL C-TIN PREZAN” DUMEŞTI",DUMEŞTI,VS,1043,2,5,0,7,3,5,0,8,5,6,0,11,8,9,0,17,14,9,0,23
163743,275,"GRĂDINIŢA NR. 1 DUMEŞTI",DUMEŞTI,VS,748,3,0,0,3,5,0,0,5,14,0,0,14,21,0,0,21,21,0,0,21
163752,276,"GRĂDINIȚA DUMEŞTII VECHI","DUMEŞTII VECHI",VS,348,3,0,0,3,8,0,0,8,10,0,0,10,13,0,0,13,15,3,0,18
163770,277,"ŞCOALA PRIMARĂ VALEA MARE","VALEA MARE",VS,700,2,1,0,3,4,1,0,5,11,1,0,12,12,2,0,14,13,2,0,15
163798,278,"SCOALA GIMNAZIALA ,, MANOLACHE COSTACHEEPUREANU"" SAT EPURENI",EPURENI,VS,777,4,0,0,4,7,0,0,7,11,2,0,13,14,4,0,18,19,7,0,26
163814,279,"ȘCOALA PRIMARĂ NR.2 BURSUCI",BURSUCI,VS,734,9,0,0,9,19,2,0,21,25,2,0,27,29,4,0,33,31,4,0,35
163805,280,"SCOALA PRIMARA .SAT BIRLALESTI",BÎRLĂLEŞTI,VS,573,4,0,0,4,7,0,0,7,10,0,0,10,11,1,0,12,11,1,0,12
163823,281,"SCOALA PRIMARA ,SATHORGA",HORGA,VS,319,4,8,0,12,4,8,0,12,20,12,0,32,29,14,0,43,30,14,0,44
163841,282,"LICEUL TEHNOLOGIC ""DIMITRIE CANTEMIR"" SAT FĂLCIU",FĂLCIU,VS,1054,1,2,0,3,5,4,0,9,13,6,0,19,16,7,0,23,17,7,0,24
163841,283,"CĂMINUL CULTURAL FĂLCIU",FĂLCIU,VS,1054,4,2,0,6,12,2,0,14,17,2,0,19,17,4,0,21,18,4,0,22
163850,284,"ŞCOALA PRIMARĂSAT BOGDĂNEŞTI",BOGDĂNEŞTI,VS,477,3,0,0,3,4,0,0,4,6,0,0,6,6,0,0,6,6,0,0,6
163896,285,"ŞCOALA GIMNAZIALĂ SAT RÂNZEŞTI",RÎNZEŞTI,VS,845,8,5,0,13,17,6,0,23,31,7,0,38,37,7,0,44,39,7,0,46
163869,286,"ŞCOALA PRIMARĂ SAT BOZIA",BOZIA,VS,331,4,1,0,5,5,2,0,7,7,2,0,9,10,2,0,12,11,2,0,13
163878,287,"ŞCOALA PRIMARĂ SAT COPĂCEANA",COPĂCEANA,VS,461,5,2,0,7,10,3,0,13,13,5,0,18,20,7,0,27,20,7,0,27
163887,288,"ŞCOALA PRIMARĂ SAT ODAIA BOGDANA","ODAIA BOGDANA",VS,258,1,1,0,2,5,2,0,7,6,7,0,13,6,8,0,14,6,9,0,15
166654,289,"CENTRUL CULTURAL ""SANDU TRIFAN"", FEREŞTI",FEREŞTI,VS,1653,10,0,0,10,16,1,0,17,28,1,0,29,37,1,0,38,40,1,0,41
164151,290,"ŞCOALA GIMNAZIALĂ ""GENERAL AVIATOR INGINER GHEORGHE NEGRESCU"" FRUNTIŞENI",FRUNTIŞENI,VS,760,4,3,0,7,16,4,0,20,27,4,0,31,35,4,0,39,36,4,0,40
164160,291,"ŞCOALA GIMNAZIALĂ GRĂJDENI",GRĂJDENI,VS,637,8,2,0,10,17,4,0,21,21,4,0,25,33,8,0,41,35,8,0,43
163912,292,"ŞCOALA GIMNAZIALA ”ION ARTENE” GĂGEŞTI",GĂGEŞTI,VS,380,7,1,0,8,15,1,0,16,17,1,0,18,18,4,0,22,18,4,0,22
163921,293,"GRĂDINIŢA CU PROGRAM NORMAL GIURCANI",GIURCANI,VS,463,5,5,0,10,10,16,0,26,13,16,0,29,17,19,0,36,22,19,0,41
163930,294,"ŞCOALA PRIMARA ”DUMITRU MARIN” PEICANI",PEICANI,VS,429,7,1,0,8,7,1,0,8,9,1,0,10,18,1,0,19,18,2,0,20
163958,295,"ŞCOALA PRIMARA TUPILATI",TUPILAŢI,VS,255,1,2,0,3,4,2,0,6,6,4,0,10,7,4,0,11,7,4,0,11
163976,296,"CĂMINUL CULTURAL, GHERGHEŞTI",GHERGHEŞTI,VS,935,4,2,0,6,9,3,0,12,9,3,0,12,10,3,0,13,13,3,0,16
164035,297,"CONTAINER MODULAR",LUNCA,VS,386,5,0,0,5,6,0,0,6,7,0,0,7,7,0,0,7,7,0,0,7
163994,298,"ŞCOALA PRIMARA SAT CORODESTI",CORODEŞTI,VS,177,2,4,0,6,3,4,0,7,5,5,0,10,7,6,0,13,7,6,0,13
163985,299,"ŞCOALA GIMNAZIALA SAT CHETROSU",CHETROSU,VS,405,0,3,0,3,4,3,0,7,5,3,0,8,6,3,0,9,7,3,0,10
164017,300,"ŞCOALA PRIMARA SAT DRAXENI",DRĂXENI,VS,121,1,5,0,6,2,5,0,7,3,5,0,8,4,5,0,9,5,5,0,10
164071,301,"CĂMINUL CULTURAL GÎRCENI",GÎRCENI,VS,729,7,4,0,11,17,7,0,24,24,7,0,31,26,11,0,37,34,13,0,47
164080,302,"ŞCOALA PRIMARĂ, DUMBRĂVENI",DUMBRĂVENI,VS,173,4,3,0,7,4,3,0,7,9,6,0,15,12,6,0,18,14,6,0,20
164124,303,"ŞCOALA PRIMARĂ, TROHAN",TROHAN,VS,182,2,0,0,2,3,0,0,3,6,0,0,6,12,0,0,12,13,0,0,13
164099,304,"ŞCOALA GIMNAZIALĂ, RACOVA",RACOVA,VS,155,3,0,0,3,3,0,0,3,9,1,0,10,9,1,0,10,9,1,0,10
164106,305,"ŞCOALA PRIMARĂ, RACOVIŢA",RACOVIŢA,VS,176,1,0,0,1,5,1,0,6,11,1,0,12,12,1,0,13,13,1,0,14
164115,306,"ŞCOALA PRIMARĂ, SLOBOZIA",SLOBOZIA,VS,346,2,0,0,2,4,0,0,4,9,1,0,10,9,2,0,11,9,3,0,12
164142,307,"GRĂDINIŢA CU PROGRAM NORMALGRIVIŢA",GRIVIŢA,VS,1310,6,1,0,7,12,5,0,17,14,7,0,21,21,8,0,29,23,8,0,31
164188,308,"ŞCOALAGIMNAZIALĂ TRESTIANA",TRESTIANA,VS,1131,5,0,0,5,8,0,0,8,10,0,0,10,16,0,0,16,19,0,0,19
164179,309,"ŞCOALA PRIMARĂ ODAIA BURSUCANI","ODAIA BURSUCANI",VS,437,4,2,0,6,6,2,0,8,9,2,0,11,13,3,0,16,16,3,0,19
164204,310,"CĂMINUL CULTURAL HOCENI",HOCENI,VS,425,5,1,0,6,10,2,0,12,13,2,0,15,15,2,0,17,16,3,0,19
164213,311,"GRĂDINIŢA CU PROGRAM NORMAL BARBOŞI",BARBOŞI,VS,556,11,0,0,11,16,1,0,17,26,1,0,27,29,1,0,30,29,1,0,30
164222,312,"ŞCOALA PRIMARĂ DELENI",DELENI,VS,358,2,1,0,3,7,4,0,11,13,4,0,17,14,4,0,18,15,4,0,19
164231,313,"ŞCOALA PRIMARĂ OŢELENI",OŢELENI,VS,416,4,0,0,4,5,0,0,5,10,2,0,12,20,3,0,23,22,3,0,25
164268,314,"ŞCOALA PRIMARĂ TOMȘA",TOMŞA,VS,245,2,1,0,3,5,1,0,6,7,1,0,8,7,3,0,10,7,3,0,10
164268,315,"ŞCOALA PRIMARĂ TOMŞA",TOMŞA,VS,103,1,0,0,1,1,0,0,1,1,0,0,1,1,0,0,1,1,0,0,1
164348,316,"ŞCOALA GIMNAZIALA NR.1 IANA",IANA,VS,917,15,1,0,16,17,1,0,18,21,2,0,23,22,2,0,24,23,2,0,25
164357,317,"ŞCOALA PRIMARA HĂLĂREŞTI",HĂLĂREŞTI,VS,814,8,0,0,8,23,0,0,23,30,0,0,30,37,0,0,37,38,2,0,40
164375,318,"ŞCOALA PRIMARA SILIŞTEA",SILIŞTEA,VS,771,2,0,0,2,6,3,0,9,11,3,0,14,11,5,0,16,12,5,0,17
164366,319,"ŞCOALA GIMNAZIALA RECEA",RECEA,VS,378,5,3,0,8,6,3,0,9,11,3,0,14,12,3,0,15,13,4,0,17
164384,320,"GRĂDINIŢA VADURILE",VADURILE,VS,255,7,5,0,12,17,6,0,23,17,6,0,23,20,6,0,26,20,6,0,26
162103,321,"CĂMINUL CULTURAL IBĂNEŞTI",IBĂNEŞTI,VS,533,10,2,0,12,50,2,0,52,60,2,0,62,75,4,0,79,86,5,0,91
162112,322,"ŞCOALA PRIMARĂ SAT. MÎNZAŢI",MÎNZAŢI,VS,519,8,0,0,8,8,2,0,10,17,2,0,19,33,5,0,38,33,5,0,38
162130,323,"FOSTA ŞCOALA CU CLASELE I-IV, PUŢU OLARULUI","PUŢU OLARULUI",VS,110,0,0,0,0,0,3,0,3,0,3,0,3,3,3,0,6,4,3,0,7
164400,324,"ŞCOALA IVĂNEŞTI",IVĂNEŞTI,VS,994,5,1,0,6,16,2,0,18,20,2,0,22,31,4,0,35,33,4,0,37
164437,325,"ŞCOALA BROŞTENI",BROŞTENI,VS,463,6,0,0,6,16,0,0,16,19,0,0,19,24,6,0,30,25,7,0,32
164525,326,"ŞCOALA VALEA MARE","VALEA MARE",VS,409,0,0,0,0,1,0,0,1,1,1,0,2,4,2,0,6,4,2,0,6
164455,327,"ŞCOALA COȘCA",COŞCA,VS,267,3,1,0,4,4,1,0,5,7,2,0,9,7,3,0,10,7,3,0,10
164464,328,"ŞCOALA COŞEȘTI",COŞEŞTI,VS,294,5,0,0,5,13,0,0,13,13,1,0,14,15,2,0,17,15,2,0,17
164534,329,"ŞCOALA VALEA OANEI","VALEA OANEI",VS,228,2,0,0,2,2,2,0,4,6,3,0,9,7,3,0,10,7,3,0,10
164516,330,"ŞCOALA URSOAIA",URSOAIA,VS,361,1,1,0,2,5,2,0,7,9,5,0,14,10,5,0,15,12,5,0,17
164516,331,"GRADINITA CU PROGRAM NORMAL SAT.URSOAIA",URSOAIA,VS,381,4,1,0,5,4,1,0,5,5,1,0,6,7,4,0,11,8,4,0,12
164552,332,"ŞCOALA GIMNAZIALĂ NR. 1 IVEŞTI - CORP A",IVEŞTI,VS,1090,5,0,0,5,10,1,0,11,11,2,0,13,19,2,0,21,19,2,0,21
164552,333,"ŞCOALA GIMNAZIALĂ NR. 1 IVEŞTI - CORP B",IVEŞTI,VS,1098,6,0,0,6,14,2,0,16,20,3,0,23,20,4,0,24,20,4,0,24
164605,334,"ŞCOALAGIMNAZIALĂ ""MIHAI EMINESCU"" LAZA",LAZA,VS,1474,7,0,0,7,20,0,0,20,25,0,0,25,28,0,0,28,33,0,0,33
164650,335,"ŞCOALA PRIMARA ,SAUCA",SAUCA,VS,867,2,0,0,2,7,0,0,7,10,0,0,10,14,2,0,16,15,2,0,17
164641,336,"ŞCOALA PRIMARĂ, RÂŞNIŢA",RÎŞNIŢA,VS,239,1,3,0,4,1,3,0,4,3,3,0,6,4,5,0,9,4,5,0,9
164696,337,"CENTRUL CULTURAL ""ȘTEFAN CIOBOTĂRAȘU""SAT LIPOVAȚ",LIPOVĂŢ,VS,1271,11,1,0,12,18,5,0,23,30,6,0,36,35,7,0,42,37,7,0,44
164721,338,"ŞCOALA PRIMARĂ SAT CORBU",CORBU,VS,450,8,1,0,9,12,1,0,13,20,1,0,21,25,3,0,28,26,3,0,29
164712,339,"ŞCOALA GIMNAZIALĂ ""SPĂTAR ŞTEFAN ANGHELUȚĂ"" SAT CHIŢOC",CHIŢOC,VS,827,4,0,0,4,16,2,0,18,29,5,0,34,40,6,0,46,43,6,0,49
164703,340,"ŞCOALA PRIMARĂ SAT CĂPUŞNENI",CĂPUŞNENI,VS,202,5,3,0,8,7,5,0,12,8,5,0,13,11,6,0,17,12,7,0,19
164730,341,"ŞCOALA GIMNAZIALĂ SAT FUNDU - VĂII","FUNDU VĂII",VS,456,5,4,0,9,5,5,0,10,9,5,0,14,12,5,0,17,15,5,0,20
164758,342,"ŞCOALA GIMNAZIALĂ NR. 1 LUNCA BANULUI","LUNCA BANULUI",VS,1655,4,1,0,5,24,2,0,26,31,2,0,33,39,2,0,41,39,2,0,41
164801,343,"ŞCOALA PRIMARĂ SAT OŢETOAIA",OŢETOAIA,VS,682,7,1,0,8,15,3,0,18,26,4,0,30,30,4,0,34,30,4,0,34
164794,344,"ŞCOALA PRIMARĂ SAT LUNCA VECHE","LUNCA VECHE",VS,76,2,1,0,3,3,1,0,4,4,1,0,5,6,1,0,7,6,4,0,10
164785,345,"ŞCOALA PRIMARĂ SAT FOCŞA",FOCŞA,VS,154,3,1,0,4,5,1,0,6,7,3,0,10,7,6,0,13,7,6,0,13
164767,346,"ŞCOALA PRIMARĂ SAT BROSCOŞEŞTI",BROSCOŞEŞTI,VS,400,2,1,0,3,4,3,0,7,7,3,0,10,7,3,0,10,9,3,0,12
164838,347,"ŞCOALA GIMNAZIALĂ NR.1,SAT MĂLUȘTENI",MĂLUŞTENI,VS,504,4,0,0,4,4,0,0,4,7,2,0,9,8,3,0,11,9,3,0,12
164883,348,"ŞCOALA CENTRU ȚUȚCANI",ŢUŢCANI,VS,437,7,0,0,7,8,1,0,9,8,2,0,10,11,3,0,14,12,3,0,15
164865,349,"ŞCOALA MÎNĂSTIREA",MÎNĂSTIREA,VS,83,0,0,0,0,3,2,0,5,4,2,0,6,4,2,0,6,4,2,0,6
164847,350,"ŞCOALA GHIREASCA",GHIREASCA,VS,155,0,0,0,0,0,0,0,0,0,0,0,0,0,0,0,0,0,0,0,0
164856,351,"SALA FESTIVITĂȚI LUPEȘTI",LUPEŞTI,VS,345,1,1,0,2,1,1,0,2,2,1,0,3,3,1,0,4,4,1,0,5
164874,352,"ŞCOALA PRIMARĂ MÎNZĂTEȘTI",MÎNZĂTEŞTI,VS,278,2,2,0,4,3,2,0,5,7,2,0,9,9,2,0,11,9,2,0,11
164909,353,"CĂMINUL CULTURAL MICLEŞTI",MICLEŞTI,VS,786,24,3,0,27,38,3,0,41,41,6,0,47,45,6,0,51,50,6,0,56
164918,354,"ŞCOALA GIMNAZIALĂ CHIRCEŞTI-DEAL",CHIRCEŞTI,VS,571,5,2,0,7,8,3,0,11,16,6,0,22,19,6,0,25,21,6,0,27
164918,355,"ŞCOALA DEZAFECTATĂ CHIRCEŞTI -VALE",CHIRCEŞTI,VS,369,6,2,0,8,12,4,0,16,13,4,0,17,20,4,0,24,25,4,0,29
164927,356,"ŞCOALA PRIMARĂ POPEŞTI",POPEŞTI,VS,366,6,0,0,6,9,1,0,10,15,2,0,17,25,3,0,28,32,3,0,35
164945,357,"SALA DE EDUCAŢIE FIZICĂ ŞCOLARĂ MUNTENII DE JOS","MUNTENII DE JOS",VS,1830,9,0,0,9,20,1,0,21,36,1,130,167,48,1,130,179,52,1,130,183
164963,358,"ŞCOALA PRIMARĂ SATMÎNJEŞTI",MÎNJEŞTI,VS,649,7,3,0,10,13,4,0,17,18,4,126,148,24,6,126,156,24,6,126,156
164954,359,"ŞCOALA PRIMARĂ SATBĂCĂOANI",BĂCĂOANI,VS,1048,6,5,0,11,7,5,0,12,9,11,169,189,12,11,169,192,14,11,169,194
166217,360,"ŞCOALA GIMNAZIALĂ ""ION AGARICI"", MUNTENII DE SUS","MUNTENII DE SUS",VS,1210,2,0,0,2,6,0,0,6,10,0,0,10,18,0,0,18,18,0,0,18
166226,361,"ŞCOALA PRIMARĂ, SATU-NOU","SATU NOU",VS,1152,6,1,0,7,13,2,0,15,18,2,0,20,21,3,0,24,22,3,0,25
166226,362,"SCOALA PRIMARA, SATU NOU","SATU NOU",VS,994,2,0,0,2,10,0,0,10,11,0,0,11,14,0,0,14,17,0,0,17
165078,363,"ŞCOALA PRIMARĂ OLTENEŞTI",OLTENEŞTI,VS,394,5,1,0,6,7,4,0,11,11,6,0,17,15,6,0,21,16,7,0,23
165121,364,"ŞCOALA PRIMARĂ ZGURA",ZGURA,VS,69,2,4,0,6,2,4,0,6,4,4,0,8,8,4,0,12,9,4,0,13
165087,365,"ŞCOALA PRIMARĂ CURTENI",CURTENI,VS,165,2,0,0,2,3,0,0,3,6,1,0,7,8,5,0,13,15,5,0,20
165112,366,"ŞCOALA GIMNAZIALA GRIGORE ŞT. RĂILEANU VINEŢEŞTI",VINEŢEŞTI,VS,528,4,2,0,6,9,2,0,11,13,4,0,17,19,4,0,23,24,4,0,28
165103,367,"ŞCOALA GIMNAZIALĂ CONSTANTIN ROTARU TÎRZII",TÎRZII,VS,868,11,3,0,14,24,3,0,27,37,4,0,41,57,4,0,61,59,4,0,63
165096,368,"ŞCOALA PRIMARĂ PÎHNA",PÎHNA,VS,121,7,0,0,7,16,0,0,16,24,3,0,27,26,6,0,32,29,7,0,36
165149,369,"ŞCOALA GIMNAZIALĂ ''MIHAI EMINESCU'' SAT OŞEŞTI",OŞEŞTI,VS,1016,3,1,0,4,11,2,0,13,18,2,0,20,21,3,0,24,26,3,0,29
165158,370,"ŞCOALA GIMNAZIALĂ ”LUIZA ZAVLOSCHI” SAT BUDA",BUDA,VS,1092,4,0,0,4,7,0,0,7,12,1,0,13,14,1,0,15,15,1,0,16
165167,371,"ŞCOALA PRIMARĂ SAT PĂDURENI",PĂDURENI,VS,251,0,0,0,0,2,0,0,2,3,0,0,3,7,0,0,7,7,0,0,7
165194,372,"ŞCOALA GIMNAZIALA NR.1 PĂDURENI",PĂDURENI,VS,1014,9,0,0,9,14,0,0,14,18,0,0,18,25,0,0,25,28,0,0,28
165247,373,"ŞCOALA PRIMARA RUSCA",RUSCA,VS,535,2,4,0,6,4,6,0,10,8,6,0,14,10,6,0,16,11,6,0,17
165210,374,"ŞCOALA PRIMARA DAVIDEŞTI",DAVIDEŞTI,VS,414,6,0,0,6,8,2,0,10,15,2,0,17,16,4,0,20,16,4,0,20
165229,375,"ŞCOALA PRIMARA IVĂNEŞTI",IVĂNEŞTI,VS,346,2,3,0,5,3,4,0,7,5,5,0,10,11,5,0,16,11,5,0,16
165265,376,"ŞCOALA PRIMARA VĂLENI",VĂLENI,VS,871,12,4,0,16,27,6,0,33,32,9,0,41,35,9,0,44,37,9,0,46
165283,377,"ŞCOALA GIMNAZIALĂ PERIENI - CENTRU",PERIENI,VS,1264,7,1,0,8,11,2,0,13,15,3,0,18,18,3,0,21,18,3,0,21
165283,378,"ŞCOALA PRIMARĂ PERIENI - SATUL NOU",PERIENI,VS,1193,7,2,0,9,8,2,0,10,12,2,0,14,20,2,0,22,20,2,0,22
165283,379,"ŞCOALA PRIMARĂ PERIENI - VALE",PERIENI,VS,462,4,6,0,10,4,7,0,11,5,7,0,12,7,7,0,14,8,7,0,15
166556,380,"P.A.P.I. - ACCES INTERNET, BORODEŞTI",BORODEŞTI,VS,216,6,4,0,10,7,4,0,11,10,7,0,17,10,7,0,17,10,7,0,17
166592,381,"ȘCOALAPRIMARĂ POCHIDIA",POCHIDIA,VS,367,3,0,0,3,12,5,0,17,14,13,0,27,17,18,0,35,18,19,0,37
166618,382,"ŞCOALA GIMNAZIALĂ NR.1 , SĂLCENI",SĂLCENI,VS,784,5,0,0,5,20,0,0,20,22,1,0,23,31,1,0,32,35,2,0,37
165425,383,"ŞCOALA GIMNAZIALA NR. 1 POGANA",POGANA,VS,641,2,0,0,2,14,10,0,24,14,10,0,24,28,10,0,38,30,17,0,47
165461,384,"ŞCOALAGIMNAZIALA SAT TOMEŞTI",TOMEŞTI,VS,728,2,0,0,2,5,0,0,5,7,0,0,7,9,0,0,9,9,0,0,9
165434,385,"ŞCOALAGIMNAZIALA SATBOGEŞTI",BOGEŞTI,VS,565,1,1,0,2,4,1,27,32,8,1,27,36,9,4,27,40,10,4,27,41
165452,386,"ŞCOALAGIMNAZIALA SATMĂSCUREI",MĂSCUREI,VS,551,3,0,0,3,11,0,0,11,12,0,0,12,22,0,0,22,23,0,0,23
164570,387,"SCOALA GIMNAZIALA ""DIMITRIE NEGRUTIU""",POGONEŞTI,VS,1232,6,0,0,6,16,0,0,16,24,1,0,25,28,1,0,29,32,1,0,33
164589,388,"SALA TINERETULUI",POLOCIN,VS,160,1,0,0,1,3,2,0,5,6,2,0,8,7,4,0,11,7,4,0,11
165363,389,"ŞCOALA GIMNAZIALA, FLOREŞTI",FLOREŞTI,VS,424,1,0,0,1,4,0,0,4,5,0,0,5,13,5,0,18,15,5,0,20
165345,390,"CĂMIN CULTURAL POIENEŞTI",POIENEŞTI,VS,716,2,1,0,3,5,2,0,7,7,2,0,9,8,2,0,10,11,2,0,13
165390,391,"ŞCOALA OPRIŞIŢA",OPRIŞIŢA,VS,691,5,0,0,5,14,0,0,14,21,0,0,21,27,0,0,27,27,0,0,27
165372,392,"ŞCOALA FRASINU",FRASINU,VS,293,0,0,0,0,2,0,0,2,4,1,0,5,4,2,0,6,4,5,0,9
165407,393,"ŞCOALA POIENEŞTI DEAL",POIENEŞTI-DEAL,VS,93,0,0,0,0,0,2,0,2,0,3,0,3,3,7,0,10,3,7,0,10
165381,394,"ŞCOALA FUNDU VĂII","FUNDU VĂII",VS,67,1,4,0,5,2,5,0,7,5,5,0,10,6,5,0,11,6,5,0,11
165489,395,"LICEUL TEHNOLOGIC, SAT PUIEŞTI",PUIEŞTI,VS,1151,17,1,0,18,19,2,0,21,23,2,0,25,27,2,0,29,28,2,0,30
165577,396,"ŞCOALA PRIMARĂ,SAT IEZER",IEZER,VS,231,0,1,0,1,0,1,0,1,0,1,0,1,2,2,0,4,2,4,0,6
165568,397,"ŞCOALA PRIMARĂ,SAT GÎLŢEŞTI",GÎLŢEŞTI,VS,114,0,0,0,0,0,0,0,0,0,0,0,0,4,0,0,4,6,0,0,6
165602,398,"ŞCOALA PRIMARĂ,SAT RUŞI",RUŞI,VS,301,4,0,0,4,4,2,0,6,6,2,0,8,7,2,0,9,8,2,0,10
165540,399,"ŞCOALA PRIMARĂ, SAT FÎNTÎNELE",FÎNTÎNELE,VS,90,1,0,0,1,3,5,0,8,3,5,0,8,8,7,0,15,11,12,0,23
165513,400,"ŞCOALA PRIMARĂ, SAT CĂLIMĂNEŞTI",CĂLIMĂNEŞTI,VS,278,7,0,0,7,10,1,0,11,16,2,0,18,17,2,0,19,18,3,0,21
165559,401,"ŞCOALA PRIMARĂ, SAT FULGU",FULGU,VS,120,0,0,0,0,0,4,0,4,7,4,0,11,9,8,0,17,12,11,0,23
165586,402,"ŞCOALA GIMNAZIALĂ, SAT LĂLEŞTI",LĂLEŞTI,VS,377,5,0,0,5,7,0,0,7,10,0,0,10,22,0,0,22,23,0,0,23
165531,403,"ŞCOALA PRIMARĂ, SAT CRISTEŞTI",CRISTEŞTI,VS,361,1,0,0,1,5,2,0,7,5,3,0,8,7,3,0,10,7,3,0,10
165522,404,"ŞCOALA PRIMARĂ, SAT CETĂŢUIA",CETĂŢUIA,VS,309,0,0,0,0,3,0,0,3,3,0,0,3,6,0,0,6,11,2,0,13
165595,405,"ŞCOALA PRIMARĂ, SAT ROTARI",ROTARI,VS,83,3,1,0,4,6,1,0,7,7,2,0,9,9,2,0,11,9,2,0,11
165498,406,"ŞCOALA PRIMARĂ, SAT BĂRTĂLUŞ -MOCANI",BĂRTĂLUŞ-MOCANI,VS,209,0,0,0,0,0,1,0,1,2,1,0,3,4,1,0,5,5,5,0,10
165620,407,"ŞCOALA GIMNAZIALA NR. 1 , SATPUNGEŞTI",PUNGEŞTI,VS,765,4,1,0,5,11,1,0,12,13,1,0,14,24,3,0,27,24,3,0,27
165693,408,"ŞCOALA PRIMARA,SAT STEJARU",STEJARU,VS,190,1,0,0,1,5,0,0,5,5,0,0,5,9,1,0,10,10,1,0,11
165684,409,"ŞCOALA PRIMARA,SATSILIŞTEA",SILIŞTEA,VS,203,0,0,0,0,0,0,0,0,2,0,0,2,5,0,0,5,5,0,0,5
165639,410,"ŞCOALA PRIMARA, SAT ARMÃŞOAIA",ARMĂŞOAIA,VS,446,3,0,0,3,9,2,0,11,12,2,0,14,17,2,0,19,17,2,0,19
165700,411,"ŞCOALAPRIMARA,SATTOPORĂŞTI",TOPORĂŞTI,VS,521,7,0,0,7,9,0,0,9,16,2,0,18,24,3,0,27,25,3,0,28
165648,412,"ŞCOALA PRIMARA,SAT CURSEŞTI DEAL",CURSEŞTI-DEAL,VS,173,1,0,0,1,3,0,0,3,4,0,0,4,7,2,0,9,7,2,0,9
165657,413,"ŞCOALA PRIMARA, SAT CURSEŞTI VALE",CURSEŞTI-VALE,VS,207,1,0,0,1,2,0,0,2,2,1,0,3,3,2,0,5,4,2,0,6
164632,414,"ŞCOALA GIMNAZIALA NR. 1 PUŞCAŞI",PUŞCAŞI,VS,1170,9,2,0,11,14,2,0,16,25,2,0,27,30,4,0,34,34,4,0,38
164623,415,"ŞCOALA PRIMARA POIANA LUI ALEXA","POIANA LUI ALEXA",VS,263,1,0,0,1,10,2,0,12,14,2,0,16,18,4,0,22,18,4,0,22
164669,416,"SCOALA PRIMARA TEIŞORU",TEIŞORU,VS,415,6,4,0,10,9,4,0,13,16,4,0,20,27,4,0,31,29,4,0,33
164678,417,"ŞCOALA PRIMARA VALEA TÂRGULUI","VALEA TÂRGULUI",VS,131,1,0,0,1,4,0,0,4,5,0,0,5,9,0,0,9,9,0,0,9
164632,418,"SCOALA GIMNAZIALA NR. 1 PUSCASI",PUŞCAŞI,VS,946,6,3,0,9,11,3,0,14,16,3,0,19,22,5,0,27,25,5,0,30
166477,419,"GRĂDINIŢA CU PROGRAM NORMAL, RAFAILA",RAFAILA,VS,1476,3,0,0,3,10,0,0,10,12,0,0,12,16,0,0,16,19,0,0,19
165728,420,"ŞCOALA GIMNAZIALĂ REBRICEA",REBRICEA,VS,448,3,0,0,3,3,2,0,5,4,3,0,7,5,3,0,8,5,3,0,8
165755,421,"CĂMINUL CULTURAL, DRAXENI",DRAXENI,VS,659,31,0,0,31,47,1,0,48,74,2,0,76,92,7,0,99,97,7,0,104
165782,422,"ŞCOALA PRIMARĂ SASOVA",SASOVA,VS,240,5,0,0,5,7,0,0,7,12,7,0,19,18,8,0,26,18,8,0,26
165808,423,"ŞCOALA PRIMARĂ TUFEŞTII DE JOS","TUFEŞTII DE JOS",VS,315,4,4,0,8,8,9,0,17,16,9,0,25,31,9,0,40,31,9,0,40
165737,424,"ŞCOALA PRIMARĂ BOLAŢI",BOLAŢI,VS,154,15,2,0,17,36,8,0,44,47,17,0,64,55,19,0,74,56,20,0,76
165746,425,"ŞCOALA PRIMARĂ CRĂCIUNEŞTI",CRĂCIUNEŞTI,VS,239,5,0,0,5,6,0,0,6,8,1,0,9,16,1,0,17,16,3,0,19
165791,426,"ŞCOALA PRIMARĂ TATOMIREŞTI",TATOMIREŞTI,VS,252,4,2,0,6,8,2,0,10,9,2,0,11,10,4,0,14,10,4,0,14
165773,427,"ŞCOALA PRIMARĂ RATEŞU-CUZEI","RATEŞU CUZEI",VS,440,2,0,0,2,7,2,0,9,11,2,0,13,17,2,0,19,18,2,0,20
165826,428,"ŞCOALA GIMNAZIALĂ ""VENIAMIN COSTACHI"" , ROŞIEŞTI",ROŞIEŞTI,VS,951,10,1,0,11,15,1,0,16,17,1,0,18,28,4,0,32,30,7,0,37
165880,429,"ŞCOALA PRIMARĂ VALEA LUI DARIE","VALEA LUI DARIE",VS,477,12,3,0,15,20,4,0,24,28,4,0,32,37,4,0,41,37,5,0,42
165862,430,"ŞCOALA PRIMARĂ IDRICI",IDRICI,VS,329,2,3,0,5,9,7,0,16,11,7,0,18,13,7,0,20,13,7,0,20
165853,431,"ŞCOALA PRIMARĂ GURA IDRICI","GURA IDRICI",VS,362,2,1,0,3,3,2,0,5,5,2,0,7,10,5,0,15,10,5,0,15
165844,432,"GRĂDINIȚA CU PROGRAM NORMAL GARA ROŞIEŞTI","GARA ROŞIEŞTI",VS,317,4,0,0,4,7,1,0,8,12,1,0,13,13,1,0,14,15,1,0,16
165871,433,"ŞCOALA PRIMARĂ REDIU",REDIU,VS,142,0,0,0,0,1,4,0,5,3,4,0,7,4,6,0,10,5,6,0,11
165906,435,"BIBLIOTECA ”ELENA CUZA” DIN LOCALITATEA SOLEȘTI",SOLEŞTI,VS,928,10,0,0,10,14,11,0,25,17,13,0,30,27,13,0,40,30,13,0,43
165915,436,"FOSTA ŞCOALACU CLASELE I-IV BOUȘORI",BOUŞORI,VS,212,0,1,0,1,3,1,0,4,4,2,0,6,10,3,0,13,11,3,0,14
165924,437,"GRĂDINIȚA CU PROGRAM NORMAL IAZ",IAZ,VS,284,2,2,0,4,3,2,0,5,6,2,0,8,10,2,0,12,13,2,0,15
165933,438,"GRĂDINIȚA CU PROGRAM NORMAL SATUNOU","SATU NOU",VS,308,5,2,0,7,9,2,0,11,11,2,0,13,18,2,0,20,19,2,0,21
165942,439,"ŞCOALA GIMNAZIALĂ ȘERBOTEȘTI",ŞERBOTEŞTI,VS,615,4,0,0,4,10,0,0,10,13,0,0,13,14,0,0,14,16,0,0,16
165951,440,"GRĂDINIȚA CU PROGRAM NORMAL ȘTIOBORĂNI",ŞTIOBORĂNI,VS,292,1,0,0,1,4,2,0,6,8,3,0,11,8,3,0,11,15,3,0,18
165960,441,"FOSTA ŞCOALA CU CLASELE I-IVVALEA SILIȘTEI","VALEA SILIŞTEI",VS,238,5,1,0,6,9,3,0,12,11,5,0,16,15,6,0,21,17,6,0,23
165988,442,"ŞCOALA GIMNAZIALĂ NR. 1, CORP B",STĂNILEŞTI,VS,1417,10,0,0,10,16,1,0,17,24,1,0,25,25,2,0,27,28,2,0,30
165988,443,"ŞCOALA GIMNAZIALĂ NR. 1, CORP B",STĂNILEŞTI,VS,875,7,0,0,7,9,0,0,9,12,0,0,12,18,0,0,18,19,0,0,19
165997,444,"ŞCOALA PRIMARĂ, BOGDANA - VOLOSENI",BOGDANA-VOLOSENI,VS,126,3,3,0,6,3,5,0,8,5,5,0,10,5,5,0,10,5,6,0,11
166002,445,"ŞCOALA PRIMARĂ, BUDU - CANTEMIR","BUDU CANTEMIR",VS,225,0,0,0,0,1,0,0,1,2,0,0,2,4,0,0,4,6,0,0,6
166011,446,"ŞCOALA PRIMARĂ, CHERSĂCOSU",CHERSĂCOSU,VS,415,1,3,0,4,2,3,0,5,4,3,0,7,9,4,0,13,9,4,0,13
166020,447,"GRĂDINIŢA CU PROGRAM NORMAL, GURA VĂII","GURA VĂII",VS,377,2,0,0,2,8,0,0,8,16,4,0,20,18,4,0,22,22,4,0,26
166039,448,"ŞCOALA GIMNAZIALĂ, POGĂNEŞTI",POGĂNEŞTI,VS,886,3,4,0,7,11,4,0,15,23,10,0,33,46,13,0,59,49,13,0,62
166066,449,"CĂMINUL CULTURAL, ŞTEFAN CEL MARE","ŞTEFAN CEL MARE",VS,602,1,3,0,4,4,3,0,7,10,3,0,13,18,3,0,21,28,4,0,32
166075,450,"CĂMINUL CULTURAL BÎRZEŞTI",BÎRZEŞTI,VS,1003,8,0,0,8,15,0,0,15,25,0,0,25,28,0,0,28,32,1,0,33
166119,451,"ŞCOALA PRIMARA ""CONSTANTIN MANOILESCU"" MARASENI",MĂRĂŞENI,VS,731,3,5,0,8,5,5,0,10,12,5,0,17,14,5,0,19,15,6,0,21
166084,452,"ŞCOALA PRIMARA, BRĂHĂŞOAIA",BRĂHĂŞOAIA,VS,429,7,3,0,10,12,3,0,15,16,3,0,19,18,3,0,21,19,3,0,22
166146,453,"CĂMINUL CULTURAL ""VIRGIL CARAIVAN"" ŞULETEA",ŞULETEA,VS,930,8,0,0,8,11,0,0,11,18,0,0,18,23,0,0,23,29,0,0,29
166155,454,"ŞCOALA PRIMARĂ ""NATALIA ŞI DUMITRU CIOBANU""",FEDEŞTI,VS,484,3,0,0,3,4,0,0,4,6,0,0,6,11,0,0,11,13,0,0,13
166164,455,"ŞCOALA PRIMARĂ ""DUMITRU BAHRIM""",JIGĂLIA,VS,187,3,1,0,4,6,1,0,7,10,1,0,11,13,1,0,14,13,1,0,14
166173,456,"ŞCOALA PRIMARĂ RĂŞCANI",RĂŞCANI,VS,201,1,4,0,5,2,4,0,6,3,5,0,8,3,5,0,8,3,5,0,8
166191,457,"ŞCOALA GIMNAZIALĂ NR. 1 SAT. TANACU",TANACU,VS,1306,11,1,0,12,28,4,0,32,39,8,0,47,46,11,0,57,49,16,0,65
166208,458,"ŞCOALA PRIMARĂ SAT. BENEŞTI",BENEŞTI,VS,283,2,0,0,2,5,1,0,6,10,4,0,14,14,10,0,24,14,10,0,24
166244,459,"CĂMINUL CULTURAL TĂCUTA",TĂCUTA,VS,670,7,0,0,7,22,2,0,24,26,4,0,30,29,4,0,33,32,4,0,36
166262,460,"ŞCOALA PRIMARĂ DUMASCA",DUMASCA,VS,243,3,5,0,8,3,5,0,8,3,5,0,8,3,6,0,9,4,6,0,10
166280,461,"ŞCOALA PRIMARĂ MIRCEŞTI",MIRCEŞTI,VS,211,0,1,0,1,0,1,0,1,0,2,0,2,1,3,0,4,2,4,0,6
166271,462,"ŞCOALA GIMNAZIALĂ FOCŞEAŞCA",FOCŞEAŞCA,VS,624,1,0,0,1,2,0,0,2,4,0,0,4,5,0,0,5,11,0,0,11
166299,463,"ŞCOALA GIMNAZIALĂ PROTOPOPEŞTI",PROTOPOPEŞTI,VS,685,9,3,0,12,12,3,0,15,16,3,0,19,17,3,0,20,17,3,0,20
166360,464,"SCOALA PRIMARA - SAT.LEOSTI",LEOŞTI,VS,261,1,0,0,1,2,0,0,2,4,2,0,6,14,2,0,16,16,2,0,18
166324,465,"CĂMINUL CULTURAL TĂTĂRĂNI",TĂTĂRĂNI,VS,614,2,2,0,4,5,2,0,7,6,4,0,10,14,6,0,20,14,6,0,20
166333,466,"ŞCOALA GIMNAZIALA ,,ION ANGHELUTA'' - SAT BALTATI",BĂLŢAŢI,VS,469,7,2,0,9,14,3,0,17,18,4,0,22,22,4,0,26,22,4,0,26
166388,467,"SCOALA PRIMARA - SAT STROIESTI",STROIEŞTI,VS,287,4,0,0,4,7,2,0,9,10,5,0,15,12,7,0,19,12,7,0,19
166486,468,"ŞCOALA PRIMARA SATSILIŞTEA",SILIŞTEA,VS,291,5,0,0,5,6,0,0,6,6,0,0,6,10,6,0,16,11,7,0,18
166422,469,"ŞCOALA GIMNAZIALA ”GH.CIOATĂ” TODIREŞTI",TODIREŞTI,VS,764,5,0,0,5,14,3,0,17,16,4,0,20,17,4,0,21,17,4,0,21
166431,470,"ANEXA BISERICII SF.,, MIHAIL ȘI GAVRIL""",COTIC,VS,244,6,3,0,9,8,4,0,12,9,4,0,13,11,4,0,15,11,4,0,15
166440,471,"ŞCOALA PRIMARA SAT DRĂGEŞTI",DRĂGEŞTI,VS,299,1,0,0,1,8,0,0,8,10,0,0,10,11,0,0,11,11,0,0,11
166459,472,"ŞCOALA PRIMARA SATHUC",HUC,VS,472,2,3,0,5,6,3,0,9,10,4,0,14,10,4,0,14,14,4,0,18
166468,473,"ŞCOALA PRIMARA SATPLOPOASA",PLOPOASA,VS,190,2,0,0,2,5,0,0,5,12,0,0,12,14,1,0,15,14,4,0,18
166495,474,"ŞCOALA PRIMARA SAT SOFRONEŞTI",SOFRONEŞTI,VS,121,1,0,0,1,1,1,0,2,4,1,0,5,7,1,0,8,7,1,0,8
166501,475,"ŞCOALA PRIMARA SAT VALEA -POPII","VALEA POPII",VS,94,3,3,0,6,7,3,0,10,15,4,0,19,16,5,0,21,16,5,0,21
166510,476,"ŞCOALA PRIMARA SAT VIIŞOARA",VIIŞOARA,VS,95,1,0,0,1,2,0,0,2,2,0,0,2,2,0,0,2,2,0,0,2
166538,477,"CĂMINUL CULTURAL TUTOVA",TUTOVA,VS,1104,7,3,0,10,30,4,0,34,39,8,0,47,50,8,0,58,54,10,0,64
166547,478,"ŞCOALA GIMNAZIALA BADEANA",BĂDEANA,VS,1144,4,0,0,4,7,1,0,8,16,2,0,18,27,5,0,32,29,5,0,34
166583,479,"CĂMINUL CULTURAL CRIVESTI",CRIVEŞTI,VS,369,4,3,0,7,8,5,0,13,11,7,0,18,14,8,0,22,16,9,0,25
166565,480,"ŞCOALA CIORTOLOM",CIORTOLOM,VS,143,5,5,0,10,5,5,0,10,5,5,0,10,7,5,0,12,7,5,0,12
166574,481,"ŞCOALA COROIU",COROIU,VS,160,4,7,0,11,9,10,0,19,11,11,0,22,14,12,0,26,14,12,0,26
166627,482,"ŞCOALA VIZURENI",VIZURENI,VS,141,0,0,0,0,1,4,0,5,3,4,0,7,4,6,0,10,4,6,0,10
166645,483,"ŞCOALA GIMNAZIALĂ NR. 1 SAT VĂLENI COM VĂLENI",VĂLENI,VS,1366,11,0,0,11,21,0,0,21,25,0,0,25,28,0,0,28,28,0,0,28
166645,484,"ŞCOALA GIMNAZIALĂ NR. 1 SAT VĂLENI COM. VĂLENI",VĂLENI,VS,1370,5,0,0,5,15,0,0,15,18,0,0,18,18,0,0,18,18,0,0,18
166663,485,"ŞCOALA PRIMARĂ SAT MOARA DOMNEASCĂ","MOARA DOMNEASCĂ",VS,1313,6,0,0,6,12,0,0,12,18,0,0,18,22,0,0,22,23,0,0,23
166681,486,"CĂMIN CULTURAL VETRIȘOAIA",VETRIŞOAIA,VS,1559,4,1,0,5,10,1,0,11,28,2,0,30,29,2,0,31,29,2,0,31
166681,487,"LICEUL TEHNOLOGIC ”PETRU RAREȘ” VETRIȘOAIA",VETRIŞOAIA,VS,850,5,0,0,5,6,0,0,6,10,1,0,11,12,2,0,14,12,2,0,14
166690,488,"ȘCOALA BUMBĂTA",BUMBĂTA,VS,100,1,0,0,1,4,0,0,4,15,2,0,17,18,3,0,21,18,3,0,21
166716,489,"CAMIN CULTURAL, SAT VIIȘOARA",VIIŞOARA,VS,963,10,1,0,11,16,2,0,18,22,3,0,25,30,9,0,39,35,10,0,45
166734,490,"ȘCOALA PRIMARĂ HALTA DODEȘTI","HALTA DODEŞTI",VS,166,3,5,0,8,4,6,0,10,5,6,0,11,7,8,0,15,9,8,0,17
166752,491,"ȘCOALA PRIMARĂ VĂLENI",VĂLENI,VS,108,3,0,0,3,5,0,0,5,9,1,0,10,15,5,0,20,15,5,0,20
166761,492,"ȘCOALA PRIMARĂ VILTOTEȘTI",VILTOTEŞTI,VS,163,4,0,0,4,5,0,0,5,9,0,0,9,12,4,0,16,13,4,0,17
166789,493,"ŞCOALA GIMNAZIALA NR.1, VINDEREI",VINDEREI,VS,770,7,0,0,7,17,0,0,17,29,0,0,29,36,4,0,40,37,4,0,41
166798,494,"ŞCOALA PRIMARA, BRADESTI",BRĂDEŞTI,VS,454,5,1,0,6,7,2,0,9,10,4,0,14,15,4,0,19,15,4,0,19
166805,495,"ŞCOALA GIMNAZIALA, DOCANI",DOCANI,VS,495,0,1,0,1,1,1,0,2,4,2,0,6,6,2,0,8,10,3,0,13
166814,496,"ŞCOALA PRIMARA DOCANEASA",DOCĂNEASA,VS,390,6,1,0,7,6,1,0,7,6,1,0,7,6,1,0,7,8,1,0,9
166841,497,"ŞCOALA GIMNAZIALA OBIRSENI",OBÎRŞENI,VS,739,5,0,0,5,10,0,0,10,18,2,0,20,24,5,0,29,28,5,0,33
166850,498,"ŞCOALA PRIMARA VALEA LUNGĂ","VALEA LUNGĂ",VS,394,8,0,0,8,15,3,0,18,19,3,0,22,19,4,0,23,20,5,0,25
166878,499,"ȘCOALA GIMNAZIALĂ NR.1 VOINEȘTI",VOINEŞTI,VS,310,1,0,0,1,1,0,0,1,2,0,0,2,3,0,0,3,3,0,0,3
166887,500,"ȘCOALA PRIMARĂ SAT AVRĂMEȘTI",AVRĂMEŞTI,VS,526,0,0,0,0,0,0,0,0,2,0,0,2,6,0,0,6,6,0,0,6
166921,501,"ȘCOALA PRIMARĂ MĂRĂȘEȘTI",MĂRĂŞEŞTI,VS,172,2,0,0,2,7,0,0,7,7,2,0,9,9,3,0,12,11,4,0,15
166896,502,"ȘCOALA PRIMARĂ BĂNCEȘTI",BĂNCEŞTI,VS,151,0,0,0,0,3,0,0,3,3,0,0,3,5,0,0,5,5,0,0,5
166967,503,"ȘCOALA PRIMARĂ STÎNCĂȘENI",STÎNCĂŞENI,VS,161,2,0,0,2,3,0,0,3,4,2,0,6,5,2,0,7,5,2,0,7
166912,504,"ȘCOALA GIMNAZIALĂ GÎRDEȘTI",GÎRDEŞTI,VS,483,0,0,0,0,4,0,0,4,13,0,0,13,25,0,0,25,42,0,0,42
166930,505,"ȘCOALA PRIMARĂ OBÎRȘENI",OBÎRŞENI,VS,283,2,0,0,2,3,0,0,3,5,0,0,5,6,0,0,6,6,0,0,6
166949,506,"ȘCOALA GIMNAZIALĂ OBÎRȘENII LINGURARI","OBÎRŞENII LINGURARI",VS,656,2,0,0,2,2,0,0,2,2,0,0,2,2,0,0,2,2,0,0,2
166994,507,"SCOALA GIMNAZIALA ""NICOLAIE CIUBOTARU"" VULTUREŞTI",VULTUREŞTI,VS,833,10,2,0,12,17,2,0,19,22,2,0,24,30,5,0,35,31,5,0,36
167008,508,"CĂMINUL CULTURAL BUHĂIEŞTI",BUHĂIEŞTI,VS,638,7,2,0,9,14,5,0,19,17,6,0,23,22,6,0,28,26,6,0,32
167026,509,"GRADINITA CU PROGRAM NORMAL VOINEŞTI",VOINEŞTI,VS,291,5,3,0,8,6,3,0,9,9,3,0,12,10,4,0,14,13,4,0,17
167044,510,"ŞCOALA GIMNAZIALĂ NR.1, VUTCANI",VUTCANI,VS,1124,3,0,0,3,9,0,0,9,19,3,0,22,29,7,0,36,34,7,0,41
167053,511,"ŞCOALA PRIMARĂ MĂLĂIEŞTI",MĂLĂIEŞTI,VS,255,6,3,0,9,14,4,0,18,14,4,0,18,16,4,0,20,16,4,0,20
167062,512,"ŞCOALA PRIMARĂ POŞTA-ELAN","POŞTA ELAN",VS,128,0,0,0,0,4,0,0,4,8,0,0,8,11,0,0,11,11,0,0,11
167080,513,"CĂMINUL CULTURAL ZĂPODENI",ZĂPODENI,VS,1190,11,0,0,11,25,5,0,30,30,6,0,36,39,7,0,46,40,7,0,47
167106,514,"ȘCOALA PRIMARĂ,SAT CIOFENI",CIOFENI,VS,114,3,0,0,3,6,1,0,7,14,4,0,18,17,4,0,21,17,4,0,21
167142,515,"ȘCOALA PRIMARĂ, SAT PORTARI",PORTARI,VS,503,8,2,0,10,11,2,0,13,16,2,0,18,19,2,0,21,20,2,0,22
167115,516,"ȘCOALA PRIMARĂ, SAT DELEA",DELEA,VS,167,3,1,0,4,4,1,0,5,7,2,0,9,9,3,0,12,9,3,0,12
167151,517,"ȘCOALA PRIMARĂ, SAT TELEJNA",TELEJNA,VS,304,7,1,0,8,8,2,0,10,8,2,0,10,12,2,0,14,13,2,0,15
167099,518,"ȘCOALA GIMNAZIALĂ, SAT BUTUCĂRIA",BUTUCĂRIA,VS,122,3,4,0,7,5,5,0,10,5,5,0,10,8,6,0,14,8,6,0,14
167124,519,"ȘCOALA PRIMARĂ, SAT DOBROSLOVEȘTI",DOBROSLOVEŞTI,VS,305,5,6,0,11,17,6,0,23,17,6,0,23,26,8,0,34,27,8,0,35
167160,520,"ȘCOALA PRIMARĂ, SAT UNCEȘTI",UNCEŞTI,VS,289,6,3,0,9,8,3,0,11,10,3,0,13,13,4,0,17,13,4,0,17
167188,521,"ŞCOALAGIMNAZIALĂ NR. 1 ZORLENI",ZORLENI,VS,1386,10,2,0,12,11,4,0,15,15,6,0,21,20,9,0,29,26,9,0,35
167188,522,"ŞCOALA GIMNAZIALĂ NR.1 ZORLENI",ZORLENI,VS,1359,10,0,0,10,26,2,0,28,41,2,0,43,43,2,0,45,44,2,0,46
167188,523,"ŞCOALA GIMNAZIALĂNR. 2 ZORLENI",ZORLENI,VS,1470,5,0,0,5,7,2,0,9,12,3,0,15,16,3,0,19,17,4,0,21
167197,524,"IMOBIL PROPRIETATE MUNTIANU VASILE-VIRGILIU","DEALU MARE",VS,207,1,0,0,1,5,5,0,10,6,5,0,11,8,6,0,14,8,6,0,14
167213,525,"ŞCOALAPRIMARĂ SATSIMILA",SIMILA,VS,1051,4,1,0,5,10,1,0,11,18,6,0,24,27,8,0,35,40,9,0,49
167204,526,"ŞCOALA GIMNAZIALĂ NR. 3 POPENI",POPENI,VS,1152,9,2,0,11,22,8,0,30,30,8,0,38,38,11,0,49,39,11,0,50
167204,527,"ŞCOALA GIMNAZIALĂ NR. 3 POPENI",POPENI,VS,1044,10,3,0,13,16,9,0,25,19,9,0,28,23,15,0,38,27,15,0,42
